//ERB\EVENT_K\48 メアリー
PRINTFORMW ジュルルルッ…ちゅぽんっ	PRINTFORMW 啾噜噜噜…滋噗嗯~
PRINTFORMW 「おはようございます、%CNAMET(ARG, "二人称")%」	PRINTFORMW 「早上好、%CNAMET(ARG, "二人称")%」
PRINTFORMW 「こういうのがお好きかと思いまして」	PRINTFORMW 「我想您会喜欢这样的。」
PRINTFORMW 「それとも、もっと下品な方がよろしいですか？」	PRINTFORMW 「还是说、再下流一点比较好呢？」
PRINTFORML 「本日は体育でございますね、グラウンドではお気をつけください」	PRINTFORML 「今天是体育课吧、在球场上还请小心。」
PRINTFORML 「脚を掴まれるかもしれませんので」	PRINTFORML 「可能会被拌到脚」
PRINTFORMW 「%CNAMET(ARG, "対象")%様、%CNAMET(ARG, "二人称")%、こんにちは」	PRINTFORMW %CNAMET(ARG, "対象")%大人、%CNAMET(ARG, "二人称")%、你好
PRINTFORMW %CALLNAME:ARG%は%CNAMET(ARG, "対象")%が入室する前に挨拶してきた…	PRINTFORMW %CALLNAME:ARG%在%CNAMET(ARG, "対象")%入室之前被打招呼了…
PRINTFORMW （また階段でパンツを覗いていましたね）	PRINTFORMW （又在楼梯上督见胖次了）
PRINTFORMW こちらを見据えたまま何か言いたげに首を傾げている…	PRINTFORMW 凝视着这边、像是要说什么似的歪着头……
PRINTFORMW （どうやったら転んだ拍子に女生徒のパンツを脱がせるのですか？）	PRINTFORMW （怎样才能在摔倒的时候让女学生把胖次脱掉呢？）
PRINTFORMW 「お先にお邪魔しています」	PRINTFORMW 「我先告辞了」
PRINTFORML 部室の壁から煙が染み出すように人形が現れた	PRINTFORML 从部室的墙壁上冒出带污迹似的人形
PRINTFORMW 「おはようございます、少し眠っていました」	PRINTFORMW 「早上好、稍微睡了一会儿。」
PRINTFORMW 「遅くなりました」	PRINTFORMW 「我迟到了」
PRINTFORMW KOJO_GREETING_K33, %ARGS%(部室に先生がいる)	PRINTFORMW %ARGS%(部室に先生がいる)
PRINTFORML 「%CALLNAME:TARGET%と申します、%CALLNAME:MASTER%様の愛玩人形として参りました」	PRINTFORML 「我叫%CALLNAME:TARGET%、我是作为%CALLNAME:MASTER%大人的玩偶而来的。」
PRINTFORML 「動くのはあまり得意ではありませんので、皆様、どうかお手柔らかにお願いします」	PRINTFORML 「我不太擅长运动、请大家手下留情。」
PRINTFORML そう云うと%CALLNAME:TARGET%はゆっくりとカーテシーの姿勢を取り、メンバー達に改めて挨拶を行った	PRINTFORML 这么说来、%CALLNAME:TARGET%采取了慢节奏的谨慎的姿势、重新向成员们发出了打招呼
PRINTFORML KOJO_DAILY_K33, %CSTR:PREV_DAILYCOM%後	PRINTFORML KOJO_DAILY_K33,%CSTR:PREV_DAILYCOM%后
PRINTFORML KOJO_DAILY_K33, 質問１	PRINTFORML KOJO_DAILY_K33,问题1
PRINTFORML KOJO_DAILY_K33, 質問２	PRINTFORML KOJO_DAILY_K33,问题2
PRINTFORML %TEXTR("こちらを見据えたまま紅茶に角砂糖をゆっくりと入れている/頬杖をつきながら紅茶に角砂糖を一つ一つ指で粉々に砕きながら注いでいる/こちらを見据えたままティーカップの縁を軽くひっかき続けている")%	PRINTFORML %TEXTR("看着这边、把红茶里的角糖慢慢地放在杯子里/支着手、把红茶里的角糖一个一个地掰烂、倾注其中/轻佻地看着你、抓着茶杯的边缘")%
PRINTFORML 「ご存知ですか？学園の女子トイレで起きた不幸な事故のことを」	PRINTFORML 「您知道吗？在学园的女厕所里发生的不幸事故」
PRINTFORML 「他意はありません、ただの怪談話の一つです」	PRINTFORML 「没有别的意思、只是一个怪谈而已。」
PRINTFORM 紅茶を飲みながら%TEXTR("ゆったりとした所作で/お茶菓子を軽くつまみつつ/片手で角砂糖を弄びつつ")%	PRINTFORM 喝着红茶%TEXTR("看着电视剧《茶菓子》/、动作轻柔/一只手着玩弄方糖")%
PRINTFORM いつもの姿勢で%TEXTR("正面を見据えたまま/時折、視線を巡らせながら/目を閉じて/虚ろな目をしながら/どことなく気だるげな目をしながら")%	PRINTFORM 以平常的姿势%TEXTR("一直盯着前方/不时地转动着视线/闭目望着/眼神空洞无精打神地/眼神中总有种羞涩的感觉")%
PRINTFORML %TEXTR("静かに椅子に座っている/椅子に座っている")%	PRINTFORML %TEXTR("安静地坐在椅子上/坐在椅子上")%
PRINTFORML KOJO_SLEEP_K33, 汎用台詞(寝言３)	PRINTFORML KOJO_SLEEP_K33,通用台词(梦话3)
PRINTFORML KOJO_SLEEP_K33, 汎用台詞(寝言２)	PRINTFORML KOJO_SLEEP_K33,通用台词(梦话2)
PRINTFORML KOJO_SLEEP_K33, 汎用台詞(寝言１)	PRINTFORML KOJO_SLEEP_K33,通用台词(梦话1)
CALL DAILY_MESSAGE, "帰り道"	CALL DAILY_MESSAGE, "归途"
GREETING = こんばんは	GREETING = 晚上好
GREETING = こんにちは	GREETING = 你好
GREETING = おはようございます	GREETING = 早上好
PRINTFORMW 「暖かいですね、%CNAME("二人称")%は」	PRINTFORMW 「好暖和啊、是%CNAME("二人称")%呢」
//PRINTFORMW %CALLNAME:TARGET%は少し名残惜しそうにしながらいつもの姿勢に戻った;	PRINTFORMW %CALLNAME:TARGET%有点舍不得地又恢复了平常的姿势
それだけ云うと%CALLNAME:TARGET%はいつもの姿勢に戻ってしまった…	这么一说、%CALLNAME:TARGET%就恢复了姿势……
PRINTFORM 少し名残惜しそうにした後、	PRINTFORM 稍稍有些恋恋不舍之后、
PRINTFORMW 腕を離し、いつもの姿勢に戻った	PRINTFORMW 放开手臂、恢复了往常的姿势
PRINTFORMW %CALLNAME:TARGET%の唇は、人のそれとは違いひんやりとしている…	PRINTFORMW %CALLNAME:TARGET%的嘴唇、与人的嘴唇不同、是冰冷的……
PRINTFORMW 「…んっ……」	PRINTFORMW 「…嗯……」
PRINTFORMW 「こんにちは、%CNAME("二人称")%」	PRINTFORMW 「你好、是%CNAME("二人称")%啊」
PRINTFORMW 「挨拶にしては少々情熱的で御座いますね、もう一度されますか？」	PRINTFORMW 「作为打招呼有点不够热情呢、要再来一次吗？」
PRINTFORMW 「愛玩人形にする挨拶としては相応しい物かと」	PRINTFORMW 「作为玩偶的这种打招呼方式是合适的吗？」
PRINTFORMW 「そのままお使いになられますか？」	PRINTFORMW 「可以直接用吗？」
PRINTFORMW そう云いながら%CALLNAME:TARGET%は鎖骨の上に置いた指を滑らせた	PRINTFORMW 一边这么说着、%CALLNAME:TARGET%把放在锁骨上的手指滑了一下
PRINTFORMW 程よく色気を感じさせる首元に目が吸い寄せられてしまう…	PRINTFORMW 适当地使人觉得性感的脖子、目光被吸引了…
PRINTFORMW KOJO_DAILYCOM_K33, %ARGS%(%CALLNAME:MASTER%に先に挨拶された)	PRINTFORMW KOJO_DAILYCOM_K33,%ARGS%(先被%CALLNAME:MASTER%召唤)
PRINTFORMW 「ありがとうございます」	PRINTFORMW 非常感谢
PRINTFORMW 見えない何かに身体を抑えられたかと思うと	PRINTFORMW 一想到被什么看不见的什么东西压抑住了身体
PRINTFORMW %CALLNAME:TARGET%が耳元に顔を近づけて囁いてきた	PRINTFORMW %CALLNAME:TARGET%把脸贴近耳边低声私语
PRINTFORMW 「あまり%CNAME("一人称")%の心をかき乱さないでください」	PRINTFORMW 不要太过扰乱%CNAME("一人称")%的心
PRINTFORMW 「我慢できなくなってしまいます」	PRINTFORMW 「变得无法忍耐了」
PRINTFORMW 「%CNAME("一人称")%のような無機物にも愛を囁いてくれるのですね、ありがとうございます」	PRINTFORMW 「像%CNAME("一人称")%一样的无机物也会对我们说爱吗、谢谢」
PRINTFORMW 「同じ言い回しを校内で聞いた覚えがございます」	PRINTFORMW 「我记得在校内听到过同样的措辞。」
PRINTFORMW 「どのような方が喋っていたのかまでは覚えておりませんが」	PRINTFORMW 「虽然不记得有哪些人在说话」
PRINTFORMW %CALLNAME:TARGET%の声はいつも以上に冷たく無機質に聞こえる…	PRINTFORMW %CALLNAME:TARGET%的声音比平时更冷酷、听起来像无机质一样……
//PRINTFORMW %CALLNAME:TARGET%は何も反応もしてくれないが急に身体が動かしづらくなった気がする… ;	PRINTFORMW %CALLNAME:TARGET%虽然没有做出任何反应、但感觉身体突然变得难以动弹……
PRINTFORMW 「%CNAME("二人称")%は保健室の先生という噂をご存知ですか？」	PRINTFORMW 「关于保健室的老师、%CNAME("二人称")%知道这个传闻吗？」
PRINTFORMW 「誰も居ない保健室の薬棚から勝手に薬を取り出そうとすると」	PRINTFORMW 「如果从空无一人的保健室的药架上随便拿药。」
PRINTFORMW 「罰として"先生"にお腹が裂けるまで薬を詰め込まれてしまうという物です」	PRINTFORMW 「惩罚是‘老师’把药塞到肚子裂开为止。」
PRINTFORMW 「不祥事を起こして失踪した養護教諭の方が保健室に潜んでいて、薬棚を監視しているそうです」	PRINTFORMW 「据说发生了丑闻而失踪的保健教师躲在保健室、监视着药架。」
PRINTFORMW 「%CNAME("二人称")%も保健室の薬を勝手に使わないようお気をつけください」	PRINTFORMW 「请注意、%CNAME("二人称")%也不要随便使用保健室的药」
//PRINTFORMW 「先生がいるかもしれませんから」  ;	PRINTFORMW 「因为可能有老师哦」
PRINTFORMW 「%CNAME("二人称")%は枯れない花壇という噂をご存知ですか？」	PRINTFORMW 「%CNAME("二人称")%知道不会枯萎的花坛的传闻吗？」
PRINTFORMW 「学園の何処かに一年中青い草花が咲いている不思議な花壇があるという物です」	PRINTFORMW 「学园的某处有着一年四季都开着蓝色花草的不可思议的花坛。」
PRINTFORMW 「その花壇には死体が埋まっていて、それが草花の栄養となっていると言われております」	PRINTFORMW 「据说那个花坛里埋着尸体、这些尸体就是花草的营养。」
PRINTFORMW 「だとしても青い草花しか生えないというのは何故でございましょうか」	PRINTFORMW 「话虽如此、为什么只能长出蓝色的花草呢？」
PRINTFORMW 「少し、話疲れました」	PRINTFORMW 「说话有点累」
PRINTFORMW そう云うと%CALLNAME:TARGET%は僅かに首を傾げ、目を閉じてしまった	PRINTFORMW 这么说着、%CALLNAME:TARGET%略微歪着头、闭上了眼睛。
PRINTFORMW 「この学園には七不思議のような怪談とは別に都市伝説のような物が幾つもあります」	PRINTFORMW 「这个学园里除了七大不可思议的怪谈、还有很多都市传说之类的东西。」
PRINTFORM %TEXTR("女性しか入れない秘密の部室/尻尾や耳が生えている学生/女性になってしまった男子生徒/生徒会室の天使")%、	PRINTFORM %TEXTR("只有女性才能进入的秘密活动室/长着尾巴和耳朵的学生/变成了女性的男生/学生会室的天使")%
PRINTFORM %TEXTR("巨大な男性器を持った女生徒/怪しげな実験を繰り返す魔女の娘/毎日違う女性と一緒に帰宅している男子生徒/宿直室の魔人")%、	PRINTFORM %TEXTR("长着巨大的男性器的女学生/重复着奇怪实验的女巫的女儿/每天和别的女性一起回家的男学生/宿管值班室的魔人")%
PRINTFORM %TEXTR("魔界に繋がる焼却炉/部室棟で目撃される謎の学園メイド/放課後の魔法少女/聖都からやってきた本物の悪魔狩り")%	PRINTFORM %TEXTR("连接魔界的焚化炉/部门大楼里被目击的神秘学园女仆/放学后的魔法少女/来自圣都的真正的猎魔人")%
PRINTFORMW 「幾つかはご存知でございましょう」	PRINTFORMW 「您知道几个吧。」
PRINTFORMW そう云いながら%CALLNAME:TARGET%はこちらを一瞥した	PRINTFORMW %CALLNAME:TARGET%瞥视了这边
PRINTFORMW 「力の調整をしております。今後、%CNAME("二人称")%の繊細な部分に触れる機会が増えますので」	PRINTFORMW 「正在调整力量。今后、接触%CNAME("二人称")%纤细部分的机会会增加」
PRINTFORMW %CALLNAME:TARGET%の眼前で、宙に浮いたかぎ針と糸が踊り、次々とレースが織られていく…	PRINTFORMW 在%CALLNAME:TARGET%的面前、悬浮在空中的钩针和线在跳舞、蕾丝一个接一个地织出……
PRINTFORMW 「%CNAME("一人称")%が勝手に拝借しているとはいえ、西洋人形研究会にはお礼を申し上げなくてはいけませんね」	PRINTFORMW 「虽说%CNAME("一人称")%擅自借了钱、但是必须向西洋人偶研究会道谢。」
PRINTFORMW 「こうして毎日のように紅茶とお茶菓子を提供してくださるのですから」	PRINTFORMW 「像这样每天提供红茶和茶点」
PRINTFORMW 「陽が差している間はこの学園も静かでございますね」	PRINTFORMW 「阳光照射的时候、这个学校也很安静啊。」
PRINTFORMW 「この身体が貴方様の物であると誇示するための行いにしては、些か地味でございますね」	PRINTFORMW 「为了炫耀自己的身体是你的东西、这种行为有点太无趣了。」
PRINTFORMW 「当初の身体と比べるとだいぶ%CNAME("二人称")%好みにされてしまいましたが」	PRINTFORMW 「和当初的身体相比、我被%CNAME("二人称")%所喜爱着。」
PRINTFORMW 「まだ大きくされるおつもりですか？」	PRINTFORMW 「你还打算长大吗？」
PRINTFORMW 「辱めの一種でしょうか？であれば、もう少し乱暴にされた方が効果的でございます」	PRINTFORMW 「是一种侮辱吗？如果是这样、再稍微粗暴一点的做法会更有效的降临在你身上」
PRINTFORMW 「造形には自信がありますので、お気に召して頂けると良いのですが」	PRINTFORMW 「我对造型很有自信、希望您能喜欢。」
//PRINTFORMW 「それはこの身体に触れる為の建前ですか？」  ;	PRINTFORMW 「那是为了触摸这个身体的原则吗？」
PRINTFORMW 「そのような建前など用意せずとも、触られて良いのですが」	PRINTFORMW 「即使没有准备那样的场面话、也可以触摸。」
PRINTFORMW 「はむ…あむっ……ちゅっ…んちゅ……ちゅる……じゅるるっ…ちゅ……ちゅっ……ぴちゃ……」	PRINTFORMW 「哈姆…啊姆……啾…嗯啾……啾噜……啾噜噜…啾……啾……噗恰……」
PRINTFORMW 「もう息が続かないようでございますね」	PRINTFORMW 「好像已经无法呼吸了呢」
PRINTFORM そう云うと%CALLNAME:TARGET%は	PRINTFORM 这么说的话、%CALLNAME:TARGET%还是可以呼吸的
PRINTFORM 名残惜しそうにしながらも、こちらを抱きしめていた腕と	PRINTFORM 虽然看起来恋恋不舍、但这里抱住的手臂和
PRINTFORMW 唇を離し、いつもの姿勢に戻ってしまった	PRINTFORMW 嘴唇还是放开、回到了往常的姿势
PRINTFORMW 「…んんっ………」	PRINTFORMW 「…嗯……」
PRINTFORMW %CALLNAME:TARGET%の血が通っているかのように赤く瑞々しく彩られた唇は	PRINTFORMW 宛如%CALLNAME:TARGET%的血液通过般鲜红娇艳的嘴唇
PRINTFORMW 見た目通りの柔らかさと人形独特のひんやりとした体温を伝えてきた	PRINTFORMW 传递着外表上柔软的人偶独特的凉爽的体温
PRINTFORMW 「口づけというのは不思議な物でございますね」	PRINTFORMW 「接吻真是不可思议啊」
PRINTFORMW 「紅茶をお願いいたします、そちらの棚に封を切ってしまった物が残っておりますので」	PRINTFORMW 「请给我红茶、那边的架子上还留有已经拆封过的东西。」
PRINTFORMW %CALLNAME:TARGET%が膝を枕にしてきたと思ったら	PRINTFORMW %CALLNAME:TARGET%把膝盖当枕头了
PRINTFORMW いつのまにかファスナーの間から露出していた	PRINTFORMW 不知不觉间从拉开的拉链露出来了
PRINTFORMW %CALLNAME:MASTER%の物にしゃぶりついてきた	PRINTFORMW 对着%CALLNAME:MASTER%的物体
PRINTFORMW 段々と舌の動きが激しくなっているのがわかる…	PRINTFORMW 舌头的动作越来越激烈了……
PRINTFORMW ズボンの膨らみに顔を近づけ鼻を鳴らしたかと思うとそのまま咥え始めた…	PRINTFORMW 把脸靠近裤子的膨胀、吸了吸鼻子、就又开始叼了起来……
PRINTFORMW ひんやりとした手の感触が心地良い…	PRINTFORMW 冰凉的手感很舒服……
PRINTFORMW %CALLNAME:TARGET%は音もなく%CALLNAME:MASTER%の近くに座ったかと思うと	PRINTFORMW %CALLNAME:TARGET%安静地坐在%CALLNAME:MASTER%附近
PRINTFORMW こちらを見ることなくスルリとズボンの中へ手を差し込み	PRINTFORMW 不看这边把手伸进裤子里
PRINTFORMW %CALLNAME:MASTER%のものを指で撫でるように刺激し始めた…	PRINTFORMW 像用手指抚摸%CALLNAME:MASTER%般开始刺激……
PRINTFORMW %CALLNAME:TARGET%はズボンの中に手を差し込んだかと思うと	PRINTFORMW %CALLNAME:TARGET%刚想把手伸进裤子里
PRINTFORMW %CALLNAME:MASTER%の物を勢いよくしごきはじめた	PRINTFORMW %CALLNAME:MASTER%的阳物开始有气势了
PRINTFORMW 「こことベッド、どちらがよろしいですか？」	PRINTFORMW 「这里和床上、哪个都可以吗？」
//PRINTFORMW %CALLNAME:TARGET%はズボンの膨らみを人差し指でなぞり始めた;	PRINTFORMW %CALLNAME:TARGET%开始用食指描画着裤子的膨胀
PRINTFORMW %CALLNAME:TARGET%は何も言わずに優しく頭を撫でてくれている…	PRINTFORMW %CALLNAME:TARGET%什么也没说、只是轻轻的抚摸着我的头……
;例）PRINTFORMW 「よければ%CSTR:お茶の種類%どうぞ」	;例）PRINTFORMW 「如果可以的话请品尝%CSTR:お茶の種類%どうぞ」
PRINTFORMW 「%CNAME("二人称")%、アフタヌーン・ティーに%TEXTR("アールグレイ/ダージリンのオータム/アッサム/プリンス・オブ・ウェールズ")%は如何でしょうか？」	PRINTFORMW %CNAME("二人称")%、下午茶时来些%TEXTR("格雷伯爵/大吉岭蛋白/阿萨姆/布丁威尔士")%怎么样？
PRINTFORMW 「お茶菓子として%TEXTR("スコーン/綺麗な狼の口が開いたスコーン/アップルパイ/ショートブレッド/チョコレート/カップケーキ")%もご用意致しました」	PRINTFORMW 「作为茶点也准备了%TEXTR("玉米/漂亮的如同狼的嘴巴张开的玉米/苹果馅饼/短面包/巧克力/茶杯蛋糕")%」
PRINTFORMW 「呑気な方ですね」	PRINTFORMW 「您真是个漫不经心的人啊。」
PRINTFORMW 「これほどの美女に囲まれていながら、なにもしないというのは」	PRINTFORMW 「被这么多美女包围的同时什么也不做」
PRINTFORMW 「究極の贅沢でございますね」	PRINTFORMW 「真是极致的奢侈啊」
PRINTFORMW そう云いながら%CALLNAME:TARGET%は%CALLNAME:MASTER%の%TEXTR("頬/背中/脇腹/太もも/お腹/胸板")%を%TEXTR("軽くつついている/触っている/撫でている/見ている/くすぐっている")%	PRINTFORMW 一边这么说、%CALLNAME:TARGET%一边把%CALLNAME:MASTER%的%TEXTR("脸颊/背/侧腹/大腿/肚子/胸口")%%TEXTR("轻轻地触摸着/抚摸着/看着/痒痒的摸着")%
PRINTFORMW 壁から黒い霞みが滲み出し、その中から%CALLNAME:TARGET%が現れた	PRINTFORMW 从墙壁渗出黑霞、%CALLNAME:TARGET%从墙壁中出现
PRINTFORMW 「%CNAME("二人称")%に求められた時にどんな行為でも行えるよう内臓を一通り揃えましたが」	PRINTFORMW 「为了达成「只要%CNAME("二人称")%需要的话想干什么都可以」的这个目的、我准备了一整套内脏。」
PRINTFORMW 「尿意という物は厄介でございますね、気持ちが落ち着かなくなります」	PRINTFORMW 「尿意这个东西、真是麻烦、心情会跟着变得不安定呢。」
PRINTFORMW 「少し、失礼致します」	PRINTFORMW 「有点失礼了」
PRINTFORMW そう云うと%CALLNAME:TARGET%は壁の中へ、溶けるように消えてしまった	PRINTFORMW 这么一说、%CALLNAME:TARGET%就象融化在墙壁中一样消失了
PRINTFORMW 「壁を抜けて曰くのあるトイレで排泄しておりました」	PRINTFORMW 「穿过墙壁、在某个厕所排泄。」
PRINTFORMW 「%CNAME("一人称")%の排泄行為にご興味が？」	PRINTFORMW 对%CNAME("一人称")%的排泄行为有兴趣吗？
PRINTFORMW 「体液の排出をしておりました、内臓というものは面倒でございますね」	PRINTFORMW 「已经排出体液了、内脏什么的真是麻烦啊。」
PRINTFORMW KOJO_DAILYCOM_K33, %ARGS%：合意無し	PRINTFORMW KOJO_DAILYCOM_K33,%ARGS%：合意没有
PRINTFORMW 「%CNAME("二人称")%の気が済むまで、自由にお調べください」	PRINTFORMW 「在%CNAME("二人称")%兴趣消散之前、请自由的看吧。」
PRINTFORMW 「このような行為に合意した覚えはありませんが」	PRINTFORMW 「我不记得我同意过这种行为」
PRINTFORMW 「………この身体は%CNAME("二人称")%の物でございましたね、数瞬忘れておりました」	PRINTFORMW 「……」这个身体是%CNAME("二人称")%的东西吧、那就请随意吧」
PRINTFORMW 「確かに合意はしましたが、全く遠慮されないのですね」	PRINTFORMW 「确实达成了协议、但是完全没有客气呢。」
PRINTFORMW 「それとも、この布は%CNAME("二人称")%をそこまで興奮させるものなのですか？」	PRINTFORMW 「还是说、这块布能让%CNAME("二人称")%如此兴奋呢？」
PRINTFORMW %CALLNAME:TARGET%は身を捩り、姿勢をより観察しやすい物に変えてくれた	PRINTFORMW %CALLNAME:TARGET%扭转着身体、把姿势变成更容易观察的样子。
PRINTFORMW こちらの視線に気付いた%CALLNAME:TARGET%は下腹部に指をあて、ゆっくりと撫で始めた…	PRINTFORMW %CALLNAME:TARGET%注意到这边的视线、将手指放在下腹部、开始慢慢地抚摸……
PRINTFORMW %CALLNAME:TARGET%は先ほどパンチラした時と同じような姿勢でパンツを見せつけてきた	PRINTFORMW %CALLNAME:TARGET%用和刚才一样闪烁的姿势展示了胖次
PRINTFORMW 「この姿勢がお好きなのですか？」	PRINTFORMW 「你喜欢这个姿势吗？」
PRINTFORMW 「今後は必ずスカートを着用していた方がよろしいでしょうか？」	PRINTFORMW 「今后必须穿上裙子比较好吧?」
PRINTFORMW いつもの調子で普通に挨拶されてしまった…	PRINTFORMW 保持平常的状态一般打招呼…



//EVENT_K33_SHOP.ERB
CALL DAILY_MESSAGE, "パンツを脱いで手渡し"	CALL DAILY_MESSAGE, "脱下胖次亲手递了过来"
CALL EVENT_DATUI, "ハダカ"	CALL EVENT_DATUI, "裸体"
PRINTFORMW %CALLNAME:TARGET%は羊皮紙の束を手渡してきた。	PRINTFORMW %CALLNAME:TARGET%把羊皮纸束递给了我。
PRINTFORMW 「%CNAME("一人称")%もよくは知らないのですが、人を淫らな気分にする刺青の彫り方が記されてるようですよ」	PRINTFORMW 「虽然%CNAME("一人称")%不太了解、但是上面记载了让人产生淫乱心情的刺青的雕刻方法。」
PRINTFORMW 「付箋によると、期間限定お試し版のシールの作り方も添えられているようですね」	PRINTFORMW 「根据标签、好像附加了时间限定的试用版贴纸的制作方法。」
PRINTFORMW 「……妙に親切だなって？……フフフ♪」	PRINTFORMW 「……你真是太好了？……呼呼♪」
CALL PRINT_STR, "「つまり、それだけ危険な代物って事ですよ……恐ろしいですねぇ_H_」_W"	CALL PRINT_STR, "「也就是说、这是一种危险的代号啊……好可怕。_H_」_W"
PRINTFORMW %CALLNAME:TARGET%は、またも羊皮紙の束を手渡してきた。	PRINTFORMW %CALLNAME:TARGET%又把羊皮纸束递给了我。
PRINTFORMW 「この巻には女性にペニスを生やす能力……%CNAME("一人称")%達は[具現]と呼んでいますが、の習得法が書かれているようですよ」	PRINTFORMW 「这卷是让女性长出阴茎的能力……%CNAME("一人称")%把这种方法称之为[具现]、这里好像有写这种学习方法哦」
PRINTFORMW 「しかし、%CNAME("二人称")%も物好きですねぇ……そんなに生やしたいものなのですか？」	PRINTFORMW 「但是、%CNAME("二人称")%的阴茎也非常令人喜欢呢……是那么想长出来的东西吗？」
PRINTFORMW %CALLNAME:TARGET%は、羊皮紙に目を通しだした%CALLNAME:PLAYER%の様子を眺めつつ小首を傾げた。	PRINTFORMW %CALLNAME:TARGET%一边看着羊皮纸上看到的%CALLNAME:PLAYER%的样子、一边歪着头。
PRINTFORML 「こうやって書物を手渡すのも３回目ですね」	PRINTFORML 「像这样递书已经是第三次了吧」
PRINTFORMW %CALLNAME:TARGET%は、またまた羊皮紙の束を用意してきた。	PRINTFORMW %CALLNAME:TARGET%又准备了一捆羊皮纸。
PRINTFORMW 「%CNAME("二人称")%も研究能力はともかく、能力としては魔法使いの仲間入りをしたと言っていいと思われます」	PRINTFORMW 「%CNAME("二人称")%的研究能力姑且不论、作为能力可以说是能够加入魔法使的行列了。」
CALL PRINT_STRW, @"「……まぁ、%CNAME("二人称")%の事ですからＨな目的にしか使わないんでしょうけどね_H_」"	CALL PRINT_STRW, @"「……也就是说、%CNAME("二人称")%可以把这些能力用于Ｈ的目的来使用了_H_」"


//EVENT_K33_メアリー.ERB
LOCALS = 私_わたくし	LOCALS = 我_我
LOCALS = 貴方様_あなたさま	LOCALS = 您_您
LOCALS = "貴方様"_あなたさま	LOCALS = "您"_您
LOCALS = あの方_あのかた	LOCALS = 那位大人_那位大人
LOCALS = %CALLNAME:ASSI%さん_%CALLNAME:ASSI%さん	LOCALS = %CALLNAME:ASSI%桑_%CALLNAME:ASSI%桑
PRINTFORML 美しい見た目に反してどこか不気味な雰囲気を感じさせる"等身大"ビスクドール	PRINTFORML 与美丽的外表相反、是带来让人感到毛骨悚然的气氛的等身大的瓷人偶。
PRINTFORML 数代ほど前から西洋人形研究会の備品という事なっているが、誰が持ち込んだのか不明という曰く付きの品	PRINTFORML 从数代前开始成为西洋偶人研究会的备品,不过、不知道谁带来了不明的这个附有的东西
PRINTFORML 稀に部室以外の場所に座っていることがあり、学園七不思議の一つとなっている	PRINTFORML 很罕见的会坐在部室以外的地方、是学园七大不可思议事件之一
PRINTFORMW ある日の夜	PRINTFORMW 某日夜晚
PRINTFORMW 夜の学校へと忘れ物を取りに来た%CALLNAME:MASTER%	PRINTFORMW 晚上去学校取回遗忘的东西
PRINTFORML 最近我が家へやってきた悪魔のメイドさんが作ってくれる今日の晩ごはんはなにかな～などと	PRINTFORML 想着最近来我家的恶魔女仆做的今天的晚饭是什么之类的事
PRINTFORML 呑気な事を考えながら教室の戸を開くとそこにはありえない物が座っていた	PRINTFORML 一边想着这种随便的事情、一边打开教室的门、坐在那里的是不可能存在的东西。
PRINTFORMW ダークブラウン色の姫カット、青緑色の濡れたような瞳、ドール特有の化粧が施された目元	PRINTFORMW 深蓝色胸罩颜色的公主头型、青绿色的潮湿般的瞳孔、被施予了人偶特有的化妆的眼睛
PRINTFORML 学園七不思議の一つ、生き人形の噂がある西洋人形研究会の等身大ビスクドールだった	PRINTFORML 学园七大不可思议事件之一、是传说中活人偶的西洋人偶研究会的等身大瓷人偶。
PRINTFORMW 驚きのあまり固まっている%CALLNAME:MASTER%の耳に木がこすれるような音が聞こえた	PRINTFORMW 惊讶之余、%CALLNAME:MASTER%的耳边响起了树木摩擦般的声音。
PRINTFORMW ビスクドールの顔がこちらに向いたのだと気付いた瞬間…	PRINTFORMW 发现瓷人偶的脸朝向这边的瞬间……
PRINTFORMW %CALLNAME:MASTER%の身体は見えない力によって教室の中へと乱暴に引きずり込まれる	PRINTFORMW %CALLNAME:MASTER%的身体被看不见的力量粗暴地拖进教室里
PRINTFORMW 教室の中へ転がるように引きずり込まれていく%CALLNAME:MASTER%の目に	PRINTFORMW %CALLNAME:MASTER%的眼中的教室仿佛在滚动般、就这样被拖入了
PRINTFORMW ドアが不気味なほど滑らかに閉じていくのが見えた	PRINTFORMW 看见门干脆的被关上了、令人毛骨悚然
PRINTFORMW 教卓にぶつかったところで我に返り悲鳴を上げそうになった%CALLNAME:MASTER%の耳にか細い声が届く	PRINTFORMW 即使撞到了教桌、也只能叫苦不迭、细小的声音传到%CALLNAME:MASTER%耳边
PRINTFORMW 「手荒になってしまい、申し訳ありません」	PRINTFORMW 「下手有些粗暴了、对不起」
PRINTFORMW 「ですが、%CNAME("二人称")%を害するつもりはないのです。落ち着いて%CNAME("一人称")%の話をお聞きください」	PRINTFORMW 「但是、我不打算伤害%CNAME("二人称")%。请冷静下来听%CNAME("一人称")%的话」
//PRINTFORMW 「悲鳴をあげて頂いても構いませんよ」  ;	PRINTFORMW 「你可以尖叫」。
//PRINTFORMW 「…いえ、%CNAMET(ARG, "二人称")%に危害を加える気はないのです、%CNAMET(ARG, "一人称")%の話を聞いて頂けませんか」 ;	PRINTFORMW 「…不、%CNAMET(ARG, "二人称")%不想被我伤害的话、就好好听着%CNAMET(ARG, "一人称")%的话吧」
PRINTFORMW 僅かに落ち着きを取り戻した%CALLNAME:MASTER%の前でビスクドールがカーテシーの姿勢を取りながら喋りだした	PRINTFORMW 在略微恢复了平静的%CALLNAME:MASTER%面前、瓷人偶一边摆着卡特西的姿势一边说话了
//PRINTFORMW 僅かに落ち着きを取り戻した%CALLNAME:MASTER%の前でビスクドールが謝罪の言葉を口にしながら頭を下げる  ;	PRINTFORMW 在稍微冷静下来的%CALLNAME:MASTER%面前、瓷人偶一边道着歉一边低下了头
//PRINTFORML 「先程は申し訳ありませんでした」 ;	PRINTFORML 「刚才真是对不起。」
//PRINTFORMW 「少々手荒になってしまいましたが、怪異である%CNAMET(ARG, "一人称")%には、このようなやり方しか出来ないものですから」  ;	PRINTFORMW 「虽然刚刚有些太粗暴了、但是对于怪異的%CNAMET(ARG, "一人称")%来说、就只能使用这种办法了...」
PRINTFORMW 「改めましてご挨拶を」	PRINTFORMW 「请允许我重新介绍一下」
PRINTFORMW 「%CNAMET(ARG, "一人称")%は%CALLNAME:TARGET%、しがない生き人形で御座います」	PRINTFORMW 「%CNAMET(ARG, "一人称")%是%CALLNAME:TARGET%、是个很渺小的活的人偶。」
PRINTFORMW 「ここ数日、%CNAMET(ARG, "二人称")%を見ておりました」	PRINTFORMW 「这几天、我遇见了%CNAMET(ARG, "二人称")%。」
PRINTFORMW 「特に、朝は美しく、夕には傷つき小さくなる、不思議なその"魂"を」	PRINTFORMW 「特别是你那早上朝气蓬勃、晚上受伤变小、却能回复如初的、不可思议的‘灵魂’」
PRINTFORMW 「暗がりの中から食い入るように焦がれるように%CNAME("一人称")%が欲していた物を見つけたのでないかという喜びに胸を踊らせ震える指を必死に抑えながら闇の中で%CNAME("一人称")%の心は身悶えのたうち回ってこの時を」	PRINTFORMW 「仿佛在黑暗中被渴望着一般、是否找到了%CNAME("一人称")%所想要的东西呢？我怀着喜悦的心跳、颤抖的手指拼命压抑着、在黑暗中%CNAME("一人称")%的心灵在苦闷中转动着、这个时刻。」
PRINTFORMW 「少々饒舌が過ぎました」	PRINTFORMW 「稍微饶舌过头了」
PRINTFORMW 「%CNAME("二人称")%は人です、その魂が傷つくことはあっても、決して癒えることはありません」	PRINTFORMW 「%CNAME("二人称")%是人、按理说即使灵魂受到伤害、也绝不会痊愈。」
PRINTFORMW 「故に、とても興味をそそられたのです」	PRINTFORMW 「因此、我非常感兴趣。」
PRINTFORMW 「不躾なお話だとは思いますが、その魂の秘密をどうか%CNAMET(ARG, "一人称")%に教えて頂けませんか？」	PRINTFORMW 「虽然觉得有些失礼、但是能否把灵魂的秘密告诉%CNAMET(ARG, "一人称")%呢？」
//PRINTFORMW 「再生する魂ですか…なるほど、それは…とても、魅力的ですね」	PRINTFORMW 「再生的灵魂吗…原来如此、那是…非常的有魅力。」
PRINTFORMW 「なるほど、理由は定かでは無いようですが、再生する魂をお持ちなのですね」	PRINTFORMW 「原来如此、虽然理由不明确、但还是拥有重生的灵魂。」
PRINTFORMW 「それなりに古くからありますが、そのような方は初めて見ました」	PRINTFORMW 「虽然从很早以前就有听说过、但是这样的人还是第一次看到。」
PRINTFORMW 「怪異の願いなど無碍にされても仕方がないと思いますが」	PRINTFORMW 「怪异的愿望什么的、即使顺利的说出来、也是没办法的事。」
PRINTFORMW 「僅かばかりでも良いのです、%CNAME("一人称")%に%CNAMET(ARG, "二人称")%の魂を、溢れる輝きをお与えくれないでしょうか？」	PRINTFORMW 「哪怕只是一点点也好、能把%CNAMET(ARG, "二人称")%的灵魂、给与我部分那溢出的光辉吗？」
PRINTFORMW 「魂の対価としては不足かもしれませんが」	PRINTFORMW 「作为灵魂的代价可能还不够」
PRINTFORMW 「この身体と怪異に関する知識の提供、そして%CNAMET(ARG, "二人称")%への助力をお約束します」	PRINTFORMW 「我保证提供关于这个身体和怪异的知识、并给予%CNAMET(ARG, "二人称")%帮助。」
PRINTFORMW 「ご存知かもしれませんが、この地は非常に奇妙な場所です」	PRINTFORMW 「也许您知道、这个区域是非常奇妙的地方。」
PRINTFORMW 「このような場所では%CNAMET(ARG, "一人称")%の力と知識は%CNAMET(ARG, "二人称")%の助けになるはずです」	PRINTFORMW 「在这样的地方%CNAMET(ARG, "一人称")%的力量和知识应该可以帮助到%CNAMET(ARG, "二人称")%。」
//PRINTFORMW 「……それに、魔は%CNAMET(ARG, "二人称")%の欲望を満たすのにきっと役立つことでしょう」   ;	PRINTFORMW 「并且、或许可以满足%CNAMET(ARG, "二人称")%满溢出来的欲望呢」
//PRINTFORMW 月明かりに照らし出された表情が変わらぬはずのその顔は、酷く残酷な笑みを浮かべているように見えた;	PRINTFORMW 在月光下照出的表情应该没有变化的那张脸、看起来就像是在浮现出为了残酷而残酷的笑容。
PRINTFORMW 「失礼しました、承諾して頂けるとは思っていませんでしたので」	PRINTFORMW 「失礼了、我没想到您会同意呢。」
;まさか本当に承諾するとは思っていませんでしたが、あの悪魔を敵に回さずに済むのなら、それに越したことはありませんね	PRINTFORMW 「真的呢」
;内臓を用意する必要がありますが、手持ちの魔力でなんとかなるでしょう…	PRINTFORMW 「我真没想到你会同意、如果你不把恶魔当成敌人、那就更好了。」
PRINTFORMW 「承諾して頂き、ありがとうございます」	PRINTFORMW 「谢谢您的承诺啊。」
PRINTFORMW 「明日から部室の方にお伺いしますので、これからよろしくお願いしますね。%CNAMET(ARG, "二人称")%」	PRINTFORMW 「从明天开始会去问下部室的人、今后也请%CNAMET(ARG, "二人称")%多多关照。」
PRINTFORMW 彼女がそう云い終えると同時に視界が少しぶれたかと思うと	PRINTFORMW 一想到她这样说完的同时、视野好像有点模糊了
PRINTFORMW %CALLNAME:MASTER%は忘れ物を片手に昇降口に立っていた…	PRINTFORMW %CALLNAME:MASTER%一手拿着遗忘的东西站在电梯升降口……
PRINTFORMW …本当に彼女の願いを受け入れて良かったのだろうか？	PRINTFORMW ……真的可以接受她的愿望吗？
PRINTFORMW そんな考えが頭をよぎったが、改めて考えてみると	PRINTFORMW 重新考虑的话、这样的想法在脑海中闪过。
PRINTFORMW 悪魔との取引の方がよっぽど不味いのではないかと、今更気づいた%CALLNAME:MASTER%であった	PRINTFORMW 和恶魔的交易会不会更糟糕呢、%CALLNAME:MASTER%现在才注意到。
PRINTFORMW 壁紙から家具に至るまで暗い色合いのロココ調の物に統一されている	PRINTFORMW 从壁纸到家具、统一成暗色调的洛可可风格
PRINTFORML 備え付けてあったはずの天井照明は見当たらず、代わりに複数の壁掛けのルームランプが室内を淡く照らしている	PRINTFORML 本应配备的天花板照明灯却没有找到、取而代之的是多个壁挂在房间内的壁灯在室内淡淡地照亮。
PRINTFORML 壁際に置かれた肘掛けの無い椅子とランプの置かれた小さなサイドテーブルが目を引く	PRINTFORML 墙边放着的没有扶手的椅子和放着灯的小桌子、格外引人注目。
//PRINTFORMW 「このような身体に情愛を注いで頂けること望外の喜びです」 ;	PRINTFORMW 「我很高兴能在这样的身体里注入爱情。」
PRINTFORMW 「この身体、%CNAME("二人称")%のご随意に」	PRINTFORMW 「这个身体、%CNAME("二人称")%请随意」
PRINTFORMW 「それともこの不自由な身体で、情けなく必死に奉仕する様をご覧になるほうがお好みでしょうか？」	PRINTFORMW 「还是说您喜欢看到这个身体不由自主、无情地拼命服务的样子呢？」
//PRINTFORMW 「久しく忘れていた命の煌き、魂の熱」   ;	PRINTFORMW 「久已忘却的生命的辉煌、灵魂的激情」
//PRINTFORMW 「%CNAME("一人称")%にもっと感じさせてください」;	PRINTFORMW 「%CNAME("一人称")%更能感受到了」
PRINTFORMW 「この身体が段々と快楽に慣れ始めているのを感じます」	PRINTFORMW 「感觉这个身体渐渐开始习惯了快乐的感觉呢。」
PRINTFORMW 「%CNAME("二人称")%は%CNAME("一人称")%をどうするおつもりなのですか？」	PRINTFORMW 「%CNAME("二人称")%打算怎么对待%CNAME("一人称")%呢？」
PRINTFORMW 「睦事を始める前にご報告したいことが御座います」	PRINTFORMW 「在开始情事之前有想向您报告的事情」
PRINTFORMW 「この身体は貴方様に屈服致しました」	PRINTFORMW 「我的身体向您屈服了」
PRINTFORM 「貴方様に抱かれていないと	PRINTFORM 「如果没有你的拥抱...
PRINTFORM 口寂しさから常に何か咥える求め	PRINTFORM 从寂寞的口中不断追求着什么
PRINTFORM 乳頭は勃起が治まらず、刺激を求めて震え	PRINTFORM 乳头无法停止勃起、为了寻求刺激而颤抖着
PRINTFORM 陰核は攻めを求めてひくつき	PRINTFORM 阴核为了追求进攻而一按一弹的抖动着
PRINTFORM 排泄のたびに尿道が快感に震え	PRINTFORM 每次排泄、尿道都会因快感而颤抖
PRINTFORM 秘部は切なさを訴えて蠢き	PRINTFORM 秘部诉说着蠢蠢欲动的渴求
PRINTFORMW ます。」	PRINTFORMW 我会的。」
PRINTFORMW 「もはやこの身体は快楽に屈し、淫蕩を貪る淫らな精液便器と成り果てました」	PRINTFORMW 「这个身体已经屈服于快乐、成为贪图淫乐的淫荡精液便器。」
PRINTFORMW 「今後は愛玩人形ではなく、卑しい精液便器としてお使いください」	PRINTFORMW 「今后请不要作为性爱玩偶、而是作为卑微的精液便器来使用哦。」
PRINTFORMW 「%CNAME("二人称")%、大丈夫ですか？」	PRINTFORMW %CNAME("二人称")%没事吧？
PRINTFORMW 「あまりにも激しくされるものですから、少々吸いすぎたかもしれません」	PRINTFORMW 「因为做地太过激烈、可能吸得太多了呢。」
PRINTFORMW 「申し訳ありません、本日はここまでのようです」	PRINTFORMW 「对不起、今天就只能到这里了...」
PRINTFORMW %CALLNAME:TARGET%の動きは普段と比べてぎこちない…	PRINTFORMW %CALLNAME:TARGET%的动作和平时相比有些笨拙……
PRINTFORMW %CALLNAME%の肌はスベスベとしているが、少し力を込めると	PRINTFORMW %CALLNAME%的皮肤非常光滑,不过、稍微注入力量的话
PRINTFORMW 奥の方から柔らかな弾力を感じさせる不思議な触り心地をしている	PRINTFORMW 从里头能感到柔软的弹力和不可思议的触感
PRINTFORMW 「如何ですか、人ならざる者の肌は」	PRINTFORMW 「怎么样、非人之人的肌肤」
PRINTFORMW 「お気に召して頂けると良いのですが」	PRINTFORMW 「希望您能喜欢呦。」
//PRINTFORMW 「もっと激しくして頂いても構いませんよ」  ;	PRINTFORMW 「并且做得更激烈也没关系。」
//PRINTFORMW 「この身体は壊れてしまっても、しばらく経てば元に戻りますから」;	PRINTFORMW 「这个身体哪怕已经坏了、再过一段时间、就会恢复原来的状态。」
PRINTFORMW 「このような身でも、そのように攻められては快楽に身を捩ってしまいます」	PRINTFORMW 「因为是这样的身体、即使被那样攻击的话、也会很轻松地扭转身体。」
//PRINTFORMW 「愛玩人形としてあるまじき願いだとはわかっています」  ;	PRINTFORMW 「作为一个玩偶、我知道这算不算是我的愿望？」
PRINTFORMW 「%CNAME("二人称")%のお好きなように」	PRINTFORMW %CNAME("二人称")%随你喜欢就好
PRINTFORMW 「この身体も、唇も、そしてここも%CNAME("二人称")%の物ですから」	PRINTFORMW 「因为这个身体、嘴唇、还有这里都是%CNAME("二人称")%的东西」
PRINTFORMW そう云いながら%CALLNAME:TARGET%は自らの恥丘に指を這わせた	PRINTFORMW 一边这样说着、%CALLNAME:TARGET%一边将手指爬上了自己的耻丘上
//PRINTFORMW %CALLNAME%は口では平静を装っているが時折身体がピクリと反応している;	PRINTFORMW %CALLNAME%嘴上装着平静的样子、身体却诚实的做出了反应
PRINTFORMW 「申し訳ありません%CNAME("二人称")%」	PRINTFORMW 「对不起%CNAME("二人称")%啊」
PRINTFORMW 「やはり%CNAME("一人称")%にはこの方が性に合っているようです」	PRINTFORMW 「果然、对于%CNAME("一人称")%来说、这方面可能更符合我的性格呢。」
PRINTFORMW 「さぁ、しっかり愛してください」	PRINTFORMW 「那么、好好地爱我吧。」
PRINTFORMW 「さもないと%CNAME("一人称")%、段々歯止めが効かなくなってしまいます」	PRINTFORMW 「不然,%CNAME("一人称")%、下面就会渐渐失灵的...」
PRINTFORMW そう言い放つと%CALLNAME:TARGET%は普段とは比べ物にならない程の力強さで秘裂を押し付けてきた	PRINTFORMW 这样说着、%CALLNAME:TARGET%就凭借着平时无法比拟的力量、将秘裂强加给了我。
//PRINTFORMW 「はしたないことを承知で申し上げますが」  ;	PRINTFORMW 「一直不愿意主动说出来」
//PRINTFORMW 「そちらの穴を攻めて頂けることを密かに期待していました」  ;	PRINTFORMW 「我偷偷地希望你能进攻那个洞呢。」
PRINTFORMW 「そちらの穴を弄られるのは初めてです」	PRINTFORMW 「第一次被玩弄那里的小穴呢」
PRINTFORMW 普段と変わらない表情をしているがその視線からは熱っぽさを感じる	PRINTFORMW 虽然表情和平时没什么不同、但是从视线中感受到满满的热情
PRINTFORMW 「…やはり秘部とは違う何かを感じます」	PRINTFORMW 「…果然和秘部那里有什么不同啊」
PRINTFORMW 「自分で、ですか？」	PRINTFORMW 「自己吗？」
PRINTFORMW 「稚拙な物をお見せするかもしれませんが、それでもよろしいのなら」	PRINTFORMW 「可能会给你看幼稚拙劣的东西、但如果那样也可以的话。」
PRINTFORMW その言葉通り%CALLNAME:TARGET%の動きはとてもたどたどしい	PRINTFORMW 那句话说完、%CALLNAME:TARGET%的动作非常地缓慢
PRINTFORMW 自慰をしたことが無いのだろう	PRINTFORMW 可能从没有自慰过吧
PRINTFORMW 「このような作り物でも%CNAME("二人称")%の劣情が誘えると良いのですが」	PRINTFORMW 「像这样制作的东西、能诱发%CNAME("二人称")%的欲情就好了。」
PRINTFORMW 「……先端ばかり虐めるのですね」	PRINTFORMW 「……只虐待前端吗」
PRINTFORMW 「この突起がそんなにお好きなのですか？」	PRINTFORMW 「你就那么喜欢这个突起吗？」
//PRINTFORMW 「%CNAME("二人称")%の劣情が収まるまで好きなだけ弄んでください」 ;	PRINTFORMW 「%CNAME("二人称")%尽情的玩弄吧、直到欲望满足了」
//PRINTFORMW %CALLNAME:TARGET%はいつもの調子で喋っているが ;	PRINTFORMW %CALLNAME:TARGET%以平常的语气说道
//PRINTFORMW 口の端から僅かに涎を垂らし、乳首をプルプルと震わせている ;	PRINTFORMW 嘴角微微垂涎、乳头不停地颤动着。
PRINTFORMW 「また%CNAME("一人称")%の胸を大きくするおつもりですか？」	PRINTFORMW 「你打算再度变大%CNAME("一人称")%的胸部吗？」
PRINTFORMW 「人形の身で胸の肥大に悩む日がくるとは思いませんでした」	PRINTFORMW 「没想到会有人偶的身体因为胸部肥大而烦恼的日子到来。」
PRINTFORMW 「気に入って頂けたようでなによりです」	PRINTFORMW 「您好像很中意呢、这比什么都好。」
PRINTFORMW 「不思議に思うかもしれませんがキスは初めてなのです」	PRINTFORMW 「可能会觉得不可思议、但是接吻还是第一次呢。」
PRINTFORMW 「んっ……んんっ…んちゅ…ちゅぷ…………」	PRINTFORMW 「嗯……嗯……嗯……啊……」
PRINTFORMW 「%CNAME("二人称")%…%CNAME("一人称")%、どうやら唇が他の箇所より敏感みたいです」	PRINTFORMW 「%CNAME("一人称")%、好像嘴唇比其他地方更敏感啊」
PRINTFORMW 「だからもっと激しくしてください」	PRINTFORMW 「所以请更加激烈一点。」
PRINTFORMW 「…んんっ……んっ…」	PRINTFORMW 「…嗯……嗯……」
PRINTFORMW 「息が続かないのですか？人の身体は不便ですね」	PRINTFORMW 「呼吸不能不持续吗？人的身体真的很不方便啊」
PRINTFORMW 「ちゅ……」	PRINTFORMW 「ちゅ……」
PRINTFORMW 「…はむっ……ちゅっ……」	PRINTFORMW 「…哈哈……ちゅ……」
PRINTFORMW 「……人形相手に柔らかいキスで焦らすだなんて」	PRINTFORMW 「……用对人偶柔和的接吻来挑逗」
PRINTFORMW 「%CNAME("二人称")%の性癖は本当に度し難いですね」	PRINTFORMW 「%CNAME("二人称")%的性癖真的很特别啊」
PRINTFORMW 「%CNAME("一人称")%のそこは少女のそれと同じように作ってあります」	PRINTFORMW 「%CNAME("一人称")%的那个地方、是按着和少女的一样的样子做的」
PRINTFORMW 「壊れるほどに激しく扱っても元に戻るというのは少女には無い利点でしょうね」	PRINTFORMW 「即使把被处理得如此激烈、但归还原状对于少女来说是绝无仅有的优点吧。」
PRINTFORMW 「殆どぬくもりが無いことを除けば、ですが」	PRINTFORMW 「除了几乎没有什么温暖、但是...」
//PRINTFORMW 突然%CALLNAME:TARGET%の腰が跳ねた  ;	PRINTFORMW 突然、%CALLNAME:TARGET%的腰部颤抖着
//PRINTFORMW よく見ると陰核が小刻みに震えている;	PRINTFORMW 细细一看、阴核在微微地颤抖
PRINTFORMW 「……執拗に責められてはこのような身でも快楽に震えるのです」	PRINTFORMW 「……如果被执拗地玩弄那里的话、即使是这样的身体也会因快乐而颤抖」
PRINTFORMW 「%CNAME("一人称")%は痛みなど殆ど感じませんのに」	PRINTFORMW 「%CNAME("一人称")%根本不觉得疼痛」
PRINTFORMW 「きちんと前戯をしてくださるですね」	PRINTFORMW 「好好地给我开个前戏吧。」
//PRINTFORMW %CALLNAME:TARGET%の目が僅かに泳いだ;	PRINTFORMW %CALLNAME:TARGET%眼神稍微游移了一下
//PRINTFORMW 「%CNAME("二人称")%は目ざといですね」  ;	PRINTFORMW 「%CNAME("二人称")%的分身真大啊」
//PRINTFORMW 「%CNAME("一人称")%のこんな反応ですらお気づきになるのですから」 ;	PRINTFORMW 「%CNAME("一人称")%光是看着甚至会发现要有反应了。」
PRINTFORMW 「人間のそれと遜色ないと思いますが、どうでしょうか？」	PRINTFORMW 「我觉得我这里不逊色于人类、您觉得怎么样？」
PRINTFORMW 「ご覧になりながら慰めるのでしたら、ここにお出しください」	PRINTFORMW 「如果想边看边自慰的话、请到这里来。」
PRINTFORMW そう云いながら%CALLNAME:TARGET%は秘部の中がよく見えるように更に広げた	PRINTFORMW 一边这样说着、%CALLNAME:TARGET%为了让秘部看起来更清楚而仔细展开了
PRINTFORMW 「人形のここを広げて観察するだなんて」	PRINTFORMW 「居然要展开人偶的屁股观察」
PRINTFORMW 「世界広しといえど%CNAME("二人称")%だけでしょうね」	PRINTFORMW 「虽说世界广阔、但只有%CNAME("二人称")%能看到吧。」
PRINTFORMW 「やっと挿れる気になりましたか」	PRINTFORMW 终于要有插进去的感觉了吗
PRINTFORMW 「二度と他の娘で満足出来ないようにしてさしあげます」	PRINTFORMW 「为了不再让其他女孩子满足」
PRINTFORMW 「覚悟してください」	PRINTFORMW 「请做好心理准备」
//PRINTFORMW 「気になりますか？元々%CNAME("一人称")%に処女膜はありません」 ;	PRINTFORMW 「会在意吗？%CNAME("第一人称")%根本没有处女膜...」
//PRINTFORMW 「ただ…研究会の方には何度か使われています、皆様すぐに"果てて"しまいましたが」  ;	PRINTFORMW 「只是……研究会的人使用过几次、大家马上就"果断"了。」
PRINTFORMW 「殿方の物を受け入れるのは初めてなのですが、気になりますか？」	PRINTFORMW 「我是第一次接待殿下的物品、您在意吗？」
PRINTFORMW 「とはいえ元々この身体に処女膜はありませんので、%CNAME("一人称")%の言葉を信じて頂くしかありませんが」	PRINTFORMW 「原来这个身体没有处女膜、%CNAME("一人称")%只能相信这些话了。」
PRINTFORMW 「このようなことをされるということは」	PRINTFORMW 「竟然做这样的事情」
PRINTFORMW 「はしたなく%CNAME("二人称")%を求める姿がお望みなのですか？」	PRINTFORMW 「这是%CNAME("二人称")%想要追求的样子吗？」
PRINTFORMW 「如何ですか？気兼ねなく膣内に吐き出せる%CNAME("二人称")%専用の穴の具合は」	PRINTFORMW 「怎么样？是%CNAME("二人称")%专用的穴位、可以随意排在阴道内哦」
PRINTFORMW 「お楽しみ頂けていると良いのですが」	PRINTFORMW 「希望大家能够享受」
PRINTFORMW 「他の方には出来ないぐらい激しくしてくださっても良いのですよ」	PRINTFORMW 「就算是其他人做不到的激烈也好。」
PRINTFORMW 「この身体なら%CNAME("二人称")%の欲望を受け止められますから」	PRINTFORMW 「因为这个身体能够接受%CNAME("二人称")%的欲望」
PRINTFORMW 「執拗に攻めるのですね、そこまで%CNAME("一人称")%の子宮を屈服させたいのですか？」	PRINTFORMW 「执拗地进攻吧、想让%CNAME("一人称")%的子宫屈服到那种程度吗？」
PRINTFORMW 「%CNAME("二人称")%の輝きを%CNAME("一人称")%にお与えください」	PRINTFORMW 请将%CNAME("二人称")%的光辉赐予%CNAME("一人称")%
PRINTFORMW %CALLNAME:TARGET%は子宮の辺りに手をかざして射精を催促している	PRINTFORMW %CALLNAME:TARGET%用手遮住子宫附近、催促着射精
PRINTFORMW %CALLNAME:TARGET%の目が僅かに泳いでいる	PRINTFORMW %CALLNAME:TARGET%的眼睛在微微地游动
PRINTFORMW 「……やはりここから受ける感覚は他の部位とは異なります」	PRINTFORMW 「……果然从这里接受的感觉和其他部位不一样」
PRINTFORMW 「不思議なことに幾度も味わいたくなるのです」	PRINTFORMW 「不可思议的是好几次都想品尝」
PRINTFORMW 「%CNAME("二人称")%の気が済むまでお使いください」	PRINTFORMW 「在%CNAME("二人称")%力竭之前、请继续使用」
//PRINTFORMW 「激しいのですね、常人では膣壁が抉り取られてしまうかもしれません」   ;	PRINTFORMW 「很激烈呢、要是常人可能会被连阴道壁都挖坏呢」
PRINTFORMW 「この穴がお気に召しましたか？」	PRINTFORMW 「你喜欢这个洞吗？」
PRINTFORMW 「ここへ%CNAME("二人称")%を受け入れる度に%CNAME("一人称")%の中で何かが埋まっていく気がします」	PRINTFORMW 「感觉%CNAME("二人称")%就在%CNAME("一人称")%之中被什么东西埋没在这儿一样」
PRINTFORMW 「この体勢なら%CNAME("二人称")%の精を余すこと無く受け取れます」	PRINTFORMW 「这个姿势的话、可以毫无保留地接受%CNAME("二人称")%的精子呢。」
PRINTFORMW 「%CNAME("二人称")%の気が済むまで膣壁を抉り、最奥までねじ込み、お注ぎください」	PRINTFORMW 「在%CNAME("二人称")%力竭之前先摩擦着阴道壁、然后拧进最里面、再射进去。」
PRINTFORMW そう云いながら%CALLNAME:TARGET%は強請るように腰を押し付けてきた	PRINTFORMW 一边这样说着、%CALLNAME:TARGET%一边强求着一边把腰推了过来
PRINTFORMW 「激しくされるのですね、それとも%CNAME("一人称")%のここを押しつぶしたいのですか？」	PRINTFORMW 「是被激烈地袭击着、还是想将%CNAME("一人称")%压碎呢？」
PRINTFORMW そう云いながら%CALLNAME:TARGET%は手で下腹部の辺りを示した	PRINTFORMW 这样说着、%CALLNAME:TARGET%用手指着小腹附近
PRINTFORMW 不良在庫の山を前に、%CALLNAME:MASTER%と%CALLNAME:TARGET%は頭を抱えた…	PRINTFORMW 在堆积成山的不良库存前、%CALLNAME:MASTER%和%CALLNAME:TARGET%抱住了脑袋…
