胖次格子	检查胖次
股間格子	检查股間
肛門チェック	检查肛門
ARGS = %PANTIES(TARGET, "胖次")%格子	ARGS = 检查%PANTIES(TARGET, "胖次")%
ARGS = %SKIRT(TARGET, "略")%の下を撮影	ARGS = 拍摄%SKIRT(TARGET, "略")%的下面
CALL PRINT_STRL, "灰色_ [×] 部屋で表示される颜绘の一番左に%CALLNAME:MASTER%を表示する"	CALL PRINT_STRL, "灰色_ [×] 在房间中最左边展示%CALLNAME:MASTER%的颜绘"
CALL PRINT_STRL, @" [ 5] 部屋で表示される颜绘の一番左に%CALLNAME:MASTER%を表示する　現在：_黄色_\@ CONFIG("MASTER颜绘") ? 〇 # × \@"	CALL PRINT_STRL, @" [ 5] 在房间中最左边展示%CALLNAME:MASTER%颜绘　現在：_黄色_\@ CONFIG("MASTER颜绘") ? 〇 # × \@"
CALL PRINT_STRL, @" [ 6] 胖次画像などの特写のON/OFF　現在：_黄色_\@ CONFIG("特写ＯＦＦ") ? OFF # ON \@"	CALL PRINT_STRL, @" [ 6] 胖次画像等特写ON/OFF　現在：_黄色_\@ CONFIG("特写ＯＦＦ") ? OFF # ON \@"
ド萝莉と	慢慢地
襲来する少年	袭来的少年
かむろ風	半遮眼
かむろ風	半遮眼
うね毛バング	自然卷
真ん中分け	中分
前髪クロス	交叉前发
ベリーショート	短前发

陰部を接写する	阴部摄影
肛門を接写する	肛門摄影
ARGS = 拍摄%SKIRT(TARGET, "略")%的下面	ARGS = %SKIRT(TARGET, "略")%下摄影
股間に見入る	观察股间
ARGS = お掃除を頼む	ARGS = 拜托扫除
お掃除を頼む	拜托扫除
CALL PRINT_STRW, @"%CALLNAME:TARGET%の[躁动难忍]が治まりました"	CALL PRINT_STRW, @"%CALLNAME:TARGET%的[躁动难忍]退去了"
PRINTFORMW 虽然很可惜%CALLNAME:TARGET%には断られてしまったので一人で飲みます。	PRINTFORMW 很可惜被%CALLNAME:TARGET%拒绝了、所以只能自己一个人喝了。
動物タレ耳	動物耷拉耳

頬染め呆れ	红潮恍惚
ハート	爱心眼

戦化粧	战妆
隈取	脸谱
頬染	红晕
丸ほっぺ	婴儿红晕
返り血	血迹

ふきだし	对话框
ハート	爱心
ワイワイ	兴奋
驚き	惊讶
眠り	睡眠
寝ぼけ	困倦
満開	开心

みかん	橘子
スクールバッグ	挎包
タバコ	烟
アイス	冰

肛門チェック	检查肛門