揺れる	晃动的
豊満な	豊満的
形のいい	外形良好的
小振りな	小巧的
可愛らしい	可愛的
逞しい	健壮的
はだか	赤裸的
濃厚な	濃厚的
舌と唇で	舌和唇上
小柄な	小只的
乱雑に	胡乱
丁寧に	精心
適当に	随意
大胆に	大胆地
さりげなく	不动声色地
激しく	激烈地
ゆっくりと	慢慢地
軽く	轻轻地
二つの	两个
優しく	温柔的
じっくりと	细心的
話をした	说着话
情熱的に	热情地
そっと	悄悄的
荒々しく	粗暴的
ねっとりと	纠缠着
自らの	自己的
ギラついた	闪闪发光的
潤んだ	水润的
楽しげに	开心的
凶悪な	凶悪的
貧相な	寒酸的
レースの	蕾丝的
大きめの	大号
指ほどの大きさの	手指粗的
あり得ない太さの	不太可能的粗细的
凶悪極まる	極其凶悪的
物凄い大きさの	非常大的
ありえない太さの	不太可能的粗细的
太い	粗大的
野太い	很大号的
大きな	大号的
バルーン	充气
ドロドロにほぐされた	黏黏糊糊被放鬆的

ようにお願い中	拜托中
に普段から	平常一直
に常に	里一直
になった	变成了
上げた…	動作著…
眠っている	沉眠著
優しげに	温柔地
微笑みながら	微笑着并
微笑みかけて	微笑着
恥ずかしそうにし	有点害臊并
幼いワレメを	用幼小裂缝
陰唇を	用陰唇
恥ずかしそうに	有点害臊的
露わになった	暴露了出来
勃起している	勃起来了
腰を動かし始めた	开始动起了腰身
濡れそぼった	充分湿润的
満面の笑みを	満脸笑容地
見つめている	看了过来
おずおずと	怯生生地
無理やり	强行
くすくすと笑い	嘻嘻一笑
顔を赤くした	红了脸的
顔を赤くして	红着脸
脱ぎ捨てた	脱了下来
を晒した	给展示出来
うっとりしている	神情陶醉的
顔を緩ませてい	微笑起来
快楽を与えようと	为给予快楽
嬉しそうに頬を緩ませ	开心地挂上笑容
笑みを浮かべて	露出笑容
嬉しそうな表情で	露出开心的表情
頭を抱えている	抱住了脑袋
見せつけてきた	展示了出来
を揉みしだきながら	揉捏起来并
を締め付けながら	紧缠住并
腰を前後に動かし	前後动起了腰
犯し続けている	持续侵犯起来
犯し続けた	持续侵犯着
を抱きしめ	抱住
嬉しそうに	开心地
撫でてきた	抚摸着
に抱きついてきた	抱住了
ちょっと背伸びした	稍微长大了
楽しそうに微笑みながら	开心地微笑着并
揉みしだいた	揉捏起来
後ろから	从后面将
快感を味わっている	品味着快感
寄り添って	偎依在一起
頬に手を添えて	摸着脸蛋并
弾力を楽しみながら	弾性享受着的同时
存分に揉みしだいた	尽情的揉弄着
を捻りあげた	捻动起来
垂らした	滴下去
ながら、	的同时、
重ねられた	把重合起来的
並んだ	把靠在一起的
に指をゆっくりと挿入した	用手指慢慢的插了进去
指が沈み込む感触を堪能した	享受着手指陷入进去的触感
応じる	回应
嫌そうに	厌恶地
人形のような	像人偶一樣的
頬を紅潮させて	臉上泛起了紅潮
甘い息を吐きながら	吐出了甜蜜的喘息
腰をくねらせる	扭動著腰肢
つながったまま	身體連接著
大量に	大量的
注ぎ込まれた	被灌进
放たれた	被释放进
汗をかいた	带着汗水
うっとりした表情で	一脸陶醉
されるがままになっている	任凭摆布
互いの	互相用
歯を食いしばって	咬紧牙关
弾む	起伏着的
愛撫した	愛撫起来
擦りあげている	摩擦了起来
はちきれんばかりに	装的满满的
口移しで	嘴对嘴地
粘液にまみれた	充满粘液的
にまみれた	充满的
たっぷりと	充分
の最奥まで突き入れた	的最深处插了进去
ぷにぷにした	捏住感觉很有弹性
しとどに濡れ	湿濡湿濡的
感触を味わいながら、	触感品味着的同时、
の柔らかな	的柔软的
顔を赤らめて	红着脸
半勃ちの	半勃起的
声を押し殺し	压抑声音
甘い声を上げ	发出甜美的声音
胸を愛撫し	爱抚着胸
口づけ	接吻
甘い言葉を囁いて	诉说着甜言蜜语
自慰に耽っている	沉溺于自慰之中
驚いているようだ	受惊了的様子
腸内から	从腸内
はちきれんばかりの	快要装不下的
…ええと	…那么
そうですか	是这様吗
またね	回头见
やっぱりやめる	果然還是放棄
無理です	不行
戻ってきた	回来了
よろしいですか？	可以吗？
汚れを意図的にそのままにする	有意识的保持着污秽
汚れをそのままにさせる	使污垢保持原状
あまりよく洗わない	平常不怎么洗这里
残念ながら	虽然很可惜
Ｈのお誘いをしてきた	邀请来Ｈ
[0] はい	[0] 是
[1] いいえ	[1] 否
そのまま	就这様
%CALLNAME:MASTER%は少し	%CALLNAME:MASTER%稍微
%CALLNAME:TARGET%を背後から抱きしめ、再び%CALLNAME:TARGET%の身体を揺らし始めた	将%CALLNAME:TARGET%从背後抱住、再次开始摇晃起了%CALLNAME:TARGET%的身体
%CALLNAME:MASTER%と%CALLNAME:TARGET%は	%CALLNAME:MASTER%和%CALLNAME:TARGET%
%CALLNAME:TARGET%の膣内の感触を味わいながら、再び腰を動かし始めた	在品味着%CALLNAME:TARGET%膣内的触感的同时、再次开始动起了腰
%CALLNAME:TARGET%の膣内から抜かずに、再び腰を動かし始めた	没有从%CALLNAME:TARGET%的膣内拔出、再次开始动起了腰
膣内から抜き去ることなく%CALLNAME:TARGET%を仰向けに寝かせ、再び腰を動かし始めた	不从膣内拔出并让%CALLNAME:TARGET%仰面躺下、再次开始动起了腰
