

//C字典目录
//版本：AM葱神字典 V1.19
//进行行数：已完成


//时间天气类

//服装类
//	服装属性
//		颜色属性
//	服装类别
//	飾品CLO9_OTHER
//	胸罩CLO1_BRA
//	胖次（内衣）CLO0_PANTIES
//	贴身制服CLO4_BODYSUIT
//	褲子CLO5_OUTER
//	上衫CLO2_SHIRT
//	裙子CLO3_SKIRT
//	襪子CLO6_SOCKS
//	鞋子CLO7_SHOES
//	手套CLO8_GLOVE
//	其他服装
//	角色特有服装

//髪型
//颜绘表情相关（不包括髪型）

//角色
//	角色名称
//	角色称号和关系
//	角色属性（非TALENT，性、弱点、调教知识相关）
//	助手能力
//	角色其它（人物scv附属）

//角色交易

//通用选项类
///長选项（只在一个地方出现的）

//系统类
//	系统文本
//	设置选项与文本

//日常类
//	学习相关
//	合意
//	日常状态
//	日常行动
//	日常指令
//		健康指令
//		性骚扰指令
//		性处理指令
//	标语相关
//	摄影相关
//	日常履歴
//	食物类
//	地点


//调教类
//	调教道具
//	调教指令相关短词
//	调教指令
//	调教选项
//		射精部位
//	调教状态（INFO.ERB）
//	调教履历
//	特別経験
//	身嗜相关

//体态属性

//ABL
//TALENT
//	TALENT分支
//EXP
//CSTR
//CFLAG
//FLAG
//TEQUIP

//物品类


//称呼

//片假名英文
//	片假名英文术语
//	其他片假名英文短词

//其他日文短词
//非判定词
//其他未分类文本




















//时间天气类
お正月	新年
バレンタイン前日	情人節前日
バレンタイン	情人節
バレンタインデー	情人節
バレンタイン翌日	情人節翌日
ホワイトデー	白色情人節
ビキニの日	比基尼の日
バニーの日	兔女郎の日
もうすぐクリスマス	圣诞节前夕
ハロウィン	万圣节
クリスマス	圣诞节
クリスマス翌日	圣诞节翌日
クリスマス期間	圣诞节期間
昼下がり	午后
夕方	傍晚
晴れ	晴天
曇り	陰天
あられ	冰雹
衣替え(夏)	换衣季(夏)
衣替え(冬)	换衣季(冬)
日曜	周日
月曜	周一
火曜	周二
水曜	周三
木曜	周四
金曜	周五
土曜	周六
サンタ	圣诞
日付	日期
もうすぐ文化祭	即将到来文化祭




//服装类

///服装属性




男物の	男式
部屋着	居家服
エッチ衣装	Ｈ衣装
隙間チラ可	可从缝隙偷窥的
汗透け	汗水浸湿的
タイト	紧身
プリーツ	百褶
ヒップボーン	包臀
へそ露出	露脐
へそ出し	露脐
汚れた	弄脏的
破損した	破損了的
ロング	長
刺繍入り	刺绣
コルセット	束腰
//チェック	格子
背中開き	露背
ニット	针织
だぼだぼ	宽大的
ルーズ	宽松的
濡れ	湿的
蒸れ	闷热的
染み	带污迹的
クロッチ	開洞
食い込み	勒紧的
足首まで	直到脚腕
太ももまで	直到大腿
肘まで	直到手肘
シャツの裾	衬衫下摆
ボトムレス	没穿下衣
トップレス	没穿上衣
ハダカ	裸体
ギャル	辣妹
エロチックな	洋溢著情色氣息的
コキ不可	不可手交
ノーパン	没穿内褲








////颜色属性
おとなしい色	淡色
ランダムカラー	隨機顏色

Ｈな色	Ｈ的颜色
緑と白	緑白
青と白	青白
黄色と白	黄白
黒と白	黒白
ピンク	粉紅
オレンジ	橘
ベージュ	米色
ブラウン	棕色
黒い	黑色
白い	白色
子供パンツカラー	儿童胖次颜色



///服装类别

////通用
はだけた	半脱的
ずらした	移開的
ずれ不可	不可移開
ずれ	移開

////@CHECK_OTHER
ペンダント	吊坠
ネックレス	項鏈
タイ	領帯
ハット	礼帽
キャップ	帽
つけ耳	饰耳
髪飾り	髪飾
コート	外套
ジャケット	夹克
ジャンバー	夹克
アウター	外套
アクセサリ	飾品

////@PANTIES & BRA (@COORDINATE_BRA)
Ｈな	Ｈ的
オープン	開放型
マイクロ	Micro
ビキニ	比基尼
マイクロビキニ	Micro比基尼
縞々	條紋
豹柄	豹纹
レース	蕾丝
シースルー	透明
フリル	褶边
レザー	皮革
セクシー	性感
シンプル	简约


////@CHECK_BRA
シルク	絲綢


////@CHECK_PANTIES等褲子类型
//オープンクロッチ	開放型開洞
ハイレグ	高開衩
ファスナー	带拉链的
破いた	破開的
ローライズ	低腰
ローレグ	超低腰
フロント	正面
フロントリボン	正面蝴蝶結
スリット	開衩

////@CHECK_SWIM
パレオ	荷葉邊


////@CHECK_BODYS
バニー	兔
水着	泳装
はだけ	半脱


////@CHECK_OUTER
ショート	短

////@CHECK_SHIRT
ノースリーブ	无袖
ワイシャツ	衬衫
ネグリジェ	晨衣
パジャマ	睡衣
ビスチェ	紧身胸衣
ドレス	礼服
セーラー	水手
重ね着	衣领颜色
ウェイトレス	侍者服
アイドル衣装	偶像衣装
シャツ	恤
セーター	毛衣


////@CHECK_SHIRT
上下セット	两件套
ミニ	迷你
超ミニ	超短迷你
スカート	裙
アメスク	美式校服


















///飾品CLO9_OTHER
ネクタイ	領帯
リボンタイ	蝴蝶結領帯丝巾
蝶ネクタイ	蝶形領帯
マフラー	围巾
ストール	披肩
チョーカー	颈环
首輪	项圈
イルカのペンダント	海豚吊坠
//眼鏡
フィンチ眼鏡	金丝眼鏡
ロイド眼鏡	玳瑁眼鏡
モノクル	单片眼鏡
ブロー眼鏡	专家眼鏡
フルリム眼鏡	黑框眼鏡
サングラス	太阳鏡
目隠し	眼罩
シルクハット	絲綢礼帽
//魔女の帽子
ベレー帽	贝雷帽
ヘッドドレス	礼服头花
//メイドキャップ	女僕帽
ピクチャーハット	妇人礼帽
麦わら帽子	草帽
ニット帽	针织帽
ナースキャップ	护士帽
ハーフボンネット	半遮帽
キャスケット帽	鸭舌帽
シスターベール	修女帽
ネコ耳	猫耳
うさ耳	兔耳
キツネ耳	狐耳
イヌ耳	犬耳
カチューシャ	髮箍
リボン	蝴蝶結
サークレット	头箍
ティアラ	头冠
かんざし	簪子
ケープ	披风
マント	斗篷
分厚いコート	厚外套
ステッチコート	织布外套
トレンチコート	风衣外套
ダッフルコート	粗呢外套
ポンチョコート	披风外套
ダウンジャケット	羽绒夹克
キャットガーター	腿环
フリルサスペンダー	褶边裙吊带
サスペンダー	裤吊带



///胸罩CLO1_BRA
ブラ	胸罩
ノーブラ	无胸罩
//シンプルブラ	简约胸罩
ブラジャー	文胸
フルカップ	满杯
３／４カップ	３／４杯
ハーフカップ	半杯
シェルフ	１／４杯
チューブトップ	抹胸
タンクトップ	吊帯背心
スポーツブラ	運動胸罩
ヌーブラ	胸垫
オープンブラ	開放型胸罩
マイクロブラ	Micro胸罩
キャミソール	吊帯衫
//縞々ブラ	條紋胸罩
//水玉模様のブラ
//豹柄ブラ	豹纹胸罩
レースのブラ	蕾丝胸罩
シースルーブラ	透明胸罩
//フリルのブラ	褶边の胸罩
//レザーブラ	皮革胸罩
//猫型ブラ	猫型胸罩
さらし	裹胸布
//ビキニブラ	比基尼胸罩
//マイクロビキニブラ	Micro比基尼胸罩
//Ｈなブラ	Ｈ的胸罩
ノーマルブラ	普通胸罩

クォーターカップ	１／４杯
サラシ	裹胸

貝殻ブラ	貝殻胸罩



///胖次（内衣）CLO0_PANTIES
パンツ	胖次
ショーツ	內褲
パンティ	三角胖次
フルバック	全後衛
ローライズパンツ	低腰胖次
ローレグパンツ	超低腰胖次
ハイレグパンツ	高開衩胖次
Ｔバック	Ｔ字褲
Ｇストリング	丁字褲
Ｃストリング	Ｃ胖次
ボーイレッグ	四角内褲
//オープンクロッチパンツ	開放型開洞胖次
Ｏバック	後開型
マイクロショーツ	Micro內褲
//縞々パンツ
//水玉模様のパンツ
//豹柄パンツ
//レースのパンツ
//シースルーパンツ
//フリルのパンツ
紐パン	繩系胖次
レザーパンツ	皮革胖次
褌	兜襠布
//貞操帯
前貼り	前貼
子供パンツ	儿童胖次
//ビキニ	比基尼
//マイクロビキニ	Micro比基尼
ティアドロップ	淚珠泳衣
トランクス	四角褲
ボクサーパンツ	鬥士胖次
//ハイレグブルマ	高開衩布鲁马
Ｈな下着	Ｈ的内衣
葉っぱパンツ	叶子胖次

ブリーフ	简约胖次
ドロワーズ	襯褲
サーフパンツ	衝浪胖次
メンズビキニ	男式比基尼
プリント	印花


///贴身制服CLO4_BODYSUIT
レオタード	緊身内衣
//セクシーレオタード	性感緊身内衣
エナメル	漆皮
//エナメルレオタード	漆皮緊身内衣
バニースーツ	兔女郎制服
ハイレグバニー	高開衩兔女郎服
ボンデージ	拘束衣
スク水	死库水
ワンピース水着	連体泳装
//ハイレグ水着	高開衩泳装
//競泳水着
スリングショット	彈弓泳衣

ボディスーツ	贴身制服
ハイレグワンピ	高開衩連衣裙




///褲子CLO5_OUTER
ブルマ	布鲁马
//ハイレグブルマ	高開衩布鲁马
スパッツ	紧身短褲
ホットパンツ	热褲
ショートパンツ	短褲
ハーフパンツ	五分褲
ズボン	長褲
//ジャージズボン
ジーンズ	牛仔褲
//ローライズジーンズ	低腰牛仔褲
キュロットスカート	褲裙
レギンス	打底褲
パンスト	连褲襪
網パンスト	渔网连褲襪
オープンパンスト	開放型连褲襪

スラックス	西褲
ハーパン	运动短褲







///上衫CLO2_SHIRT
メイド服	女僕装
ナース	护士
チャイナドレス	旗袍
//巫女服
ウェディングドレス	婚纱礼服
//修道服
ゴスロリドレス	哥特蘿莉礼服
ベビードール	情趣内衣
着物	和服
//振袖
//浴衣
どてら	褞袍
セーラー服	水手服
ブレザー	西装上衣
学ラン	校服
//男子ブレザー
//体操服
ジャージ	运动衫
ブラウス	女式衬衫
ネクタイブラウス	領帯女式衬衫
ノースリーブブラウス	无袖女式衬衫
ルーズブラウス	宽松女式衬衫
フリルブラウス	褶边女式衬衫
Ｔシャツ	Ｔ恤
変な柄のＴシャツ	怪图案Ｔ恤
だぼだぼＴシャツ	宽大的Ｔ恤
オフショルダー	露肩上衣
カーディガン	V领毛衣
Ｙシャツ	衬衫
//はだけシャツ
カットソー	切驳服
バックリボンカットソー	后背蝴蝶結切驳服
タートルネック	高領毛衣
胸開きタートルネック	開胸高領毛衣
リボン付きオフショル	蝴蝶結露肩上衣
ニットオフショル	针织露肩衣
ニットセーター	针织毛衣
背中開きニットセーター	露背针织毛衣
萌え袖セーター	萌袖毛衣
//タンクトップ	吊帯背心
へそ出しタンクトップ	露脐吊帯背心
サマードレス	夏日礼服
ワンピース	連衣裙
甘ロリワンピース	洛丽塔連衣裙
ゴシック	哥特
//ゴシックワンピース	哥特連衣裙
チュニック	紧身長袍
パーカー	連帽風衣
前開きパーカー	前开連帽風衣
スーツ	制服
//シャツジャケット	恤夹克
前開きシャツ	前開的衬衫

ミニスカ	露脐装超短裙
チアユニフォーム	啦啦队制服
ショートコート	短外套
フレンチメイド	法式女僕装

要たくし上げ	提起裙角



///裙子CLO3_SKIRT
裾	下摆
着物の裾	和服下摆
ミニスカ	迷你裙

ミニスカート	迷你裙
チェックミニスカート	格子迷你裙
タイトスカート	紧身裙
エプロンスカート	围裙
プリーツスカート	百褶裙
ヒップボーンスカート	包臀裙
チェックスカート	格子裙
マイクロチェックスカート	Micro格子裙
コルセットスカート	束腰裙
コルセットミニスカート	束腰迷你裙
マイクロミニスカート	Micro迷你裙
プリーツミニスカート	百褶迷你裙
刺繍入りロングスカート	刺绣長裙
パニエ入りサーキュラスカート	帯裙撑的蓬蓬裙


///襪子CLO6_SOCKS
ソックス	短襪
ハイソックス	膝下襪
ニーソックス	及膝襪
//フリルニーソ
サイハイソックス	高筒襪
足袋	短布襪
ストッキング	長筒襪
網ストッキング	网纹長筒襪
ガーターストッキング	吊帯長筒襪
ガーターニーソ	吊帯襪

靴下	襪子
ニーソ	襪
オーバーニーソ	过膝襪
タイツ	褲襪






///鞋子CLO7_SHOES
ローファー	小皮靴
スニーカー	運動鞋
パンプス	平底鞋
ミュール	无后跟鞋
サンダル	凉鞋
ハイヒール	高跟鞋
ブーツ	靴
//ショートブーツ	短靴
ブーティ	短筒女靴
ロングブーツ	長靴
下駄	木屐





///手套CLO8_GLOVE
シルクグローブ	絲綢手套
ドレスグローブ	礼服手套
レザースリーブ	皮革袖套
ドレススリーブ	礼服袖套




///其他服装
バスタオル	浴衣
スリーブ	袖
普段着	便装
ヘッドホン	頭戴式耳机
ベルト	吊帯
新スク	新死库水
ワンピ水着	连体泳装
ネコランジェリー	猫内衣
ベスト	背心
パン	胖次
上着	外衣




///角色特有服装
ボロボロのジャンバー	破破烂烂的夹克
レースブラ	蕾丝胸罩
前張り	Ｃ字袴
シックなメイド服	潇洒的女僕裝
白と金の装飾のされた民族衣装	白色和金色装饰的民族衣装
モカシン	莫卡辛软皮鞋
バレエシューズ	芭蕾舞鞋
アームバインダー	手臂束缚器



//髪型
真鍮	棕
ダークブロンド_姫カット	DarkBlonde色_公主头
セミロング	披肩
ぱっつん	齐刘海
ストレート	直髪
ウェーブ	卷髪
外ハネヘア	外卷髪尾
ツインテール	双马尾
ポニーテール	马尾辫
でか三つ編み	大三股辫
三つ編み	三股辫
編み上げ	编起来
シニヨン	盘头
おさげ	麻花辫
ミディアム	中等長度
ミディアムロング	中長髪
ミディアムショート	中短髪
ボブ	巻髪
デコ出し	露额头
斜めバング	斜刘海
編み込み	編髪
ショートツインテ	短双马尾
ロングツインテ	長双马尾
ウェーブツインテ	卷双马尾
ドリルツインテ	钻头双马尾
お団子	団子頭
ナチュラルバング	自然刘海
ショートバング	短刘海
かきあげ	撩刘海
外ハネバング	外八刘海
もみあげロング	長鬓角
ボサボサ	乱髪
ナチュラル	自然
外ハネ	外八
ノーアレンジ	无特殊髪型
サイドテール	侧马尾
サイドシニヨン	侧盘头
髪の長さ	髪長
髪の色	髪色
後ろ髪	後髪
アレンジ	改髪
片目隠れ	单眼遮盖
両目隠れ	双眼遮盖
Ｍ字バング	Ｍ字刘海
アシメ	不对称
インテーク	进气口发型
右分け	右斜
弱目隠れ	大半遮盖
かむろ風	半遮眼
うね毛バング	自然卷
真ん中分け	中分
前髪クロス	交叉前发
ベリーショート	短前发


シースルーバング	透明刘海
お団子ツインテ	团子头双马尾
一つ結び	单辫
二つ結び	双辫
バレッタ留め	简易扎发

//颜绘表情相关（不包括髪型）
顔グラ	颜绘
びっくり	惊嚇
寝起き	刚睡醒
状態リセット	状態重置

動物タレ耳	動物耷拉耳

頬染め呆れ	红潮恍惚
ハート目	爱心眼

戦化粧	战妆
隈取	脸谱
頬染	红晕
丸ほっぺ	婴儿红晕
返り血	血迹

ふきだし	对话框
ハート	爱心
ワイワイ	兴奋
驚き	惊讶
眠り	睡眠
寝ぼけ	困倦
満開	开心

みかん	橘子
スクールバッグ	挎包
タバコ	烟
アイス	冰
ココアシガレット	pocky
食パン	面包
食胖次	面包
フランスパン	法棍
チーク	脸颊

半開き	半開
への字	へ字
困り眉	困扰眉
たれ眉	斜眉
通常眉短	短通常眉
怒り眉短	短憤怒眉
たれ眉短	短斜眉
困り眉短	短困扰眉
白目なし	无眼白
白目あり	有眼白
黒目あり	黑眼白
糸目	眯眯眼
ぱっちり	水灵眼
ジト目	斜眼
たれ目	垂眼
ツリ目	吊眼
ジト三白眼	重度三白眼
通常目	普通眼
眼鏡なし	无眼鏡
アホ毛	呆毛
アホ毛なし	无呆毛
リボンなし	无蝴蝶結
片側リボン	单側蝴蝶結
後ろリボン	頭後蝴蝶結
目の色	瞳色
目の形	眼形
白目	白眼
白目描写	白眼描写
眉の形	眉形
口の形	嘴形
怒り	憤怒
ふくれっ面	嘟嘴



//角色
キャラ	角色

///角色名称
あなた	你
フェリシエル	弗理希艾尔
ツェツィーリア	西西莉亚
アリーヌ	阿丽努
さくら	樱
ハナ	哈娜
パラチネ	帕拉奇娜
メリィエーナ	麦莉爱娜
リアラ	莉雅拉
九重アイリ	九重亜依璃
シキ	織
玉寄あんず	玉寄杏珠
あんず	杏珠
長谷川ホムラ	長谷川焰
ホムラ	焰
マノン	万音
カリスタ	卡莉斯塔
リューナ	琉娜
マリー	玛丽
ノノ	乃々
オスカー	奥丝卡
メアリー	梅莉
グレイス	格蕾丝
獅鷹コルレオニス	獅鷹·獅心
コルレオニス	獅心
マセル	玛塞璐
みなみ	南実
エティエンヌ	艾迪安奴
すず	鈴
にいこ	贰壹伍
ユカ	佑香
アンナ	安娜
カエデ	卡艾蒂
ノイ・ドミナ	诺伊.德米那
ノイ	诺伊
パトラ	帕图拉
リディア	莉迪亚
シルフィ	西露芙
真っ白い死神	纯白死神
シュトリー	休托莉
ミス・メイプル	Miss.梅普尔
ミア	米娅



///角色称号和关系
化け狐	狐妖
若手魔道士	年轻魔道士
元人間の淫魔	原人类の淫魔
鬼の血を引くギャル	继承了鬼之血的女孩
火鼠見習い	見習火鼠
取り残された半妖	被遗弃的半妖
ビスクドール	瓷人偶
メスガキ半悪魔	萝莉碧池の半悪魔
いじめられっこ先輩	被欺负的前辈
殺しか知らない殺人姫	只知杀戮的杀人姫
クールな悪魔メイド	冷冷的恶魔女僕
セフレ	炮友
お弁当の作り手	便当制作者
クラスメイト	同班同学
ご主人様	主人様
メイド	女僕
部活仲間	社团同伴
悪魔祓い	驱魔人
ラミア	拉米亚
サラマンダー	火精灵
密留学エルフ	秘密留学的精灵
改造子猫	改造幼猫
死を蒐集する神の農夫	收集死亡的神之农夫
リトルデビル	小恶魔
帰ってきた幼馴染	归来的青梅竹马
アナルサキュバス	后庭魅魔
クラスのオナペット	全班的性幻想对象
襲来する少年	襲来的少年








///角色属性（非TALENT，性、弱点、调教知识相关）

////CSTR:ARG:弱点
手に弱い	手弱点
口に弱い	口弱点
胸に弱い	胸弱点
脚に弱い	脚弱点
♀に弱い	♀弱点
キスに弱い	接吻弱点
アナルに弱い	肛門弱点
♂に弱い	♂弱点
尿道に弱い	尿道弱点
においに弱い	气味弱点
匂いに弱い	气味弱点
精液に弱い	精液弱点
全てに弱い	全部弱点

////TALENT:ARG:精液に弱い
精飲に弱い	精飲弱点
膣内射精に弱い	膣内射精弱点
肛内射精に弱い	肛内射精弱点
乳内射精に弱い	乳内射精弱点
尿道内射精に弱い	尿道内射精弱点

////TALENT:ARG:調教知識
大人のおもちゃ学	大人的玩具学
大魔法使い	大魔法使
魔法使い	魔法使
教え上手	教育上手
道具使い	道具使






///助手能力
ロマンチック	罗曼蒂克
リジェネレイト	再生
ファシネイション	调教师
縁結び	縁結
マナ蒐集	魂蒐集
ソロプレイヤー	单人玩家
毎日にぎやか	和和闹闹
不毛な相談	无用相談
サプレッション	抑制器
見習いの意地	見習的心情
射精煽り	催精师
クールダウン	冷却器
頑張る先輩	努力的前輩
テンプテーション	誘惑
痛いの痛いのとんでけ	痛痛飞走啦
小悪魔の囁き	小悪魔の轻语
ナチュラリスト	原生主义者
隣の人妻	隔壁的人妻
トリックスター	欺诈师





///角色其它（人物scv附属）
魂不要	不需要魂
メロンパン	菠萝包
臭気の強すぎる食べ物	味道太冲的食物
噂話	八卦
ゲームの対戦	游戏対戦
ホイップ山盛りのスイーツ	超大份的甜点
堅苦しい話題	严肃的話題
退屈	无聊
風通しの悪い所	通风不好的地方
髪留め	髪卡
学園の生徒	学校的学生
土いじり	园艺
特撮ヒーロー番組	特撮英雄连续剧
せまいところ	狭窄的地方
消毒液のにおい	消毒液的味道
髪_ロング	髪_長髪
ラウドロック	Loud Rock
亡くなった両親	亡故的双親
実家の召し使い	家里的佣人
紫がかった	带着紫色的
ぱっつんぱっつんのセーラー服	绷得紧紧的水手服
甘いもの	甜食
辛いもの	辣的食物
幽霊とか怪談とか	幽霊以及怪談什么的
伸びっぱなし	光滑柔顺
ボタンのはじけたブラウス	没系扣子的女式衬衫
ハートのチョーカー	心形颈环
レトロゲーム	远古游戏
フルーツ入りサラダ	放了水果的沙拉
山歩き	登山
地元の緑茶	当地的緑茶
隠れること	躲藏
思い込みの激しい人	固执激动的人
冷めたシチュー	冰橙汁
煮干	小鱼干
臭いもの	不好闻的东西
ぬいぐるみ	玩偶
可愛いもの	可愛的东西
特に无	没什么特别的
好きなもの,本	喜欢的东西,书
お祈り	祈祷
ワイバーン	飞龙
卑怯者	卑鄙小人
お勉強	学习
マカロン	马卡龙
フレーバーティー	花茶
手作り	亲手自制
バナナ	香蕉
焼き芋	烤红薯
ハーブティー	香草茶
嫌いなもの,特になし	讨厌的东西,没有什么特别讨厌的
好きなもの,親友/学園生活/冬	喜欢的东西,親友/学園生活/冬天
ライ麦パン	黑麦面包
荒縄	麻縄
むち	鞭子
路地裏	小巷子
ジャム入り紅茶	加了果酱的紅茶
人殺しです！	殺人！
けいさつさんです…	警察…
優しい人	温柔的人
甘い食べ物	甜的食物
ケチャップ	番茄酱
いじわるな人	坏心眼的人
苦い食べ物	苦的食物
綺麗に研がれたナイフ	磨的很漂亮的小刀
赤黒いノースリーブパーカー	红黑色无袖連帽風衣
レアチーズケーキ	芝士蛋糕
シフォンケーキ	戚风蛋糕
レモンのタルト	柠檬蛋挞
ナッツチョコ	坚果巧克力
茶葉の量り売り店	茶叶批发店
アルファベット	字母表顺序
うるさい奴	很吵的家伙
人の話を聞かない奴	不听人说话的家伙
蒐集者	收集人
ヒト	人类
あん畜生	某个畜生


//角色交易
取引をする	做交易
取引相手	交易对象
恋人になって！	成为恋人！
同棲頻度の相談	同居頻度的相談
同棲して欲しい	想要同居
お弁当作って	做便当
ピルを渡す	服用避孕药
ピルの服用中断	避孕药服用中断
淫紋彫らせて	雕绘淫紋
性処理を頼む	拜托処理性欲
尻尾を見せて	给我看尾巴
裸になって欲しい	裸体希望
裸になった	变成裸体
全裸取引	全裸交易
お金が欲しい	想要钱
背を大きく	身材变大
背を小さく	身材变小
ペニスを大きく	阴茎变大
ペニスを小さく	阴茎变小
胸を大きく	胸部变大
胸を小さく	胸部变小
お尻を大きく	臀部变大
お尻を小さく	臀部变小
ふたなり化	扶她化
あだ名変更	爱称変更
呼び名変更	称呼変更
淫紋シール	淫紋贴纸
尻尾を見せる	给看尾巴
パンツ取引	胖次交易
魂支払い済	已支付魂
ずっと！	一直！
同棲：ずっと	同居：一直
同棲：一週間	同居：一周間
同棲：週末のみ	同居：仅周末
とりあえず１週間	总而言之先１周吧
毎週土曜(夜)から月曜(朝)まで/	毎周周六(晚上)到周一(早上)为止
髪を弄らせて	改变髪型
髪を弄る	改变髪型
パンスト着替えて	换上褲襪
居候	借住
同棲	同居
お弁当	便当
パンツを脱いで手渡し	脱下胖次交了出去



//通用选项类
どうしますか？	该怎么做呢？

はい	是
いいえ	否
なし	无
ページ	页
その他	其他
閉じる	关閉
前のページ	察看前一頁
次のページ	察看下一頁
戻る	返回
無し	没有
有り	有些
多め	很多
強い	很强
上手	擅長
リロード	随机属性
やっぱやめる	果然还是算了
頼んでみる	拜托试试
誘いに乗る	答应了
やめとく	还是算了
お願いする	拜托了
貰う	要
これでよい	这様就好
外す	取下
帰る	返回
受け入れる	接受
誘う	邀请
誘わない	不邀请
やめておく	还是算了
あげる	给
あげない	不给
抜く	拔出
抜かない	不拔出
払わない	不支付
あきらめる	放弃



///長选项（只在一个地方出现的）
パンツ見せてくれるならしてもいい	给我看一眼内褲的话倒也不是不可以
今の格好のまま連れていく	保持现在的装扮一起去
パンツを没収して連れていく	没収胖次带过去
パンツを穿かせて連れていく	穿着胖次一起去
没収したパンツを穿かせて連れていく	穿上没收的胖次一起去
下着姿で同行してもらう	只穿内衣带过去
全裸で同行してもらう	全裸着带过去
まだ取っておく	还是保留吧
別に外さなくていい	不用装备其他的
今日のところは解散	今天原地解散
食べ歩き	尋訪美食
下着姿になる	变成内衣姿态
チップを渡す	给小费
よろこんで！	请多指教！
頼む！	拜托了！
前の穴を貸してもらう	借用一下前穴
こっそり口で抜いてもらう	请求偷偷口交
我慢する	忍耐
こっそり手コキしてもらう	请求偷偷手交
映画に集中する	专心看电影
ちょっと物陰へ	到暗处去
次は何処に行こうか？と話を振る	下次去哪里呢？询问
合わせない	不搭配
これに決める	决定好就是这个了
別の水着を試してもらう	试试别的泳装
合わせるものを変える	试试搭配别的东西
真面目に勉強する	认真学习
就労ビザを申請しに行く	去申請就业签证




//系统类
///系统文本

ああ忙しい、忙しい……	啊啊好忙啊、好忙啊……
～メイドのお姉さんと堕落した日々を過ごそう～	～女僕姐姐与堕落的日常生活～
何番をロードしますか？	加載哪一個存檔？
キャラ紹介	角色介绍
最初からはじめる	從最初開始
ロードしてはじめる	讀档继續
変更しますか？	要进行変更吗？




///设置选项与文本
カットイン	特写
コンフィグ	Config
属性と外見	属性与外表
包茎ペニスの呼び方	包茎阴茎的称呼
素質の固定と除外	素質的固定与除外
オートちょっかい	自动调戏
夏の運動で蒸れ蒸れ	夏天的運動汗流浃背
キャラメイク関連	角色定制関連
システム＆イベント全般	系统＆事件相关
着せ替え設定	着装設定
搾精ランキング	搾精排行
射精ランキング	射精排行
助手のお仕事指示	助手的任务指示
パンツコレクション	胖次收藏
所持アイテム一覧	所持道具一覧
普段の格好	平常的装扮
自宅では靴を脱ぐ	在家里脱鞋
キャラ衣装	角色衣装
セクハラ	性騷擾
アニメ	动画
コーディネート	装扮
３サイズ	３围
最初に戻す	回到初始状态
ランダム	随机
not黒目ランダム	不出现黒眼的随机
色＆柄	颜色＆花纹
お腹周り	肚子周围
普通にする	普通就好
[226]少し	[226]少许
[231]少し	[231]少许
自動脱衣の禁止	禁止自動脱衣
自宅に限り靴を脱ぐ	在自己家里会脱掉靴子
パンツを選択した際にブラも自動で選ぶ	選択内裤時会自动同時选择胸罩
顔グラ表示をやめる	放弃显示顔绘

//日常类

いらっしゃいませー	欢迎光临ー
いらっしゃいませ	欢迎光临
おめでとうございます	祝贺您！



///学习相关
週末に試験	周考
勉強pt	学习pt
Ｈな約束	Ｈ的約定








///合意
ポージング	摆POSE
Ｈな写真	Ｈ的写真
呼び出しＨ	叫出来Ｈ
黒いチョーカー	黒色颈环


///日常状态
レベルアップ可能	可以lv UP
汗だく	浑身是汗
起きそう	快要醒了
デートの約束	约会的约定
眠気	困倦
酔い	酔酒
悪酔い	烂醉
デート	约会
うたた寝	打瞌睡


///日常行动
なでなで	抚摸
耳かき	掏耳朵
食事	吃飯
茶汲み	沏茶
着替える	更衣
お茶汲み	沏茶
お風呂のお誘い	邀请一起入浴
抱きつき	抱住
膝を枕にしてくる	膝枕
お酌	对酌
頬キス	亲脸頬
膝枕する	膝枕
Ｈのお誘い	Ｈ的邀请
パンツ見せ	展示内褲
おっぱい押し付け	把胸部压了上去
股間擦り付け	摩擦股間
勉強のお誘い	邀请学习
余韻に浸る	沉浸在余韻里
抜け出す	摆脱
特殊イベント	特殊事件
買い出し	採購
お参り	参拜
イチャイチャ	打情骂俏
立ち読み	站着读书
買い食い	買食物
ゲームを物色	物色游戏
ゲーム	游戏
新刊のチェック	检查新刊
音ゲー	玩音游
メダルゲーム	街机游戏
新作の物色	物色新作
プリクラ	大头贴
対戦ゲーム	対戦游戏


///日常指令
////健康指令
お茶を淹れる	泡茶
みんなにお茶を淹れる	给大家泡茶
頭を撫でる	摸頭
買い物する	買東西
お酒をふるまう	勸酒
みんなにお酒をふるまう	给大家勸酒
挨拶	打招呼
起こす	叫醒
挨拶する	打招呼
普通に挨拶	普通地打招呼
みんなに挨拶	向大家打招呼
ハグしながら	用拥抱打招呼
トーク	Talk
お誘いに乗る	邀请
体を拭く	擦身体
汗を拭く	拭汗
もてなす	互动
寝姿を整える	整理睡姿
隙を見せる	卖个破绽
お掃除を頼む	拜托扫除
股間に見入る	观察股间
しっぽをなでる	抚摸尾巴
マッサージする	按摩
褒める	夸奖
雑談する	雑談
みんなで雑談する	和大家雑談
お買い物	购物
おやつを褒める	夸奖点心
一緒に勉強する	一起学习
プレゼントを渡す	送一份礼物
手頃な物	小礼物
そこそこする物	普通的礼物
お高い物	高价的礼物
手頃な物をプレゼント	送一份小礼物
そこそこする物をプレゼント	送一份普通的礼物
お高い物をプレゼント	送一份高价的礼物


////性骚扰指令
キスしながら	用接吻打招呼
ちんキスしながら	用亲吻阴茎打招呼
アソコにキスしながら	用亲吻阴部打招呼
寝込みを襲う	趁睡袭击
アソコチェック	检查阴部
スカートをめくる	掀起裙子
スカートたくし上げ	撩起裙子
スカートめくり	掀起裙子
ブルマチェック	检查布鲁马
パンツチェック	检查内褲
おっぱいリフトする	托一托胸部
お尻を触る	摸屁股
股間を撫でる	撫摸股間
寝バック	后背位睡姦



////性处理指令
ながら性処理	进行性処理
性処理のジャンル	性処理的类型
/////选项
手でして欲しい	希望用手
口でして欲しい	希望用口
前の穴でして欲しい	希望用前穴
前の穴を使わせて欲しい	希望用前穴
お尻の穴でして欲しい	希望用尻穴
お尻の穴を使わせて欲しい	希望用尻穴
おしっこの穴を使わせて欲しい	希望用尿道穴
おしっこの穴でして欲しい	希望用尿道穴
パンツをオカズにさせて欲しい	希望用胖次
クンニをさせて欲しい	希望用舐陰
口で奉仕(クンニ)させて欲しい	希望用口的奉仕(舐陰)
フェラチオをさせて欲しい	希望用口交
口で奉仕(フェラ)させて欲しい	希望用口的奉仕(口交)
その前に一発するとかどう？	在那之前先来一発如何？
その前にお尻でするとかどう？	在那之前先用屁股如何？
その前におしっこの穴でするとかどう？	在那之前先用尿道如何？
ティッシュに出す	在纸巾上出来
%CALLNAME:TARGET%のパンツにかける	戴上%CALLNAME:TARGET%的胖次
出す時だけ%CALLNAME:TARGET%の膣を使わせてもらう	出来的时候使用%CALLNAME:TARGET%的膣
ゴム使ってならいいよ	使用避孕套就好了
今日は危ないからダメ	今天很危险所以不行

///标语相关
別の標語にする	其他的標語
日焼けに注意	注意晒痕
喉の渇きに注意	注意口渴
体操服はやっぱり×××	体操服果然还是×××
学生服は×××に限る	学生服必须是×××
学生服はアメスクに限る	学生服必须要穿美式校服

///摄影相关
スマホで写真撮影	用手机拍照
クローズアップ	特写镜头
////选项
スカートを脱いでもらう	拜托脱掉裙子
パンツを脱いでもらう	拜托脱掉胖次
やっぱり今のままでいい	还是这样就好
隠し撮り	隐秘摄影
没収済パンツを撮影	已没收的胖次撮影
スカートの下を撮影	裙下撮影
股間を撮影する	股間撮影
股間をを接写する	股間撮影
パンツを接写する	内褲摄影
アソコを接写する	阴部摄影
ポーズ撮影	POSE撮影



///日常履歴
勉強の誘いを断られた	被拒绝了学习的邀请
シャワー後着替え	淋浴後换装
シャワー後着替え失敗	淋浴後换装失敗
今の格好のまま出発	保持现在的装扮出発
パンツ没収して出発	没収胖次出発
お見送り	目送
睡眠姦寝バック	睡眠姦寝后背位
欲しい物を聞く	询问有什么想要的东西
買い物欲しい物を聞く	询问有什么想买的东西


///食物类
おやつ	点心
チョコレート	巧克力
アイス	冰淇淋
飴	糖
キャベツ	捲心菜
レタス	生菜
イチゴ	草莓
カブ	芜菁
トマト	番茄
ナス	茄子
サツマイモ	紅薯
ブドウ	葡萄
ネギ	葱
の苗	苗
ポーション	薬水
サンド	三明治
サンドイッチ	三明治
おにぎり	飯団
ハンバーガー	漢堡
肉まん	肉包
焼き魚	焼鱼
味噌汁	味噌汤
おひたし	涼拌菜
うどん	烏冬面
ハンバーグ	漢堡肉
ラーメン	拉麵
生姜焼き	姜汁焼肉
ギンギー料理	金吉獣料理
プリン	布丁
ケーキ	蛋糕
ゼリー	果凍
クッキー	曲奇
パイ	餡餅
カステラ	蜂蜜蛋糕
うな重	鰻魚盒飯
ティラミス	提拉米苏
レモン	柠檬
ゴマ	芝麻
メロン	甜瓜
チーズ	乳酪
フキ	款冬
ハーブ	香草
カカオマス	可可豆
カカオバター	代可可脂
コーヒー	咖啡
デザート	甜点
スパイス	香料
ごちそう	佳肴
キノコ	蘑菇
甘酒	甜酒
お薬	薬
チョコ菓子	巧克力点心
駄菓子	粗点心
バランス栄養食	营养平衡的点心
ビーフジャーキー	肉干
シュー菓子	奶油点心


///地点
大まかな現在位置	大致的現在位置

押入れ	壁櫥間
階段	樓梯
キッチン	廚房
離れ	出口
夢の世界	夢之世界
広間	大廳

裏庭	後院
台所	廚房
風呂	浴室
カフェ	咖啡館
あなたの部屋	主人公的房間
応接間	會客廳
空き部屋	空的部屋
の部屋	的房間
の家	的家
大通り	大街
通り	街道
帰り道	归途
ランジェリーショップ	内衣店
ゲームセンター	游戏中心
ベッド	床
体操マット	体操垫
ソファベッド	沙发床
物陰	草丛

///SAVESTR:現在位置
にわか雨	阵雨
トイレ	廁所
寄り道	繞道
学食	学校食堂
屋上	房顶
人気のない校舎裏	人迹罕至的教学楼后侧
ラブホテル	情人旅館
ヤリ部屋	做爱房
コンビニ	便利店
ドーナツ屋	甜甜圈店
ハンバーガーショップ	漢堡店
洋菓子店	洋点心店
和菓子屋	日式点心店
肉屋	肉店
メロンパン屋	菠萝包店
本屋	书店
ゲームショップ	游戏店
中古屋	二手商店
スーパー	超市
河川敷	河边
ゲーセン	游戏中心
空き地	空地
カラオケ	卡拉OK

///校园祭相关
メイド喫茶	女僕咖啡厅
執事喫茶	執事咖啡厅
お化け屋敷	恐怖屋敷
バンド演奏	乐队演奏
お悩み相談室	烦悩相談室
占いの館	占卜館
レストラン	西式料理店
ぱふぱふ屋	PaFuPaFu屋





//调教类


///调教道具
ローター	跳蛋
オナホール	飛機杯
バイブ	振動棒
極太サイズのバイブ	極太尺寸的振動棒
アナルバイブ	肛用振動棒
アナルプラグ	肛塞
プラグ	塞子
極太サイズのアナルプラグ	極太尺寸的肛塞
アナルビーズ	後庭拉珠
ペニスバンド	穿戴式假陰茎
アイマスク	眼罩
ボールギャグ	口球
ビデオカメラ	攝像機
カメラ	照相机
エプロン	圍裙
ローション	潤滑液
コンドーム	避孕套
ピル	口服避孕薬
バイブセット	振動棒套装
アナルパール	肛门拉珠
オナホ	飞机杯
カテーテル	导管
ピアスセット	穿环套装
アフターピル	事后避孕药
エリクサー	万能薬
毛生え薬	生毛薬
使用済みゴム	用过的避孕套
未飲ゴム	未飲的避孕套
鼻フック	鼻钩
リングギャグ	環形口枷
ペニバン	假阳具
絆創膏	創口貼
ピアス	穿環
ゴム	避孕套






///调教指令相关短词
胸揉み	揉胸
焦らし	挑逗


///调教指令
キス	接吻
キスする	接吻
アナル愛撫	肛門愛撫
押し倒す	推倒
身を任せる	任憑擺佈
抵抗する	抵抗
自慰する	自慰
着せ替え	換装
鼻フックを外す	取下鼻钩
Ｖセックス	Ｖ性交
Ａセックス	Ａ性交
クンニ	舐陰
フェラする	舐陰莖
アナル舐め	舐肛
何もしない	什麼也不做
フェラチオ	口交
逆レイプ	逆強姦
パイズリ	乳交
泡踊り	泡泡浴
足コキ	足交
スパンキング	打屁股
拘束プレイ	拘束PLAY
貝合わせ	磨鏡
足コキする	给对方足交
手淫する	手淫
イラマチオ	強制口交
フィストファック	拳交
アナルフィスト	肛門拳交
アナル奉仕	肛門奉仕
胸の谷間を犯す	雙乳間抽插
野外プレイ	野外PLAY
お風呂場プレイ	浴室PLAY
新妻プレイ	新妻PLAY
シャワー	淋浴
シックスナイン	六九式
Ｇスポット刺激	刺激Ｇ點
挿入子宮口責め	挿入子宮口玩弄
パイズリフェラ	乳夾口交
二本フェラ	双龙入穴口交
フェラ	口交
逆アナル	逆肛交
アナルセックス	肛门性交
お掃除フェラ	清洁口交
ピロートーク	枕邊話
ピストンする	活塞運動
ゴム精飲	喝套内精液
腰を動かす	動起腰身
指入れ	指插入
オナニー	自慰
押し倒され	被逆推
二人に押し倒される	被两人逆推
ゴム装着	戴上套套

テンダーキッス	深吻
アソコ愛撫	阴部愛撫
指挿入れ	指挿入
手コキする	给对方手交
手コキ	手交
Ａ責め	玩弄Ａ
パイズリする	给对方乳交
足で股間を弄ぶ	用脚玩弄股間
くぱぁさせる	扒開阴道
Ａくぱぁさせる	扒開菊穴
両穴くぱぁさせる	扒開双穴
尿道指挿入れ	尿道指挿入
挿入Ｇスポ責め	挿入刺激Ｇ点
ニプルファック	乳头奸
ぱんつコキ	内褲冲
足舐め奉仕	舔足奉仕
胸愛撫させる	被胸爱抚
胸の揉み合い	互相揉胸
ぱふぱふ	洗面奶
オナホコキ	飞机杯冲
浴尿させる	让对方浴尿
騎乗位で犯す	騎乗位侵犯
Ａ騎乗位で犯す	Ａ騎乗位侵犯
両穴フィスト	両穴拳交
身嗜み管理	身嗜管理
ピアッシング	穿环
尿道カテーテル	尿道导管
ディープスロート	深喉
尿道ブジー	尿道探针
館内露出プレイ	館内露出PLAY
押し倒される	被逆推
二人で押し倒される	被两人逆推
もがく	挣扎
なすがまま	顺其自然
秘め事の終了	结束调教
手加減	手下留情
挿入局所責め	刺激挿入部位
ふきふき	擦拭
セックス	性交
焦らす	挑逗
ビデオ撮影	视频拍摄
拘束する	拘束
お風呂プレイ	浴室PLAY
万謝の口付け	万謝的亲吻
拘束を解く	解開拘束
インサート	挿入
抱きしめる	抱上去
ワイルドスウィング	狂野摇摆
立ちバック	立后背位
ハードコマンド	重口指令
ゴムリセット	重置避孕套
Ａバイブ結腸責め	振动棒玩弄Ａ結腸
Ａバイブ弄り	振动棒玩弄Ａ
尿道バイブ弄り	振动棒玩弄尿道
母乳飲み	喝母乳
乳首舐め	舔乳头
バイブ弄り	用振动棒玩弄
お掃除フェラする	给对方清洁口交
バイブを抜く	拔出振動棒
アナルパールを抜く	拔出肛門拉珠
Ａバイブを抜く	拔出Ａ振動棒
Ｖ二本挿入	两根挿入Ｖ中
Ａ二本挿入	两根挿入Ａ中
種付けプレス	播種姿势
Ｓ状結腸責め	欺负Ｓ状結腸
ニプルオナホ	乳头奸飞机杯
二本手コキ	两根手交
ディープフェラ	深喉口交
見せ槍	展示肉棒
アナル責め	玩弄肛門
ブルマコキ	用布鲁马来冲
ビキニコキ	用比基尼来冲
アソコ舐め	舔陰部
相互お掃除６９	相互６９掃除
目隠しを外す	取下眼罩
口枷を外す	取下口球
腸内ガス排泄	排出腸内气体
浣腸液追加	追加灌腸液
湯船に浸かる	泡在浴缸里
ディープイラマチオ	強制深喉口交
Ｓ状結腸フィスト	Ｓ状結腸拳交
カテーテルを抜く	拔出导管
ディープスロート終了	结束深喉
尿道バイブを抜く	拔出尿道振动棒
撮影終了	结束摄影
野外プレイ終了	结束野外PLAY
風呂から出る	从浴室里出来
新妻プレイ	新婚PLAY
新妻プレイ終了	结束新婚PLAY
露出プレイ終了	结束露出PLAY
下着を脱ぐ	脱掉内衣
ハダカになる	脱成裸体
下着を脱がす	扒掉对方内衣
ハダカにする	扒成裸体
押し倒し終了	结束推倒
絆創膏を剥がす	揭下创可贴
ふりほどく	挣脱開
駅弁	火车便当位
手袋コキ	用手套来冲
子宮口責め	玩弄子宮口
騎乗子宮口責め	騎乗位玩弄子宮口
Ｇスポ責め	玩弄Ｇ点
騎乗Ｇスポ責め	騎乗位玩弄Ｇ点
ハードピストン	活塞运动
ハードアナルピストン	肛門活塞运动
ハード尿道ピストン	尿道活塞运动
顔面騎乗	面部騎乗
こらえる	忍住
尻コキ	尻素股



///调教选项
フィルタ	过滤器
ハード系	硬核系
極厚ゴム	極厚避孕套
Ｖゴム	Ｖ避孕套
Ａゴム	Ａ避孕套
ゴム交渉リセット	初始化避孕套交渉
下脱ぎ	脱掉胖次
靴脱ぎ	脱掉鞋子
汚れ表示	污渍显示


////射精部位
射精した場所	想要射精的位置
射精箇所	射精部位
広げられた鼻の穴	広開的鼻穴
ゴム内	套套内



///调教状态（INFO.ERB）
ムード	情緒
痛み	疼痛
恐れ	恐惧
ムードハート	情緒Heart


Ｈなご褒美	Ｈ的奖励
Ｖ潤十分	Ｖ潤充分
Ａ潤十分	Ａ潤充分
焦らされ中	焦躁中
隙あらばキス	一有破绽就接吻
お風呂場	浴室
ときめき	心动不已
ムラムラ	躁动难忍
Ｃ寸止め	Ｃ绝顶前骤停
Ｖ寸止め	Ｖ绝顶前骤停
Ａ寸止め	Ａ绝顶前骤停
Ｂ寸止め	Ｂ绝顶前骤停
Ｍ寸止め	Ｍ绝顶前骤停
尿道寸止め	尿道绝顶前骤停
噴乳寸止め	噴乳前骤停
射精寸止め	射精前骤停
放尿寸止め	放尿前骤停
排泄寸止め	排泄前骤停
イくのをこらえた	绝顶忍耐
お楽しみ中	享受中
ジャストフィット	完美契合
個室ではない	不在個室
押し倒し	推倒
キャンセル	中止
好きな体位	喜欢的体位
奉仕フラグ	奉仕FLAG
コスプレ	Cosplay
イきそう	要去了
上機嫌	心情好







///身嗜相关
入浴せずベッドイン	不洗澡直接上床
ツルツルに剃る	剃得精光
形を綺麗に保つ	形状修剪得很漂亮
剃らない	从不剃
アナルプレイの準備	肛門PLAY的準備
ハート型	心型

//体态属性

///BASE
バストサイズ	胸圍
身長	身高
バスト	胸圍
ウェスト	腰圍
ヒップ	臀圍

///TALENT:肌の色，CONDS("肌の色", ARG)
///TEXTS("日焼け跡", ARG)
///CONDS("体型", ARG)
//CONDS("バストカップ", ARG)
ズル剥け	露茎
馬並	馬根
仮性	假性
青い肌	青肌
小柄	娇小
長身	高大
バストカップ	罩杯
トランジスタグラマー	娇小豐满
グラマー	S型
むちむち	肉感
お尻大きめ	大臀
スレンダー	高挑
男の娘	伪娘
ショタ	正太
お姉さん	大姐姐
オトナ	大人
ぺたんこ	飞机场
ウサギ	兔
トカゲ	蜥蜴
ジャバウォック	颊脖龙
キツネ	狐狸
ウマ	马
人間	人类
クネクネ動く尻尾	卷来卷去的尾巴
しなやかな尻尾	柔软的尾巴
パタパタ動く尻尾	啪嗒啪嗒動着的尾巴
もふもふした尻尾	毛茸茸的尾巴
ふさふさした尻尾	蓬松的尾巴
尻尾の先端の心型部分	尾巴前端的心型部分
先端が燃え盛る尻尾	前端燃着火的尾巴
ゆらゆら動く尻尾	摇晃着的尾巴
鱗に覆われた尻尾	覆盖着鱗片的尾巴
尻尾	尾巴

パイパン	白虎
エルフ耳	精灵耳
デカ尻ロリ	巨尻萝莉
つるぺた	光滑飞机场
ちっちゃい	小小的
お尻大きめスレンダー	蜂腰肥臀
尻部大きめ	大尻部
馬根み	馬根
腕並み	腕粗
お手入れ済	保养完毕
ツルツル	光滑无毛
生え放題	随意生長
ジョリジョリ	刺啦刺啦
無精髭	無髭
生えかけ	还没長出来
ペニスサイズ	阴茎尺寸
ペニス	阴茎
クリトリス	阴蒂
体つき	身材
皮被り	包皮
おっぱい	胸部
ちっぱい	贫胸
薄い胸	单薄的胸
アソコ	阴部
アナル	肛門
アヌス	菊花
尻の穴	菊门
乳首	乳頭
ペニ	阴茎
クリ	阴蒂




///调教履历
イかせた回数	强制绝顶回数
寸止め数合計	骤停数合計
エナジードレイン	吸能
破瓜の血	破瓜之血



///特別経験
筆下ろし	脱离童贞
キスより先にフェラ	初吻之前先口交
キスより先にＡ奉仕	初吻之前先Ａ奉仕
キスより先にクンニ	初吻之前先舐陰
処女より先にＡ処女喪失	在喪失処女之前先喪失了Ａ処女
童貞より先にＡ処女喪失	在喪失童貞之前先喪失了Ａ処女
見られながらの排泄	一边被看着一边排泄
バイブで処女喪失	以振动棒喪失処女
騎乗位で処女喪失	以騎乗位喪失処女
ペニバンで処女喪失	以假阳具喪失処女
望まぬ妊娠	意外的妊娠
幸せな妊娠	幸福的妊娠
キス未経験	無接吻経験






//ABL
舌使い	舌靈活
指使い	指靈活
腰使い	腰靈活
サド	施虐狂
マゾ	受虐狂
サドっ気	施虐属性
マゾっ気	受虐属性
Ｖ使い	Ｖ技術
Ａ使い	Ａ技術
喉使い	喉技術
尿道使い	尿道技術
お尻責め	玩弄臀部


//TALENT
オトコ	男性
オンナ	女性
ふたなり	扶她
反抗的	叛逆
気丈	堅強
素直	坦率
生意気	傲慢
感情乏しい	感情缺乏
一線越えない	難以越過的底線
目立ちたがり	喜歡引人注目
貞操無頓着	不在乎貞操
恥じらい	害羞
恥薄い	不知羞恥
濡れやすい	容易濕
濡れにくい	不易濕
痛み無視	疼痛無視
汚れ無視	汚臭無視
快感に素直	接受快感
快感の否定	否定快感
中毒しやすい	容易中毒
両刀	兩面通吃
男嫌い	討厭男人
女嫌い	討厭女人
謎の魅力	謎之魅力
貞操観念	贞操重视
リザレクション	復活
妊娠しづらい	难以妊娠
力持ち	大力士
スリム	苗条
油断	豐腴
愚か	笨蛋
賢い	聰慧
優しい	温柔
意地悪な	坏心眼
意地悪	坏心眼
気品	高贵
ロリ	萝莉
ロリババア	萝莉老太婆
男の娘	伪娘
惚れっぽい	容易迷恋
妊娠しやすい	容易妊娠
片思い	单相思
初めての人	第一次的对象
尿道狂い	尿道狂
ツノ	角
しっぽ	尾巴
肌の色	肤色
へそピアス	肚脐环
常時Ａプラグ	常時Ａ肛塞
常時尿道プラグ	常時尿道塞
孕ませ男	小种马
縦割れアナル	縦深菊穴
汗かき	易出汗
筋肉質	筋肉
ラビアピアス	陰唇環
クリピアス	陰蒂環
ニプルピアス	乳环
甘い言葉	甜言蜜语
禁断の知識	禁断的知識
陽気	開朗
彼氏持ち	有男朋友
寒がり	体寒
モブＨ禁止	禁止与路人Ｈ
グロマン	黑木耳
美マン	美穴
美まん	美穴
色素沈着	色素沉淀
子供マンコ	萝莉小穴
子供まんこ	萝莉小穴


///TALENT分支
ピル嫌い	讨厌口服避孕薬
ゴム嫌い	讨厌避孕套
超孕ませ男	大种马
とても濡れやすい	非常容易濕
カウパー多め	前列腺液多
カウパー少なめ	前列腺液少
ペニピアス	陰茎穿環





//EXP
パイズリ経験	乳交経験
キス経験	接吻経験
レズ経験	百合経験
ゴム性交	避孕套性交
ゴム挿入	避孕套挿入
Ｖフィスト	Ｖ拳交
Ａフィスト	Ａ拳交
指舐め	舔指
童貞狩り	童貞狩猎
お掃除クンニ	清洁舔阴
お掃除Ａ舐め	清洁舔A
口説き	奉承
お漏らし	漏尿
トコロテン	前列腺高潮射精

//CSTR
初期パラ	初期变量
Ｖ受け入れ履歴	Ｖ插入履歴
Ａ受け入れ履歴	Ａ插入履歴
尿道受け入れ履歴	尿道插入履歴
Ｖ中出され	被Ｖ中出
Ａ中出され	被Ａ中出
乳内中出され	被乳内中出
膀胱中出され	被膀胱中出
着替え希望	希望着装
ゴム履歴	避孕套履歴
日焼け	晒痕
日焼け跡	晒痕
脱いだ服一式	脱掉的衣服一览
脱いだパンツ	脱掉的胖次
脱いだ靴	脱掉的靴
夜這い	夜袭
朝駆け	朝袭
肩書	称号
アドバイス	建议
陰毛の好み	陰毛的喜好
腋毛の好み	腋毛的喜好
好きな色	喜欢的颜色
好きなパンツ	喜欢的胖次
嫌いなパンツ	讨厌的胖次
好きなブラ	喜欢的胸罩
嫌いなブラ	讨厌的胸罩
好きなもの	喜欢的东西
嫌いなもの	讨厌的东西
好みの部屋	喜欢的房间
お茶	茶


//CFLAG
びしょびしょ	湿透
中出し済	已中出
肛門チェック	检查肛門
肛门チェック	检查肛門


//FLAG
性の乱れ	乱性

//TEQUIP
お風呂上り	出浴

//物品类
おみくじ	神簽
ハンカチ	手帕
布団	被窝
タオル	毛巾




//称呼
あたし	我
アタシ	我
わたし	我
ワタシ	我
わたくし	我
ワタクシ	我
わたくし_わたくし	我_我
あたい	我
アタイ	我
ぼく	僕
ボク	僕
おれ	俺
オレ	俺
パパ	爸爸
ぱぱ	爸爸
ママ	妈妈
//まま	妈妈
ちちうえ	父上
ははうえ	母上
お父さん	父亲
おとうさん	父亲
あねうえ	姉上
あにうえ	兄上
お兄さん	哥哥
おにいさん	哥哥
お兄ちゃん	欧尼酱
おにいちゃん	欧尼酱
にーちゃん	尼酱
お姉さん	姐姐
おねえさん	姐姐
お姉ちゃん	欧内酱
おねえちゃん	欧内酱
マスター	Master
ますたー	Master
マスタぁ	Master
あるじ	主上
ご主人様	主人大人
ゴシュジン様	主人大人
ごしゅじんさま	主人大人
ぼうや	小哥
せんせい	老师
せ・ん・せ・い	老・师
せんせぇ	老师
せ・ん・せ	老・师
センセ	老师
せんせ	老师
先生	老师
ぶちょう	部長
先輩	前輩
せんぱぁい	前輩
センパイ	前輩
せんぱい	前輩
こうはい	後輩
きみ	你
キミ	你
アンタ	你
あんた	你
お前	你
おまえ	你
さま	大人
しゃま	大涅
さん	桑
さ・ん	桑
さぁん	桑
サン	桑
くん	君
く・ん	君
くぅん	君
ちゃん	酱
ち・ゃ・ん	酱
ちゃぁん	酱
お嬢様	大小姐
おじょうさま	大小姐
奥様	母亲大人
おくさま	母亲大人
おばさま	母亲大人
ダーリン	达令
だーりん	达令
彼ピ	男票
かれぴ	男票
オッサン	大叔



//片假名英文

///片假名英文术语
プレイ	PLAY
コマンド	指令
ボーナス	BOUNS
マップ	Map
アイテム	道具

パートナー	对象
アドバイザー	指导者

ザーメン	精液



///其他片假名英文短词
カップル	情侣
レイプ	强奸
ターン数	回合数
ラグジャラスヒット	Luxurious
タイトル	标题
ボックス	BOX
コレクション	收藏
アナライズ	分析
プレゼント	送禮


//其他日文短词
匂い	气味
やる気	干劲
ちょっかい	调戏
大きさ	尺寸
大人しい	老實
度胸	胆量
プライド	自尊心
ツンデレ	傲嬌

不機嫌	心情差
機嫌	心情
子供	兒童
若者	青年
抑圧	圧抑
痛みに強い	不怕痛
互角	平手
かわいい	可爱
わんぱく	淘气
チアリーダー	啦啦队
カエル	青蛙

気配り	细心
バラの花	蔷薇花
バラ	蔷薇
挑発的な	挑衅的
釣り竿	釣魚竿

連れ出す	帯出去
集めた魂	收集的魂


//非判定词
待つ	等待
謝る	道歉
逃げる	逃跑
散策	散步
寄り道する	繞道
読み聞かせ	朗読
お弁当を食べる	吃便當
部屋に入る	進入房間
外に出る	外出
遊ぶ	玩遊戲
遊びに付き合う	陪着玩
掃除を手伝って	幫忙做掃除
お料理	料理
教えてあげる	進行解答
掃除する	掃除
探す	尋找
昼寝	午睡
寝言	梦话
スキンシップ	身体接觸
いいもの	好東西
宿題	作業
授業を受ける	聽課
ほろ酔い	微醺
顔に精液	脸上精液
オナニーした	自慰过了
無理矢理	强行
に来た	来了
好きにして	随便
お礼	礼物
カレンダー	日历
目を覚ます	睁開眼睛
誰もいない	誰也不在
お米	米
甘い	甜
さっぱり	清爽
怪しい	可疑
鮮やか	新鲜的
なめらか	光滑
人助け	帮助别人
紅い	红的
華やか	华丽
あたたかい	暖和
こころ	心
アリス	愛麗絲
はずれ	落空了
顔を赤らめながら	红了脸并
無表情のまま	無表情的
外に出た	外出了
後片付け	善后工作
入れません	进不去
申し訳ございません	非常抱歉
月見	赏月
トレーニング	训练
脱ぐ	脱掉
遊び	玩耍
払い	支付
抱き寄せる	抱到身边
仮眠	假寐
辱め	侮辱
お招き	招待
イタズラ	恶作剧
目に涙を浮かべ	眼里流着泪水
処女を奪われた	夺去了処女
男を知らない	不识男人滋味的
処女を捧げた	献出了処女
薄い	单薄的
勃起した	勃起的
硬くしこった	硬起来的
小さな	小小的
糊のような	糊状的
を得ました	获得了
マイナス	减少
おっぱいおっぱい	胸部胸部
ファーストキス	初吻
うふふ	诶嘿嘿
二人で	二人
疲れた	疲惫
ヤダ	不要
//ちょっと	稍微
振り払う	摆脱
しないよ	不会
勃起し	勃起
うまい	好吃
おぱんつ	胖次
カリスマ	筹码
の汚れ	的污垢
自身の	自己的
仕込み	去采购
えっちな本	小黄书
その後、	那之后、
自分で	自己
小ぶり	小不点
力ずくで	霸王硬上弓
一方的に	单方面地
揚げ	油炸
の握り	握饭团
手持ち	手持
バニーガール	兔女郎
白衣の天使	白衣天使
走った	走着
塞いだ	堵住
見通し	開阔处
狭い	狭窄
広い	广阔
自分から	主动
追い出し	逐出
気配	气息
顔をしかめている	紧缩眉头
笑って	笑着
みんなで	大家
危なかった	危险
丹念に	精心地
しばし	片刻后
サンキュー	Thank you
サンプル	样本
はいてない	沒穿
絶倫	精力超群
性的興味	性的兴趣
たまに奇行	偶尔奇行





//其他未分类文本
絶頂：調教者がオンナ	絶頂：調教者为女性

その２	之２
現在の	現在的
になりました	成为了

見知らぬ男	陌生男人
脂ぎった中年男	油腻的中年男人
見覚えのある男子生徒	似乎见过的男学生
