//EVENT_K1_COMM.ERB
PRINTFORML 「暑くなってきましたね～……%CNAME(CALLNAME:PLAYER)%はもう、今年の水着とか買いました？」	PRINTFORML 「天气变热了呢～……%CNAME(CALLNAME:PLAYER)%已经买了今年的游装吗？」
PRINTFORMW 「まだでしたら今度、私と一緒に見に行きませんか」	PRINTFORMW 「如果还没有的话下次、要不要和我一起去看看」
PRINTFORML 「そうだ、%CNAME(CALLNAME:PLAYER)%。今日って講義終わった後に予定が入ってたりしますか？」	PRINTFORML 「对了、%CNAME(CALLNAME:PLAYER)%。今天的课结束后有什么安排吗？」
PRINTFORMW 「もしよかったらですけど、一緒にお買い物に行きませんか……ちょっと、夏物を見たいなって♪」	PRINTFORMW 「如果可以的话、一起去购物吧……有点、想看夏季用品♪」
PRINTFORML 「ねぇねぇ、%CNAME(CALLNAME:PLAYER)%。よかったら少し、私とおしゃべりしませんか？」	PRINTFORML 「内内~、%CNAME(CALLNAME:PLAYER)%。如果可以的话、要不要和我聊天？」
PRINTFORMW 「%CNAME("主人")%抜きで一緒に話したことってあんまりなかったですし♪」	PRINTFORMW 「没有%CNAME("主人")%在的话也没怎么一起聊天过♪」
PRINTFORMW 「%CNAME("主人")%の事……色々と教えてあげますよ♪」	PRINTFORMW 「%CNAME("主人")%の事……各种各样的事我都可以告诉你哟♪」
PRINTFORML 「%CNAME(CALLNAME:PLAYER)%、今お話して大丈夫ですか？」	PRINTFORML 「%CNAME(CALLNAME:PLAYER)%、现在方便说话吗？」
PRINTFORML 「%CNAME(CALLNAME:PLAYER)%、今お時間大丈夫ですか？」	PRINTFORML 「%CNAME(CALLNAME:PLAYER)%、现在有空闲时间吗？」
PRINTFORMW 「お暇ならで良いんですけど……一緒にお茶でもいかがでしょう」	PRINTFORMW 「如果有空的话就好了……一起喝杯茶怎么样」

//EVENT_K1_DAILY.ERB
CALL PRINT_STRW, "「フフフ……_H_」"	CALL PRINT_STRW, "「呼呼呼……_H_」"
CALL PRINT_STRW, "「まだまだ夜までは間が有ります……たっぷりと、愉しみましょうね……_H_」"	CALL PRINT_STRW, "「离晚上还有些时间呢……充分、一起享受吧……_H_」"
CALL PRINT_STRW, @"「%CNAMET(ARG, "二人称")%、おはようございます……_H_」"	CALL PRINT_STRW, @"「%CNAMET(ARG, "二人称")%、早上好……_H_」"
PRINTFORMW %CALLNAME:ARG%は阴茎\@ COND("假性包茎", MASTER) ? の皮をグッと引き下ろし # の先端を舌先でほじり \@、口に咥えて\@ COND("体育") ? 昼の体育で # 一日の間に \@蓄積された汚れをお掃除してきた……	PRINTFORMW %CALLNAME:ARG%将阴茎\@ COND("假性包茎", MASTER) ? の包皮拉下来し # の敏感部分用舌尖刺激 \@、再含在嘴里\@ COND("体育") ? 并把在白天的体育课上 # 并把一日の間 \@蓄積的污垢掃除干净了……
CALL PRINT_STRW, "「失礼します……フフ_H_」"	CALL PRINT_STRW, "「失礼了……呼呼_H_」"
PRINTFORMW 「はいはい、%CNAMET(ARG, "二人称")%の忠実な僕、%NAME:ARG%ですよ。何の御用でしょう」	PRINTFORMW 「是的、我是%CNAMET(ARG, "二人称")%の忠実的仆人、%NAME:ARG%ですよ。有什么事吗」
PRINTFORMW %CALLNAME:ARG%はパタパタと足音を立てながら入室してきた	PRINTFORMW %CALLNAME:ARG%发出パタパタ的脚步声站着进了房间
PRINTFORMW 「すいません、遅れましたー」	PRINTFORMW 「对不起，我迟到了ー」
PRINTFORMW 『%CNAMET(ARG, CSVNAME_ACTOR)%こんにちは。お先に失礼してます』	PRINTFORMW 『%CNAMET(ARG, CSVNAME_ACTOR)%你好。对不起我先走了』
PRINTFORML %CALLNAME:TARGET%は、これから起こることを思い描いて頬を染めている	PRINTFORML %CALLNAME:TARGET%心里描绘着接下来要发生的事情、脸上泛着红晕
CALL PRINT_STRL, @"「もしかして、%CNAME("一人称")%が居なくて寂しくなっちゃいましたか？フフ_H_」"	CALL PRINT_STRL, @"「难道、%CNAME("一人称")%不在就会寂寞吗？呼呼_H_」"
PRINTFORML 「ふぅ。少し暑くなっちゃいましたね」	PRINTFORML 「呼~。天气有点变热了呢」
PRINTFORML %CALLNAME:TARGET%はハンカチで汗を拭いつつ、可愛らしい絵柄のうちわで%CALLNAME:MASTER%をパタパタと扇いでいる	PRINTFORML %CALLNAME:TARGET%一边用手帕擦拭汗水、一边用可愛的絵柄の扇子为%CALLNAME:MASTER%啪嗒啪嗒地扇着
PRINTFORML 「%CNAME("二人称")%お疲れさまでした。……フフ♪」	PRINTFORML 「%CNAME("二人称")%辛苦了。……呼噜♪」
PRINTFORML 「宜しければ、どうぞ？」	PRINTFORML 「如果可以的话、请用？」
PRINTFORML %CALLNAME:TARGET%は汗でしっとりした髪をかき上げつつ、お茶と小さな菓子を２つ用意してくれた	PRINTFORML %CALLNAME:TARGET%一边把因汗而湿润的头发撩上去、一边准备了两杯茶和两个小点心
CALL PRINT_STRL, @"「ねぇ、今どういうお気持ちですか？%CNAME("二人称")%_H_」"	CALL PRINT_STRL, @"「内~您现在是什么样的心情？%CNAME("二人称")%_H_」"
PRINTFORML 「コタツと合体して過ごすのもいいですが……よいしょ」	PRINTFORML 「和被炉合体度过也不错呢……哟咿（嘿）咻」
PRINTFORML 「今日という日は二度と来ない特別な一日だという事を忘れない様にしたいものですね」	PRINTFORML 「真希望你不会忘记、今天是不会再有的独特的一天」
PRINTFORML 「後で見に行ってあげてはどうでしょうか？」	PRINTFORML 「一会儿去看看怎么样？」
PRINTFORML 「新年明けましておめでとうございます」	PRINTFORML 「恭喜新年快乐！」
PRINTFORML 「今年も宜しくお願い致しますね、ご主人様」	PRINTFORML 「今年也请多关照、主人」
PRINTFORML 「早速ですが、姫初めでも構いませんよ？フフフ」	PRINTFORML 「恕我直言、从姫开始也没关系哦？呼呼呼」
PRINTFORML 「%TEXTR("ふんふんふふーん♪/♪～～♪～～～/ら～～らららら～～♪/ふーんふんふふーんふーん♪")%」	PRINTFORML 「%TEXTR("呜嗯 呜嗯 呜呜ー嗯♪/♪～～♪～～～/ら～～らららら～～♪/呜ー嗯 呜嗯 呜呜ー嗯 呜ー嗯♪")%」
PRINTFORM %TEXTR("楽しそうに/鼻歌混じりで/テキパキと/手際よく/慣れた様子で")%	PRINTFORM %TEXTR("愉快地//哼唱着/麻利地/手法熟练地/熟练的様子")%
PRINTFORML %TEXTR("掃除をして/洗濯物を畳んで/洗い物をして/ベッドメイクをして/明日のお弁当の下拵えをして/明日の予定を確認して/カレンダーをチェックして/靴の手入れをして")%いる	PRINTFORML 正在%TEXTR("进行掃除/把洗好的衣服叠好/洗东西/装扮自己/准备做好明日の便当/確認明日の安排/翻阅日历的格子/保养学生鞋")%
PRINTFORM %TEXTR("時折お茶を口に運びつつ/お茶菓子をつまみながら/リラックスした様子でお茶を飲みつつ")%	PRINTFORM %TEXTR("偶尔把茶送到嘴里/一边吃着茶点/一边放松心情一边喝茶")%
PRINTFORM %TEXTR("黙々と/没頭した様子で/真剣な眼差しで/やる気なさそうに/如何にも暇つぶしといった様子で/無言で")%	PRINTFORM %TEXTR("默默地/一副专注的样子/用认真的眼神/毫无起劲地/一副如何消磨时间的様子/沉默的")%
PRINTFORML %TEXTR("雑誌を読んで/参考書を読んで/携帯ゲーム機で遊んで/スマホを弄って/料理の本を読んで/教科書を読み込んで/予習をして")%いる	PRINTFORML 正在%TEXTR("阅读雑誌/阅读参考書/玩着携帯式游戏機/摆弄手机/阅读料理の本/阅读教科書/预习一下")%
PRINTFORMW やる気なさげに机に突っ伏していたフェリシエルの友達のＡ子がぼそりと呟く。	PRINTFORMW 无精打采地趴在桌子上的弗理希艾尔的友達のＡ子嘟囔着。
PRINTFORML - フェリシエル -	PRINTFORML - 弗理希艾尔 -
PRINTFORMW 「いきなり何言ってんですか……？って、ちょっとぉ……」	PRINTFORMW 「突然说什么呢……？嗯、喂……」
PRINTFORMW 怪訝な顔をしたフェリシエルだったが、自分のパンツのことだと気づいてＡ子の視線からスカートの中を手でガードした。	PRINTFORMW 虽然弗理希艾尔露出了惊讶的表情、从A子瞥自己胖次的视线中用手遮住了裙子。
PRINTFORMW 『んふふ、周りに男子いないからって油断してたね。	PRINTFORMW 『嗯哼哼、因为周围没有男生所以大意了呢。
CALL PRINT_STRW, "　にしてもフェリったらかーわいーい♪そんな反応するなら、もうちょっと長いの履けばいいのに～_H_』"	CALL PRINT_STRW, "　这样子还真是可爱♪如果有这种反应的话、穿更长一点的就好了呢～_H_』"
PRINTFORML 「……Ｂ美は割り切りすぎ。	PRINTFORML 「……Ｂ美想太多了。
PRINTFORMW 　別に見せたいからじゃなくって、私が気に入ってこの格好してるんだから、これでいいの」	PRINTFORMW 　又不是因为给你看的、是因为我喜欢所以才穿这个、这样就可以了」
PRINTFORMW 『今日は何食べようかなぁ……学食にしようか……それとも購買でパン買って済ませちゃうか……』	PRINTFORMW 『今天吃什么好呢……是去食堂呢……还是买面包来解决呢……』
PRINTFORMW 「あ、私は今日はちょっと。というか、暫くは予定入っちゃった。ごめんね」	PRINTFORMW 「啊、我今天有点。或者说、我临时有了预定。对不起啦」
RINTFORMW 『ふ～～～～ん？』	RINTFORMW 『呜～～～～嗯？』
PRINTFORMW 『わかった！部長でしょ！部長さんと一緒にご飯なんでしょ！？』	PRINTFORMW 『知道了！是部長吧！和部長桑一起吃饭对吧！？』
PRINTFORMW 『いいな～フェリシエルの事だから、お弁当作ったりしてあげるんでしょ？いいなぁ～～？』	PRINTFORMW 『真好啊～毕竟是弗理希艾尔、所以会帮部長桑做便当吧？真好啊～～？』
PRINTFORMW 「Ａ子、声でかいですよ、もう。	PRINTFORMW 「Ａ子、声音太大了、真是的。
PRINTFORMW 　……まぁ、うん。そんなところ」	PRINTFORMW 　……嘛~、呜嗯。既然那样的话」
PRINTFORMW 「よかったら、Ａ子の分も作る？あんまり期待されても困りますけどね、ふふふ」	PRINTFORMW 「如果需要的话、我也帮A子做一份吧？不过如果太被期待了话也很困扰呢、呼呼呼」
PRINTFORMW フェリシエルが更衣室で水着に着替えながらクラスメイトと雑談している。	PRINTFORMW 弗理希艾尔一边在更衣室换上游衣、一边和班里的同学聊天。
PRINTFORML 『はー水泳の授業って本当に憂鬱。私カナヅチだし気づいたら男子がこっち見てるし……って、え！	PRINTFORML 『哈ー游泳课真让人郁闷。我注意到男生那边总是有视线投过来……啊、诶！
PRINTFORMW 　どうしたのフェリシエル下の毛が随分と綺麗になっていらっしゃいますけど？』	PRINTFORMW 　为什么弗理希艾尔下面的毛那么干净啊？』
PRINTFORMW 「う……やっぱり気づいちゃいました？まぁ、気分転換というかなんというか……」	PRINTFORMW 「嗯……果然注意到了吗？嘛、该说是转换心情还是怎么说呢……」
PRINTFORML 『お。ついにフェリもアタシの仲間入りかー水泳の授業の度に熱弁した甲斐あったわー、いいよねー。	PRINTFORML 『喔~。终于弗理也加入了我的队伍ー每次上游泳课的时候传教的热情没有白费ー、非常好ー。
PRINTFORMW 　Ａ子も騙されたと思って一回全部剃ってみ？めっっちゃ快適なんだから！ねー？♪』	PRINTFORMW 　A子也是、就当做被骗了也好、试着把下面的毛剃一次试试看呗！超级舒服的！对吧ー？♪』
PRINTFORMW 「ねー（棒)。まぁ……快適なのは本当ですよね。ちょっとだけ心細い感じはありますけど……」	PRINTFORMW 「对——（生硬)。嘛……舒适是真的吧。虽然有一点不安心的感觉……」

PRINTFORMW 「ふぅ……って、あ！」	PRINTFORMW 「呜ぅ……って、啊！」
PRINTFORMW フェリシエルは脚の半ばまで下ろされて左右に引き伸ばされている自らのパンツを見て思わず声を上げてしまった。	PRINTFORMW 弗理希艾尔看到自己的胖次被拉到腿半截左右、不禁叫出声来。
PRINTFORMW （し、しまった、私とした事が……）	PRINTFORMW （糟、糟糕了、我所做的事……）
PRINTFORMW 早朝に%CALLNAME:MASTER%とＨしたのにナプキンを敷き忘れていたため、そのクロッチ部には膣内から垂れてきた精液による汚れがバッチリと付いてしまっていた。	PRINTFORMW 早朝和%CALLNAME:MASTER%做了Hの事情但是忘记铺上餐巾、所以開洞部分被膣内滴下来的精液弄得很脏。
PRINTFORMW あとで念入りに洗えばいいとは言え、なんとも言えないだらしなさを己に感じ、フェリシエルは軽く後悔している……	PRINTFORMW 虽说以后再仔细洗就行了、但自己却感觉到无法言喻的邋遢、弗理希艾尔很轻易地后悔着……
PRINTFORMW %CALLNAME:TARGET%の股間から一時間に数度、耳を澄ませていても分からない程度の僅かな振動音が漏れ出る。	PRINTFORMW %CALLNAME:TARGET%の股間一小时震动数次、达到耳朵仔细听可以听到轻微的振動音的程度。
PRINTFORMW %CALLNAME:MASTER%のお願い通り、きちんとアソコにバイブを忍ばせているようだ。	PRINTFORMW 在%CALLNAME:MASTER%所期望的街道上、好好的在阴部藏着振動棒。
PRINTFORMW 周囲の人に気づかれることはまず無いだろうが、何が起きるか分からない。	PRINTFORMW 虽然周围的人不会注意到、但是不知道会发生什么。
PRINTFORMW %CALLNAME:TARGET%は否が応にも胎内の粘膜へと意識を散らされながらも、ゆっくりと深く呼吸をしつつ平静を保とうとしている……	PRINTFORMW %CALLNAME:TARGET%不管是否愿意意识都将分散到胎内の粘膜上、边慢慢地深呼吸一边保持平静……
PRINTFORMW 「よろしいんですか？」	PRINTFORMW 「可以吗？」
PRINTFORMW 「まぁ、%CNAME("二人称")%がそのままで良いと仰るなら%CNAME("一人称")%は構いませんけど」	PRINTFORMW 「嘛ぁ、如果%CNAME("二人称")%感觉这様就好的话%CNAME("一人称")%不会介意的」
PRINTFORMW 「はぁあ……なかなか良いものですよね、こういうのも♪」	PRINTFORMW 「はぁあ……真是不错的、很棒的东西呢♪」
PRINTFORMW 「きゃっ……っとっと、%GREETING%」	PRINTFORMW 「呀……等一下、%GREETING%」
PRINTFORMW 「……フフ♪%CNAME("二人称")%に先に打招呼されちゃいましたね」	PRINTFORMW 「……呼呼♪真糟糕居然让%CNAME("二人称")%先打招呼」
PRINTFORMW %CALLNAME:TARGET%は、にこにこ笑顔で背中に腕を回して抱きしめ返してきた。	PRINTFORMW %CALLNAME:TARGET%、にこにこ（nico nico）笑着将手臂转回后背紧紧抱住。
PRINTFORML 「あら、ありがとうございます。では、お言葉に甘えて……おねがいしますね」	PRINTFORML 「啊啦、非常感谢。那么、就恭敬不如从命……拜托了」
PRINTFORMW %CALLNAME:TARGET%は素直に礼を述べ、%CALLNAME:MASTER%の厚意に甘えはじめた	PRINTFORMW %CALLNAME:TARGET%对坦率表示感谢、开始顺从%CALLNAME:MASTER%の厚意撒娇
PRINTFORML 「どうせなら背中と……あと、ここもお願いしますね」	PRINTFORML 「反正是背和……之后、这里也拜托了」
PRINTFORMW %CALLNAME:MASTER%はお風呂上がりの匂いを楽しみながら、%CALLNAME:TARGET%の背中や腋の下をタオルで拭ってサッパリとさせました…	PRINTFORMW %CALLNAME:MASTER%在享受洗完澡时的气味、用毛巾擦拭%CALLNAME:TARGET%の后背和腋下使之清爽…
PRINTFORML 「わっ、あっ、ちょ……あぁ、もうっ、頭はわしゃわしゃしないで下さい！」	PRINTFORML 「哇っ、啊っ、等……啊ぁ、もうっ、请不要把头扭过来！」
PRINTFORMW 素直に体を拭かれていた%CALLNAME:TARGET%だったが、髪の扱いについては不満なようだ。	PRINTFORMW 虽然%CALLNAME:TARGET%被坦率地擦拭着身体、但是对于头发的处理好像很不满。
PRINTFORML 「まったくもう……お風呂上りは傷みやすいんですから。注意してくださいね」	PRINTFORML 「真是的……因为出浴容易受伤。请注意哦」
PRINTFORMW %CALLNAME:TARGET%はお返し、といった感じで%CALLNAME:MASTER%の頭を手櫛でガシガシやりかえしてきた……	PRINTFORMW %CALLNAME:TARGET%以回礼的感觉、用手梳着%CALLNAME:MASTER%の頭ガシガシ得响着……
PRINTFORMW 「あら、汗を拭いて下さるんですか」	PRINTFORMW 「啊啦、能帮我擦汗吗」
PRINTFORMW 「……って%CNAME("二人称")%……真っ先に股の汗から拭くのはどうかと思いますよ？」	PRINTFORMW 「……但是%CNAME("二人称")%……我觉得先从腿上的汗开始擦怎么样？」
PRINTFORMW 「正直さに少し感心しましたが、人として大切なものを無くしつつあるのではと心配にもなります」	PRINTFORMW 「虽然稍微佩服你的诚实、但也会担心你会渐渐失去作为一个人重要的东西」
PRINTFORMW %CALLNAME:MASTER%は%CALLNAME:TARGET%と雑談しながら楽しい一時を過ごした。	PRINTFORMW %CALLNAME:MASTER%和%CALLNAME:TARGET%一边雑談し一边度过愉快的时光。
PRINTFORMW 「服の下も拭いてもらって良いですか？」	PRINTFORMW 「衣服下面也可以擦一下吗？」
PRINTFORMW 「ほら、良いじゃないですか……くすくす♪」	PRINTFORMW 「ほら（ho la）、不是挺好的吗……咕呲くす♪」
PRINTFORMW %CALLNAME:TARGET%は目を細めて笑いつつ、%CALLNAME:MASTER%に甘えて腋の下や乳房の下も拭くように促している……	PRINTFORMW %CALLNAME:TARGET%眯着眼睛笑着、对%CALLNAME:MASTER%撒娇、催促%CALLNAME:MASTER%把腋下和乳房下面也擦一擦……
PRINTFORMW 「あら。なかなか気が利きますね」	PRINTFORMW 「啊啦。你真机灵」
PRINTFORMW %CALLNAME:TARGET%は意味深な笑みを浮かべつつ、%CALLNAME:MASTER%に流れる汗を拭かれている……	PRINTFORMW %CALLNAME:TARGET%带着意味深长的笑容、擦拭着%CALLNAME:MASTER%流淌的汗水……
PRINTFORML 「%TEXTR("ふんふんふふーん♪/♪～～♪～～～/ら～～らららら～～♪/ふーんふんふふーんふーん♪")%」	PRINTFORML 「%TEXTR("呼嗯 呼嗯 呼呼ー嗯♪/♪～～♪～～～/ら～～らららら～～♪/呼ー嗯 呼嗯 呼呼ー嗯呼ー嗯♪")%」
PRINTFORMW 「あら。戻ってらしたんですか」	PRINTFORMW 「啊啦。回来了嘛」
PRINTFORMW 「あら。来てらしたんですか」	PRINTFORMW 「啊啦。你来了嘛」
PRINTFORMW %CALLNAME:TARGET%は濡れた髪をタオルで拭きながら%TEXTR(@"室内を見渡し、後ろから%CALLNAME:MASTER%に抱きついてきた/、%CALLNAME:MASTER%の横に腰を下ろした")%。	PRINTFORMW %CALLNAME:TARGET%用抹布擦湿头发一边%TEXTR(@"环视室内、从后面将%CALLNAME:MASTER%抱住了/、坐在%CALLNAME:MASTER%の旁边")%。
PRINTFORMW 「……で、いかがでした？」	PRINTFORMW 「……那么、怎么样？」
PRINTFORMW %CALLNAME:TARGET%は%CALLNAME:MASTER%の耳元に口を寄せ、心底楽しそうに囁く。	PRINTFORMW %CALLNAME:TARGET%把嘴凑到%CALLNAME:MASTER%の耳边、从心底里高兴地低声私语。
PRINTFORMW 「何がって、もちろん%CNAME("一人称")%のパンツですよ……バレていないと思いましたか？」	PRINTFORMW 「怎么说呢、当然是%CNAME("一人称")%の胖次啊……你觉得没有暴露吗？」
CALL PRINT_STR, @"「フフフ_H_」_W"	CALL PRINT_STR, @"「呼呼呼_H_」_W"
PRINTFORMW 「なんですか、黙っちゃって。……変な悪戯とかしてないですよね？」	PRINTFORMW 「怎么了、不要说话。……没有什么奇怪的恶作剧吧？」
PRINTFORMW 汗を流したばかりの%CALLNAME:TARGET%からは、ずっと嗅いでいたくなる様な良い匂いが立ち昇っている…	PRINTFORMW 从刚刚流汗の%CALLNAME:TARGET%身上、一股想一直闻下去的好气味油然而生…
PRINTFORMW 「フフっ……お待たせいたしました」	PRINTFORMW 「呼呼っ……让您久等了」
PRINTFORMW 「どうです？似合っていますか、%CNAME("二人称")%？」	PRINTFORMW 「怎么样？适合吗、%CNAME("二人称")%？」
PRINTFORMW %CALLNAME:TARGET%は%CALLNAME:MASTER%の目の前で両手を広げ、自分の着替えた姿を見せつけて悪戯っぽく微笑んだ。	PRINTFORMW %CALLNAME:TARGET%在%CALLNAME:MASTER%の目前摊开双手、露出自己换好衣服的样子、恶作剧般地微笑着。
PRINTFORMW 「……やっぱり%CNAME("二人称")%の仕業でしたか」	PRINTFORMW 「……果然是%CNAME("二人称")%干的好事」
PRINTFORMW 「横に見覚えのないものが置いてあったので、何事かと思いましたよ……フフ♪」	PRINTFORMW 「旁边放着一个不奇怪的东西、我还以为是什么事呢……呼呼♪」
PRINTFORMW 湯上りの%CALLNAME:TARGET%は髪をタオルで拭きながら、%CALLNAME:MASTER%の横に腰を下ろして少しだけ意地悪そうに微笑んだ。	PRINTFORMW 洗完澡的%CALLNAME:TARGET%用抹布擦头发的同时、坐在%CALLNAME:MASTER%的旁边稍微坏心眼地微笑着。
PRINTFORMW 「あら……なかなか楽しそうですね」	PRINTFORMW 「啊啦……看起来很开心呢」
PRINTFORMW 「あら、いきなりですね……どうかしましたか？」	PRINTFORMW 「啊啦、很突然呢……怎么了？」
PRINTFORMW 「…………は？ え～と……どうしました？」	PRINTFORMW 「…………哈？ 诶～怎……怎么了？」
PRINTFORMW 「……あの。いったい何をしておられるんでしょうか」	PRINTFORMW 「……那个。究竟在干什么呢」
PRINTFORMW %CALLNAME:TARGET%は困惑している……おっぱいの重さから解放してあげている%CALLNAME:MASTER%の気遣いが分かって無い様だ	PRINTFORMW %CALLNAME:TARGET%很困惑……%CALLNAME:MASTER%好像不明白从胸部的重量中解放出来的心思
PRINTFORML 「ああもう……あんまりユサユサさせないで下さい」	PRINTFORML 「啊啊、已经……请不要犹豫」
PRINTFORML 「ああもう……あんまり指に力込めたりしないでください」	PRINTFORML 「啊啊、真是的……手指请不要太用力」
PRINTFORMW %CALLNAME:TARGET%は怒る程ではないものの、終始困惑していた……	PRINTFORMW %CALLNAME:TARGET%虽然还不至于生气、但始终很困惑……
PRINTFORMW 「あら、支えていて下さるんですか。ありがとうございます……なかなか良いですね」	PRINTFORMW 「啊啦、就这样替我拖住吗。非常感谢……真不错啊」
PRINTFORMW 「……なんて、言うと思いました？」	PRINTFORMW 「……怎么、以为我会说什么吗？」
PRINTFORMW 重くて柔らかい……	PRINTFORMW 又沉又柔软……
PRINTFORMW 「ねぇ、%CNAME("二人称")%……もしよければですが、ここもお願いしていいですか？」	PRINTFORMW 「吶~、%CNAME("二人称")%……如果可以的话、这里也可以拜托你吗？」
PRINTFORMW %CALLNAME:TARGET%はスカートの裾をつまんでヒラヒラさせつつ、%CALLNAME:MASTER%に流し目を送ってきた	PRINTFORMW %CALLNAME:TARGET%捏着裙子的下摆翩翩起舞、向%CALLNAME:MASTER%送去了秋波
PRINTFORMW 「ほう。なかなか気が利きますね……流石は%CNAME("一人称")%の愛する%CNAME("二人称")%♪」	PRINTFORMW 「吼~。你真机灵……不愧是%CNAME("一人称")%爱的%CNAME("二人称")%♪」
PRINTFORMW %CALLNAME:TARGET%は%CALLNAME:MASTER%に身体を委ね、マッサージを満喫している……	PRINTFORMW %CALLNAME:TARGET%把身体交给了%CALLNAME:MASTER%、享受着按摩……
PRINTFORML 「あら、ありがとうございます……結構お上手ですね」	PRINTFORML 「啊啦、非常感谢……你对結構很擅长呢」
PRINTFORMW %CALLNAME:TARGET%は目を細めて気持ちよさそうに肩を揉まれている……	PRINTFORMW %CALLNAME:TARGET%眯着眼睛、好像很舒服似的让肩膀被揉着……
PRINTFORMW 「……ふぅ。結構なお手並みでした。次は私の番ですね」	PRINTFORMW 「……呼ぅ。你的本领真不错。下一次该我了吧」
PRINTFORMW 「どうですか？……もっと強い方がいいですか？」	PRINTFORMW 「怎么样？……再用力点好吗？」
PRINTFORMW 「お客様はこういうお店初めてですか？」	PRINTFORMW 「客人是第一次来这种店吗？」
PRINTFORMW 「わぁ、すごい。ガッチガチですねぇ……♪」	PRINTFORMW 「哇ぁ、好厉害。嘎吱嘎吱的响呢……♪」
PRINTFORMW %CALLNAME:TARGET%は上機嫌で%CALLNAME:MASTER%の肩を揉み解している……	PRINTFORMW %CALLNAME:TARGET%心情好、揉解了%CALLNAME:MASTER%的肩膀……
PRINTFORMW 「フフ。いつまで続けるんですか？」	PRINTFORMW 「呼呼。要持续到什么时候？」
PRINTFORMW %CALLNAME:MASTER%と%CALLNAME:TARGET%は代わり番こでキスしあった。	PRINTFORMW %CALLNAME:MASTER%和%CALLNAME:TARGET%轮吻。
PRINTFORMW 「もう、だめですよ？いきなりこんなことしては」	PRINTFORMW 「已经不行了、突然这么做」
PRINTFORMW 不意打ちで唇を奪われた%CALLNAME:TARGET%は、頬を緩ませつつ%CALLNAME:MASTER%を窘めた	PRINTFORMW 因为冷不防的攻击而双唇被夺走的%CALLNAME:TARGET%は、两颊绯闻地责备了%CALLNAME:MASTER%
PRINTFORML 「フフ。頬っぺたですか」	PRINTFORML 「呼呼。是脸颊嘛」
PRINTFORMW 頬にキスされた%CALLNAME:TARGET%は唇を指先で軽くなぞった	PRINTFORMW 亲吻了脸颊的%CALLNAME:TARGET%用指尖轻触著嘴唇
PRINTFORMW %CALLNAME:TARGET%は目を細めて%CALLNAME:MASTER%の口づけを受け入れた	PRINTFORMW %CALLNAME:TARGET%眯着眼睛接受了%CALLNAME:MASTER%の接吻
PRINTFORMW 「まぁ……いいですけど」	PRINTFORMW 「嘛ぁ……可以、但是」
PRINTFORML 「こういう事って、%CNAME("一人称")%がする側だと思うんですよねぇ」	PRINTFORML 「这样的事、%CNAME("一人称")%才是膝枕的一方吧」
PRINTFORMW %CALLNAME:MASTER%の膝に頭を乗せてきた%CALLNAME:TARGET%だったが、どうも落ち着かなさそうだ……	PRINTFORMW 头搭在%CALLNAME:MASTER%の膝上的%CALLNAME:TARGET%、总觉得有些不自在……
PRINTFORMW 「%CNAME("二人称")%……？ いったいどういう風の吹き回しですか？」	PRINTFORMW 「%CNAME("二人称")%……？ 到底吹的是什么風？」
PRINTFORMW %CALLNAME:TARGET%は警戒を声色に滲ませている……	PRINTFORMW %CALLNAME:TARGET%的声音渗透着警戒声……
PRINTFORMW が、怪訝な表情をしながら%CALLNAME:MASTER%の膝に頭を乗せてきた	PRINTFORMW 但、带着惊讶的表情把头放在%CALLNAME:MASTER%の膝盖上
PRINTFORMW 「変な事を考えてないでしょうね……？」	PRINTFORMW 「你没有考虑奇怪的事情吧……？」
PRINTFORMW どうやら慣れていないだけで、楽しんでくれてはいるようだ？	PRINTFORMW 看来只是不习惯而已、却好像很开心？
PRINTFORMW 「ありがとうございます……どれどれ？」	PRINTFORMW 「非常感谢……哪个？」
PRINTFORMW 「ふむ。なかなか……でも、少し熱いお湯で淹れると更に良いですね、水っぽさが消えますよ？」	PRINTFORMW 「嗯。相当……但是、用稍微热一点的热水泡的话会更好、水分不会消失掉吗？」
PRINTFORMW %CALLNAME:TARGET%は蘊蓄を垂れながら、美味しそうにお茶を味わっている	PRINTFORMW %CALLNAME:TARGET%在蘊蓄知识的同时、津津有味地品茶
PRINTFORMW %CALLNAME:TARGET%は笑顔でお茶を受け取った	PRINTFORMW %CALLNAME:TARGET%笑着接了茶
PRINTFORMW 「へぇ……美味しいですね。見直しました」	PRINTFORMW 「诶……很美味呢。需要重新审视了。」
PRINTFORMW 「あ、いえ、別に今まで軽んじていたとかそういう訳ではないですよ？」	PRINTFORMW 「啊、不、并不是说至今为止都很轻视？」
CALL PRINT_STR, "「きゃっ、んっ……_H_ し、少々敏感な場所ですので……お手柔らかにお願いします」_W"	CALL PRINT_STR, "「きゃっ、んっ……_H_ し、因为是稍微敏感的地方……所以请手下留情」_W"
PRINTFORMW %CALLNAME:TARGET%はくすぐったいような気持ちいいような様子で悶絶している……	PRINTFORMW %CALLNAME:TARGET%以痒痒的、舒服的样子昏厥着……
PRINTFORMW 「……優しくしてくださいね」	PRINTFORMW 「……请温柔一点」
PRINTFORMW %CALLNAME:TARGET%は僅かに頬を紅潮させて刺激に耐えている……	PRINTFORMW %CALLNAME:TARGET%稍微忍耐臉上泛起了紅潮的刺激……
PRINTFORMW 「きゃっ……もう、%CNAME("二人称")%ったらまた尻尾ですか」	PRINTFORMW 「きゃっ……真是的、%CNAME("二人称")%回去后又是抚摸尾巴嘛」
PRINTFORMW 「あら。なかなか気が利きますね♪」	PRINTFORMW 「啊啦。你真机灵♪」
PRINTFORMW 「%CNAME("二人称")%すいません、もう限界なんです……どうかお情けを」	PRINTFORMW 「%CNAME("二人称")%对不起、已经忍耐到极限了……请原谅我」
PRINTFORMW %CALLNAME:TARGET%は%CALLNAME:MASTER%に身体を密着させて、エッチのおねだりをしている……	PRINTFORMW %CALLNAME:TARGET%紧贴着%CALLNAME:MASTER%身体、还做出涩情动作……
RINTFORMW 「%CNAME("二人称")%ったら、お暇そうですねぇ」	RINTFORMW 「%CNAME("二人称")%的话、好像有空呢」
PRINTFORMW 「……退屈を紛らすお手伝いでも致しましょうか？%CNAME("一人称")%で宜しければですけど」	PRINTFORMW 「……如果可以的话、%CNAME("一人称")%呢来帮你排解无聊吗？」
PRINTFORMW 「どうです？こういうの……お好きですか？」	PRINTFORMW 「怎么样？这样的……喜欢吗？」
CALL PRINT_STRW, @"「%CNAME("二人称")%、失礼します……フフ_H_」"	CALL PRINT_STRW, @"「%CNAME("二人称")%、不好意思了……フフ_H_」"
PRINTFORMW 「すいません、あまりに無防備な%CNAME("二人称")%の様子に、つい……♪」	PRINTFORMW 「对不起、都是%CNAME("二人称")%の様子太毫不防备了……♪」
PRINTFORMW %CALLNAME:TARGET%は言葉では申し訳なさそうだが、表情は笑っている……	PRINTFORMW %CALLNAME:TARGET%的话听起来很对不起、但表情却是笑着的……
PRINTFORMW 「ちゅっ……♪ ほら、今度は%CNAME("二人称")%の番ですよ？」	PRINTFORMW 「ちゅっ……♪ 看、这次不是轮到%CNAME("二人称")%吗？」
PRINTFORMW 「なーんて。 冗談ですよ、冗談♪」	PRINTFORMW 「没什么。开玩笑啦、玩笑♪」
PRINTFORMW %CALLNAME:TARGET%はクスクス笑いながら%CALLNAME:MASTER%の顔を覗き込んでいる…	PRINTFORMW %CALLNAME:TARGET%笑嘻嘻的窥视者%CALLNAME:MASTER%の顔…
PRINTFORMW 「隙だらけですよ？」	PRINTFORMW 「真是冒失呢？」
PRINTFORMW ニマリと笑った%CALLNAME:TARGET%は、%CALLNAME:MASTER%に軽く抱きついてきた	PRINTFORMW 微微一笑的%CALLNAME:TARGET%、轻轻地抱住%CALLNAME:MASTER%
PRINTFORMW 「ん……%CNAME("二人称")%の体温が染み入るようです」	PRINTFORMW 「ん……%CNAME("二人称")%の体温好像感受到了」
PRINTFORMW %CALLNAME:TARGET%は%CALLNAME:MASTER%の身体に密着して人肌の温もりを楽しんでいる……	PRINTFORMW %CALLNAME:TARGET%紧紧贴住%CALLNAME:MASTER%の身体享受着人肌带来の温度……
PRINTFORMW 「%CNAME("二人称")%どうです？ドキドキしますか？」	PRINTFORMW 「%CNAME("二人称")%怎么了？心扑通扑通地跳呢？」
PRINTFORMW 「%CNAME("一人称")%は、ドキドキしていますよ……少しだけ」	PRINTFORMW 「%CNAME("一人称")%、心也稍微有点……扑通扑通地跳呢」
PRINTFORMW %CALLNAME:TARGET%は%CALLNAME:MASTER%の身体に猫の様に身体を擦り付けている……	PRINTFORMW %CALLNAME:TARGET%的身体像猫一样蹭着%CALLNAME:MASTER%の身体……
PRINTFORMW 「%CNAME("二人称")%、如何ですか？」	PRINTFORMW 「%CNAME("二人称")%、怎么了吗？」
PRINTFORMW 「%CNAME("一人称")%みたいな女の子に甘えてもらえるなんて、実は内心嬉しかったりしますか？」	PRINTFORMW 「能得到像%CNAME("一人称")%这样的女孩子的撒娇、实际上内心会高兴吗？」
PRINTFORMW %CALLNAME:TARGET%は即答しづらい質問を口にしつつ、目を閉じて%CALLNAME:MASTER%の温もりを味わっている	PRINTFORMW %CALLNAME:TARGET%一边说着难以马上回答的问题、一边闭上眼睛体味着%CALLNAME:MASTER%の温暖
PRINTFORMW 「悪くないですねぇ、こういうのも♪」	PRINTFORMW 「不讨厌内、这样的也不错♪」
PRINTFORMW 「……なんです？固まっちゃって」	PRINTFORMW 「……怎么了？都僵住了」
PRINTFORMW 「%CNAME("一人称")%がこういう事するのって意外ですか？」	PRINTFORMW 「%CNAME("一人称")%做这种事不意外吗？」
PRINTFORMW 「あ、ちょっと、逃げないで下さいよ……良いじゃないですか、たまには♪」	PRINTFORMW 「啊、等一下、请不要逃啊……偶尔这样也不错呢♪」
PRINTFORMW %CALLNAME:TARGET%は無邪気な笑顔で、%CALLNAME:MASTER%とのじゃれ合いを楽しんでいる	PRINTFORMW %CALLNAME:TARGET%用天真无邪的笑容、享受着和%CALLNAME:MASTER%の嬉戏
PRINTFORMW 「%CNAME("二人称")%って、結構触り心地が良いですよね」	PRINTFORMW 「%CNAME("二人称")%的话、感觉很舒服呢」
PRINTFORMW 「暇そうですね……なにかしないんですか？」	PRINTFORMW 「看起来很闲啊……不做些什么吗？」
PRINTFORMW 「しないなら、もっともっと撫でちゃいますよ？」	PRINTFORMW 「如果你不做的话、那能让我再更多更多的抚摸你吗？」
PRINTFORMW 「フフ……撫でられるの、結構好きだったりしますか？」	PRINTFORMW 「呼呼……这样抚摸着、你很喜欢吗？」
PRINTFORMW 「あら、枕はうつ伏せになって使う派ですか？」	PRINTFORMW 「啊啦、枕头是趴着用的吗？」
PRINTFORMW 「息苦しいだけだと思うんですけどねぇ」	PRINTFORMW 「我觉得这样只会呼吸困难而已呢」
PRINTFORMW 「主に膝枕ができるなんて、%CNAME("一人称")%は幸せなメイドですよねぇ」	PRINTFORMW 「能让主人膝枕、%CNAME("一人称")%是个幸福的女仆呢」
PRINTFORMW %CALLNAME:TARGET%は%CALLNAME:MASTER%の頭を優しく撫でつつ、目を細めてしみじみ呟いた	PRINTFORMW %CALLNAME:TARGET%温柔地抚摸着%CALLNAME:MASTER%の頭、眯缝着眼睛小声地嘟囔着
PRINTFORMW 「いえね、母にして貰った時の事を思い出してました」	PRINTFORMW 「不是呢、我只是想起了妈妈给我做的事情」
PRINTFORMW 「%CNAME("一人称")%も、子供が出来たらしてあげたいものです」	PRINTFORMW 「%CNAME("一人称")%啊、也真的想为你生个孩子」
PRINTFORMW 「%CNAME("二人称")%、どうぞ。熱いのでフーフーしてから飲んでくださいね」	PRINTFORMW 「%CNAME("二人称")%、请。因为很烫、所以请呼一下之后再喝」
PRINTFORMW 「今日は少しお高い茶葉を使いました。お口に合うと良いのですが」	PRINTFORMW 「今天用了稍微贵一点的茶叶。希望合您的口味」
PRINTFORMW 「粗茶ですが、どうぞ」	PRINTFORMW 「只是粗茶而已、请用」
PRINTFORMW 「最近マンネリなんですよねぇ……なにか面白いこと知りません？」	PRINTFORMW 「最近总是千篇一律呢……都没有什么有趣的事情发生吗？」
PRINTFORMW %CALLNAME:TARGET%は気怠げな様子で%CALLNAME:MASTER%に話しかけつつ、もたれかかってきた	PRINTFORMW %CALLNAME:TARGET%一副倦怠的样子跟%CALLNAME:MASTER%搭话、然后靠过来
PRINTFORMW 「ふぅ……疲れました」	PRINTFORMW 「呼ぅ……我累了」
PRINTFORMW %CALLNAME:TARGET%は%CALLNAME:MASTER%に後ろから抱きついて動かない……	PRINTFORMW %CALLNAME:TARGET%从%CALLNAME:MASTER%的从后面抱住然后一动不动……
PRINTFORMW 「重いですって？ ……フフ」	PRINTFORMW 「（胸）很重吗？ ……呼呼」
PRINTFORMW 「%CNAME("一人称")%の事、好きって言って下さったらどいてあげますよ？」	PRINTFORMW 「如果说喜欢%CNAME("一人称")%的话，说不定可以放开你呢？」
PRINTFORMW 「ただいま戻りました……あら？%CNAME("二人称")%もでしたか」	PRINTFORMW 「我回来了……啊啦？%CNAME("二人称")%在啊」
PRINTFORMW 「……っとと、ゴホン。なんでもありません」	PRINTFORMW 「……っとと、咳哼。没什么事」
PRINTFORMW うっかり言外で自分がトイレに行って来たと表明してしまった%CALLNAME:TARGET%は一つ咳払いをした。	PRINTFORMW %CALLNAME:TARGET%无意中表明自己去了厕所、咳嗽了一声。
PRINTFORMW 「ただいま戻りました」	PRINTFORMW 「我回来了」
PRINTFORMW 「%CNAME("一人称")%が居ない間、寂しくなかったですか？ フフ♪」	PRINTFORMW 「%CNAME("一人称")%不在的期间、不寂寞吗？ 呼呼♪」
PRINTFORMW 「……%CNAME("二人称")%、ちょっと失礼します」	PRINTFORMW 「……%CNAME("二人称")%、等、真是失礼了」
PRINTFORMW 「……少々席を外させていただきますね」	PRINTFORMW 「……请让我稍微离开一下座位」
PRINTFORMW 「今回だけは許してあげます。こういう質問は以後なさらぬよう」	PRINTFORMW 「这次我就原谅你。这种问题以后再也不会提了」
PRINTFORMW %CALLNAME:TARGET%は口は笑顔だが目が笑ってない……	PRINTFORMW %CALLNAME:TARGET%虽然嘴上是笑容、但眼睛却不笑……
PRINTFORMW 「えぇ……。%CNAME("二人称")%……流石にその質問はどうかと思いますよ……」	PRINTFORMW 「额……。%CNAME("二人称")%……关于那个问题怎么样……」
PRINTFORMW %CALLNAME:TARGET%は%CALLNAME:MASTER%の質問にドン引きしている……	PRINTFORMW %CALLNAME:TARGET%对%CALLNAME:MASTER%の質問感到惊讶……
PRINTFORMW 「え？！ え、えーと……少々、お花を摘んでいました」	PRINTFORMW 「诶？！ 诶、那个……稍微、去摘花了」
PRINTFORMW %CALLNAME:TARGET%は質問に面食らいながら、しどろもどろになりつつトイレに行っていたと白状した。	PRINTFORMW %CALLNAME:TARGET%面对提问不知所措的同时、弄得语无伦次坦白说是去了厕所。
PRINTFORMW 「ひゃああああ！」	PRINTFORMW 「呀啊啊啊啊！」
PRINTFORMW 「えっ！ちょっ、%CNAME("二人称")%、ちょっと！！」	PRINTFORMW 「哎っ！等下、%CNAME("二人称")%、等一下！！」
PRINTFORMW 「…………は？ え～と……どうしました？」	PRINTFORMW 「…………哈？ え～と……怎么了？」
PRINTFORMW 「……あの。いったい何をしておられるんでしょうか」	PRINTFORMW 「……那个。到底在干什么呢」
PRINTFORMW 「もう……しつこいですよ」	PRINTFORMW 「真是的……真烦人」
PRINTFORMW 「そういう事は、ＴＰＯを選んで仰ってください」	PRINTFORMW 「那样的事、请选择用ＴＰＯ来告诉我」
PRINTFORMW %CALLNAME:TARGET%はジト～っとした視線と共に%CALLNAME:MASTER%を窘めた	PRINTFORMW %CALLNAME:TARGET%用锐利的視線责备%CALLNAME:MASTER%
PRINTFORMW これ以上言っても駄目そうだ……	PRINTFORMW 看来说再多也没用……
PRINTFORMW 「そういう事はベッドの上で仰ってください」	PRINTFORMW 「那种事情到床上再说吧」
PRINTFORMW %CALLNAME:TARGET%の目は……笑ってない	PRINTFORMW %CALLNAME:TARGET%の目里……没有笑意
PRINTFORMW 「流石に%CNAME("二人称")%と言えどそれはちょっと……」	PRINTFORMW 「虽说是%CNAME("二人称")%但也有点……」
PRINTFORMW %CALLNAME:TARGET%は%CALLNAME:MASTER%の要求に馬鹿を見る様な表情をしている……	PRINTFORMW %CALLNAME:TARGET%对%CALLNAME:MASTER%の要求露出一副瞧不起的表情……
PRINTFORMW 「それって、遠回しに%CNAME("一人称")%の身嗜みを確認しようってことでしょうか？」	PRINTFORMW 「那个是、绕圈子确认%CNAME("一人称")%の身嗜状况？」
PRINTFORMW 「フフ、しっかり綺麗にしてありますよ……♪」	PRINTFORMW 「フフ、有好好的清洁哦……♪」
PRINTFORMW 「お楽しみのところ申し訳ありませんけど、そういう事するの止めてもらえませんかねぇ」	PRINTFORMW 「很抱歉在你期待的时候打扰了，但是能请不要做那样的事吗」
PRINTFORMW %CALLNAME:TARGET%は、%CLO("股間")%から食み出た陰毛で遊んでいる%CALLNAME:MASTER%に疲れた表情で抗議している。	PRINTFORMW %CALLNAME:TARGET%以疲惫的表情、对玩着玩弄%CLO("股間")%刚露出来的阴毛的%CALLNAME:MASTER%表示抗议。
PRINTFORMW 「随分じっくり見てますけど…………！？」	PRINTFORMW 「虽然看得很仔细…………！？」
PRINTFORMW 「ちょ、これは違うんです、もう……見ちゃだめです！」	PRINTFORMW 「等、这个不行、真是的……不要看！」
PRINTFORMW 剃り損ねた陰毛が%CLO("股間")%から食み出ているのに気づいた%CALLNAME:TARGET%は慌てて手で隠した！	PRINTFORMW %CALLNAME:TARGET%注意到没有剔好的陰毛从%CLO("股間")%露出来就慌忙用手遮住！
PRINTFORMW 「あの。近いですよ」	PRINTFORMW 「那个。太近了」
PRINTFORMW 「何って……顔に決まってます。ちょっとがっつき過ぎですよ」	PRINTFORMW 「什么太近了……是脸啦。等下、有点太过分了」
PRINTFORMW %CALLNAME:TARGET%は太ももに当たる%CALLNAME:MASTER%の息遣いに少しくすぐったそうにしている……	PRINTFORMW %CALLNAME:MASTER%の呼吸刺激着%CALLNAME:TARGET%の大腿、看上去有点痒痒的……
PRINTFORMW 「%CNAME("二人称")%は、こういうのお好きですよねぇ本当に」	PRINTFORMW 「%CNAME("二人称")%は、真的很喜欢这样的呢」
PRINTFORMW 「……良かったら、もっとじっくり見ます？」	PRINTFORMW 「……如果可以的话、不再仔细看一下吗？」
PRINTFORMW %CALLNAME:TARGET%は腰掛ける%CALLNAME:MASTER%の前に仁王立ちし、股間を顔に触れる程に近づけてきた！	PRINTFORMW %CALLNAME:TARGET%仁王立坐在在%CALLNAME:MASTER%の面前、接近了将股间触摸到脸的程度！
PRINTFORMW %CALLNAME:TARGET%の%TEXTS("匂い")%が%CALLNAME:MASTER%の鼻孔を刺激する……	PRINTFORMW %CALLNAME:TARGET%の%TEXTS("气味")%刺激%CALLNAME:MASTER%の鼻孔……
PRINTFORMW 「……流石にジロジロ見過ぎですよ」	PRINTFORMW 「……果然是盯着看太多了」
PRINTFORMW 「気づいてないと思ったら大間違いですからね？」	PRINTFORMW 「如果觉得没被注意到的话就大错特错了不是吗？」
PRINTFORMW %CALLNAME:TARGET%は、ほんの少しだけ恥じらいを浮かべて体勢を変えてしまった。	PRINTFORMW %CALLNAME:TARGET%は、只要露出一点羞耻的地方就改变的自己的姿势。
PRINTFORMW 「随分熱心に見られているようですけど」	PRINTFORMW 「虽然看起来很热心」	
PRINTFORMW 「そんなに夢中になる程のものですかねぇ、この姿って」	PRINTFORMW 「真就那么着迷吗、这个姿势」
PRINTFORMW %CALLNAME:TARGET%は%CALLNAME:MASTER%の様子を眺めつつ、少し不思議そうな様子で視姦を受け入れている……	PRINTFORMW %CALLNAME:TARGET%一边望着%CALLNAME:MASTER%の様子、一边以稍微有些不可思议的样子接受了视奸……
PRINTFORMW 「フフ……お顔にバッチリ出てましたよ、これが見たかったんですよね？」	PRINTFORMW 「フフ……脸上完美地露出来了，很想看这个吗？」
PRINTFORMW 「どうです？答え合わせの結果は♪」	PRINTFORMW 「怎么样？回答の結果是♪」
PRINTFORMW 「ほら、いいですよ。どうぞ見てください」	PRINTFORMW 「ほら（ho la）、可以的。请看好了」
PRINTFORMW 「…………あら？もしかして違いました？」	PRINTFORMW 「…………啊啦？难道不是？」
PRINTFORMW 「うわ……私、まるで露出狂じゃないですか……うわぁ」	PRINTFORMW 「呜哇……我、简直就是个露出狂……うわぁ」
PRINTFORMW 「分かっておりますとも……%CNAME("二人称")%のなさりたい事なんて、%CNAME("一人称")%程のメイドならお見通しです」	PRINTFORMW 「我是知道的……%CNAME("二人称")%想要做的事情、%CNAME("一人称")%是会对这种程度就豁出去的女仆」
PRINTFORMW 「さ、存分に……どうぞ？」	PRINTFORMW 「撒、不尽情的……享用吗？」
PRINTFORMW 「って、何してるんですか%CNAME("二人称")%……」	PRINTFORMW 「って、在干什么呢%CNAME("二人称")%……」
PRINTFORMW 「…………は？ え～と……どうしました？」	PRINTFORMW 「…………は？ え～と……怎么了？」
PRINTFORMW 「どうもしてない？そ、そうで……すか？」	PRINTFORMW 「什么也没做？是、是那样……吗？」
PRINTFORMW 「スカートをめくってる？ いや、そうですけど、そうじゃなくてですね……」	PRINTFORMW 「你在翻裙子吗？ 不、是这样、但不是那样……」
PRINTFORMW 「うわぁ……本当、%CNAME("二人称")%ってご自分に正直ですよねぇ」	PRINTFORMW 「库哇啊……真的、%CNAME("二人称")%对自己很诚实呢」
PRINTFORMW 「ちょっと呆れを通り越して尊敬の念が芽生えてきましたよ……」	PRINTFORMW 「通过街道稍微有些吃惊、萌生出了尊敬的心情……」
PRINTFORMW 「もう……お行儀悪いですよ、%CNAME("二人称")%」	PRINTFORMW 「真是的……真没礼貌。、%CNAME("二人称")%」
PRINTFORMW 「こういうことは、せめて挨拶なさってからにして下さい」	PRINTFORMW 「话说回来、请至少在打招呼之后再说」
PRINTFORMW 「顔をあわせるなりこれですか……フフ。仕方のないお人ですねぇ」	PRINTFORMW 「见面就是这个吗……呵呵。真是没办法的人啊」
PRINTFORMW 「あら、いきなりですねぇ……ホント、油断も隙も無いんですから」	PRINTFORMW 「啊啦、真突然啊……真的、因为豐腴的间隙差点露出来」
PRINTFORMW 「で、どうです？こういう趣向、お好きですか？」	PRINTFORMW 「那么、怎么样？这样的性取向、你喜欢吗？」
PRINTFORMW 「で、どうです？こういうパンツ、お好きですか？」	PRINTFORMW 「那么、怎么样？这样的胖次、你喜欢吗？」
PRINTFORMW 「%CNAME("一人称")%のパンツをご覧になりたいのなら言ってくださればよかったのに……フフ」	PRINTFORMW 「如果想看%CNAME("一人称")%の胖次直接说出来不就好了……呵呵」
PRINTFORMW 「確かに言いました、そういう事して良いですよと。……それは認めます」	PRINTFORMW 「我确实说过了，这样做很舒服。……我承认那个」
PRINTFORMW 「でもですね、%CNAME("二人称")%。しちゃいます！？%CNAME("一人称")%の目の前でそういうこと……」	PRINTFORMW 「但是呢、%CNAME("二人称")%。确定要做吗！？当着%CNAME("一人称")%の眼前说那样的话……」
PRINTFORMW 目の前で自分のパンツを使われた%CALLNAME:TARGET%は、羞恥で頬を染めつつ咎めてきた。	PRINTFORMW 在眼前是使用自己胖次的%CALLNAME:TARGET%は、因羞辱得面红耳赤、责备起来。
RINTFORMW 「うわぁ……%CNAME("二人称")%。しちゃいます？%CNAME("一人称")%の目の前でそういうこと……」	RINTFORMW 「呜哇……%CNAME("二人称")%。确定要做吗？当着%CNAME("一人称")%の眼前说那样的话……」
PRINTFORMW %CALLNAME:TARGET%は%CALLNAME:MASTER%の行動にドン引きしている……	PRINTFORMW %CALLNAME:TARGET%对%CALLNAME:MASTER%の行動感到厌恶……
PRINTFORMW 「もう……見てるこっちが恥ずかしくなっちゃいます」	PRINTFORMW 「真是的……看的这边会害羞的」
PRINTFORMW 「少しは恥じらいと言うか礼儀と言うかをですね……」	PRINTFORMW 「要说是有点害羞还是说礼儀呢……」
PRINTFORMW %CALLNAME:TARGET%は赤い顔で目を逸らしつつ、%CALLNAME:MASTER%に小言を言った。	PRINTFORMW %CALLNAME:TARGET%红着脸移开视线、对%CALLNAME:MASTER%说了这样的话。
PRINTFORMW 「やっとお誘いしてくれましたね、%CNAME("二人称")%……ふふふっ♪」	PRINTFORMW 「终于邀请我了、%CNAME("二人称")%……呼呼呼っ♪」
PRINTFORMW %CALLNAME:TARGET%はその場で下着を脱ぎ、あやとりのような手つきでパンツを広げてクロッチ部分の愛液染みを見せつけてきた。	PRINTFORMW %CALLNAME:TARGET%当场脱去内衣、用类似捉拿的手势展开胖次、開洞部分の愛液带污迹的被展示了出来。
CALL PRINT_STRW, "「見てくださいよこれ……私、待ちきれなくてもうこんなに……_H_」"	CALL PRINT_STRW, "「请好好看着这里……我、已经等不及了……_H_」"
CALL PRINT_STRW, "「さ、はやくいたしましょう……私、準備万端ですから……_H_」"	CALL PRINT_STRW, "「撒、我们快点吧……我、已经做好万全準備万端了……_H_」"
PRINTFORMW 「あら、我慢できなくなっちゃいました？」	PRINTFORMW 「啊啦、变得忍受不了不是吗？」
PRINTFORMW 「……仕方ないですねぇ♪」	PRINTFORMW 「……这也是没办法的啊♪」
PRINTFORMW 「あら、我慢できなくなっちゃいましたか」	PRINTFORMW 「啊啦、变得不能忍耐了吗？」
PRINTFORMW 「フフ……お尻でしたら構いませんよ？」	PRINTFORMW 「呵呵……屁股的话没关系哦？」

PRINTFORMW 「……フフ♪構いませんよ」	PRINTFORMW 「……呼呼♪没关系。」
PRINTFORMW 「う～ん…………はい、わかりました」	PRINTFORMW 「呜～嗯…………好的、知道了」
PRINTFORMW 「途中でお相手できなくなるかもしれませんが、そこは許してくださいね？」	PRINTFORMW 「途中就不能和你交合了、这一点请见谅呢？」
PRINTFORMW 「ええ、それでも構いませんよ……ご自由にどうぞ」	PRINTFORMW 「嗯、那样也没关系……请随意」

PRINTFORMW 「ん……ゴク。……フフっ、すっきりしたみたいですね」	PRINTFORMW 「ん……ゴク。……呵呵っ、看起来变得清爽呢」
PRINTFORMW %CALLNAME:TARGET%は一仕事終えて柔らかくなった%CALLNAME:MASTER%のペニスに頬ずりしながら、上目遣いに微笑んだ。	PRINTFORMW %CALLNAME:TARGET%在工作结束后贴上%CALLNAME:MASTER%变得柔软の阴茎的同时、向上看的时候微笑了。
PRINTFORMW 「んんっ……あっ、%CNAME("二人称")%そのままそのまま……今、綺麗にしてあげますからね」	PRINTFORMW 「嗯嗯っ……啊っ、%CNAME("二人称")%就保持这様……现在、我给你弄干净」
PRINTFORMW 口に出された精液を飲み干した%CALLNAME:TARGET%は、ペニスにこびりついた汚れを自らのハンカチで拭き清めた。	PRINTFORMW 喝完了口中精液的%CALLNAME:TARGET%は、用自己的手帕擦掉附着在阴茎上的污垢。
PRINTFORMW 「フフ、凄いですね。%CNAME("一人称")%の胸でされるの……そんなに良かったですか？」	PRINTFORMW 「呵呵、好厉害啊。用%CNAME("一人称")%の胸来做……那么舒服吗？」
PRINTFORMW %CALLNAME:TARGET%は自分の身体を汚す白濁液を指で掬い取り、見せつけるように舌で舐め取りながらからかってきた。	PRINTFORMW %CALLNAME:TARGET%用手指捞取了弄脏自己身体的白浊液、像是给人看似的用舌头一边舔一边戏弄。
PRINTFORMW 「おっとっと……いっぱい出ましたね」	PRINTFORMW 「喔等下……出来了很多呢」
PRINTFORMW 「ほんと、お元気なんですから%CNAME("二人称")%は♪」	PRINTFORMW 「真是的、%CNAME("二人称")%很健康呢♪」
PRINTFORMW %CALLNAME:TARGET%は乳房を擦り合わせて精液を塗り広げた後に左右に広げ、濃厚な白い粘液の橋が両胸にかけて架かるのを見せてきた。	PRINTFORMW %CALLNAME:TARGET%摩擦涂满精液的乳房然后向左右展开、突显着橋挂在両胸中间的濃厚的白色粘液。
PRINTFORMW 「%CNAME("二人称")%お疲れさまでした……ちょっとお待ちくださいね」	PRINTFORMW 「%CNAME("二人称")%大人辛苦了……请稍等一下」
PRINTFORMW %CALLNAME:MASTER%からゴムを外した%CALLNAME:TARGET%は汚れたペニスを口で綺麗にお掃除した。	PRINTFORMW 从%CALLNAME:MASTER%身上取下避孕套的%CALLNAME:TARGET%用嘴漂亮地弄脏的掃除阴茎。
PRINTFORMW そればかりか、避孕套の中の精液を口に垂らして涼しい顔で飲み干し始めた……	PRINTFORMW 不仅如此、还把避孕套の中の精液滴在嘴上以涼爽表情开始飲干し……
PRINTFORMW 「今回は中に頂けませんでしたしね。フフフ♪」	PRINTFORMW 「这次下面的里面还没有收到呢。呵呵呵♪」
PRINTFORMW 「ん……ぁ……ふぅっ……♪」	PRINTFORMW 「嗯……啊……呜呼~……♪」
PRINTFORMW 「気持ちよくなって頂けたみたいですね、フフ」	PRINTFORMW 「感觉心情变好了呢、呵呵」
PRINTFORMW うっすらと汗をかいた%CALLNAME:TARGET%は目を細めて微笑みつつ、そのままの体勢で余韻に浸っている……	PRINTFORMW 微微带着汗水%CALLNAME:TARGET%眯着眼睛微笑着、就这様一交合の体勢沉浸在余韻中……
PRINTFORMW %CALLNAME:TARGET%は中出しして貰えた事に頬を緩めつつ、%CALLNAME:MASTER%の顔に手を伸ばして頬を優しく撫でて来た。	PRINTFORMW %CALLNAME:TARGET%对中出的事放緩脸頬、把手伸向%CALLNAME:MASTER%の顔頬温柔的撫摸着。
PRINTFORMW 「……ところで%CNAME("二人称")%。今度のお休みって、もしかしてお暇だったりします？」	PRINTFORMW 「……对了%CNAME("二人称")%。这次的休息日、有空吗？」
PRINTFORMW 「いえ、もし宜しければですけど……一緒に少し、お出かけしませんか」	PRINTFORMW 「不是的、只是如果可以的话……一起稍微的、出去玩一会吧」
PRINTFORMW %CALLNAME:TARGET%は顔を僅かに逸らし、チラリと横目で%CALLNAME:MASTER%を見つめてきた。	PRINTFORMW %CALLNAME:TARGET%稍微把脸挪开一点、斜着眼睛凝视着%CALLNAME:MASTER%。
PRINTFORMW 「あら……デートのお誘いですか？ご主人様」	PRINTFORMW 「啊啦……是约会的邀请吗？主人様」
PRINTFORMW 「お弁当を用意しますから、少しお待ちくださいね」	PRINTFORMW 「那我来准备便当、请稍微等一下吧」
PRINTFORMW 「買出しの予定だったのですが、いいですよ」	PRINTFORMW 「原本就打算要买的、现在没关系的呢」
PRINTFORMW 「熱は……ありませんね」	PRINTFORMW 「发烧了……没有啊」
PRINTFORMW 「ちょっとビックリしちゃいましたがＯＫですよ」	PRINTFORMW 「稍微吓了一跳呢、但没事就ＯＫ了」
PRINTFORMW 「お待たせしました、ご主人様。と言ってもお家の玄関ですけどね」	PRINTFORMW 「让您久等了、主人様。虽然是这么说但也还是在家の玄関」
PRINTFORMW 「さてさて、何処に行きましょう？」	PRINTFORMW 「快点快点、我们去哪里呢？」
PRINTFORMW 「%TEXTR("すっかり遅くなってしまいましたが……このまま帰りますか？/楽しいデートでしたね。今日はもう帰っちゃいますか？")%」	PRINTFORMW 「%TEXTR("现在已经很晚了……就这样回去吗？/很开心的约会呢。今天就要回去了吗？")%」
PRINTFORMW 「たまにはこう言う普通なのもいいですね」	PRINTFORMW 「偶尔这样普通做也不错的呢」
PRINTFORMW 「%TEXTR("頭がいい方がモテます。だから頑張りましょうね、ご主人様/勉強の為に来たのですが……料理の本が充実していてちょっと目移りしちゃいますね/うちの学校の図書館は何でもあるので便利なのですが、司書様が見てますね")%」	PRINTFORMW 「%TEXTR("聪明的人很受欢迎。所以加油吧、主人様/我是来学习的……料理书很充实，但让人有点眼花缭乱呢/我们学校的図書館什么都有、很方便的、图书管理员看看过来呢")%」
PRINTFORMW 「あんまりエッチなのは駄目ですからね？」	PRINTFORMW 「这么H的是不行的吧？」
PRINTFORMW 「……まぁ、少しぐらいなら良いですけど」	PRINTFORMW 「……嘛ぁ、稍微有一点就行了」
PRINTFORMW 「フフ。いいですよね、こういうの……なんだかドキドキしてきました♪」	PRINTFORMW 「呵呵。好啊、这样的……总觉得心里扑通扑通地跳♪」
PRINTFORMW 「今年はどういうものが流行りなんでしょうねぇ」	PRINTFORMW 「今年流行什么样的东西呢」
PRINTFORMW 「%CNAME("二人称")%お待たせしました。……いかがですか？」	PRINTFORMW 「%CNAME("二人称")%让您久等了。……怎么样？」
PRINTFORMW 「%CNAME("二人称")%お待たせしました。……似合ってます？」	PRINTFORMW 「%CNAME("二人称")%让您久等了。……合适吗？」
PRINTFORMW 「……フフ♪ 聞くまでも無いみたいですね」	PRINTFORMW 「……呵呵♪ 好像没必要问啊」
PRINTFORMW 「%CNAME("二人称")%お待たせしました。……いかがですか？」	PRINTFORMW 「让%CNAME("二人称")%就等了。……怎么样？」
PRINTFORMW 「すいません、%CNAME("二人称")%。大変お待たせいたしました」	PRINTFORMW 「抱歉、%CNAME("二人称")%。让您久等了」
PRINTFORMW 「……急いで着替える場合はビキニの方が良いかもしれませんねぇ」	PRINTFORMW 「……如果要急急忙忙更衣的话、也许比基尼比较好呢」
PRINTFORMW 「……あの。あんまりジロジロ見ないでください」	PRINTFORMW 「……那个。请不要盯着看」
PRINTFORMW 「わっ……もう、ご主人様ったら」	PRINTFORMW 「哇~……真是的、但如果是主人様的话」
PRINTFORMW 「あら。不意打ちとは……なかなかやりますね♪」	PRINTFORMW 「啊啦。突然袭击什么的……挺能干的嘛♪」
PRINTFORMW 「そうですね。……少し、休憩してからにしましょうか」	PRINTFORMW 「是啊。……稍微、休息一下再做吧」
PRINTFORMW 「%TEXTR("……フフ。何でもありません。今日は手を繋いで帰りましょうか/ちょっと名残惜しい気もしますが、帰ったら特別にご主人様の好きな料理を作ってあげますね")%」	PRINTFORMW 「%TEXTR("……呵呵。没什么。今天就牵着手回去吧/虽然有点舍不得，但回去后会特别为主人做喜欢的料理")%」
PRINTFORMW 「あら、つれませんね。しょんぼりです」	PRINTFORMW 「啊啦、真无情啊。有点失落」
PRINTFORMW 「あら。他に用事がおありでしたか」	PRINTFORMW 「啊啦。还有别的事吗」
PRINTFORMW 「なんだかお勉強に身が入らなくなりそうですがまぁ、よしとしましょう……どうぞ」	PRINTFORMW 「总觉得好像不能专心学习了、算了吧……请用」
PRINTFORMW 「……まぁ、その程度のお願いでしたら」	PRINTFORMW 「……嘛ぁ、如果是那种程度的请求的话」
PRINTFORMW 「フフ……仕方ないお人ですねぇ♪」	PRINTFORMW 「呼呼……真是没办法的人啊♪」
PRINTFORMW 「%CNAMET(ARG, "二人称")%、%TEXTR("お疲れさま/今日も一日ご苦労さま")%でした」	PRINTFORMW 「%CNAMET(ARG, "二人称")%%TEXTR("、辛苦了/、今天一天也辛苦了")%」
PRINTFORMW 「う～ん%CNAME("二人称")%って普段がアレな癖に頭いいですから、そうですね……」	PRINTFORMW 「嗯～ん%CNAME("二人称")%平时总是那么聪明、是啊……」
PRINTFORMW 「ちょっと良い成績程度だと簡単にクリアしちゃいそうですし、TOP10に入れたら、でいかがでしょう。フフフ♪」	PRINTFORMW 「如果成绩稍微好一点的话、就很容易进入TOP10、怎么样。呼呼呼♪」
PRINTFORMW 「突然神妙な表情になって何を言い出すかと思ったらＨなご褒美が欲しいとか……フフ」	PRINTFORMW 「突然表情变得神妙、一想说到想要什么就说想要H的奖励之类的……呼呼」
PRINTFORMW 「ええ、いいですよ……%CNAME("二人称")%のそういう所けっこう好きですよ、%CNAME("一人称")%♪」	PRINTFORMW 「唉、可以哦……%CNAME("二人称")%可是很喜欢你那地方、%CNAME("一人称")%♪」
PRINTFORMW ……%CALLNAME:TARGET%からＯＫが出ました！	PRINTFORMW ……%CALLNAME:TARGET%做出了ＯＫ的意思！
CALL PRINT_STR, "「フフフ……_H_」_W_"	CALL PRINT_STR, "「呼呼呼……_H_」_W_"
CALL PRINT_STR, "「まだまだ夜までは間が有ります……たっぷりと、愉しみましょうね……_H_」_W_"	CALL PRINT_STR, "「离晚上还有一段时间……让我们好好享受吧……_H_」_W_"
CALL PRINT_STR, @"「%CNAMET(ARG, "二人称")%、おはようございます……_H_」_W"	CALL PRINT_STR, @"「%CNAMET(ARG, "二人称")%、早上好……_H_」_W"
PRINTFORMW 「%CNAMET(ARG, "二人称")%、おはようございます」			PRINTFORMW 「%CNAMET(ARG, "二人称")%、早上好」
PRINTFORMW 「本日は体育が有る日ですよ。体操着とタオルは大丈夫でしょうか？」		PRINTFORMW 「今天是有体育课的日子、体操服和毛巾有带着吗？」
PRINTFORMW 「本日は体育が有る日ですね。女の子のお尻ばっか見てちゃだめですよ？」		PRINTFORMW 「今天是有体育的日子、不能一直盯着女孩子的屁股看哟」
PRINTFORMW 「さてさて本日は何をしましょうかねぇ」	PRINTFORMW 「那么今天要做什么呢？」
PRINTFORMW 「お食事の準備が出来ていますよ……ささ、どうぞこちらへ」	PRINTFORMW 「已经准备好饭菜了……来、这边请」
PRINTFORMW 「ふむ。他の方は遅れているようですね」	PRINTFORMW 「嗯。其他人好像迟到了」
PRINTFORMW 「今日は%CNAMET(ARG, "一人称")%達の貸し切りみたいですよ」	PRINTFORMW 「今天的%CNAMET(ARG, "一人称")%包场了哟」
PRINTFORMW 「……なーんて、フフフ♪」	PRINTFORMW 「……开玩笑的、哼哼♪」
PRINTFORMW 標語を横目で確認した%CALLNAME:ARG%は、衣擦れの音をさせつつ%CALLNAME:MASTER%の横で下着姿になった……	PRINTFORMW 专心悬挂标语的%CALLNAME:ARG%无意中露出了内衣、春光乍泄的一幕正好被%CALLNAME:MASTER%看见了……
PRINTFORMW 「……先に始めちゃいますか？」	PRINTFORMW 「……要先开始吗？」
PRINTFORMW %CALLNAME:ARG%は%CALLNAME:MASTER%の腕を取り、%TOFULL(CONDS("バストカップ", ARG) )%カップの%TALENT_NAME(GETNUM(TALENT, "巨乳"), TALENT:ARG:巨乳)%で挟んできた……	PRINTFORMW %CALLNAME:ARG%伸手握住%CALLNAME:MASTER%的手臂、用%TOFULL(CONDS("バストカップ", ARG) )%カップ的%TALENT_NAME(GETNUM(TALENT, "巨乳"), TALENT:ARG:巨乳)%紧紧裹了起来……
PRINTFORMW 「いま戻りましたー」	PRINTFORMW 「我回来了」
PRINTFORMW 「%CNAMET(ARG, "一人称")%が居なくて寂しかったりしませんでしたか？フフ♪」	PRINTFORMW 「不在家的时候%CNAMET(ARG, "一人称")%寂寞了吗？呼呼♪」
PRINTFORMW 「%CNAMET(ARG, "二人称")%、%TEXTR("お疲れさま/今日も一日ご苦労さま")%でした」	PRINTFORMW 「%CNAMET(ARG, "二人称")%、%TEXTR("お疲れさま/今日も一日ご苦労さま")%でした」
PRINTFORMW ……何故か下着姿で。	PRINTFORMW ……为什么下半身只穿着内裤。
PRINTFORMW 「今週も終わりですしね。頑張った%CNAMET(ARG, "二人称")%へのささやかなサービスってやつですよ」	PRINTFORMW 「这周终于结束了呢。稍稍给你一点%CNAMET(ARG, "二人称")%的杀必死服务哟~」
PRINTFORMW 「フフ♪」	PRINTFORMW 「呼呼♪」
PRINTFORMW 「今日は汗かきましたねぇ……ほら、凄い事になってますよ」	PRINTFORMW 「今天出汗了呢……你看、真是了不得的程度啊」
PRINTFORMW %CALLNAME:ARG%は自然な動作で股間の前に膝をつき、%CALLNAME:MASTER%のペニスを取り出した。	PRINTFORMW %CALLNAME:ARG%很自然地跪到了%CALLNAME:MASTER%面前、把%CALLNAME:MASTER%的阴茎取了出来。
PRINTFORMW 「フフフ、これこれ。このペニスを取り出し\@ COND("仮性包茎", MASTER) ? て皮を剥い # \@た瞬間の%TEXTR("匂い")%が好きなんですよ」	PRINTFORMW 「呼呼呼、啊啦啊啦。取出这个\@ COND("仮性包茎", MASTER) ? て皮を剥い # \@的瞬間%TEXTR("匂い")%好惊人哦」
PRINTFORMW 「……なんですか、変な顔して」	PRINTFORMW 「……怎么了嘛、一副奇怪的表情」
PRINTFORMW 「%CNAMET(ARG, "二人称")%だって女性のアソコを押し開いた時の%TEXTR("匂い")%とか、少し嗅ぎたくなるんじゃないですか？」	PRINTFORMW 「%CNAMET(ARG, "二人称")%之类的女性、双腿被打开的时候%TEXTR("匂い")%之类的、你不也是有点想闻闻看嘛」
CALL PRINT_STR, "「…臭いだけですって？まったく、素直じゃないんですから。そんな人は……こうです_H_」_W"	CALL PRINT_STR, "「……阴茎单纯只有臭味吗？真是的、真是个不坦率的孩子呢。别扭的家伙……就要这様_H_」_W"
PRINTFORMW %CALLNAME:ARG%はペニス\@ COND("仮性包茎", MASTER) ? の皮をグッと引き下ろし # の先端を舌先でほじり \@、口に咥えて\@ COND("体育") ? 昼の体育で # 一日の間に \@蓄積された汚れをお掃除してきた……	PRINTFORMW %CALLNAME:ARG%伸出软滑的舌头把\@ COND("仮性包茎", MASTER) ? 的外皮退下 # 的前端包住 \@、用口叼住\@ COND("体育") ? 在昼の体育上 # 一日の間に \@蓄積的脏东西掃除干净……
PRINTFORMW 「今日も一日大変でしたね。頑張りすぎちゃ駄目ですよ？」	PRINTFORMW 「今天一天也很辛苦呢。不要拼命过头了哦」
PRINTFORMW 「ご飯出来てますけど、先にお茶にしましょうか」	PRINTFORMW 「饭做好了、先来喝茶吧」
PRINTFORMW 「ほらほら、そのまま寛ぐと皺が出来ちゃいますよ」	PRINTFORMW 「啊啦啊啦、就这様随便放着的话衣服会起皱褶的」
PRINTFORMW %CALLNAME:ARG%は%CALLNAME:MASTER%の後ろに回って上着を脱ぐのを手伝ってくれた	PRINTFORMW %CALLNAME:ARG%把%CALLNAME:MASTER%随手一扔的衣服好好挂了起来。
PRINTFORMW 「喉が渇いてませんか？お茶淹れてありますよ」	PRINTFORMW 「口渴了吗？茶已经沏好了」
PRINTFORMW 「お茶入ってますから、手洗いとうがいをなさって来てください」	PRINTFORMW 「我正在泡茶、先去洗把脸吧。」
PRINTFORMW 「%CNAMET(ARG, "対象")%と一緒でしたか。何か面白いお話とかありました？」	PRINTFORMW 「%CNAMET(ARG, "対象")%一起吗。有什么有趣的事情吗？」
PRINTFORMW 「来るのが遅いから心配してましたよ……ほっとしました」	PRINTFORMW 「还以为要迟到了……呼（松了一口气)……」
PRINTFORMW 「あら。重役出勤でしたね、%CNAMET(ARG, "二人称")%♪」	PRINTFORMW 「啊啦、%CNAMET(ARG, "二人称")%今天可有得忙了♪」
PRINTFORMW 「%CNAMET(ARG, "二人称")%ったら、何処に寄り道してらしたんですか？」	PRINTFORMW 「%CNAMET(ARG, "二人称")%呀、到底是从哪条近道传过来的啊」
CALL PRINT_STR, "「失礼します……フフ_H_」_W_"	CALL PRINT_STR, "「打扰了……呼呼_H_」_W_"
PRINTFORMW %CALLNAME:ARG%は口説いてる最中の%CALLNAME:MASTER%に微笑んだ。	PRINTFORMW %CALLNAME:ARG%对着正说教到一半的%CALLNAME:MASTER%送去一个微笑。
PRINTFORMW 「失礼します…………もしかして、本当に失礼しちゃいました？」	PRINTFORMW 「打扰了…………啊啦啊啦、看来是真的打扰了呢」
PRINTFORMW 「ああいえ、どうぞどうぞ、%CNAMET(ARG, "一人称")%の事なぞ気にせずに」	PRINTFORMW 「啊呀、继续继续、还请不要在意%CNAMET(ARG, "一人称")%」
PRINTFORMW 「すいません、遅れました……って」	PRINTFORMW 「对不起、我迟到了……」
PRINTFORMW 「なに、やってるんですか？%CNAMET(ARG, "二人称")%」	PRINTFORMW 「啊啦、在干什么呢？%CNAMET(ARG, "二人称")%」
PRINTFORMW 「ほーんと、えっちなんですから！」	PRINTFORMW 「真是的、太色情了！」
PRINTFORMW 「すいません、遅れました……すぐお茶の用意をしますね」	PRINTFORMW 「对不起、我迟到了……马上为您准备茶水」
CALL SETFLAG_DAILY, "お茶"	CALL SETFLAG_DAILY, "请喝茶"
PRINTFORMW 「おはようございまーす」	PRINTFORMW 「早上好」
PRINTFORMW 『あ、%CNAMET(ARG, CSVNAME_ACTOR)%。お疲れ様です』	PRINTFORMW 『啊、%CNAMET(ARG, CSVNAME_ACTOR)%。辛苦了』
PRINTFORMW 『おはようございます、%CNAMET(ARG, CSVNAME_ACTOR)%』	PRINTFORMW 『早上好、%CNAMET(ARG, CSVNAME_ACTOR)%』
PRINTFORMW 『はい、おはようございます』	PRINTFORMW 『啊啦、早上好』
PRINTFORMW 「む～～……」	PRINTFORMW 「唔嗯嗯嗯嗯（〃｀ 3′〃）～～……」
PRINTFORMW 「いえ。なんでもございません」	PRINTFORMW 「不。没什么╭(╯^╰)╮」
PRINTFORMW 少しだけ不満を表した%CALLNAME:ARG%だったが、特に引き留めたりはしなかった	PRINTFORMW 稍稍透露着不满表情的%CALLNAME:ARG%、没有引起别人的注意……
PRINTFORMW 「あら。%CNAMET(ARG, "対象")%との用事がおありでしたか……後片付けは%CNAMET(ARG, "一人称")%がしておきますね」	PRINTFORMW 「啊。%CNAMET(ARG, "対象")%已经做过了吗……后面收尾的活让%CNAMET(ARG, "一人称")%来做好了」
PRINTFORMW 「どうぞ楽しんできてください」	PRINTFORMW 「请继续享受快乐时光吧~」
PRINTFORMW %CALLNAME:ARG%は少しだけ寂しそうに%CALLNAME:MASTER%を見送った	PRINTFORMW %CALLNAME:ARG%透露出少许寂寞的表情、目送着%CALLNAME:MASTER%离去
PRINTFORMW 「一緒にお弁当食べるのって楽しいですね……あら？」	PRINTFORMW 「一起吃便当真开心呢……哎呀？」
PRINTFORMW 「ご飯粒ついてますよ、%CNAMET(ARG, "二人称")%」	PRINTFORMW 「饭粒沾到脸上咯、%CNAMET(ARG, "二人称")%」
PRINTFORMW %CALLNAME:ARG%は%CALLNAME:MASTER%の%TEXTR("唇/頬")%に付いたご飯粒を手で摘み上げた。	PRINTFORMW %CALLNAME:ARG%伸手把%CALLNAME:MASTER%の%TEXTR("唇/脸颊")%上的饭粒摘了下来。
PRINTFORMW 「こういうの良いですよね。なんか、普通の仲の良い友達みたいです」	PRINTFORMW 「这様真好哟。总觉得、像是关系很好的正常人类朋友一様」
PRINTFORMW 「……ん？友達はお弁当作ったりまではしないですかね？どう思います？」	PRINTFORMW 「……嗯？正常朋友才不会给对方做便当吗？那你怎么看？」
PRINTFORMW 「はい、%CNAMET(ARG, "二人称")%あ～～～ん♪」	PRINTFORMW 「来、%CNAMET(ARG, "二人称")%、啊～～～ん♪」
PRINTFORML 「パクッ」	PRINTFORML 「啊~（张嘴」
PRINTFORMW %CALLNAME:ARG%は%CALLNAME:MASTER%が口を開くと、箸をＵターンさせて自分の口に運んで食べてしまった！	PRINTFORMW %CALLNAME:ARG%送往%CALLNAME:MASTER%嘴中的筷子、突然掉了个头自己一口吃掉了！
PRINTFORMW 「フフっ……フフフ、冗談ですよ、そんな拗ねた顔なさらないでください♪」	PRINTFORMW 「啊嗯啊嗯……呼呼呼~、开个玩笑而已嘛、不要摆出那様别扭的表情♪」
PRINTFORMW 「どうですか？その%TEXTR("ほうれん草/小松菜/蕪の葉っぱ")%のおひたし」	PRINTFORMW 「味道怎么様？这道凉拌%TEXTR("菠菜/小油菜/芜菁叶")%」
PRINTFORMW 「根元のじゃぎじゃぎした食感とか、我ながらとても良い出来栄えだと思うのですが」	PRINTFORMW 「这种清脆的口感、连我自己都觉得做得很不错哦」
PRINTFORML 「只今より%CNAME("一人称")%達の共同生活が始まる訳ですね。フフ」	PRINTFORML 「从今天起、和%CNAME("一人称")%在一起的共同生活开始了哦。呼呼~」
PRINTFORML %CALLNAME:TARGET%は%CALLNAME:MASTER%のベッドに腰かけて、猫のように目を細めた	PRINTFORML %CALLNAME:TARGET%坐在%CALLNAME:MASTER%的床上、像偷到了鱼儿的猫一様笑眯眯的
PRINTFORML 「%CNAME("二人称")%暇そうですねぇ」	PRINTFORML 「%CNAME("二人称")%看起来很闲呢」
PRINTFORML 「……もしですけれど、体力が余ってるなら肩揉んで頂けませんか？最近どうも凝っちゃって困ってるんです」	PRINTFORML 「……虽然有点冒昧、可以帮我按摩肩膀吗？最近总觉得肩膀有点僵硬、让我很困扰呢」
PRINTFORML 「何って……フフ。%CNAME("一人称")%の、"アレ"のチェックですよ♪」	PRINTFORML 「要做什么？……呼呼呼~。%CNAME("一人称")%的"那个"的检查哟♪」
PRINTFORML 「%CNAME("二人称")%、そういえば……今日はまだですよねぇ」	PRINTFORML 「%CNAME("二人称")%说起来……今天时间还有很多呢」
PRINTFORML 「何って……フフ。%CNAME("一人称")%の、"アソコ"のチェックですよ♪」	PRINTFORML 「要做什么？……呼呼呼~。%CNAME("一人称")%的"那·个·呢"的检查哟♪」
PRINTFORML 「暇ですね……良かったら、%CNAME("一人称")%と遊びませんか？」	PRINTFORML 「好闲呢……如果可以的话、能和%CNAME("一人称")%一起玩吗？」
PRINTFORML 「%CNAME("二人称")%も一緒にどうですか？たまにすると良いものですよ」	PRINTFORML 「%CNAME("二人称")%一起来怎様？偶尔做一下对身体比较好哦」
PRINTFORML 体操服姿の%CALLNAME:TARGET%は、ベッドの上で柔軟体操をしている	PRINTFORML 身着体操服的%CALLNAME:TARGET%在床上做着柔软体操
PRINTFORML 「ん？体操着のままなのが気になりますか？」	PRINTFORML 「嗯？在意为什么是穿着体操服的様子吗？」
PRINTFORML 「いいじゃないですか。お好きでしょう？こういう格好」	PRINTFORML 「不是很好吗？你喜欢对吧？这様的打扮」
PRINTFORML 運動直後の%CALLNAME:TARGET%からは爽やかなかきたての汗の%TEXTS("匂い")%が漂っている……	PRINTFORML 运动了一会后、%CALLNAME:TARGET%的汗水从头发上洒了下来、空气中漂浮着%TEXTS("匂い")%的味道……
PRINTFORML 「う～ん……ちょっと疲れちゃいました」	PRINTFORML 「嗯……有点累了」
PRINTFORML %CALLNAME:TARGET%は頭の後ろで腕を組み、瑞々しい腋を披露しながら身体を捻って筋を伸ばしている	PRINTFORML %CALLNAME:TARGET%双手抱在头后露出娇嫩的腋下、一边扭动着身体、伸展着肌肉。
PRINTFORML 「ふぅ。汗かいちゃいました」	PRINTFORML 「呜。汗水流出来了」
PRINTFORML 「……もしかして臭いますか、%CNAME("一人称")%？」	PRINTFORML 「……不会有臭味吧、%CNAME("一人称")%？」
PRINTFORML %CALLNAME:TARGET%は肩口の%TEXTS("匂い")%をクンクンと嗅いだ	PRINTFORML %CALLNAME:TARGET%凑向领口嗅了嗅、%TEXTS("匂い")%
PRINTFORML 「いっちにっ、さんっ、しっ…………」	PRINTFORML 「一、二、三…………」
PRINTFORML %CALLNAME:TARGET%は軽く体を動かして眠気を飛ばそうとしている	PRINTFORML %CALLNAME:TARGET%想要轻轻地活动身体驱散睡意。
PRINTFORML %CALLNAME:TARGET%は、まだ眠そうだ……口数少なく動きが鈍い	PRINTFORML %CALLNAME:TARGET%看起来很困的様子……声音逐渐低沉了下去。
PRINTFORML 「う～～ん……結構、よく寝ましたね」	PRINTFORML 「唔～～嗯………睡得真好啊」
PRINTFORML %CALLNAME:TARGET%は気持ちよさそうに伸びをしている	PRINTFORML %CALLNAME:TARGET%心情舒畅地伸了个懒腰。
PRINTFORML 「はぁー……%CNAME("一人称")%が、%CNAME("二人称")%と……」	PRINTFORML 「啊啊啊……%CNAME("一人称")%、以及%CNAME("二人称")%……」
CALL PRINT_STR, "「フフっ_H_ 好きな人から愛してるって言われるのって……最高ですねぇ_H_」_L"	CALL PRINT_STR, "「呼呼呼_H_被喜欢的人说我爱你……最棒了_H_」_L"
PRINTFORML %CALLNAME:TARGET%は今まで見た中で一番幸せそうな表情で、ニコニコしながら身悶えしている……	PRINTFORML %CALLNAME:TARGET%展露出至今为止从未见过的幸福表情、身子都激动得微微颤抖…………
PRINTFORML 「ふぅ。これで暫くはノルマを気にせずに暮らせそうです」	PRINTFORML 「呼。这様的话就可以暂且不介意工作指标一起生活了」
PRINTFORML おどける%CALLNAME:TARGET%だが、ノルマなんて本当にあるのだろうか？	PRINTFORML 说起来%CALLNAME:TARGET%、真的有工作指标这种说法吗？
PRINTFORML 「しかしリザレクションとは凄いものですね……本当に何ともないのですか？」	PRINTFORML 「复活技能真的好厉害啊……身体真的没什么问题吗？」
PRINTFORML 「常人なら徐々に衰弱が起きてもおかしくないんですけどねぇ」	PRINTFORML 「如果是普通人的话、渐渐变得衰弱下去也不奇怪。」
PRINTFORML 「良い取引をなさいましたね……フフ♪」	PRINTFORML 「我们做了很好的交易呢……呼呼♪」
PRINTFORML %CALLNAME:TARGET%は魂を集めることが出来て上機嫌な様子だ	PRINTFORML %CALLNAME:TARGET%欣赏着收集到的灵魂、看起来很开心的様子。
PRINTFORML 「色々と買ってきましたね」	PRINTFORML 「买了很多东西呢」
PRINTFORML 「これなんか、凄い大きいですけど……いつか入るようになるんでしょうか。どう思います？」	PRINTFORML 「这个什么啊、好大一根……什么时候才有用到的机会呢？你在打什么坏主意呢？」
PRINTFORML 「お疲れさまでした、%CNAME("二人称")%」	PRINTFORML 「辛苦了呢、%CNAME("二人称")%」
PRINTFORML 「しかしこれ……凄い大きいですけど、いつか入るようになるんでしょうか。どう思います？」	PRINTFORML 「但是这个……也太大了！什么时候才能塞进去？你在想什么呢？」
PRINTFORML %CALLNAME:TARGET%は戦利品を開封して吟味している%CALLNAME:MASTER%に後ろから抱きつき、頬をくっつけてきた	PRINTFORML %CALLNAME:TARGET%看着战利品、玩味着从背后抱住%CALLNAME:MASTER%、羞红的脸颊蹭了过去。
PRINTFORML 「お買い物お疲れ様です、%CNAME("二人称")%」	PRINTFORML 「您购物辛苦了、%CNAME("二人称")%」
PRINTFORML 「それにしても……いろいろ買ってきましたねぇ」	PRINTFORML 「话说回来……买了很多东西呢」
PRINTFORML 「ふぅ。一仕事終えた感じですね、%CNAME("二人称")%」	PRINTFORML 「呼。您工作结束了、%CNAME("二人称")%」
PRINTFORML 「あとは%CNAME("一人称")%にお任せを」	PRINTFORML 「之后的工作就交给%CNAME("一人称")%吧！」
PRINTFORML %CALLNAME:TARGET%はテキパキと紙袋の中身を仕分けして綺麗に収納していった	PRINTFORML %CALLNAME:TARGET%仿佛跳舞一様、优雅又迅速地将纸袋的内容分类放好。
PRINTFORML 「ねぇ%CNAME("二人称")%、これから……なにをなさるんですか？」	PRINTFORML 「呐、%CNAME("二人称")%、现在……你准备干什么呢？」
PRINTFORML 「先程の場所では出来なかった事をするって解釈で良いんですよね？」	PRINTFORML 「可以理解为是在刚才那个地方做不到的事情吧？」
PRINTFORML 「……フフフ♪」	PRINTFORML 「……呼呼呼♪」
PRINTFORML 「フフ…一杯可愛がってくださいね？」	PRINTFORML 「呼呼…真是可爱的様子呢」
PRINTFORML 「こういうの……ドキドキしますね♪」	PRINTFORML 「是要这様吗……好紧张呢♪」
PRINTFORML %CALLNAME:TARGET%は%CALLNAME:MASTER%のファスナーを口で器用に下ろし、飛び出してきた硬いものにキスをした	PRINTFORML %CALLNAME:TARGET%用嘴把%CALLNAME:MASTER%胯间的拉链打开、并亲了一口弹在脸上硬邦邦的肉棒。
PRINTFORML %CALLNAME:TARGET%は%CALLNAME:MASTER%の前に跪くと、腰を抱きしめるようにしてファスナーから飛び出す硬いものに口づけした。	PRINTFORML %CALLNAME:TARGET%跪在%CALLNAME:MASTER%面前、环抱住腰并笑吟吟地用脸蹭着硬邦邦的肉棒。
PRINTFORML 「あら%CNAME("二人称")%に%CNAME(CSVCALLNAME(NO:ASSI) )%、いらっしゃいませ」	PRINTFORML 「啊啦、%CNAME("二人称")%に%CNAME(CSVCALLNAME(NO:ASSI) )%、欢迎光临」
PRINTFORML 「どうかなさいました？」	PRINTFORML 「要来点什么？」
PRINTFORML 「あら%CNAME("二人称")%。どうかなさいました？」	PRINTFORML 「哦呀%CNAME("二人称")%。要来点什么？」
PRINTFORML 「%CNAME(CSVCALLNAME(NO:ASSI) )%、失礼しますね」	PRINTFORML 「%CNAME(CSVCALLNAME(NO:ASSI) )%、真是失礼了」
PRINTFORML %CALLNAME:TARGET%は%CALLNAME:MASTER%と%CALLNAME:ASSI%が腰を下ろしたのちに、二人の邪魔にならない場所に座った	PRINTFORML %CALLNAME:TARGET%在不妨碍%CALLNAME:MASTER%和%CALLNAME:ASSI%的旁边坐了下来。
PRINTFORML 「あ、あのですね%CNAME("二人称")%、さっきのはそういう事ではなく……いえ、えーと……うぅぅ」	PRINTFORML 「啊、那个、%CNAME("二人称")%刚才不是那様的……不、那个……呜呜呜」
PRINTFORML %CALLNAME:TARGET%は自らの行いを恥じて小さくなってしまっている……	PRINTFORML %CALLNAME:TARGET%对自己的行为感到羞耻、声音越来越小……
PRINTFORML 「%CNAME("二人称")%……見ましたね？」	PRINTFORML 「%CNAME("二人称")%……看见了吧？」
PRINTFORML 「とぼけたって駄目ですよ……だってほら、なんでそんなになってるんですか？」	PRINTFORML 「装糊涂也不行哟……你看、为什么会变成那様？」
PRINTFORML %CALLNAME:TARGET%は%CALLNAME:MASTER%の股間を指さしてくすくす笑っている	PRINTFORML %CALLNAME:TARGET%指着%CALLNAME:MASTER%的股间窃笑道。
PRINTFORML 「どうしました？なにか良いものでも見えましたか？」	PRINTFORML 「怎么了？看到什么好东西了吗？」
PRINTFORML %CALLNAME:TARGET%は少しだけ頬を染め、楽しそうに微笑んでいる	PRINTFORML %CALLNAME:TARGET%面色微红、开心地微笑着。
PRINTFORML 「%CNAME("二人称")%、もしかして……見えちゃいました？」	PRINTFORML 「%CNAME("二人称")%、难道说……看到了吗？」
PRINTFORML %CALLNAME:MASTER%の視線に気づいた%CALLNAME:TARGET%は、頬を染めて遅まきながら手でガードをした	PRINTFORML 注意到%CALLNAME:MASTER%的视线、%CALLNAME:TARGET%一下子红了脸、伸手护住春光。
PRINTFORML 「もう……いけませんよ？女の子のスカートの中を無断で覗いたりしては」	PRINTFORML 「真是的……不可以哟？擅自窥视女孩子的裙底」
PRINTFORML 「%CNAME("二人称")%って、本当にパンツがお好きですよねぇ」	PRINTFORML 「%CNAME("二人称")%、真的是很喜欢内裤呢」
PRINTFORML 口では呆れを滲ませている%CALLNAME:TARGET%だが、表情は楽しそうだ……怒ってはいないらしい	PRINTFORML 虽然震惊得合不拢嘴、但是%CALLNAME:TARGET%表情看起来很开心……？似乎没有生气。
PRINTFORML 「Ｈの最中でもないのに、こんな格好で居るなんて……フフ」	PRINTFORML 「明明不是在H的时候、居然打扮成这様……呼」
;PRINTFORMW 「2018年era悪魔メイドProject始動より早くも一年」	;PRINTFORMW 「2018年era恶魔女仆Project比预计早完成了一年」
;PRINTFORMW 「当バリアントをご愛顧いただき誠にありがとうございます」	;PRINTFORMW 「承蒙阁下照顾、真的非常感谢您的支持」
;PRINTFORMW 「ですが……とても残念なお知らせをせねばなりません」	;PRINTFORMW 「但是……有个非常遗憾的消息必须要告诉您」」
;PRINTFORMW 「本日を持ちましてera悪魔メイドは終了。今日よりこのバリアントタイトはera笑ってはいけない悪魔メイドに変更されました」	;PRINTFORMW 「今天起era恶魔女仆结束了、从今天起将变成更加不苟言笑的era冷眼恶魔女仆」
PRINTFORML 「今年も一年が終わろうとしていますが、心残りはありませんか？　ご主人様」	PRINTFORML 「今年一年就要过去了、有没有遗憾呢？主人」
PRINTFORMW 「コタツと合体して過ごすのもいいですが……よいしょ」	PRINTFORMW 「和被炉合体、虚度光阴的感觉不错呢……对吧」
PRINTFORMW 「今日という日は二度と来ない特別な一日だという事を忘れない様にしたいものですね」	PRINTFORMW 「希望不要忘记、今天是不会再有的特别的一天」
PRINTFORML 「六華さんが神社の方で何やらやっておられる模様です」	PRINTFORML 「六华小姐好像在神社里做什么」
PRINTFORMW 「後で見に行ってあげてはどうでしょうか？」	PRINTFORMW 「待会去看看怎么様？」
PRINTFORMW 「新年明けましておめでとうございます」	PRINTFORMW 「新年到了、新年快乐」
PRINTFORMW 「今年も宜しくお願い致しますね、ご主人様」	PRINTFORMW 「今年也请多多关照、主人」
PRINTFORMW 「早速ですが、姫初めでも構いませんよ？フフフ」	PRINTFORMW 「恕我冒昧、虽然新的一年该吃年初饭、但是年轻人更想做爱对吧？呼呼呼」
PRINTFORML 「そうそう」	PRINTFORML 「对了对了」
PRINTFORML 「ローションとコンドームの所持数には気を配った方が良いと思いますよ」	PRINTFORML 「最好注意调教消耗道具的携带数量」
PRINTFORML 「お互い気持ちよくエッチしたいですしね。フフフ」	PRINTFORML 「我们都想要更加心情舒畅地H呢。呼呼呼」
PRINTFORML 「本当に悪魔なのか、ですって？」	PRINTFORML 「真的是恶魔吗？是不是这様想」
PRINTFORML 「はい。そうですよ。%CNAME("一人称")%の主食はあなたみたいな人の魂なんです」	PRINTFORML 「是的、没错。%CNAME("一人称")%的主食就是你这様的人的灵魂呢」
PRINTFORML 「そういえば%CNAME("二人称")%……%TEXTS("助手の名称")%を有効活用されてますか？」	PRINTFORML 「说起来%CNAME("二人称")%……%TEXTS("助手の名称")%有在好好干活吗？」
PRINTFORML 「例えばですが、%CNAME("一人称")%が%TEXTS("助手の名称")%ならばエッチの際に使った消耗品が自動で補充されますよ」	PRINTFORML 「比如说、%CNAME("一人称")%が%TEXTS("助手の名称")%进行H时会自动补充消耗品」
PRINTFORML 「おやすみ？……ああ、%CNAME("一人称")%の休暇ですか」	PRINTFORML 「晚安？……啊啊、%CNAME("一人称")%闲下来了吗」
PRINTFORML 「別に無くても良いですけど、そうですねぇ」	PRINTFORML 「虽然没有做也没关系、但是啊」
PRINTFORML 「日曜日の朝だけはゆっくり寝させてもらうとしましょうか」	PRINTFORML 「休息时间只有在星期天的早上睡懒觉、其他时候还请尽情地使唤我」
PRINTFORML 「すやすや……」	PRINTFORML 「咻~咻~……」
PRINTFORML 「ぅう～～ん…………ﾑﾆｬﾑﾆｬ」	PRINTFORML 「呜呜～～咻…………啊唔啊唔」
PRINTFORML 「ああ……そんな、ご無体な……」	PRINTFORML 「啊……这様子、好丢人……」
PRINTFORML 「うう……後生ですから、使ったお茶碗は軽く水で流して下さい……zzz」	PRINTFORML 「「呜呜……后来的、用过的茶碗自己冲洗……zzz」
PRINTFORML 「まったくしょうがないお人なんですから……zzz……」	PRINTFORML 「真是的、让人没办法的家伙……zzz……」
PRINTFORML 「zzz……今日のご飯……作らないと…………」	PRINTFORML 「zzz……今天的饭……不做的话……」
PRINTFORML 「ああ忙しい……忙しい…………」	PRINTFORML 「啊、好忙啊……好忙……zzz」
PRINTFORML 「%CNAME("二人称", "甘え")%…………フフフ」	PRINTFORML 「%CNAME("二人称", "甘え")%…………呼呼呼」
PRINTFORML 「%CNAME("二人称", "甘え")%……早く起きませんと……遅刻してしまいますよ……zzz」	PRINTFORML 「%CNAME("二人称", "甘え")%……不早点起床的话……要迟到了哦……zzz」
PRINTFORML 「%CNAME("二人称", "甘え")%……そろそろお休みにならないと……朝おつらいですよ……zzz」	PRINTFORML 「%CNAME("二人称", "甘え")%……差不多该休息了……早上好辛苦啊……zzz」
PRINTFORML 「あら……今日は……情熱的、ですねぇ……zzz……」	PRINTFORML 「哎呀……今天……很热情呢……zzz……」
PRINTFORML 「あの～……ご一緒しても、大丈夫でしょうか」	PRINTFORML 「那个~……一起走的话、也没关系吗？」
PRINTFORML 「あら%CNAME("二人称")%、良いところで出会いましたね♪」	PRINTFORML 「啊啦%CNAME("二人称")%、在不错的地方相见了呢♪」
PRINTFORML 「お暇そうですね。よかったら%CNAME("一人称")%に付き合って頂けませんか？」	PRINTFORML 「看起来很闲呢。如果可以的话、要不要和%CNAME("一人称")%交往看看啊？」
PRINTFORMW 「%CNAME("二人称")%、何か食べたいものとかおありでしたら籠に入れて下さって大丈夫ですよ」	PRINTFORMW 「%CNAME("二人称")%、有什么想吃的东西的话可以放进篮子里哦」
PRINTFORML 「えーとこれとこれとあれと…………何を作るのかって？」	PRINTFORML 「嗯、这个和那个…………问我在做什么？」
PRINTFORMW 「フフ、それは出来てからのお楽しみという事で♪」	PRINTFORMW 「呵呵、这就是出门的快乐之处哦♪」
PRINTFORMW 「今晩は何にいたしましょうねぇ。食べたいものとか有りますか？」	PRINTFORMW 「今晚您要点什么呢？有想吃的东西吗？」
PRINTFORMW 「えーとこれとそれとあれを、それぞれ100gづつお願いします。はい、ラッピングは大丈夫です」	PRINTFORMW 「嗯、这个和那个、各100克。是的、包起来就好」
PRINTFORML 「これって試飲できますか？ダメ？……ですよねぇ、高いですもんね。じゃあこっちは……」	PRINTFORML 「这个可以试饮吗？不行吗？……是啊、太贵了。那么这边的呢……」
PRINTFORMW %CALLNAME:TARGET%は手隙の店員を捕まえてあれこれ交渉しつつ楽しそうだ。	PRINTFORMW %CALLNAME:TARGET%抓住空闲的店员进行各种交涉、看起来很开心。
PRINTFORML 「ふむ……これはなかなか」	PRINTFORML 「嗯……这可真不错」
PRINTFORMW %CALLNAME:TARGET%は缶に入れられた乾燥状態の葉っぱの匂いを嗅いで吟味している。	PRINTFORMW %CALLNAME:TARGET%闻着罐子里干叶子的味道如此品论。
PRINTFORML 「……他の方からの視線が気になりますか？」	PRINTFORML 「……在意其他人的视线吗？」
PRINTFORMW 「フフ、大丈夫ですよ。もっと堂々としていてくださいな」	PRINTFORMW 「呵呵、没关系的。请堂堂正正地看吧」
PRINTFORMW 「う～ん、ちょっとＨ過ぎですかね……でもこういうの好きなんですよねぇ」	PRINTFORMW 「嗯、有点太H了吧……但是这様子也喜欢呢」
PRINTFORMW 「いかがです？こういうのとか、グッときますか？」	PRINTFORMW 「怎么様？这个様子、很让人心动吗？」
CALL PRINT_STRW, "「こういう日が、毎日続くと良いですよねぇ。フフ_H_」"	CALL PRINT_STRW, "「这様的日子、每一天都能继续这様生活就好了。呼呼_H_」"
PRINTFORMW 「ああ忙しい、忙しい……」	PRINTFORMW 「啊啊忙死了、忙死了……」
PRINTFORMW 「\@ COND("授業中") ? 他の方が授業を受けているというのに、 # いくらなんでも \@こんな場所でするなんて……フフ」	PRINTFORMW 「\@ COND("授業中") ? 明明其他人在上课、 # 不管怎么说 \@竟然在这様的地方……呼呼~」
PRINTFORMW 「ちょっと楽しいですね♪」	PRINTFORMW 「有点开心呢♪」
PRINTFORMW 「次の授業まで間もないですし、さっさと始めるといたしましょう」	PRINTFORMW 「离下一节课没多久、赶紧开始吧」
PRINTFORMW 「ほらほら、ゆっくりなさってないで……休み時間は15分しかないんですから」	PRINTFORMW 「你呀、别慢慢享受……休息时间只有15分钟！」
PRINTFORMW 「んんっ、熱いっ……フフ、いっぱい出ましたね……♪」	PRINTFORMW 「嗯、好烫……呵呵、出来这么多啊……♪」
PRINTFORMW 「って%CNAME("二人称")%！」	PRINTFORMW 「啊%CNAME("二人称")%！」
PRINTFORMW 「時間！もうギリギリですよ！！」	PRINTFORMW 「时间！快来不及了！！」
PRINTFORMW 「あら、もうおしまいですか？」	PRINTFORMW 「哎呀、已经结束了吗？」
PRINTFORMW 「……ここですると、後片付けが楽なのは良いですよね」	PRINTFORMW 「「……射在这里的话、待会收拾起来方便一点」
PRINTFORMW 「ちょっと%CNAME("二人称")%、見てくださいよこれ……凄い濃さ」	PRINTFORMW 「啊啦%CNAME("二人称")%、你看这个哟……非常浓厚呢」
PRINTFORMW 「授業中にブルマに染みが出来ちゃわないか、ちょっと……心配です…♪」	PRINTFORMW 「上课时会不会从运动短裤流出来呢、有点……担心呢……♪」
PRINTFORMW 「あーあー……全くもう。中に出しましたね？」	PRINTFORMW 「啊……真是的。全都射到里面了吧？」
PRINTFORMW 「つぎ水泳なのに」	PRINTFORMW 「一会可是游泳课呢」
PRINTFORMW 「ふぅ……満足していただけましたか？」	PRINTFORMW 「呼……满足了吗？」
PRINTFORMW 「えっ……お休みですか？」	PRINTFORMW 「诶……要去休息了吗？」
PRINTFORMW 「その、あのぉ……」	PRINTFORMW 「那个、那个……」
PRINTFORMW %CALLNAME:TARGET%は頬を火照らせつつ目を泳がせ、珍しく煮え切らない態度	PRINTFORMW %CALLNAME:TARGET%脸颊火热、双眼湿润、少见地露出犹豫不决的表情
PRINTFORML ……どうしますか？	PRINTFORML ……怎么办呢？
PRINTFORMW 「きゃっ……」	PRINTFORMW 「哎呀……」
PRINTFORMW 「あ、あはは……%CNAME("一人称")%とした事が、バレバレ、でしたよね」	PRINTFORMW 「啊、啊哈哈……%CNAME("一人称")%、完全暴露、了呢」
CALL PRINT_STR, @"「%CNAME("二人称")%、その……お、お手数をおかけします……_H_」_W"	CALL PRINT_STR, @"「%CNAME("二人称")%、、那个……嗯、麻烦您了……_H_」_W"
PRINTFORMW %CALLNAME:TARGET%ははしたなくねだってしまった自分を恥じつつ、覆い被さ	PRINTFORMW %CALLNAME:TARGET%因自己身体里难以抑制的高涨欲望而感到羞耻、用手捂住了脸。
PRINTFORMW 「あっ、はい」	PRINTFORMW 「啊、好的」
PRINTFORMW 「おやすみなさいませ、%CNAME("二人称")%……」	PRINTFORMW 「晚安、%CNAME("二人称")%……」
PRINTFORMW 「あら、今日はもうお休みですか」	PRINTFORMW 「哎呀、今天已经想休息了吗？」
PRINTFORMW 「じゃあ、お風呂にします？%CNAME("一人称")%がお背中流しますよ」	PRINTFORMW 「那么、要洗澡吗？%CNAME("一人称")%可以帮忙搓背哦」
PRINTFORMW 「……エッチな事は無し、ですからね？」	PRINTFORMW 「……不做H的事、是吧？」
PRINTFORMW そう言いながら微笑む%CALLNAME:TARGET%は脱衣場で裸になり、%CALLNAME:MASTER%と一緒にお風呂に入った。	PRINTFORMW 边说边笑着、%CALLNAME:TARGET%在更衣室里将衣服一件一件脱下、和%CALLNAME:MASTER%一起进入了浴室。
PRINTFORMW 「%CNAME("二人称")%ったら、お暇そうですねぇ～」	PRINTFORMW 「%CNAME("二人称")%的话、好像很闲呢~」
PRINTFORMW 「もしよかったらですけど、夕ご飯のおかずの味見でもします？」	PRINTFORMW 「如果可以的话、要不要提前尝尝晚饭？」
PRINTFORMW %CALLNAME:TARGET%は%CALLNAME:MASTER%の返事を聞くまでもなく小皿に料理を小量よそい、お茶と一緒に差し出してきた。	PRINTFORMW %CALLNAME:TARGET%在%CALLNAME:MASTER%回话之前、把用小盘装着的料理和茶水一起端了上来。
PRINTFORMW 「お疲れのようですね」	PRINTFORMW 「好像很累的様子。」
PRINTFORMW 「肩でも揉みましょうか？女の細腕で恐縮ですけど」	PRINTFORMW 「来按摩肩膀吧？虽然女孩子的手没什么力气」
PRINTFORMW 「あら。お茶切れてますね」	PRINTFORMW 「哎呀。茶没了」
PRINTFORMW 「%CNAME("二人称")%、はいどうぞ」	PRINTFORMW 「%CNAME("二人称")%、请稍等」
PRINTFORMW 「平和ですねぇ……」	PRINTFORMW 「平静的一天呢……」
PRINTFORMW 「ねぇねぇ%CNAME("二人称")%。もしよかったらですけど、次の講義の予習しません？」	PRINTFORMW 「呐呐%CNAME("二人称")%。闲着的话不预习下一节课吗？」
PRINTFORMW 「え？しないんですか？」	PRINTFORMW 「诶？不做吗？」
PRINTFORMW 「%CNAME("一人称")%は構いませんが、本当に？」	PRINTFORMW 「%CNAME("一人称")%的话没关系的、真的吗？」
PRINTFORMW 「……%CNAME("二人称")%。何か変なものを拾い食いしたりとか、なさいましたか？」	PRINTFORMW 「……%CNAME("二人称")%、您是捡了什么奇怪的东西吃了吗？」
CALL PRINT_STRW, @"『%TEXTR(@"本日のおやつは%CALLNAME:TARGET%さんの%TEXTS("おやつ")%です。楽しみですね/%CALLNAME:TARGET%さんの手作り%TEXTS("おやつ")%だそうですよ。今から楽しみですね")%_HH_』"	CALL PRINT_STRW, @"『%TEXTR(@"本日的点心是%CALLNAME:TARGET%の%TEXTS("おやつ")%です。很期待吧/是%CALLNAME:TARGET%亲手做的%TEXTS("おやつ")%哦。今天就好好期待吧")%_HH_』"
PRINTFORMW 「%TEXTR("今回は特別に良い茶葉も仕入れておきましたから、皆さんでお茶にしましょうか/ええ、今回のお菓子も期待に応えられる美味しさだと自負しておりますよ♪")%」	PRINTFORMW 「%TEXTR("这次还采购到了特別好的茶葉、大家一起喝茶吧/嗯、我很自豪这次的菓子也能满足期待的美味♪")%」
PRINTFORMW 「フフ。食べてくれる方がいると作り甲斐ありますね♪」	PRINTFORMW 「呼呼。如果有人吃那做起来也是有价值的呢♪」
PRINTFORMW 「飲み物は何にします？お茶ですか？それともジュースにしておきますか？」	PRINTFORMW 「要飲用什么？是茶吗？还是要juice？」
PRINTFORMW 「さてさて。それではお茶の時間といたしましょうか♪」	PRINTFORMW 「好了好了。那就现在是喝茶の時間♪」
PRINTFORMW 「ご主人様。取り分けますので、ちょっと手伝ってもらってもいいですか？」	PRINTFORMW 「ご主人様。我要分茶了、可以帮我一下吗？」
CALL PRINT_STRL, "「フフ。今日は早起きして、私の好きなティラミスを作ってみました_H_」"	CALL PRINT_STRL, "「呼呼。今天起得很早、那就试着做我喜欢的提拉米苏好了_H_」"
PRINTFORMW %CALLNAME:TARGET%は大きめに切り分けたティラミスに、茶こしでポンポンとココアパウダーを振っている。	PRINTFORMW %CALLNAME:TARGET%は在切成大块的提拉米苏上、用茶壶里装入可可粉砰砰地摇晃。
PRINTFORMW 「ご主人様、ラズベリーのソースかけます？」	PRINTFORMW 「ご主人様、要加木莓酱（红莓果酱）吗？」
PRINTFORML 「今日のおやつはナチュール・クレーム・カラメルにしました」	PRINTFORML 「今天的点心是ナチュール・クレーム・カラメル好了」
PRINTFORMW 「生クリームが欲しかったら仰ってください、材料は冷蔵庫に入ってますので」	PRINTFORMW 「如果想要鲜奶油的话请告诉我、材料放在（冰箱）冷蔵庫的里面」
PRINTFORML 「いろいろなフィリングをざっくり混ぜて焼いてみました」	PRINTFORML 「试着粗略的混合各种各样的现状来焼」
PRINTFORMW 「嫌いそうな部位に当たったら言ってくださいね、私のと交換してあげますから」	PRINTFORMW 「有焼的不喜欢的部位请说出来内、会给你换一个我的」
PRINTFORMW 「今回のチーズケーキはスポンジを台にして、上に砂糖、赤ワイン、ラズベリーを合わせて煮詰めたゼリーをかけてみました」	PRINTFORMW 「这次的起司蛋糕是以海绵为底座、上面铺砂糖、红（葡萄）酒、再加上用木莓煮透的果冻」
PRINTFORMW 「とりあえず何ピース食べます？」	PRINTFORMW 「总之先吃几块？」
PRINTFORMW 「ほんのり半生にしてみました。温かい烏龍茶でどうぞ」	PRINTFORMW 「试一下微微半生的。温热的烏龍茶请慢用」
PRINTFORMW 「上の白いのですか？これは、焼き目を付けたイタリアンメレンゲですね」	PRINTFORMW 「上面是白色的吗？这是、可以看得见的焼有烤痕的菜蛋白酥（我也不知道是什么，看着像奶油）内」
PRINTFORMW 「見た目ほどは甘くないと思いますよ……たぶんですけど」	PRINTFORMW 「感觉看起来不是那么甜……大概是这样」
PRINTFORMW 「本日は%TEXTS("おやつ")%を作ってみました……お口に合うと良いのですが」	PRINTFORMW 「本日试着做了%TEXTS("おやつ")%……希望和你的口味」

PRINTFORMW 「……今日は情熱的ですねぇ、%CNAME("二人称")%」	PRINTFORMW 「……今天很热情呢、%CNAME("二人称")%」
PRINTFORMW 「もう～……汗まみれなのに抱きついてこないでくださいよ」	PRINTFORMW 「真是的~……全是汗不要抱过来嘛」
PRINTFORMW 「まぁ、%CNAME("一人称")%もなのでお互い様なんですけどね。フフ」	PRINTFORMW 「嘛、虽然%CNAME("一人称")%也一様就是啦。呼呼」
PRINTFORMW %CALLNAME:TARGET%は薄く笑って%CALLNAME:MASTER%を抱きしめ返してきた	PRINTFORMW %CALLNAME:TARGET%轻笑着、反抱向%CALLNAME:MASTER%
PRINTFORMW 「仕方のないお人なんですから……ほら、じっとしててください。汗拭いてあげますから」	PRINTFORMW 「让人没办法的家伙……来、别动。我帮你擦汗」
PRINTFORMW %CALLNAME:TARGET%は%CALLNAME:MASTER%の身体をタオルでわしゃわしゃと拭いた	PRINTFORMW %CALLNAME:TARGET%用毛巾擦拭着%CALLNAME:MASTER%的身体

PRINTFORMW 「はい、%GREETING%」	PRINTFORMW 「是、%GREETING%」
PRINTFORMW 「……フフ♪%CNAME("二人称")%に先に挨拶されちゃいましたね」	PRINTFORMW 「……呼呼♪被%CNAME("二人称")%先打招呼了呢」

PRINTFORMW 「なかなか素敵な挨拶ですね。こういうの……結構好きですよ、%CNAME("一人称")%」	PRINTFORMW 「相当可爱的打招呼啊。这様子……相当喜欢哟、%CNAME("一人称")%」
PRINTFORMW %CALLNAME:TARGET%は頬を染め、%CALLNAME:MASTER%の頬にチュっとキスを返してきた。	PRINTFORMW %CALLNAME:TARGET%脸红着、在%CALLNAME:MASTER%的脸颊上吻了一下。
PRINTFORMW 「……もう一回、いいですよね？」	PRINTFORMW 「……再来一次、可以吗？」
PRINTFORMW %CALLNAME:TARGET%は我慢できなくなったのか、%CALLNAME:MASTER%の唇を奪ってきた……	PRINTFORMW 按捺不住的%CALLNAME:TARGET%、夺走了%CALLNAME:MASTER%的唇……
PRINTFORMW %CALLNAME:TARGET%は、にこにこ笑顔で再び挨拶を返してきた。	PRINTFORMW %CALLNAME:TARGET%看起来笑嘻嘻的、再次向你问候了一遍。
PRINTFORMW 「本当に節操のない%CNAME("二人称")%ですねぇ……♪」	PRINTFORMW 「真的是没有节操的%CNAME("二人称")%呢……♪」
PRINTFORMW 「挨拶とか言いながら、本当は%CNAME("一人称")%のココを舐めたいだけなんじゃないですか？」	PRINTFORMW 「说是要打招呼、其实只是想舔%CNAME("一人称")%的这里对吧？」
PRINTFORMW %CALLNAME:TARGET%は%CALLNAME:MASTER%を言葉責めしながら微笑んでいる……	PRINTFORMW %CALLNAME:TARGET%笑骂着%CALLNAME:MASTER%……
PRINTFORMW 「%CNAME("二人称")%……あの、流石にこういうのを挨拶にするのはどうかと思いますよ」	PRINTFORMW 「%CNAME("二人称")%…………那个、果然还是觉得要这様打招呼的话、该怎么说呢」
PRINTFORMW 「いくら何でも堕落しすぎかと」	PRINTFORMW 「无论如何都太堕落了」
PRINTFORMW %CALLNAME:TARGET%は挨拶を返すのも忘れて%CALLNAME:MASTER%を軽く諫めてきた。	PRINTFORMW %CALLNAME:TARGET%连回礼都忘记了的%CALLNAME:MASTER%轻轻谏言。
PRINTFORMW 「本当に節操のない%CNAME("二人称")%ですねぇ……」	PRINTFORMW 「%CNAME("二人称")%真的是没有节操呢……」
PRINTFORMW 「他の人に見られたら、どう言い繕うおつもりなんですか？」	PRINTFORMW 「如果被别人看见了、打算怎么掩饰过去呢？」
PRINTFORMW %CALLNAME:TARGET%は特に抵抗はしないものの、あまり乗り気ではない様子だ。	PRINTFORMW %CALLNAME:TARGET%虽然没有特别抵抗、但是好像不太感兴趣的様子。
PRINTFORMW %CALLNAME:TARGET%は、にこにこ笑顔で挨拶を返してきた。	PRINTFORMW %CALLNAME:TARGET%微笑着回应了问候。
PRINTFORMW パチ。	PRINTFORMW 啪琪。
PRINTFORMW 「……あれ？もしかして寝てました？%CNAME("一人称")%？」	PRINTFORMW 「……啊嘞？难道说睡着了吗？%CNAME("一人称")%？」
PRINTFORMW 「お、おはようございます……」	PRINTFORMW 「早、早上好……」
PRINTFORMW %CALLNAME:TARGET%はバツが悪そうにしながらも、手早く身なりを整えて%CALLNAME:MASTER%の傍に控えた	PRINTFORMW %CALLNAME:TARGET%好像状态不是很好的様子、迅速地整理了一下自己、走到%CALLNAME:MASTER%的身边待機
PRINTFORMW 「うぅ～ん……お願いします……あと少しだけ寝させてください……」	PRINTFORMW 「唔～嗯……拜托你了……让我再睡一小会……」
PRINTFORMW 「あ、今のは寝言、寝言でした……ぁふ」	PRINTFORMW 「啊、刚才的是梦话、梦话啊……哈啊～」
PRINTFORMW %CALLNAME:TARGET%は眠そうに目を擦り、小さな欠伸を一つした	PRINTFORMW %CALLNAME:TARGET%看上去很困地揉了揉眼、小小地打了个哈欠
PRINTFORMW 「はぃ？」	PRINTFORMW 「嗯？」
PRINTFORMW 「こ、これはお見苦しい所をお見せしました！」	PRINTFORMW 「让、让您见笑了！」
PRINTFORMW %CALLNAME:TARGET%は凄い勢いで跳ね起きた。	PRINTFORMW %CALLNAME:TARGET%用非常惊人的气勢站了起来。
PRINTFORMW 寝姿を%CALLNAME:MASTER%に晒してしまった事を恥じているようだ……	PRINTFORMW 好像被%CALLNAME:MASTER%看到睡颜非常害羞的様子……
PRINTFORMW 「あら、ありがとうございます」	PRINTFORMW 「啊啦、您过奖了」
PRINTFORMW 「……フフ。口に出して褒めて頂くのも良いものですねぇ」	PRINTFORMW 「……呼呼。从主人口中说出来的话就是让人受用呢」
PRINTFORMW 「気が合いますね。私も、我ながら良い出来だなと内心で自画自賛しておりました」	PRINTFORMW 「很合的来呢。我也是、连我自己的内心都在自画自賛自己做的很好」
CALL PRINT_STRW, "「どうです？ご主人様も、もう一人分行きますか？……フフフ_H_」"	CALL PRINT_STRW, "「怎么样？ご主人様也、还要再来一人份吗？……呼呼呼_H_」"
PRINTFORMW %CALLNAME:TARGET%は嬉しそうに微笑みつつ、自作の%TEXTS("おやつ")%を当たり前のようにおかわりした	PRINTFORMW %CALLNAME:TARGET%は开心地微笑着、将自己做の%TEXTS("おやつ")%理所当然的换了一份
PRINTFORMW 「フフ、お気に召しました？」	PRINTFORMW 「呼呼、你喜欢吗？」



PRINTFORMW 「…えっ？ はぁ……ありがとうございます？」	PRINTFORMW 「…诶？ 哈啊……非常感谢？」
PRINTFORMW %CALLNAME:TARGET%は何を褒められたのか分からず困惑した面持ちだが、とりあえず嬉しそうだ	PRINTFORMW %CALLNAME:TARGET%一脸不知道自己为什么会被表扬的困惑表情、不过总而言之还是挺高兴的
PRINTFORMW 「あらあら、お上手ですこと」	PRINTFORMW 「啊啦啊啦、嘴真甜啊」
PRINTFORMW %CALLNAME:TARGET%は%CALLNAME:MASTER%の賛辞に笑みを浮かべた	PRINTFORMW %CALLNAME:TARGET%因为%CALLNAME:MASTER%的賛辞而满脸开心
PRINTFORMW 「%CNAME("二人称", "どもり")%。あの、わ、……私も」	PRINTFORMW 「%CNAME("二人称", "どもり")%。那个、我、……我也」
CALL PRINT_STR, "「お慕いしてます……よ_HH_」_W"	CALL PRINT_STR, "「很喜欢你……呦_HH_」_W"
CALL PRINT_STR, "「フフ_H_ そんなこと言うと……本気にしちゃいますよ？」_W_"	CALL PRINT_STR, "「呼呼_H_ 说出这种话……我可是要当真的呦？」_W_"
PRINTFORMW %CALLNAME:TARGET%は%CALLNAME:MASTER%の口説き文句に満更でもない様子だ	PRINTFORMW %CALLNAME:TARGET%对%CALLNAME:MASTER%满口的甜言蜜语非常满意的様子
CALL PRINT_STR, "「嘘でも嬉しいですよ_HH_」_W_"	CALL PRINT_STR, "「就算是骗人的我也很高兴呦_HH_」_W_"
PRINTFORMW %CALLNAME:TARGET%は%CALLNAME:MASTER%の言葉を聞き流した風だが、少しだけ嬉しそうだ	PRINTFORMW %CALLNAME:TARGET%虽然没把%CALLNAME:MASTER%的话太当真、但是还是挺高兴的
PRINTFORMW 「は？パンツの色ですか？」	PRINTFORMW 「哈？内裤的颜色？」
PRINTFORMW 「今は%CLOCOLOR(CSTR:パンツ, "形容詞")%ものを穿いていますけど、それが何か」	PRINTFORMW 「现在穿着的是%CLOCOLOR(CSTR:パンツ, "形容詞")%、怎么了？」
PRINTFORMW 「…………秘密です」	PRINTFORMW 「…………保密」
PRINTFORMW 「好きなプレイ……ですか？」	PRINTFORMW 「喜欢的PLAY……吗？」
PRINTFORMW 「そうですねぇ、やっぱり%CNAME("二人称")%に御奉仕するのが好きですかねぇ、メイドですし」	PRINTFORMW 「这么说的话、果然还是比较喜欢奉仕%CNAME("二人称")%、毕竟是女仆嘛」
//PRINTFORMW ゴキッゴキゴキ……ボキボキ
PRINTFORMW 「……なんです、その顔」	PRINTFORMW 「……什么嘛、这个表情」
PRINTFORMW 「労わってくれてもいいんですよ？ほらほら、逃げないで下さいよ」	PRINTFORMW 「全部交给你也没有关系呦？过来过来、别想逃跑哦」
PRINTFORMW 「日々かいがいしく%CNAME("二人称")%のお世話してるんです、肩だって凝りますよ」	PRINTFORMW 「每天都忙着照顾%CNAME("二人称")%、肩膀都硬了」
PRINTFORMW 「よし……お掃除おしまいです」	PRINTFORMW 「好……掃除结束了」
PRINTFORMW 「お茶にしますけど、よかったら%CNAME("二人称")%も一緒にどうですか？」	PRINTFORMW 「刚刚泡好了茶、不介意的话%CNAME("二人称")%也要来一杯吗？」
PRINTFORMW 「片付けられない誰かさんのせいで毎日大変ですよ、まったく……」	PRINTFORMW 「不知道是因为哪个不会收拾的人、每天都这个样子、真是的……」
PRINTFORMW 「ん？ %CNAME("一人称")%の顔に何かついてます？」	PRINTFORMW 「嗯？ %CNAME("一人称")%的脸上沾了什么东西吗？」
PRINTFORMW 「……あ、もしかしてリップを新しくしたのに気づかれましたか」	PRINTFORMW 「……啊、难道说是注意到我新换的唇膏了吗」
PRINTFORMW 「思ったよりも目聡いんですねぇ……褒めてるんですよ？」	PRINTFORMW 「比想象中的更有观察力嘛……表扬你一顿也可以呦？」
PRINTFORMW 「最近空気が乾燥してますよねぇ……唇がカサカサになっちゃいそうです」	PRINTFORMW 「最近空気好乾燥啊……嘴唇都要变干了」
PRINTFORMW 「ああ忙しい忙しい……%CNAME("二人称")%すいません、ちょっとどいてください」	PRINTFORMW 「啊啊好忙啊好忙啊……不好意思、%CNAME("二人称")%稍微让开一点」
PRINTFORMW 「今日のご飯は%CNAME("一人称")%の好きなエンダイブとベーコンの温サラダですよー」	PRINTFORMW 「今天的飯是%CNAME("一人称")%喜欢的苦菊拌培根的温沙拉呦ー」

PRINTFORMW フェリシエルがクラスメイトと雑談している。	PRINTFORMW 弗理希艾尔和同班同学雑談着。
PRINTFORMW 『そういえばさーフェリシエルが最近部活に入ったのって本当？今までずっと帰宅部だったのに』	PRINTFORMW 『说起来弗理希艾尔最近加了个社团是真的吗？明明一直都是帰宅部的』
PRINTFORMW 「ええ、そうなんですよ。ちょっとしたきっかけで入部する事になっちゃいまして」	PRINTFORMW 「嗯、是有这回事。因为有点小的契机所以就入部了」
PRINTFORML 『あー実はアタシも気になってたそれ！	PRINTFORML 『啊——実际上我也有个很在意的事情！
PRINTFORMW 　部長？らしき人と結構一緒に居るよね……もしかして付き合ってたりぃ？』	PRINTFORMW 　部長？大概是看上去好像是那様的人住在一起的様子……难道是在一起交往吗？』
PRINTFORMW 「いえ、そんな事ないですよ。仲良くさせてはいただいていますけどね……フフ♪」	PRINTFORMW 「没有没有、没这回事啦。只是关系很好而已啦……呼呼♪」
PRINTFORMW 「それにしてもお好きですよねぇ、パンツ」	PRINTFORMW 「还真是痴迷呢、对内裤」
PRINTFORMW 「飽きたりとかしないんですか？」	PRINTFORMW 「真的不会腻吗？」
PRINTFORMW 「この続きは……あちらでしませんか？」	PRINTFORMW 「接下来是……那边吗？」
PRINTFORMW %CALLNAME:TARGET%は脇のベッドに視線を送った	PRINTFORMW %CALLNAME:TARGET%把視線投向旁边的床
PRINTFORMW 「あの～……まだ続けるんですか？」	PRINTFORMW 「那个～……还在再继续下去吗？」
PRINTFORMW 「ホント、%CNAME("二人称")%は良い趣味してますよねぇ」	PRINTFORMW 「真是的、%CNAME("二人称")%的兴趣未免也太……」
PRINTFORMW 「見る分には構いませんが、%TEXTS("匂い")%を嗅ぐのは程々にしておいてください」	PRINTFORMW 「只是看的话倒没什么关系、只要不到嗅%TEXTS("匂い")%的程度就行了」
PRINTFORMW 「……あまり良い香りがする場所でもありませんからね」	PRINTFORMW 「……毕竟也不是什么好闻的地方呐」
PRINTFORMW 「フフ。楽しんでおられますねぇ」	PRINTFORMW 「呼呼。看上去很享受的様子呢」
PRINTFORMW 「%CNAME("二人称")%って本当にこういう行為がお好きですよねぇ」	PRINTFORMW 「%CNAME("二人称")%真的是很喜欢干这种事呢」
PRINTFORMW 「……パンツが汚れてしまうので、満足したらやめてくださいね？」	PRINTFORMW 「……内裤会脏掉的、満足了的话就到这里吧？」
PRINTFORMW ロード直後のセリフ	PRINTFORMW 加载后的台词

//EVENT_K1_SHOP.ERB
PRINTFORMW 「もちろんいいですよ」	PRINTFORMW 「当然可以」
PRINTFORMW 「……ふぅ。やはり、この姿が落ち着きますね」	PRINTFORMW 「……呜嗯~果然、这个样子很让人平静呢」
PRINTFORMW 「う～ん…………まぁ、いいでしょう」	PRINTFORMW 「う～ん…………嘛ぁ、可以吧」
PRINTFORMW 「日常生活は、こっちの方が過ごしやすいかもしれないですしね」	PRINTFORMW 「在日常生活中，这边也许更容易生活呢」
PRINTFORMW 「魂の取引ですか？もちろん構いませんよ」	PRINTFORMW 「要进行魂的交易吗？当然可以呦」
PRINTFORMW 「本日は何がお望みですか？……フフ」	PRINTFORMW 「今天想要什么呢？……呼呼」
PRINTFORMW  魂一つを対価として、[%CSTR:肩書%]%NAME:TARGET%と取引をします。	PRINTFORMW  以一单位魂为代价、和[%CSTR:肩書%]%NAME:TARGET%做交易。
PRINTFORMW  魂一つを差し出して、 [%CSTR:肩書%]%NAME:TARGET%に願いを叶えて貰います。	PRINTFORMW  付出一单位魂、 由[%CSTR:肩書%]%NAME:TARGET%来实现愿望。
PRINTFORMW  [%CSTR:肩書%]%NAME:TARGET%にお願いをします。	PRINTFORMW  拜托[%CSTR:肩書%]%NAME:TARGET%。
PRINTFORMW ……要求次第で対価を払わなければならないかもしれません。	PRINTFORMW ……根据要求的不同可能会被要求某些支付代价也说不定。
PRINTFORMW 「んっ……魂の取引ですか？もちろん、……ふぅ、構いませんよ」	PRINTFORMW 「嗯……想做灵魂交易吗？当然、……呼、没关系哦」
CALL PRINT_STRW, "「本日はっ……ぁ、何がお望み、ですか？……フフ_H_」"	CALL PRINT_STRW, "「今天哈……啊、有什么愿望、吗？……呼呼_H_」"
PRINTFORMW 「あら。何か忘れものがありましたか」	PRINTFORMW 「啊啦。你忘了什么吗?」
PRINTFORMW 「フフ……本日は何がお望みですか？」	PRINTFORMW 「呼呼……你今天想要什么？」
PRINTFORMW 「魂の取引ですか？」	PRINTFORMW 「想做灵魂交易吗？？」
PRINTFORMW 「それは構いませんが今日はバレンタインですよ、ご主人様。誰かからチョコは貰えましたか？」	PRINTFORMW 「没关系，但今天是情人節哦、主人様。有人给你巧克力吗？」
CALL PRINT_SELECT, "もらえた/もらえてない"	CALL PRINT_SELECT, "收到了/没收到"
PRINTFORMW 「モテモテですね。じゃあ%CNAME("一人称")%からのチョコは無しです」	PRINTFORMW 「很受欢迎呢。这样%CNAME("一人称")%的巧克力就没有了」
PRINTFORMW 「……なーんて、嘘ですよ。はい、どうぞ」	PRINTFORMW 「……开个玩笑。是、请收下」
PRINTFORMW 「他の方と仲良くしてくださっても全然構いませんけど、%CNAME("一人称")%だってちょっぴりは嫉妬する時もあります」	PRINTFORMW 「您是否可以与其他人成为朋友并不重要、但是即使是%CNAME("一人称")%也会有点嫉妒」
PRINTFORMW 「%CNAME("主人")%へのそんな気持ちを込めて一生懸命作りましたから、味わって食べてくださいね♪」	PRINTFORMW 「这是我怀着对%CNAME("主人")%的感情努力做出来的、所以请尽情享受♪」
PRINTFORMW 「昨年まではお母様と妹さんから義理チョコを貰ってたんですか」	PRINTFORMW 「直到去年为止，您有没有从母亲和妹妹那里收到義理巧克力?」
PRINT 「フフ……じゃあ	PRINT 「呼呼……那
PRINTFORMW からのチョコは私が初めてですね♪」	PRINTFORMW 我的巧克力是第一个喔♪」
PRINTFORMW 「腕によりをかけて作りましたから、味わって食べてくださいね、ご主人様」	PRINTFORMW 「这是我亲手做的、所以请品尝品尝、主人様」
CALL PRINT_STRW, @"黄色_%CALLNAME:TARGET%から本命チョコレートを貰いました！"	CALL PRINT_STRW, @"黄色_从%CALLNAME:TARGET%收到本命巧克力！"
CALL SET_CDAYEV, "バレンタイン"	CALL SET_CDAYEV, "情人節"
PRINTFORMW 「魂の取引ですか？」	PRINTFORMW 「魂的交易吗？」
PRINTFORMW 「え、その前に%CNAME("一人称")%にバレンタインのお返しですか？」	PRINTFORMW 「诶、这是您给%CNAME("一人称")%情人節的回礼吗？」
;PRINTFORMW （悪いものでも食べたんでしょうか……変なモノを入れた覚えはないのですけど）	;PRINTFORMW （吃了不好的东西吗?……我记得我没有放任何奇怪的东西吧）
PRINTFORMW 「ありがとうございます。あとでご主人様に感謝しながらいただきますね♪」	PRINTFORMW 「谢谢啦。以后都会感謝主人様的♪」
CALL SET_CDAYEV, "ホワイトデー"	CALL SET_CDAYEV, "白色情人節"
PRINTFORMW 「いいですけど……あまり変な名前で呼ばせないで下さいよ？」	PRINTFORMW 「可以啊……但请不要改个奇怪的名字哦？」
PRINTFORMW 「それでは只今より、%CNAME("二人称")%とお呼びしますね」	PRINTFORMW 「那现在、我就这样叫%CNAME("二人称")%啦」
PRINTFORMW 「あら？今までと一緒で良いんですか」	PRINTFORMW 「啊啦？和以前一样好吗？」
PRINTFORMW 「魂を頂くのは%CNAME("二人称")%自身を頂くようなもの……フフ♪」	PRINTFORMW 「收到魂的时候就像收到%CNAME("二人称")%一样……呼呼♪」
PRINTFORMW 「言葉にされるずっとずっと前から、%CNAME("二人称")%のお気持ちは……伝わっておりましたよ」	PRINTFORMW 「很久之前、%CNAME("二人称")%的心意……已经传达到了喔」
PRINTFORMW 頬を紅潮させた%CALLNAME:TARGET%は目を細めて嬉しそうな笑顔を浮かべると、%CALLNAME:MASTER%に口付けをした。	PRINTFORMW 面色潮红的%CALLNAME:TARGET%眯着眼露出笑容、吻了%CALLNAME:MASTER%。
PRINTFORMW 「……フフ」	PRINTFORMW 「……呼呼」
CALL PRINT_STR, "「嘘でも嬉しいですよ_H_」_W"	CALL PRINT_STR, "「就算是谎言我也很开心喔_H_」_W"
PRINTFORMW 「申し訳ありませんが、今その願いを叶えるのは出来ないようです」	PRINTFORMW 「万分抱歉，我现在似乎无法实现这个愿望」
PRINTFORMW %CALLNAME:TARGET%はペコリと頭を下げ、恥ずかしそうに目を逸らした。	PRINTFORMW %CALLNAME:TARGET%低下头、眼神飘忽似乎有点害臊。
PRINTFORMW 「……パンツ欲しさに魂を差し出そうとする人なんて、初めて見ました」	PRINTFORMW 「……为了胖次而出卖魂的人、我还真是第一次见到呢」
PRINTFORMW 「でも%CNAME("一人称")%も悪魔ですからね。いいでしょう。その取引、乗りますよ」	PRINTFORMW 「但是%CNAME("一人称")%也是悪魔。 好的、这交易我接受了」
PRINTFORMW %CALLNAME:MASTER%の申し出に少し呆れた様子の%CALLNAME:TARGET%だったが、僅かな愉快さを滲ませつつ目の前でパンツを脱いで手渡ししてきた。	PRINTFORMW %CALLNAME:TARGET%似乎对%CALLNAME:MASTER%的请求感到有些惊讶,然后便愉快地在你面前脱下胖次並交到你手上。
PRINTFORMW 「さ、どうぞ」	PRINTFORMW 「撒、请慢用」
PRINTFORMW 「それはもう%CNAME("二人称")%の物です」	PRINTFORMW 「这已经是%CNAME("二人称")%的了」
CALL PRINT_STR, "「返せとは言いませんので嗅ぐなり舐めるなりオカズにするなり、どうぞお好きに……_H_」_W_"	CALL PRINT_STR, "「我不会收回来、所以无论你想嗅还是想舐都隨你喜欢吧……_H_」_W_"
CALL DAILY_MESSAGE, "パンツを脱いで手渡し"	CALL DAILY_MESSAGE, "脱下胖次交了出去"
PRINTFORMW 「どうぞ……汗臭くて申し訳ありませんが」	PRINTFORMW 「请慢用……有阵汗味真是十分抱歉」
PRINTFORMW 体育の直後という事もあり、%CALLNAME:TARGET%のパンツは絞ると水滴が落ちそうなほど湿っている……	PRINTFORMW 在体育课结束后，%CALLNAME:TARGET%的胖次湿得一扭就会流出水来……
PRINTFORMW 汗をかいた後だけあって%CALLNAME:TARGET%のパンツはじっとりと湿り、強めの臭いを発している……	PRINTFORMW 出了身汗后，%CALLNAME:TARGET%的胖次十分湿润、散发出强烈的体味……
PRINTFORMW %CALLNAME:TARGET%は一向にパンツを脱ごうとしない……	PRINTFORMW %CALLNAME:TARGET%没有将胖次脱掉……
PRINTFORMW 「ん？どうしました？」	PRINTFORMW 「嗯？怎么了？」
PRINTFORMW 「……解かないんですか、紐」	PRINTFORMW 「……解不开的、绳结」
PRINTFORMW 「せっかくの紐付きのパンツなんですから……%CNAME("二人称")%ご自身の手で、どうぞ？」	PRINTFORMW 「因為是绳结胖次……%CNAME("二人称")%亲手来吧、请？」
PRINTFORMW 「つまらないものですが、どうぞ」	PRINTFORMW 「虽然很无聊、但是请慢用」
PRINTFORMW 「使った後は洗濯籠に入れておいてくださいね」	PRINTFORMW 「使用後請放入洗衣籃」
PRINTFORMW 「フフ。こうやってパンツを目の前で脱がされるのって、ちょっと楽しいんですよね♪」	PRINTFORMW 「呼呼。像這樣在您面前脫下胖次有點有趣♪」
PRINTFORMW 「%CNAME("二人称")%が%CNAME("一人称")%のパンツと、その下から現れるアソコに集中しきってるのが手に取るように伝わってくるんですよ」	PRINTFORMW 「%CNAME("二人称")%拿着%CNAME("一人称")%的胖次、就这样专心看下面的阴部吧」
PRINTFORMW 「すいません。ちょっとここでは、そのぉ……」	PRINTFORMW 「抱歉。这个稍微有点……」
PRINTFORMW %CALLNAME:TARGET%は他の人達の事を気にしている……	PRINTFORMW %CALLNAME:TARGET%对于有其他人在这里的事十分在意……
PRINTFORMW 「%CNAME("二人称")%すみません。今はそんな気分じゃないです」	PRINTFORMW 「%CNAME("二人称")%对不起。我现在没有这种心情。」
PRINTFORMW 「…………はい」	PRINTFORMW 「…………是」
CALL PRINT_STRW, @"「いいですよ%CNAME("二人称")%……どうぞ、%CNAME("一人称")%の姿で楽しんでください……_H_」"	CALL PRINT_STRW, @"「没关系、%CNAME("二人称")%……请欣赏%CNAME("一人称")%的身体吧……_H_」"
PRINTFORMW 「フフ、そんなにお気に召しました？」	PRINTFORMW 「呼呼、我非常欣赏你的勇气哦？」
CALL EVENT_DATUI, "ハダカ"	CALL EVENT_DATUI, "裸体"
PRINTFORMW 「……いくら%CNAME("二人称")%のお願いでも、聞けるものとダメなものがあります」	PRINTFORMW 「……不管%CNAME("二人称")%要求多少次、答案都是不行哦」
PRINTFORMW 「あら？%CNAME("一人称")%の作ったおべんとが恋しくなっちゃいました？」	PRINTFORMW 「啊啦？很想念%CNAME("一人称")%做的便当？」
PRINTFORMW 「なーんて、フフフ♪」	PRINTFORMW 「开个玩笑、呼呼呼♪」
PRINTFORMW %CALLNAME:TARGET%は目を細めて嬉しそうに笑った	PRINTFORMW %CALLNAME:TARGET%眯起眼睛开心地笑
PRINTFORMW 「えっ……？あっはい、いいですよ」	PRINTFORMW 「嗯...？ 啊,好啊」
PRINTFORMW 「改まって何を言うかと思えば拍子抜け……ｺﾞﾎﾝ、っていうか今でも殆どのご飯は%CNAME("一人称")%が作ってあげてるじゃないですか♪」	PRINTFORMW 「如果你要我说的话……咳、我的意思是现在大部分的饭不就是%CNAME("一人称")%做的吗♪」
PRINTFORMW 「じゃあ、これからは朝夕ご飯を多めに作ってお弁当準備しますから、学園で一緒に食べましょうか」	PRINTFORMW 「好吧，从现在开始我在早餐做多些作便当，然后一起在学校里吃饭吧」
PRINTFORMW 「%CNAME("一人称")%、料理好きですし、一人分も二人分も大差ないですしね」	PRINTFORMW 「%CNAME("一人称")%喜欢做饭、一人份和二人份没有太大区别呢」
PRINTFORMW 「いや～……しかしあれですね、同級生で同じお弁当を食べるなんて」	PRINTFORMW 「不过～……像这样、跟同学一起吃便當」
CALL PRINT_STR, "「……ちょっと。楽しそうですね。……フフ_H_」_W"	CALL PRINT_STR, "「……听起来挺有趣呢。……呼呼_H_」_W"
PRINTFORMW 「あら。%CNAME("二人称")%ってばゴムよりもこちらの方が好みでしたか」	PRINTFORMW 「啊啦。%CNAME("二人称")%比起用避孕套更喜欢用这个吗？」
PRINTFORMW 「まぁ……そうですよねぇ、生でした方が気持ちいいですものね♪」	PRINTFORMW 「嘛……是呢、还是无套最舒服♪」
PRINTFORMW 「はい、いいですよ」	PRINTFORMW 「是、好啊」
PRINTFORMW 「もう飲まなくても良いんですか。本当に？」	PRINTFORMW 「不用饮了? 真的吗？」
PRINTFORMW 「ゴムをしっかり使って下さる……というわけでは、ないですよねぇ？」	PRINTFORMW 「要好好地使用避孕套……您不是想这样吧？」
PRINTFORMW 「……思ったよりも、何てこと無いみたいですね」	PRINTFORMW 「……似乎没有什么我想要的」
PRINTFORMW 「見ようによっては結構お洒落ですし」	PRINTFORMW 「选了个很棒的呢」
PRINTFORMW 「%CNAME("二人称")%もお好きですねぇ」	PRINTFORMW 「%CNAME("二人称")%选这个我不太喜欢」
PRINTFORMW 「……まぁ、%CNAME("一人称")%も嫌いではないですが」	PRINTFORMW 「……嘛、%CNAME("一人称")%也不讨厌就是」
PRINTFORMW 「いいですけど……悪戯したら怒りますからね？」	PRINTFORMW 「没关系……但如果您做恶作剧，我会生气喔」
PRINTFORMW %CALLNAME:TARGET%のお尻付近から、先端がスペード形の黒くてしなやかな尻尾がにゅっと生えた。	PRINTFORMW 从%CALLNAME:TARGET%的屁股上方长出黑色的，末端呈黑桃形的柔软尾巴。
PRINTFORMW 「一応もう一度言っておきますけど。あまり気安く触ったりしちゃ……ダメですからね？」	PRINTFORMW 「我再说一次。温柔地抚摸……不行喔？」
PRINTFORMW 「%CNAME("一人称")%の尻尾なんて、%CNAME("二人称")%にお見せするほどのものではないですよ」	PRINTFORMW 「%CNAME("一人称")%的尾巴、不能轻易地给%CNAME("二人称")%看呢」
PRINTFORMW %CALLNAME:TARGET%は恥ずかしそうに拒否した。	PRINTFORMW %CALLNAME:TARGET%有点害臊地拒绝了。
PRINTFORMW 「どうです？似合ってますか？」	PRINTFORMW 「怎样? 好看吗？」
PRINTFORMW 「はい、いいですよ」	PRINTFORMW 「是、可以啊」
PRINTFORMW 「と、言いたいところですが……%CNAME("二人称")%」	PRINTFORMW 「虽然我想这样说……%CNAME("二人称")%」
PRINTFORMW 「残念ながら、魂が足りないみたいです。１.01以上に回復された後に再びお願いしますね」	PRINTFORMW 「但是很可惜、魂似乎不够了。请回复到１.01以上再来吧」
PRINTFORMW 「お金は基本ですよねぇ」	PRINTFORMW 「金钱是基础呢」
PRINTFORMW %CALLNAME:TARGET%はウンウンと頷きながら錬金術を行使して現金の山を出した。	PRINTFORMW %CALLNAME:TARGET%念了会咒语並使用炼金术变了一座山般的现金出来。
PRINTFORMW 「なかなか渋い望みをお選びになりましたねぇ……」	PRINTFORMW 「选了个很棒的愿望呢……」
PRINTFORMW 「それでは、さっそく実践してみましょうか？」	PRINTFORMW 「这样的话、让我们马上实践好吗？」
PRINTFORMW 「ささ、%CNAME("一人称")%めに向けて愛を囁いてみてください♪」	PRINTFORMW 「撒撒、请%CNAME("一人称")%小声地向我求爱吧♪」
PRINTFORMW %CALLNAME:TARGET%は無邪気に微笑んでいる……	PRINTFORMW %CALLNAME:TARGET%無邪地微笑……
PRINTFORMW 「……え？特に変化がないですって？」	PRINTFORMW 「……诶？ 没有特别的变化？」
PRINTFORMW 「まぁ、容姿自体は変わってないですしねぇ……フフ」	PRINTFORMW 「好吧，外观本身并没有改变……呼呼」
PRINTFORMW %CALLNAME:TARGET%は意味ありげに微笑んでいる……	PRINTFORMW %CALLNAME:TARGET%露出了意有所指的微笑……
PRINTFORMW %CALLNAME:TARGET%は羊皮紙の束を手渡してきた。	PRINTFORMW %CALLNAME:TARGET%递了一束羊皮纸给你。
PRINTFORMW 「%CNAME("一人称")%もよくは知らないのですが、人を淫らな気分にする刺青の彫り方が記されてるようですよ」	PRINTFORMW 「%CNAME("一人称")%虽然不太清楚、不过似乎写了如何雕刻令人淫乱的纹身」
PRINTFORMW 「付箋によると、期間限定お試し版のシールの作り方も添えられているようですね」	PRINTFORMW 「在便笺上，似乎还附带了如何制作限时试用版的贴纸」
PRINTFORMW 「……妙に親切だなって？……フフフ♪」	PRINTFORMW 「……微妙地贴心？……呼呼呼♪」
CALL PRINT_STR, "「つまり、それだけ危険な代物って事ですよ……恐ろしいですねぇ_H_」_W"	CALL PRINT_STR, "「换句话说，这是一个危险的技能...太可怕了不是吗_H_」_W"
PRINTFORMW %CALLNAME:TARGET%は、またも羊皮紙の束を手渡してきた。	PRINTFORMW %CALLNAME:TARGET%递了一束羊皮纸给你。
PRINTFORMW 「この巻には女性にペニスを生やす能力……%CNAME("一人称")%達は[具現]と呼んでいますが、の習得法が書かれているようですよ」	PRINTFORMW 这卷记录了让女性长出阴茎的能力……%CNAME("一人称")%称它为[具現]、的学习方法」
PRINTFORMW 「しかし、%CNAME("二人称")%も物好きですねぇ……そんなに生やしたいものなのですか？」	PRINTFORMW 「但是、%CNAME("二人称")%喜欢……这么想长多些吗？」
PRINTFORMW %CALLNAME:TARGET%は、羊皮紙に目を通しだした%CALLNAME:PLAYER%の様子を眺めつつ小首を傾げた。	PRINTFORMW %CALLNAME:TARGET%歪着头,透过羊皮纸看着%CALLNAME:PLAYER%的様子。
PRINTFORML 「こうやって書物を手渡すのも３回目ですね」	PRINTFORML 「这是我第三次交给你呢」
PRINTFORMW %CALLNAME:TARGET%は、またまた羊皮紙の束を用意してきた。	PRINTFORMW %CALLNAME:TARGET%又又准备了一束羊皮纸。
PRINTFORMW 「%CNAME("二人称")%も研究能力はともかく、能力としては魔法使いの仲間入りをしたと言っていいと思われます」	PRINTFORMW 「%CNAME("二人称")%的研究能力无论怎样说、已经比得上魔法使了」
CALL PRINT_STRW, @"「……まぁ、%CNAME("二人称")%の事ですからＨな目的にしか使わないんでしょうけどね_H_」"	CALL PRINT_STRW, @"「……好吧、%CNAME("二人称")%的话只会用在Ｈ的目的呢_H_」"
PRINTFORMW 「はい、いいですけど……%CNAME("二人称")%は流石ですねぇ」	PRINTFORMW 「是、没关系……真是的%CNAME("二人称")%」
PRINTFORMW 「ご自身に具現の力を使った事も無いのにサイズが分かるとは」	PRINTFORMW 「您未使用具現能力如何能改变大小呢」
PRINTFORMW 「ふむ。なかなか良い感じですね」	PRINTFORMW 「唔呣。感觉还不错」
PRINTFORMW 「おぉー……秘書嬢も大喜び、って感じですかね♪」	PRINTFORMW 「哦……助手小姐会很喜歡的感觉♪」
PRINTFORMW 「……ちょっと触ってみても良いですか？」	PRINTFORMW 「……我可以稍微碰一下吗？」
PRINTFORMW %CALLNAME:TARGET%は%CALLNAME:PLAYER%のペニスをやわやわと握って太さを楽しんでいる……	PRINTFORMW %CALLNAME:TARGET%握著%CALLNAME:PLAYER%的阴茎高興地感受它的大小……
PRINTFORMW 「凄いですね……凶器ですよ、これは」	PRINTFORMW 「太厲害了……这是凶器呢」
PRINTFORMW %CALLNAME:TARGET%は先端にキスをしたのちに根元に向けてつぅ……っと舌を這わせ、不敵な笑顔と共にペニスに頬ずりした。	PRINTFORMW %CALLNAME:TARGET%吻了一下先端，然后转向了根部……伸出舌头、带着无可挑剔的笑顔用面贴住阴茎。
PRINTFORMW 「フフフ。本当、大きすぎます」	PRINTFORMW 「呼呼呼。真的、太大了」
PRINTFORMW 「これは……比喩でなく三本目の腕、って感じですね」	PRINTFORMW 「这就像……第三只手臂、的感觉」
PRINTFORMW 「ちょっと、いや大分かなり大きいですが、まぁ喜ぶ人もいると思います、ハイ」	PRINTFORMW 「稍微、有点大、不、很大、但是我认为有些人会很高兴、对」
PRINTFORMW %CALLNAME:TARGET%は自分が相手する時を想像したのか、やや引き気味な表情だ……	PRINTFORMW %CALLNAME:TARGET%想像做你對手时的情況、露出有点微妙的表情……
PRINTFORMW 「いや～……自分でやっておいてなんですが……」	PRINTFORMW 「不要～……我自己做就可以了……」
PRINTFORMW 「流石にコレは無い気がしますよ%CNAME("二人称")%、まるで悪い夢のよう……」	PRINTFORMW 「我觉得没有勇气面对%CNAME("二人称")%、这就像一个噩梦……」
PRINTFORMW %CALLNAME:TARGET%は%CALLNAME:PLAYER%のペニスの異様な大きさに真顔になってしまっている……	PRINTFORMW %CALLNAME:TARGET%面对%CALLNAME:PLAYER%破格大小的阴茎时一脸严肃……
PRINTFORMW 「あらかわいい♪」	PRINTFORMW 「啊啦、好可爱♪」
PRINTFORMW 「ゴホン。失礼しました」	PRINTFORMW 「咳哼。失礼了」
PRINTFORMW 「僭越ながら申し上げますが……本当に小さくしてしまって良かったのですか？」	PRINTFORMW 「抱歉僭越了……缩小尺寸真的好吗？」
PRINTFORMW %CALLNAME:TARGET%は聞き慣れない願いを耳にしたせいか少々困惑している……	PRINTFORMW %CALLNAME:TARGET%は听到这个奇怪的愿望有点困惑……
PRINTFORMW 「少々勿体ない気もしますが、この大きさもなかなかですねぇ」	PRINTFORMW 「虽然我感觉有点不必要，但是这个尺寸还不错」
PRINTFORMW %CALLNAME:TARGET%は%CALLNAME:PLAYER%のペニスに惚れ惚れしている様子だ	PRINTFORMW %CALLNAME:TARGET%看着%CALLNAME:PLAYER%的阴茎陷入恍惚的様子
PRINTFORMW 「ご英断と思います。過ぎたるはなんとやら、と申しますしね」	PRINTFORMW 「英明果断的选择。我的意思是、为时未晚」
PRINTFORMW 「申し訳ありませんが……その申し出は%CNAME("一人称")%の手には余るようです」	PRINTFORMW 「对不起……%CNAME("一人称")%拒绝」
CALL PRINT_STRW, "「フフ、いいですよ……_H_」"	CALL PRINT_STRW, "「呼呼、好啊……_H_」"
PRINTFORMW %CALLNAME:TARGET%は緩く腰を動かして%CALLNAME:MASTER%を楽しませつつ、繋がりながらの魂の授受に酔いしれている…	PRINTFORMW %CALLNAME:TARGET%緩慢地动着腰、享受%CALLNAME:MASTER%带来的快感、沉醉地连繋着并進行魂的交易…
PRINTFORMW 「……次からは、エッチの前に言って下さると嬉しいですね」	PRINTFORMW 「……下次的话、在H之前说我会比较开心」
PRINTFORML 「あら、お買い物ですか？」	PRINTFORML 「啊啦、去购物吗？」
PRINTFORMW 「ちょっと待ってくださいね、用意しますから」	PRINTFORMW 「请等一下、我去做些准备的」
PRINTFORMW 「あら、デートのお誘いですか？」	PRINTFORMW 「啊啦、是约会邀请吗？」
PRINTFORMW 「いいですよ、一緒に行きましょうか。ちょうど消耗品も不足してきている事ですしね」	PRINTFORMW 「好吧，我们一起去吧。消耗品不太夠呢」
PRINTFORMW 「いいですよ。一緒に行きましょうか」	PRINTFORMW 「好啊，一起去吧」
PRINTFORMW 「%CNAME("二人称")%、行ってらっしゃいませ」	PRINTFORMW 「%CNAME("二人称")%、请走」
PRINTFORMW %CALLNAME:TARGET%は恥ずかしそうに目を逸らしつつ、%SKIRT(TARGET, "略")%を%TEXTR("おずおずと/そろそろと")%たくし上げた。	PRINTFORMW %CALLNAME:TARGET%眼神飘忽似乎有点害臊、%SKIRT(TARGET, "略")%を%TEXTR("怯生生地/很快")%举起たくし上げた。
PRINTFORMW 「え？」	PRINTFORMW 「诶？」
PRINTFORMW 「帰ってきたら返して下さいね？」	PRINTFORMW 「回来时请还回来」
PRINTFORMW 一瞬バカを見る様な表情になった%CALLNAME:TARGET%だったが、特に文句を言う事もなくゴソゴソとパンツを下ろして手渡ししてきた。	PRINTFORMW %CALLNAME:TARGET%一瞬間露出了看傻瓜表情、没有任何抱怨地脱下胖次并交了给你。
PRINTFORMW 「まったく……仕方のない人ですね」	PRINTFORMW 「真是的……是个让人没有办法的人呢」
PRINTFORMW %CALLNAME:TARGET%は少しだけ困った顔になったが、目の前で下着を脱いで手渡ししてきた。	PRINTFORMW %CALLNAME:TARGET%露出感到麻烦表情、在你面前脱下胖次并交了给你。
PRINTFORML 「う～ん……一応乾いてますし、平気ですかね？」	PRINTFORML 「呜～嗯……大致上干了、可以吧？」
PRINTFORMW 「でも%CNAME("二人称")%、一応これ持って行ってください。お店の人に断られたら困っちゃいますしね」	PRINTFORMW 「但是%CNAME("二人称")%、这个请您着一起走吧。如果被店主拒绝入内会很麻烦呢」
PRINTFORMW %CALLNAME:TARGET%は自分の着替えが入っているバッグを%CALLNAME:MASTER%に持たせた。	PRINTFORMW %CALLNAME:TARGET%將装着替换衣物的袋子交给了%CALLNAME:MASTER%。
PRINTFORML 「まぁ、この格好なら大丈夫でしょうね」	PRINTFORML 「好吧，这看起来还可以」
PRINTFORMW 「それではお買い物に行くといたしましょう」	PRINTFORMW 「就这样一起去购物吧」
PRINTFORMW 「え。この格好のまま……ですか？」	PRINTFORMW 「诶。保持现在的装扮……吗？」
CALL PRINT_STR, "「……フフ_BH_」_W"	CALL PRINT_STR, "「……呼呼_BH_」_W"
PRINTFORMW 「%CNAME("二人称")%ってば、本当に良い趣味しておられますよねぇ。なかなか楽しそうです」	PRINTFORMW 「%CNAME("二人称")%的话、真是有一个很好的爱好呢。听起来很有趣」
PRINTFORMW %CALLNAME:TARGET%は興奮で肌を汗ばませつつ、靴下と靴のみ身に着けて%CALLNAME:MASTER%に付き従った。	PRINTFORMW %CALLNAME:TARGET%兴奋得流出汗水、只穿着襪子跟鞋跟随着%CALLNAME:MASTER%。
CALL PRINT_STR, "「それでは……お買い物に行くといたしましょうか_BH_」_W"	CALL PRINT_STR, "「就这样……一起去购物吧_BH_」_W"
PRINTFORML 「構いませんけど、あまり変なものを買わせたりしないで下さいね？」	PRINTFORML 「没关系，但是不要让我买些奇怪的东西喔」
PRINTFORMW %CALLNAME:TARGET%の表情は、恥ずかしい物を買わされる事を確信している……	PRINTFORMW %CALLNAME:TARGET%的表情、就像坚信我会买一些令人尴尬的东西的样子……
PRINTFORMW 「また%CNAME("一人称")%が買うんですか？」	PRINTFORMW 「您要%CNAME("一人称")%再帮您买吗？」
PRINTFORMW 「…………まぁ、いいですけど」	PRINTFORMW 「…………好吧、没关系啦」
PRINTFORMW %CALLNAME:MASTER%にお会計を頼まれた%CALLNAME:TARGET%は、僅かな思案の後に了承した。	PRINTFORMW %CALLNAME:MASTER%叫%CALLNAME:TARGET%帮忙支付、经过一番思考后答应了。
PRINTFORML 「すいません、これを頂けますか？」	PRINTFORML 「不好意思、你能给我这个吗？」
PRINTFORMW 「袋ですか？そうですね、紙袋でお願いします」	PRINTFORMW 「要袋吗？是的、请放在纸袋里」
PRINTFORML 「すいません、これを頂けますか？ いえ、この厚いので大丈夫です」	PRINTFORML 「不好意思、我可以拿这个吗？ 不、很厚也没关系」
PRINTFORMW 「薄いものだとすぐ出ちゃうって言ってましたから」	PRINTFORMW 「如果太薄的话很快就会射出来」
PRINTFORML 「すいません、これを頂けますか？」	PRINTFORML 「不好意思、请给我这个」
PRINTFORMW 「すいません、これを頂けますか？……いえ、ラッピングは結構です」	PRINTFORMW 「不好意思、请给我这个……沒有啦、包装很好」
PRINTFORMW 「その……私用、ですので」	PRINTFORMW 「那个……是、私用的」
PRINTFORMW %CALLNAME:TARGET%は恥ずかしさで噴き出してきた汗をハンカチで軽く拭った。	PRINTFORMW %CALLNAME:TARGET%用手帕轻轻地拭去因尴尬而喷出的汗水。
PRINTFORML 「あの……そろそろ、帰りませんか？」	PRINTFORML 「那个……您想快点回家吗？」
PRINTFORMW %CALLNAME:TARGET%は他の客の視線に気が気ではないようで、いつに無くそわそわしている……	PRINTFORMW %CALLNAME:TARGET%似乎对其他顾客的視線感到不安、一直担惊受怕的样子……
PRINTFORML %TEXTR("「……」/「色々ありますね」/「見てくださいよコレ、0.0001mmですって。破けたりしないんでしょうかねぇ」/（これ……年に何個ぐらい売れているんでしょう）/（大きい……私の腕ぐらい有りますねコレ）")%	PRINTFORML %TEXTR("「……」/「有各种各样的东西呢」/「看看这个、0.0001mm。不会破吧」/（这个……每年能卖多少個呢?）/（很大……这个比我的手腕还要大呢）")%
PRINTFORMW %CALLNAME:TARGET%は棚の商品%TEXTR("を手に取って眺めながら/を興味深そうに観察して/の埃を手で軽く払いつつ/の説明書きを読みながら")%時間を潰している……	PRINTFORMW %CALLNAME:TARGET%%TEXTR("拿起并看看货架上的货物/有兴趣地观察货架上的货物/轻轻地掃着货架上的货物的尘埃/阅读货架上的货物的说明书")%,消磨时间……
PRINTFORMW 「ああ、恥ずかしかった……顔から炎が吹き出ちゃいそうでしたよ」	PRINTFORMW 「啊啊、真的很羞耻……脸上像要喷火似的」
PRINTFORMW %CALLNAME:TARGET%は手渡されたパンツの感触に、長めの溜息を吐いた……	PRINTFORMW %CALLNAME:TARGET%感觉着空荡荡的股间、发出了叹息……
PRINTFORMW 「%CNAME("二人称")%。ローションを買っておいた方が良かったのではないですか？」	PRINTFORMW 「%CNAME("二人称")%。买润滑剂不是更好吗？」
PRINTFORMW 「%CNAME("二人称")%。コンドームを買い足しておいた方が良かったのではないでしょうか？」	PRINTFORMW 「%CNAME("二人称")%。买足够避孕套不是更好吗？」
PRINTFORMW 「掘り出し物は無かったようですね」	PRINTFORMW 「似乎没有便宜货呢」
PRINTFORMW 「思った以上に何も言われませんでしたね、この格好」	PRINTFORMW 「这个服装我能说什么呢」
PRINTFORMW 「他のお客様達もチラっと見るぐらいでしたし」	PRINTFORMW 「其他客人都看过来了」


//EVENT_K1_フェリシエル.ERB
PRINTFORML 「コホン。本日は一つ、%CNAME("二人称")%にお伝えしておくことがございます」	PRINTFORML 「嗯哼。今天、有一件事要告诉%CNAME("二人称")%」
PRINTFORML 「……今日は、大丈夫な日……ですよ」	PRINTFORML 「……今日、是做的话没关系的日子……ですよ」
PRINTFORML %CALLNAME:TARGET%は頬を赤らめながら小声で耳打ちしてきた	PRINTFORML %CALLNAME:TARGET%红着脸低声耳语
PRINTFORMW 「あはぁ……%CNAME("二人称")%\@ INSERT("インサート") && PENIS(PLAYER) ? のおちんちん # \@、凄すぎです……♪」	PRINTFORMW 「啊哈ぁ……%CNAME("二人称")%\@ INSERT("インサート") && PENIS(PLAYER) ? のおちんちん # \@、太厉害了……♪」
PRINTFORMW 「もう……%CNAME("二人称")%ったらいじめっ子なんですから……♪」	PRINTFORMW 「真是的……%CNAME("二人称")%是个喜欢欺负人的孩子……♪」
PRINTFORMW 「あ、あぁぁ……って、……えぇっ！？」	PRINTFORMW 「啊、啊~~……って、……唉！？」
PRINTFORMW 「違う、これは違うんです……ああ、もう！」	PRINTFORMW 「不是、不是这样的……ああ、真是的！」
PRINTFORMW 「くっ……何度経験しても、こればかりは慣れられそうもありません」	PRINTFORMW 「呃……不管经历多少次、也不会习惯这些」
PRINTFORMW 「フフ。逃がしませんよ？」	PRINTFORMW 「呵呵。我会让你逃掉的吗？」
CALL PRINT_STR, "「私の気が済むまでは、お付き合いして頂きます……_H_」_W_"	CALL PRINT_STR, "「在让我消气之前、请好好和我交合……_H_」_W_"
PRINTFORMW 「フフ。楽しみましょうね♪」	PRINTFORMW 「呵呵。挺期待的呢♪」
PRINTFORMW 「あら、用意が良いですね。見直しちゃいました」	PRINTFORMW 「啊啦、准备得很好呢。该重新审视你了」
PRINTFORMW 「フフ、お心遣い感謝しますよ♪」	PRINTFORMW 「呵呵、谢谢您的关心♪」
CALL PRINT_STR, "「ですが今日は特別な日ですから、よければどうぞ何もつけずに……_H_」_W_"	CALL PRINT_STR, "「但是今天是特别的日子、如果可以的话请不要用（套）……_H_」_W_"
PRINTFORMW 「危険な日なので何度も求められたら困りますけど、少しでしたら……構いませんよ？」	PRINTFORMW 「因为是危险日所以要求做太多次会很困扰的、稍微多一点的话……没关系吧？」
PRINTFORMW 「初めてなんですから……避妊具無しで、どんなものか確かめておきたいでしょう？」	PRINTFORMW 「因为是第一次……没有用避孕器具，想确认一下是什么样的东西吧？」
CALL PRINT_SELECT, "それでも着ける/お言葉に甘えて生挿入！"	CALL PRINT_SELECT, "即使是那样也要着装（蒸着）/就听话生挿入！"
PRINTFORMW 「……思ったよりも誘惑に強いんですね」	PRINTFORMW 「……比想象中更能接受诱惑呢」
PRINTFORMW 「%CNAME("二人称")%の事、甘く見ていたかもしれません……」	PRINTFORMW 「%CNAME("二人称")%の事、也许是小看你了……」
PRINTFORMW 「初めての膣内射精……どうぞ%CNAME("一人称")%で経験しちゃってくださいね♪」	PRINTFORMW 「初次の膣内射精……请在%CNAME("一人称")%里面体验一下吧♪」
CALL PRINT_STR, "「ですが今日は大丈夫な日ですから、よければどうぞ何もつけずに……_H_」_W_"	CALL PRINT_STR, "「但是今日是安全日、如果可以的话请不要用（避孕器具）……_H_」_W_"
PRINTFORMW 「あらら、断られちゃいました。%CNAME("一人称")%の話術も、まだまだですねぇ♪」	PRINTFORMW 「啊啦啦、被拒绝了。%CNAME("一人称")%の話術、还差得远呢♪」
PRINTFORMW 「……フフっ♪ここだけの話、生でするの好きなんですよねぇ、%CNAME("一人称")%」	PRINTFORMW 「……呵呵~♪现在在这里说的话是、我喜欢生插入、%CNAME("一人称")%」
PRINTFORMW %CALLNAME:TARGET%は%CALLNAME:MASTER%がコンドームを着けるのを見て微笑んだ。	PRINTFORMW %CALLNAME:TARGET%看着%CALLNAME:MASTER%带上避孕套而微笑着。
PRINTFORMW 「あら？もしかしてコンドーム無くなっちゃいましたか？」	PRINTFORMW 「啊啦？难道说避孕套不见了吗？」
//PRINTFORMW 「啊啦……？%CNAME("二人称")%、难道说没有准备避孕套吗？」
PRINTFORMW 「ダメなお人ですねぇ本当に。最低限のエチケットですよ？」	PRINTFORMW 「真是个废柴啊。最低限的礼节都没有吗？」
PRINTFORMW 「と言いたいところですが……フフ」	PRINTFORMW 「我是想这么说……呼呼」
CALL PRINT_STR, "「今日は特別な日ですからねぇ。……いいですよ、このまま何も着けなくても……_H_」_W_"	CALL PRINT_STR, "「今天是特别的一天呢。……可以的啊、就这样什么也不带……_H_」_W_"
PRINTFORMW 「危険な日なので何度も求められたら困りますけど、少しでしたら……ね？」	PRINTFORMW 「因为是危险日所以要求做太多次会很困扰的、但稍微可以多做一点的话……对吧？」
PRINTFORMW 「じゃあ……\@ CHOSECOMS("Ｖ挿入") ? 続き # 今日 \@は着けずにしましょうか♪」	PRINTFORMW 「那么……\@ CHOSECOMS("Ｖ挿入") ? 继续 # 今日 \@还是不要的吧♪」
PRINTFORMW 「う～～ん……仕方ないですけど、今日はここまでにしましょう」	PRINTFORMW 「う～～ん……没办法、今天就到这里吧」
PRINTFORMW %CALLNAME:TARGET%は少し残念そうだ。	PRINTFORMW %CALLNAME:TARGET%看起来有点遗憾。
PRINTFORMW 「……中に出さなければ、大丈夫だと思うんですよね」	PRINTFORMW 「……如果不中出射在里面的话、应该大丈夫吧」
PRINTFORMW 「という事で、続けませんか？」	PRINTFORMW 「就这样，不继续吗？」
PRINTFORMW 「でも、絶対に絶対に中に出したら駄目ですからね？怒りますよ？」	PRINTFORMW 「但是、絶対絶対不能中出在里面吧？我真的会憤怒的哦？」
PRINTFORMW 「フフ。今日は大丈夫な日ですし、楽しみましょうね♪」	PRINTFORMW 「呼呼。今天是没问题的日子，一起期待吧♪」
PRINTFORMW 「あら？よろしいんですか、避妊なさらなくても」	PRINTFORMW 「啊啦？可以吗、不做任何避妊」
CALL PRINT_STR, @"「%CNAME("一人称")%ですか？%CNAME("一人称")%は……フフ_H_」_W"	CALL PRINT_STR, @"「%CNAME("一人称")%吗？%CNAME("一人称")%は……呼呼_H_」_W"
PRINTFORMW 「そうそう。はい、どうぞ」	PRINTFORMW 「对了对了。给、请用」
PRINTFORMW %CALLNAME:TARGET%は%CALLNAME:PLAYER%にコンドームを手渡してきた。	PRINTFORMW %CALLNAME:TARGET%把避孕套交给了%CALLNAME:PLAYER%。
PRINTFORMW 「今日は出来ちゃう日ですから……お願いしますね？」	PRINTFORMW 「今天是可能妊娠的日子……拜托了可以吗？」
CALL PRINT_SELECT, "着ける/着けない/魂を代価に生中出しをお願いする"	CALL PRINT_SELECT, "着装/不着装/以魂为代价请求中出"
CALL PRINT_SELECT, "着ける/着けない"	CALL PRINT_SELECT, "着装/不着装"
PRINTFORMW %CALLNAME:PLAYER%は%CALLNAME:TARGET%に従ってゴムを装着した。	PRINTFORMW %CALLNAME:PLAYER%服从%CALLNAME:TARGET%着装了避孕套。
PRINTFORMW 「……そんな顔しないで下さいよ、今度平気な日には生でさせてあげますから♪」	PRINTFORMW 「……请不要露出那种表情、下次不会妊娠的时候我会让你生插入的♪」
PRINTFORMW 「だーめーでーすー。いくら%CNAME("二人称")%のお願いでも、これは聞けません」	PRINTFORMW 「说ー了ー不ー行ー。就算%CNAME("二人称")%再怎么请求、我也不会听的」
PRINTFORMW %CALLNAME:PLAYER%は仕方なく%CALLNAME:TARGET%に従ってゴムを装着した。	PRINTFORMW %CALLNAME:PLAYER%只好服从%CALLNAME:TARGET%着装了避孕套。
PRINTFORMW 「ぇえ？！は、はぁ……うーん、そうまで仰られるのなら……？」	PRINTFORMW 「唉？！哈、哈啊……うーん、如果被这么说的话……？」
PRINTFORMW 「い、いいで……すよ？今日は危ない日ですけど、特別に生でさせて……あげます」	PRINTFORMW 「好、好的……把？今天是危险日、就特别让你……生插入」
PRINTFORMW %CALLNAME:PLAYER%の申し出に面食らった%CALLNAME:TARGET%だったが、利益が勝ったのか承諾してきた。	PRINTFORMW 对%CALLNAME:PLAYER%的提议感到不知所措的%CALLNAME:TARGET%、答应了是不是利益获胜。
PRINTFORMW （……流石に軽率だったんじゃないでしょうか、私？）	PRINTFORMW （……我、到底是不是太轻率了？）
PRINTFORMW 「そこまでの覚悟がおありでしたら、特別に生でする事だけは許してあげます……魂は、いいですよ」	PRINTFORMW 「如果你有这样的觉悟的话、我只允许你特别允许生插入……魂、是需要的」
PRINTFORMW 「でも、中で出すのはダメですよ？本当に怒っちゃいますよ？」	PRINTFORMW 「但是、不能再里面中出的哦？我真的会生气的哦？」
PRINTFORMW %CALLNAME:PLAYER%の申し出に面食らった%CALLNAME:TARGET%だったが、中には出さないことを条件にゴム無しを承諾してくれた。	PRINTFORMW %CALLNAME:PLAYER%面对%CALLNAME:TARGET%提出的条件、承諾没有避孕套不会在里面中出。
PRINTFORMW 「お手柔らかにお願いしますね」	PRINTFORMW 「拜托请手下留情」
PRINTFORMW 「フフ。見ているだけじゃ我慢できなくなっちゃいました？」	PRINTFORMW 「呼呼。光是看着就忍不住了吗？」
PRINTFORMW 「%CNAME(CSVCALLNAME(NO:ASSI) )%のお相手は、もう宜しいのですか？」	PRINTFORMW 「%CNAME(CSVCALLNAME(NO:ASSI) )%のお相手は、真的可以了吧？」
PRINTFORML 「あら。%CNAME("一人称")%の相手もして下さるんですか？」	PRINTFORML 「啊啦。和%CNAME("一人称")%做对手也可以吗？」
PRINTFORMW 「フフ……お優しいこと♪」	PRINTFORMW 「呵呵……很温柔啊♪」
PRINTFORMW 「是、どうぞ。小黄书ばかり買ってはダメですよ？」	PRINTFORMW 「是、请用。不能只買小黄书哦？」
PRINTFORMW 「あら……？%CNAME("二人称")%、もしかしてコンドーム用意してないんですか？」	PRINTFORMW 「啊啦……？%CNAME("二人称")%、难道是没有准备避孕套吗？」
あなただけの忠実で_-_意地悪な_優しいメイド	只对主人公忠実的_-_坏心眼的_温柔的女仆
立ち振る舞いは経験豊富なお姉さんのようだが、実はただの天然かもしれない	行为举止看上去像一个経験豊富的大姐姐、但事实上其实只是个天然而已
PRINTFORMW 「身の回りの世話から細々とした疑問まで、なんでも%CNAMET(ARG, "一人称")%にお任せください」	PRINTFORMW 「从照顾日常起居到各种别的事情、无论什么都交给%CNAMET(ARG, "一人称")%就好了」












