//EVENT_K2_濡烏の君.ERB
 艶やかな髪が自慢の少女にして、その本性は力を持つ狐	表面上拥有华丽长发的高傲少女，其实是拥有强大力量的狐妖。
言葉遣いがやや粗く尊大だが、面倒見が良いため意外と慕われている	虽然言辞傲慢自大，但是会因为他人的好意而有所触动。
PRINTFORMW 「生気をいくら吸っても大丈夫な人間がいる、だと？」	PRINTFORMW 「嗯？无论怎样吸收精气也没有问题的人类？」
PRINTFORMW 「ふん、面白いじゃないか。%CNAME("一人称")%の下僕となるなら付き合ってやろう」	PRINTFORMW 「唔姆，很有趣。要是能成为%CNAME("一人称")%的下仆，那就允许%CNAME("二人称")%尝一尝%CNAME("一人称")%吧」
PRINTFORMW 「ふむ、こういう味か」	PRINTFORMW 「唔姆，这个味道」
PRINTFORMW 「知識としては知っていたが、美味いものではないな」	PRINTFORMW 「虽然有相关的知识，但并不是怎么美味的东西啊……」
CALL PRINT_STR, @"「す、すごいな……まさかこの%CNAME("一人称")%が漏らさせられるとは……_H_」_W"	CALL PRINT_STR, @"「还挺、挺厉害的……竟然让尊贵的%CNAME("一人称")%漏了什么的……哈……哈……_H_」_W"
PRINTFORMW 「くくっ、床を妊娠させるつもりか？」	PRINTFORMW 濡烏の君捂着嘴轻笑着看你卖力地撸动阳具「呵呵……你是打算让床怀孕吗？」
;PRINTFORMW 「んっ…んふーっ…くちゃっ、くちゅっ…」	PRINTFORMW 「唔…唔咕…咕啾、咕啾…」
;PRINTFORML %CALLNAME:TARGET%は出した精液を口内で咀嚼しているようだ…	PRINTFORML %CALLNAME:TARGET%正在慢慢品味着你射出来的牛奶。
;PRINTFORML ダマになった部分を噛み砕き、ときには味わうようにゆっくりと顎を動かす	PRINTFORML %CALLNAME:TARGET%将精液中稍微有些已经变得非常粘稠浓郁的部分慢慢咀嚼着磨碎，动着尖俏的下巴慢慢享受着……
;PRINTFORMW 「くちゅくちゅ、んくっ…ごきゅっ…ふぅ」	PRINTFORMW 「咕啾咕啾、唔咕…咕…啾…姆……」
;PRINTFORML 飲み終わったのか口を大きく開ける%CALLNAME:TARGET%、そこに精液は一切残っていなかった。	PRINTFORML 把所有的精液喝下去后，%CALLNAME:TARGET%张开淫唇展示着、那里面没有残留下任何一点精液。
;PRINTFORMW 「ご馳走様、やはり%CNAME("二人称")%の精は甘美なものだ…」	PRINTFORMW 「多谢款待，果然%CNAME("二人称")%的牛奶很甜美呢」
;PRINTFORML 射精中のペニスに吸い付く%CALLNAME:TARGET%	PRINTFORML %CALLNAME:TARGET%用嘴使劲地吮吸着喷射中的肉棒，
;PRINTFORML その動きは今出している精液、その残滓一滴すら残さず吸い出すという意志を感じる	PRINTFORML 这激烈的动作仿佛是要将肉棒里面所有的牛奶都吸出来，连一滴都不留在里面一样。
;PRINTFORMW 精液を飲みながらも、%CALLNAME:TARGET%はペニスへのバキュームは止めない	PRINTFORMW 在饮用精液的同时，%CALLNAME:TARGET%继续用力吸着肉棒，保持着真空状态榨精。
;PRINTFORML 「んくっ…こきゅっ…ぷぁっ、ご馳走様」	PRINTFORML 「嗯…啾…哈、多谢款待……」
;PRINTFORML 丹念にお掃除バキュームされたペニスは唾液以外の汚れを纏ってはいなかった…	PRINTFORML 之后精心地为肉棒扫除着，除了一小点唾液以外，其余的污垢都被%CALLNAME:TARGET%用舌头清理了。
;PRINTFORML 出された瞬間少しの強張りはあったものの、%CALLNAME:TARGET%は口内の精液を飲み下していく	PRINTFORML 感受到射出的瞬间%CALLNAME:TARGET%稍微加强了吮吸的力度，之后把嘴巴里面的精液喝了下去。
;PRINTFORMW 「んっ…んきゅっ…ふぅ、ご馳走様」	PRINTFORMW 「嗯…嗯啾…呼、多谢款待」
PRINTFORMW 「もっと手でしてほしいという顔だな、望みを叶えてやろうか…？くくっ」	PRINTFORMW 「一副非常想让%CNAME("一人称")%用手帮%CNAME("二人称")%做的表情啊、想让%CNAME("一人称")%帮%CNAME("二人称")%实现这种愿望吗…？呵呵」
PRINTFORMW %CALLNAME:TARGET%は不敵な笑顔を浮かべつつ、射精したばかりのペニスを握っている…	PRINTFORMW %CALLNAME:TARGET%露出了妖媚的笑容，轻轻地用手握住颤抖的肉棒。
PRINTFORMW 「たくさん出したな…%CNAME("一人称")%の手がべとべとじゃないか」	PRINTFORMW 「想大量地射出来？…那就在%CNAME("一人称")%高贵的手里面biubiu~地出来吧」
PRINTFORMW しかしその発言とは裏腹に、%CALLNAME:TARGET%は嫌そうにはしていない	PRINTFORMW 但是跟%CALLNAME:TARGET%挑逗的发言相反，%CALLNAME:TARGET%露出厌恶的表情用手撸动着。
PRINTFORMW 「ふふっ、%CNAME("一人称")%との口づけはそんなに気持ち良かったか？」	PRINTFORMW 「呵呵……跟%CNAME("一人称")%接吻的感觉很舒服吧。」
PRINTFORMW 「顔に乗られて射精するとは…%CNAME("二人称")%は筋金入りの変態だな」	PRINTFORMW 「竟然在被人坐脸上侍奉的时候射出来了…%CNAME("二人称")%真是个精虫上脑的变态呢」
PRINTFORMW 「ぱーふぱーふ…ふふっ、顔がとろけているぞ？それに射精まで……」	PRINTFORMW 「啪—呼—啪—呼—呼呼，感觉这么舒服吗？竟然就这样射出来了什么的……」
PRINTFORMW 「心地よかったか、などと聞くまでもないな」	PRINTFORMW 「觉得舒服的话，一定要好↗好↗跟%CNAME("一人称")%描述一下哟」
PRINTFORMW 「おはよう、目覚ましにはちょうどいいと思ってな」	PRINTFORMW 「早安，我也想着你差不多该醒了」
PRINTFORMW 「手でも…と思ったが%CNAME("二人称")%には刺激が足りぬだろう？」	PRINTFORMW 「用手的话…%CNAME("一人称")%想对于%CNAME("二人称")%来说刺激还是太浅了？」
;PRINTFORMW そう言うと%CALLNAME:TARGET%は足に付着した精液を美味しそうに口に含んだ…	PRINTFORMW 这么说着，%CALLNAME:TARGET%用脚摩挲着肉棒，用艳唇盖住龟头，“啾、啾”地索求着美味的牛奶。
;PRINTFORMW そう言うと%CALLNAME:TARGET%は足に付着した精液を口に含んだ…	PRINTFORMW 这么说着，%CALLNAME:TARGET%用脚按摩着肉棒，用嘴盖住龟头，“啾、啾”地索求着精液。
;PRINTFORMW そう言うと%CALLNAME:TARGET%は足に付着した精液を拭き取った…	PRINTFORMW 这么说着，%CALLNAME:TARGET%用脚揉着不断溢出精液的肉棒。
PRINTFORMW %CALLNAME:MASTER%が眠ろうとした時、%CALLNAME:TARGET%がいきなり部屋に入ってきた！	PRINTFORMW %CALLNAME:MASTER%睡着的时候，%CALLNAME:TARGET%溜进了房间。
PRINTFORMW 「%CNAME("二人称")%が悪いんだからな…尻穴ばかり使うせいで疼いて仕方ないんだ…」	PRINTFORMW 「呜…都是%CNAME("二人称")%的错…如果过分地使用了后穴而疼的不得了的话，该怎么办才好」
PRINTFORMW %CALLNAME:TARGET%はベッドで四つん這いになり、アナルを見せつけるように広げた	PRINTFORMW %CALLNAME:TARGET%爬上床，费力地扩张着自己的后庭为插入做准备。
PRINTFORMW …そこには馬の性器ほどの大きさで、なおかつ大きなコブがついているえげつないバイブが奥深くまで挿入されている…	PRINTFORMW …那个即使是马根也能轻易插入的洞、将%CALLNAME:MASTER%巨大的阳具毫不客气地吞入深处…
CALL PRINT_STR, "「…お゛おっ_H_またイクっ_H_バイブにケツ穴掘削されるぅぅっ_H_」_W"	CALL PRINT_STR, "「…喔、喔_H_再一次…唔_H_搔刮着后庭，啊_H_」_W"
PRINTFORMW %CALLNAME:MASTER%はアナルでよがる%CALLNAME:TARGET%の姿を見て、少し意地悪をしてやろうと思い、ある言葉を耳打ちする	PRINTFORMW 被用肛门侵犯的%CALLNAME:MASTER%慢慢醒过来，看到了%CALLNAME:TARGET%狂气的样子，稍微有点惊讶，挣扎着试图阻止
PRINTFORMW 「あひぇっ…そ、そんなのだめだぁ…はずかしいぞ…」	PRINTFORMW 「啊呀！…那、那样不行…太害羞了…」
PRINTFORMW 出来ないならペニスでは行為をしないと言うと、顔色を変えて渋々と了承してくれた。	PRINTFORMW 如果不好好射出来的话，责罚可是不会停下来的。用充满情欲的脸传达了这样的信息。
PRINTFORMW 準備を整えた%CALLNAME:MASTER%は、望む体勢を取ってくれた%CALLNAME:TARGET%を見る	PRINTFORMW 无奈放弃抵抗的%CALLNAME:MASTER%看着%CALLNAME:TARGET%慢慢调整成喜欢的体位。
PRINTFORMW 両足を大きく広げ、アソコが丸見えのいわゆる「エロ蹲踞」という体勢である。	PRINTFORMW 一双美丽的玉腿大开着、小穴和阴核都能看得一清二楚的「M字开脚」体位。
PRINTFORMW そのポーズのまま、さっきのことをしろと命じる	PRINTFORMW 在短暂的停顿之后，发出了“继续像刚才那样做吧”的指示。
CALL PRINT_STR, "「わかった…しっかり見ているんだぞ…ふんっ…あ゛ぎぃぃっ_H_」_W"	CALL PRINT_STR, "「明白了…要好好地看着哦…呼…啊、噫～_H_」_W"
PRINTFORMW 今も震えるバイブを、排便をするかのようにひり出す%CALLNAME:TARGET%	PRINTFORMW %CALLNAME:TARGET%那努力上下套弄着肉棒的肛门，就像正在排便一样蠕动着。
PRINTFORMW 腸内を刺激していたそれは腸液にまみれ、怪しくテカついている	PRINTFORMW 因为不停刺激肠壁的缘故，分泌的肠液从里面溢了出来，发出淫荡的粘糊作响的水声。
CALL PRINT_STR, @"「見ているか…私は、%CNAME("二人称")%の頼みごとに従って…便のようにバイブを…んほぉぉっ_H_ ひり出す変態なんだっ…」_W"	CALL PRINT_STR, @"「看啊…都是因为%CNAME("二人称")%的缘故…变成了就像在公开场合…唔哈…_H_ 排泄的变态一样…」_W"
PRINTFORMW 力を入れるたび、それはミュリミュリ…と音を立てて顔を出す	PRINTFORMW 被用力抽插的同时，体内传来了“biujiu、biujiu”淫靡的声音，%CALLNAME:TARGET%脸上浮现出迷乱的表情。
CALL PRINT_STR, "「目に焼き付けるんだぞ…先輩の私が、はしたない格好で…おぉっ_H_ バイブうんちするところを…ふんっ！」_W"	CALL PRINT_STR, "「请就只看着我一个人！…作为前辈的我、淫乱的姿态…唔哦哦_H_ 用后穴发情的姿态…哈啊！」_W"
PRINTFORMW そう言うと%CALLNAME:TARGET%は腹に全力を込めた！その瞬間…	PRINTFORMW 如此说着的%CALLNAME:TARGET%把肉棒全力吞进腹中！这一瞬间…
PRINTFORMW アソコから大量の潮を吹き顔を歪ませ、%CALLNAME:TARGET%は大きな絶頂を迎えた！	PRINTFORMW 伴随着扭曲的表情，小穴大量潮吹了、%CALLNAME:TARGET%迎来了强烈的高潮！
PRINTFORMW そのまま芋虫のようにもぞもぞと動き、%CALLNAME:MASTER%に尻穴を見せつける…	PRINTFORMW 在那她之后像虫子一样缓缓扭动着慢慢拔出肉棒，向%CALLNAME:MASTER%展示着一塌糊涂的后穴…
PRINTFORMW バイブをひり出したその淫穴は、絶頂の余韻を楽しんでいるようにひくひく、ピクンと不定期に脈動する…	PRINTFORMW 刚刚高潮的淫穴，现在还在激烈的高潮的余韵之中“pikupiku”地痉挛脉动着…
CALL PRINT_STR, @"「次は…%CNAME("二人称")%の番だぞ…早く、早くその勃起ペニスで私の尻穴を…耕してくれぇっ_H_」_W"	CALL PRINT_STR, @"「下一次…就由%CNAME("二人称")%来…快点、快点勃起，把我的后穴…搞得一团糟吧_H_」_W"
PRINTFORMW その穴は埋めてくれるものを探しくぱくぱと蠢いたり、軽くいきむだけで口を大きく開ける第二の性器と化している。	PRINTFORMW 后穴为了寻找能够填补空虚的东西而饥渴地蠢动着，对着扶起来的肉棒门户大开，完全已经变成了第二性器的样子。
PRINTFORMW 「ほら…準備はできているんだ、早く挿入してくれ」	PRINTFORMW 「嗯~…已经准备完毕了，快点插进来享受吧」
PRINTFORMW 「この疼きが静まるまで、好きにしていいんだぞ…」	PRINTFORMW 说完后穴抵着肉棒缓缓落下，「嘶…再等一会…疼痛缓解之后，就可以随意享受了…」
PRINTFORMW 不良在庫の山を前に、%CALLNAME:MASTER%と%CALLNAME:TARGET%は頭を抱えた…	PRINTFORMW 在堆成山的不良库存前，%CALLNAME:MASTER%和%CALLNAME:TARGET%抱住了脑袋…



//EVENT_K2_SHOP.ERB
PRINTFORMW 「かまわんが……あまり変な事をさせるなよ？」	PRINTFORMW 「没有问题……但是不要做奇怪的事情哦？」
PRINTFORMW 「%CNAME("一人称")%に話があるだと？……ふん、下僕の願いを聞くのも主人の務めか」	PRINTFORMW 「对%CNAME("一人称")%有话要说？……唔嗯，听取下仆的请求也是主人的义务之一」
PRINTFORMW 「いいだろう。言ってみろ」	PRINTFORMW 「好啊，说说看吧」
PRINTFORMW 「ほう。何と呼ばれたいんだ」	PRINTFORMW 「那么，要怎么称呼呢」
PRINTFORMW 「%CNAME("二人称")%か……まぁいいだろう」	PRINTFORMW 「%CNAME("二人称")%吗…嗯…就这样吧」
PRINTFORMW 「む。気が変わったか？」	PRINTFORMW 「嗯？改变心意了？」
PRINTFORMW 「………………%CNAME("一人称")%は情けない。下僕の気持ちにも気づけなかったとは、主人失格だな」	PRINTFORMW 「………………%CNAME("一人称")%真是没用。连下仆的心情都没有注意到，真是主人的失职」
PRINTFORMW 自嘲する%CALLNAME:TARGET%だが……その顔は意外と明るい	PRINTFORMW 自嘲中的%CALLNAME:TARGET%，那表情却显得格外明朗愉快。
PRINTFORMW 「だが、%CNAME("二人称")%も下僕失格だぞ？」	PRINTFORMW 「但是，%CNAME("二人称")%也是不称职的下仆哦」
PRINTFORMW %CALLNAME:TARGET%は%CALLNAME:MASTER%に抱きついて、我慢の限界といった体で唇を奪ってきた。	PRINTFORMW %CALLNAME:TARGET%把%CALLNAME:MASTER%紧紧抱住，无法忍耐地夺取了嘴唇。
CALL PRINT_STR, "「待たせすぎだ、ばかっ……_H_」_W_"	CALL PRINT_STR, @"「让%CNAME("一人称")%等那么久，笨蛋……_H_」_W_"
PRINTFORMW 「好意をぶつけられて悪い気はしないが……」	PRINTFORMW 「并不会因为你的好意而感到不快哦……」
PRINTFORMW 「%CNAME("一人称")%は%CNAME("二人称")%の事を、まだよく知らん」	PRINTFORMW 「但是%CNAME("一人称")%对%CNAME("二人称")%的事情，还不是很了解」
PRINTFORMW 「すまんな」	PRINTFORMW 「抱歉呐」
PRINTFORMW 「悪いが今は無理だ。悪いな」	PRINTFORMW 「不好意思，今天不行」
PRINTFORMW %CALLNAME:TARGET%は%SKIRT(TARGET, "略")%をめくって、何も付けていない下腹部をチラリと見せてきた。	PRINTFORMW %CALLNAME:TARGET%给%SKIRT(TARGET, "略")%翻开裙子，展现了什么东西都没有穿的下体。
PRINTFORMW 「……ふん」	PRINTFORMW 「……唔」
PRINTFORMW 「聞かなかったことにしてやる」	PRINTFORMW 「就当没有听到吧」
PRINTFORMW 「ふむ、そうだな……%MONEY_C(TFLAG:取引価格)%よこすならくれてやろう」	PRINTFORMW 「唔姆，我想想……%MONEY_C(TFLAG:取引価格)%怎么样？」
PRINTFORMW 「なに？高い？」	PRINTFORMW 「嗯？太贵了？」
PRINTFORMW 「何を言う……下着とてタダでは買えんのだぞ」	PRINTFORMW 「说什么呢……即使是内衣也不是免费的哦」
PRINTFORMW 「%CNAME("一人称")%と%CNAME("二人称")%の仲だ。%MONEY_C(TFLAG:取引価格)%でいいぞ」	PRINTFORMW 「毕竟%CNAME("一人称")%和%CNAME("二人称")%是同伴的关系，%MONEY_C(TFLAG:取引価格)%就够了」
PRINTFORMW 「フ。どうやら話は平行線のようだな」	PRINTFORMW 「唉。不管怎么谈，我们的对话都像平行线一样搭不上话呢」
PRINTFORMW 「他のやつに頼むがいい」	PRINTFORMW 「拜托其他人也可以的哦」
PRINTFORMW 「こんなものがそんなに欲しいとは……%CNAME("二人称")%も物好きな奴だな」	PRINTFORMW 「这样的东西也想要啊……%CNAME("二人称")%真的是一个有恋物癖的孩子呢」
PRINTFORMW 「まぁ、よかろう」	PRINTFORMW 「嘛，好吧」
PRINTFORMW 「くれてやるから、%CNAME("一人称")%の優しさに感謝するがいい」	PRINTFORMW 「所以，要好好地感谢%CNAME("一人称")%的温柔哦」
PRINTFORMW %CALLNAME:TARGET%は一向にパンツを脱ごうとしない……	PRINTFORMW %CALLNAME:TARGET%像往常一样脱下胖次……
PRINTFORMW 「くくっ、おあずけされた犬のようだな」	PRINTFORMW 「呵呵，这副难看的样子就像狗狗一样」
PRINTFORMW 「……ほら、欲しければ自分でほどくんだな」	PRINTFORMW 「……喂、想要的话自己来拿啊」
PRINTFORMW 「せっかくの紐付きだ……%CNAME("二人称")%の好きにするがいい」	PRINTFORMW 「好不容易穿上系绳胖次的说……随%CNAME("二人称")%喜欢吧」
PRINTFORMW 「ほら、これでいいのか？」	PRINTFORMW 「喏，这样就行了吗？」
PRINTFORMW 「……ほら。しかし、%CNAME("二人称")%の趣味はよく分からんな」	PRINTFORMW 「……嗯哼。感觉已经对%CNAME("二人称")%变态爱好有充分了解了」
PRINTFORMW 「もっと、するべき事があるのではないか？」	PRINTFORMW 「不过，就没有更想做的事情了吗？」
PRINTFORMW %CALLNAME:TARGET%は横目でチラリと%NAMES("ベッド")%を見た。	PRINTFORMW %CALLNAME:TARGET%侧视着%NAMES("床")%。
PRINTFORMW 「冗談は休み休み言え」	PRINTFORMW 「不要开玩笑了」
PRINTFORMW 「……今は気分がすぐれん。あとにしろ」	PRINTFORMW 「……现在心情很好，等会再说吧」
PRINTFORMW 「悪いがタダでやるつもりはない」	PRINTFORMW 「不好意思，免费是不行的哦」
PRINTFORMW 「……%CNAME("二人称")%は、もう少し場の空気を読むという事を学んだ方が良いな」	PRINTFORMW 「……如果%CNAME("二人称")%能学学怎么观察气氛就好了」
PRINTFORMW %CALLNAME:TARGET%は他の人達の事を気にしている……	PRINTFORMW %CALLNAME:TARGET%对于其他人的事情很在意……
PRINTFORMW 「……今は駄目だ。あとにしろ」	PRINTFORMW 「……现在不行，待会再说吧」
PRINTFORMW 「同棲だと？」	PRINTFORMW 「同居？」
PRINTFORMW 「なぜそんな面倒くさい事を%CNAME("一人称")%がせねばならん」	PRINTFORMW 「为什么要跟%CNAME("一人称")%做那么麻烦的事情？」
PRINTFORMW 「しつこいぞ。他の奴にでも頼め」	PRINTFORMW 「烦死了。拜托其他的人吧」
PRINTFORMW 「…………ふむ。なかなか面白そうだな」	PRINTFORMW 「…………唔姆，好像有点意思呐。」
PRINTFORMW 「いいだろう、%CNAME("二人称")%と寝食を共にしてやろうじゃないか」	PRINTFORMW 「好吧，从此往后就跟%CNAME("二人称")%共同起居吧」
PRINTFORMW 「ん？また%CNAME("一人称")%と共に暮らしたくなったか」	PRINTFORMW 「嗯？又想跟%CNAME("一人称")%一起生活吗？」
PRINTFORMW 「%CNAME("一人称")%を退屈させないと約束するなら、考えてやらんでもないぞ？」	PRINTFORMW 「如果不会让%CNAME("一人称")%无聊的话，那就试着看看吧」
PRINTFORMW 勿体着けた物言いの%CALLNAME:TARGET%だが、表情は嬉しそうだ。	PRINTFORMW 说着装腔作势的话的%CALLNAME:TARGET%，看起来倒是非常高兴的样子。
PRINTFORMW 「むむ？……まぁ、それもよかろう」	PRINTFORMW 「姆姆？……嘛，那样也好」
PRINTFORMW 「悪いが、%CNAME("一人称")%はそういう細かい事は苦手だ」	PRINTFORMW 「不好意思，%CNAME("一人称")%不擅长处理琐碎的事情」
PRINTFORMW 「というか下僕の%CNAME("二人称")%こそが、%CNAME("一人称")%のために作るべきではないのか？」	PRINTFORMW 「相反，作为下仆的%CNAME("二人称")%不是应该给作为主人的%CNAME("一人称")%做饭吗？」
PRINTFORMW %CALLNAME:TARGET%は髪の先端を摘まんで眺めたのちに腕組みし、%CALLNAME:MASTER%を横目で伺いつつ低く唸った。	PRINTFORMW %CALLNAME:TARGET%捻着发梢双手抱在胸前，侧视着%CALLNAME:MASTER%沉思。
PRINTFORMW 「…………まぁ、いいだろう」	PRINTFORMW 「…………嘛，好吧」
PRINTFORMW %CALLNAME:TARGET%がﾑﾆｬﾑﾆｬとまじないを口にすると、ドロンと狐の耳と尻尾が現れた。	PRINTFORMW %CALLNAME:TARGET%嘴里发出“munya munya”的声音，突然狐狸的耳朵和尾巴就出现了。
PRINTFORMW 「%CNAME("一人称")%が尻尾を見せる人間は%CNAME("二人称")%が初めてだ。光栄に思うがいい」	PRINTFORMW 「%CNAME("二人称")%是%CNAME("一人称")%第一个允许给看尾巴的人类，感到光荣吧」
PRINTFORMW 「断る」	PRINTFORMW 「拒绝」
PRINTFORMW 「なんでも思い通りになると勘違いしないようにな」	PRINTFORMW 「无论怎么想都不可能给你看的」
PRINTFORMW 「なんだ、これでいいのか？私がいつもやってるのと同じじゃないか」	PRINTFORMW 「怎么、这个样子就行了？这不是跟私平时的发型一样吗」
PRINTFORMW 「フ……まぁ、こういう髪型が好きなら私に頼むのが一番だろうな」	PRINTFORMW 「呼……嘛、如果喜欢这种发型的话来拜托私当然是最好的呐」
PRINTFORMW %CALLNAME:TARGET%はニヤリとしながら髪をかき上げ、美しく長い黒髪のサラサラ具合を見せてきた。	PRINTFORMW %CALLNAME:TARGET%微笑着撩起自己的头发、展示了自己美丽柔顺的长黑发。
PRINTFORMW 「う～～ん……正直な話、私はこういう髪型は嫌いだ。%CNAME("二人称")%が望むから我慢してやってはいるが……」	PRINTFORMW 「唔～～嗯……说实话、私讨厌这种发型。不过因为是%CNAME("二人称")%的愿望所以私才试着忍耐的……」
PRINTFORMW %CALLNAME:TARGET%はあんまりお気に召していない様だ。	PRINTFORMW %CALLNAME:TARGET%似乎并不是很中意的样子。
PRINTFORML 「こういうのが好みか。耳にでも執着があるのか？それとも……」	PRINTFORML 「喜欢这种?对耳朵有某种执念吗？还是说……」
PRINTFORMW %CALLNAME:TARGET%はおさげを弄びつつ、どうでも良さげに%CALLNAME:MASTER%に話を振ってきた。	PRINTFORMW %CALLNAME:TARGET%一边玩弄着自己的头发、悠闲地询问%CALLNAME:MASTER%的意向。
PRINTFORML 「ふむ。……ふ～む。こういうのも中々だな」	PRINTFORML 「呼姆。……呼～姆。这种确实也很不错呢」
PRINTFORMW %CALLNAME:TARGET%は鏡で自分の頭を四方から眺めて出来栄えを確かめている。	PRINTFORMW %CALLNAME:TARGET%从镜子中仔细观察着自己的杰作。
PRINTFORMW 「どうだ？……まぁ、どんな髪型をしていようと元が良いからな」	PRINTFORMW 「怎么？……嘛、无论要换什么发型私都可以为你做哦」
PRINTFORMW 「悪いがお断りだ。もっと%CNAME("一人称")%が喜びそうなことを言ってみろ」	PRINTFORMW 「不好意思，%CNAME("一人称")%拒绝。而且%CNAME("一人称")%也不是喜欢做那种事情的人」
PRINTFORMW 「ふん。いいだろう」	PRINTFORMW 「唔姆。好吧」



//EVENT_K2_DAILY.ERB
PRINTFORMW 「悪いな、我慢できなくなってしまった」	PRINTFORMW 「对不起，因为实在是很想要」
PRINTFORMW 「とはいえ、なんだ……%CNAME("二人称")%も嫌いではないだろう？」	PRINTFORMW 「嗯？怎么了？……%CNAME("二人称")%你不反感这个样子吗？」
PRINTFORMW 「たっぷりと楽しもうじゃあないか。なぁ？」	PRINTFORMW 「难道在充分的享受？%CNAME("二人称")%这个变态」
PRINTFORMW 「おはよう、目覚ましにはちょうどいいと思ってな」	PRINTFORMW 「早上好、果然还是用这个做闹钟比较好呢」
PRINTFORMW 「手でも…と思ったが%CNAME("二人称")%には刺激が足りぬだろう？」	PRINTFORMW 「用手…虽然也想过呐、但是对%CNAME("二人称")%来说不够刺激吧？」
PRINTFORMW 「おはよう。ようやく目が覚めたか」	PRINTFORMW 「早安。终于醒来了吗？」
PRINTFORMW 「今日は疲れそうだからな。しっかり食っておけ」	PRINTFORMW 「今天也是辛苦了，好好吃饭吧」
PRINTFORMW 今日は%CALLNAME:ARG%がご飯を用意してくれたらしい……朝食にしては大分多いが。	PRINTFORMW 今天%CALLNAME:ARG%准备了便当……早餐的量很多。
PRINTFORMW 「おはよう。ほら、今日は汗をかくからこれを持っていけ」	PRINTFORMW 「早安。出汗了呢，把这个拿着吧」
PRINTFORMW %CALLNAME:ARG%は%CALLNAME:MASTER%にタオルを渡してきた……３枚も。	PRINTFORMW %CALLNAME:ARG%递了毛巾给%CALLNAME:MASTER%……而且是3条。
PRINTFORMW 「多いって？なに、案ずるな……%CNAME("一人称")%の分も入っている」	PRINTFORMW 「太多了？嗯？……是因为%CNAME("一人称")%的那份也放进去了」
PRINTFORMW 「おはよう。 やっと起きたな」	PRINTFORMW 「早安。终于起来了吗？」
PRINTFORMW 「今日は%CNAME("一人称")%が早起きして用意しておいたぞ……さぁ、朝ご飯にしようじゃないか」	PRINTFORMW 「今天%CNAME("一人称")%也很早起来了……不如一起吃早饭吧」
PRINTFORMW 二人して%CALLNAME:ARG%の作った朝ご飯に舌鼓を打ちながら、学園での話題に花を咲かせました。	PRINTFORMW 两人把%CALLNAME:ARG%做的早饭全部吃掉之后，还聊了很多学校的话题。
PRINTFORMW 「おはよう。 %CNAME("二人称")%が起きるのを待っていたんだ」	PRINTFORMW 「早安。 一直在等着%CNAME("二人称")%起床呢」
PRINTFORMW 「ほら、%CNAME("一人称")%の朝ご飯を作ってくれ」	PRINTFORMW 「请收下%CNAME("一人称")%的早饭」
PRINTFORMW 「ふむ。%CNAME("一人称")%たちが最初か」	PRINTFORMW 「唔姆。%CNAME("一人称")%们是最早的吗？」
PRINTFORMW 「……他の奴らが来る前に、なにかするか？」	PRINTFORMW 「……其他人来之前，有什么打算吗？」
PRINTFORMW 「なんだ、まだ誰も居ないのか……少し暇つぶしでもするかな」	PRINTFORMW 「什么嘛，谁不都在……稍微放松一下吧」
PRINTFORMW 「良い所に来たな。喉が渇いたところだ……茶を淹れてくれ」	PRINTFORMW 「看起来到了一个不错的地方。只要口渴了，就会有茶水端上来。」
PRINTFORML 「良い所に来たな、ちょうど茶を注いだところだ」	PRINTFORML 「请为%CNAME("一人称")%倒一杯茶水」
PRINTFORMW 「ほら、%CNAME("二人称")%\@ COND("同伴可能") ? 達 # \@も飲むといい」	PRINTFORMW 「唔，%CNAME("二人称")%\@ COND("同伴可能") ? 達 # \@们一起喝也没关系哦」
PRINTFORMW 「来たか。待ちかねたぞ」	PRINTFORMW 「来了吗？等很久了」
PRINTFORMW 「戻ったぞ……ふぅ。まったく、疲れた疲れた……っと」	PRINTFORMW 「回来了……呼。真是的，完全累坏了」
PRINTFORMW %CALLNAME:ARG%は独り言をこぼしながらパンツから足を抜き、脱ぎたてのソレを%CALLNAME:MASTER%に手渡してきた。	PRINTFORMW %CALLNAME:ARG%在自言自语的同时将双足从胖次中拔出，把留有体温微湿的胖次递给了%CALLNAME:MASTER%。
PRINTFORMW 「ほら、洗濯籠へ持っていけ。……別に急がなくても良いぞ」	PRINTFORMW 「唔，拿去放洗衣篮子里吧。……可不要突然弄丢了」
PRINTFORMW パンツの温もりに気を取られる%CALLNAME:MASTER%を尻目に、%CALLNAME:ARG%は新しい下着に穿き替えた。	PRINTFORMW 在因为胖次的温暖手感而有些恍惚的%CALLNAME:MASTER%面前，%CALLNAME:ARG%换上了新的内衣。
PRINTFORMW 「ただいま。今日の食事はなんだ？」	PRINTFORMW 「回来了，还不能吃饭吗？」
PRINTFORMW 「おかえり。遅かったじゃないか」	PRINTFORMW 「欢迎回来。没有迟到呢」
PRINTFORMW 「ほう……二人揃っての登場か。仲が良いものだな」	PRINTFORMW 「唔姆…两人一起出现了，关系很好呢」
PRINTFORMW 「フ、相変わらずな奴だな。%CNAME("一人称")%のも見るか？ん？」	PRINTFORMW 「呼，还是没有变呢。想欣赏%CNAME("一人称")%的下面？嗯？」
PRINTFORMW 意地悪そうに微笑んだ%CALLNAME:ARG%は自らのスカートの端を軽く持ち上げ、%CALLNAME:MASTER%をからかってきた。	PRINTFORMW 坏心眼地微笑着，%CALLNAME:ARG%轻轻提起裙子的末端撩拨着%CALLNAME:MASTER%。
PRINTFORMW 「おい。来てやったぞ」	PRINTFORMW 「唔姆。进来了哦」
PRINTFORMW 「それで今日は何をするんだ？」	PRINTFORMW 「那么今天有什么事情吗？」
PRINTFORMW 「おはよう」	PRINTFORMW 「早安」
PRINTFORMW 『おはようございます』	PRINTFORMW 『贵安』
PRINTFORMW 『む……%CNAMET(ARG, CSVNAME_ACTOR)%先生ちょうど良いところに。一つ質問いいですか？』	PRINTFORMW 『唔……%CNAMET(ARG, CSVNAME_ACTOR)%就是老师吧。失礼，能问一个问题吗？』
PRINTFORMW 『ふ。追加でトラックを走らされでもしたか？』	PRINTFORMW 『呼。又多跑了几圈吗？』
PRINTFORMW 『遅かったじゃないか。何かあったか？』	PRINTFORMW 『并没有迟到呢。要做什么吗？』
PRINTFORMW 『待ちかねたぞ。来て早々で悪いが、茶を淹れてくれ』	PRINTFORMW 『久等了。虽然来的有点早，但是茶已经准备完毕了』
PRINTFORMW 『%CNAMET(ARG, CSVNAME_ACTOR)%か。よく来たな』	PRINTFORMW 『是%CNAMET(ARG, CSVNAME_ACTOR)%啊。好好遵守约定过来了呢』
PRINTFORMW 『うむ、おはよう』	PRINTFORMW 『唔姆，早安』
PRINTFORMW 「何だ、もう帰るのか。付き合いの悪い奴だな」	PRINTFORMW 「怎么？已经要回去了？真是个不擅长社交的家伙呢」
PRINTFORMW 「ふむ。今日はもうお開きか……まぁいい、%CNAME("一人称")%はもう少しここで勉強してから帰るとしよう」	PRINTFORMW 「唔姆。今天也不错的一天……嘛，%CNAME("一人称")%再在这里学习一会再回去吧」
PRINTFORMW 「じゃあな」	PRINTFORMW 「回见」
PRINTFORMW 「お昼に下級生と裏庭で一緒の弁当を食べる……か」	PRINTFORMW 「嗯…要一起去低年级的后院里吃便当吗？」
PRINTFORMW 「ふ。改めて顧みると、なかなかこそばゆい事をやってるな」	PRINTFORMW 「呼。现在回想起来，发现这样那样的事情我们都做了呢」
PRINTFORMW %CALLNAME:MASTER%は美人の上級生との二人きりでのお昼を楽しんだ。	PRINTFORMW %CALLNAME:MASTER%跟高年级的美女一起享受了午饭。
PRINTFORMW 「今日はおにぎりにしてみたぞ。どうだ」	PRINTFORMW 「今天的午饭是饭团哦，给」
PRINTFORMW %CALLNAME:ARG%の作ったおにぎりの中に……２個だけ小振りの稲荷寿司が有る	PRINTFORMW %CALLNAME:ARG%做的饭团……只是两个小小的豆皮寿司。
PRINTFORMW 「一人一個づつだからな？」	PRINTFORMW 「一人一个哟」
PRINTFORMW 「ところで、%CNAME("二人称")%はパンとご飯、どっちが好みなんだ？」	PRINTFORMW 「说起来，%CNAME("二人称")%是喜欢面包还是米饭？」
PRINTFORMW 「%CNAME("一人称")%か？%CNAME("一人称")%は美味い方だな」	PRINTFORMW 「%CNAME("一人称")%吗？%CNAME("一人称")%的话只要是美味的东西就没有问题哦。」
PRINTFORMW 「なかなか旨そうに食べるじゃないか……もしかして少なかったか？」	PRINTFORMW 「感觉没有好好地吃饭啊……难道是我做得太少了？」
PRINTFORMW 「ほら、%CNAME("一人称")%のを少し分けてやる。遠慮するな」	PRINTFORMW 「唔姆，%CNAME("一人称")%的那部分分给你一点吧，不要客气」
PRINTFORML 「%CNAME("一人称")%の名は%NAME:TARGET%だ。よろしく頼む」	PRINTFORML 「%CNAME("一人称")%的名字是%NAME:TARGET%。请多关照」
PRINTFORML %CALLNAME:TARGET%は胸を反らし、堂々たる態度で%CALLNAME:MASTER%に挨拶した	PRINTFORML %CALLNAME:TARGET%挺着胸，有些傲慢地跟%CALLNAME:MASTER%打了招呼。
PRINTFORML 「まったく、汗まみれでたまらんな」	PRINTFORML 「满身都是汗啊，受不了」
PRINTFORML 「おい、替えの下着を持ってきてないか？」	PRINTFORML 「喂，没有替换的衣服吗？」
PRINTFORML 「ふぅ……まったく、暑くてかなわん」	PRINTFORML 「唔姆……真的是很热啊」
PRINTFORML 「おい。ボサっとしてないで汗を拭け」	PRINTFORML 「喂。有没有可以擦汗的东西？」
PRINTFORML %CALLNAME:TARGET%は汗の滴る髪を指でつまんで弄っている	PRINTFORML %CALLNAME:TARGET%用手指玩弄着汗湿的头发。
PRINTFORML 「ほう……今日の茶菓子は%TEXTS("おやつ当番")%の手製か」	PRINTFORML 「呼……今天的茶点心是%TEXTS("おやつ当番")%亲手做的呢」
PRINTFORML 「うむ、美味い」	PRINTFORML 「唔姆、好吃」
PRINTFORML %CALLNAME:TARGET%は美味しさに%TEXTR("目を細め/頬を緩め/笑みを浮かべ")%つつ、パクパクと%TEXTS("おやつ")%を食べている	PRINTFORML %CALLNAME:TARGET%%TEXTR("眯起眼睛/放松表情/浮现出笑容")%、啪库啪库地吃着%TEXTS("おやつ")%
PRINTFORML 「ふむ、今日の茶菓子は%TEXTS("おやつ当番")%の手製か」	PRINTFORML 「呼姆、今天的茶点心是%TEXTS("おやつ当番")%做的吗」
PRINTFORML 「見た目はともかく、味の方はなかなかだな。悪くない」	PRINTFORML 「先不论看起来如何、味道还只能算普通吧。总的来说蛮不错」
PRINTFORML 「うん、相変わらずいい味だ。嫁に欲しいな」	PRINTFORML 「嗯、还是没有变化的味道呢。好想嫁给这个家伙呀」
PRINTFORML 「ふむ……前食べた時より腕を上げたか？なかなか美味い」	PRINTFORML 「呼姆……感觉比起上一次做得更好了，蛮好吃的」
PRINTFORML %CALLNAME:TARGET%はウンウンと一人で頷きながら、パクパクと%TEXTS("おやつ")%を食べている	PRINTFORML %CALLNAME:TARGET%一边点着头、一边啪库啪库地吃着%TEXTS("おやつ")%
PRINTFORML %CALLNAME:TARGET%はいかにも眠そうな目つきで床を見つめている……	PRINTFORML %CALLNAME:TARGET%非常困倦无神地看着地板……
PRINTFORML 「%CNAME("二人称")%ともこれからは対等な関係だな。よろしく頼む」	PRINTFORML 「从现在开始起%CNAME("二人称")%与%CNAME("一人称")%就是对等的关系了。以后请多多关照」
PRINTFORML そんな事を言っている割には、%CALLNAME:TARGET%の態度は今まで通り偉そうなままだ……	PRINTFORML %CALLNAME:TARGET%用至今为止最为恭敬的态度说着这样的话……
PRINTFORML 「まぁ、こういうところも含めての私だ。我慢してくれ」	PRINTFORML 「嘛，从此以后%CNAME("一人称")%将一直跟随在%CNAME("二人称")%的身边。忍一忍吧」
PRINTFORML 「別に%CNAME("一人称")%は先程の部屋でも構わなかったのだがな」	PRINTFORML 「怎么%CNAME("一人称")%在之前的房间里面呆着不好吗？」
PRINTFORML 「で、なにをして楽しませてくれるんだ？」	PRINTFORML 「那么，要做什么事情来取悦%CNAME("一人称")%嘛？」
PRINTFORML %CALLNAME:TARGET%はベッドの端に腰かけて、足をブラブラさせつつ%CALLNAME:MASTER%を上目遣いで見上げた	PRINTFORML %CALLNAME:TARGET%端坐在床边，一边晃荡着脚，以一种可爱的眼神仰视着%CALLNAME:MASTER%。
PRINTFORML 「何を突っ立っている」	PRINTFORML 「怎么了？这么突然？」
PRINTFORML 「わざわざ場所を変えたんだ。%CNAME("一人称")%としたい事が有るのだろう？」	PRINTFORML 「特意要换个地方。肯定又有无论如何都想要%CNAME("一人称")%做的事情吧？」
PRINTFORML %CALLNAME:TARGET%は不敵な笑みを浮かべて%CALLNAME:MASTER%を見つめている……	PRINTFORML %CALLNAME:TARGET%露出了妖媚的笑容看向%CALLNAME:MASTER%……
PRINTFORML 「どうした？ ……ああ、この格好が気になるのか」	PRINTFORML 「怎么样？ ……嗯嗯，很钟意这件」
PRINTFORML 「スカートが皺になるのが嫌なのでな。あんまりジロジロ見るなよ？」	PRINTFORML 「裙子起皱了话就会变得很讨厌的，所以请不要盯着看哦？」
PRINTFORML 釘をさしてきた%CALLNAME:TARGET%だったが、本当に何とも思ってないようで態度は普段のままだ	PRINTFORML %CALLNAME:TARGET%似乎真的什么奇怪的想法都没有，如同往常一样相处着。
PRINTFORML 「ほら、突っ立ってないで炬燵にでも入れ。ミカンもあるぞ」	PRINTFORML 「嗯嗯，赶快到被炉里面去。还有橘子吗?」
PRINTFORML %CALLNAME:MASTER%は断る理由も無いのでコタツに入ってみかんを剥き始めた	PRINTFORML %CALLNAME:MASTER%没有拒绝的理由，只好乖乖地去厨房剥桔子。
PRINTFORML 「ど、どうした。他の奴らの相手は、もういいのか？」	PRINTFORML 「怎、怎么样？其他的怎么样？都可以吗？」
PRINTFORML %CALLNAME:TARGET%は赤い顔で汗をかき、珍しく狼狽している……	PRINTFORML %CALLNAME:TARGET%红着脸冒着蒸汽，表现出少见的狼狈样子……
PRINTFORML 「そのぐらいにしておけ」	PRINTFORML 「这样就行了吧」
PRINTFORML %CALLNAME:TARGET%は声色から見るに怒りはしていないようだが、%CALLNAME:MASTER%に釘を刺してきた	PRINTFORML %CALLNAME:TARGET%看起来非常生气，用刀剑一般锐利的眼神刺穿了%CALLNAME:MASTER%。
PRINTFORML 「夢中だったから少し大目に見てやったが、頭を下げてまで覗くのはやり過ぎだな」	PRINTFORML 「做梦的话就赶紧清醒一点，特意低下头去看裙子下面太过分了」
PRINTFORML 「む……？あぁ」	PRINTFORML 「姆……？啊啊」
PRINTFORML 「ここが気になるのか？うん？」	PRINTFORML 「这样的话你会觉得高兴吗？嗯？」
PRINTFORML 見られていた事に気づいた%CALLNAME:TARGET%はスカートの端を摘まみ上げ、%CALLNAME:MASTER%を挑発してきた	PRINTFORML 注意到被仔细欣赏着，%CALLNAME:TARGET%把裙子末端稍稍提起，挑逗着%CALLNAME:MASTER%。
PRINTFORML 「ん、どうかしたか？」	PRINTFORML 「嗯、你怎么看？」
PRINTFORML 「何でもないという割には様子がおかしいぞ」	PRINTFORML 「什么都没有的感觉好奇怪…」
PRINTFORML %CALLNAME:MASTER%の視線に気づいた%CALLNAME:TARGET%だったが、パンチラした事には気づいていない様だ	PRINTFORML %CALLNAME:TARGET%很在意%CALLNAME:MASTER%的视线，但是似乎没有注意到正在被偷窥裙底的样子。
PRINTFORML 「まったく……見たいのなら見たいと素直に言え」	PRINTFORML 「真是的……想看的话就坦率地好好讲出来啊」
PRINTFORML 「見せるのと見られる事の違いを知らんようだな、%CNAME("二人称")%は」	PRINTFORML 「%CNAME("二人称")%啊，不知道给%CNAME("二人称")%看和被看之间的区别吗？」
PRINTFORML %CALLNAME:TARGET%は不快さを露わにして%CALLNAME:MASTER%を諭した	PRINTFORML %CALLNAME:TARGET%因为被%CALLNAME:MASTER%强制露出视奸着而感到有些不愉快。
PRINTFORML 「さて、それじゃあさっそく……するか？」	PRINTFORML 「那么、要马上……来做吗？」
PRINTFORML ベッドに腰かけた%CALLNAME:TARGET%は、僅かにめくったスカートから%CLOCOLOR(CSTR:パンツ, "形容詞")%パンツをチラ見せしながらニヤリと笑った	PRINTFORML 坐到床上的%CALLNAME:TARGET%、微微拉起裙子、把%CLOCOLOR(CSTR:パンツ, "形容詞")%的胖次露出来的同时妖艳地笑着
PRINTFORML %CALLNAME:TARGET%はベッドに腰かけ、足をブラブラさせつつ%CALLNAME:MASTER%を上目遣いで見上げた	PRINTFORML %CALLNAME:TARGET%坐到床上、不断改变两腿的姿势、可爱地向上看着%CALLNAME:MASTER%
PRINTFORML 「それにしてもこの水筒はバカでかいな」	PRINTFORML 「说起来这个水壶只有笨蛋才会买呢」
PRINTFORML %CALLNAME:TARGET%はお茶を飲みながら興味深そうにウォータージャグを眺めている	PRINTFORML %CALLNAME:TARGET%一边喝茶，一边意味深长地看着那个印着幼稚图案的水壶。
PRINTFORML 「ふっ、%CNAME("二人称")%は分かりやすくて良いな」	PRINTFORML 「呼，%CNAME("二人称")%真是个很好理解的家伙呢」
PRINTFORML 「その正直さ……大切にするがいい」	PRINTFORML 「那份诚实……也是很重要的东西呢」
PRINTFORML 珍しくミニスカ姿な%CALLNAME:TARGET%は、普段は見えない太もも付近をチラ見している%CALLNAME:MASTER%を褒めた	PRINTFORML 少见地穿着迷你裙的%CALLNAME:TARGET%，对直勾勾盯着女孩子大腿的%CALLNAME:MASTER%表示赞赏。
PRINTFORML 「耳や尻尾が無い……だと？」	PRINTFORML 「耳朵和尾巴都没有……觉得奇怪吗？」
PRINTFORML 「ふん。隠しているのさ。尻尾が生えた人間なんて居ないからな」	PRINTFORML 「呵，其实是隐藏起来了。有尾巴的话就很难跟人类相处吧」
PRINTFORML %CALLNAME:TARGET%には、やはり尻尾が有るらしい	PRINTFORML 看来%CALLNAME:TARGET%还是有尾巴的。
PRINTFORML 「ん？これか？これはまぁ……なんだ。家業の手伝いみたいなものかな」	PRINTFORML 「嗯？这个？这个是……嗯，怎么说比较好。想要帮忙处理家事而已。」
PRINTFORML 油性ペンで紙に文字を書いているのは遊びではなく仕事の一環らしい	PRINTFORML 用油性笔在纸上写着文字，似乎不是在玩而是工作的一环
PRINTFORML 「昔は丈夫な和紙に墨と筆で書いていたらしいがな。便利な世の中になったものだ」	PRINTFORML 「以前是用墨笔写在结实的和纸上的，在便利的现世里文书工具变成了这样的东西啊」
PRINTFORML 「挨拶が無いぞ」	PRINTFORML 「没有打招呼哦」
PRINTFORML 「"おはようございます"はどうした？」	PRINTFORML 「“贵安”，这样试着打招呼如何？」
PRINTFORML 「うん？」	PRINTFORML 「咦？」
PRINTFORML 「どうした……%CNAME("一人称")%に遊んで欲しくでもなったか？」	PRINTFORML 「怎么了？……想和%CNAME("一人称")%一起玩吗？」
PRINTFORML %CALLNAME:TARGET%は作業を中断して%CALLNAME:MASTER%を見つめてきた	PRINTFORML %CALLNAME:TARGET%停止了工作，盯着%CALLNAME:MASTER%。
PRINTFORML 「他の奴らの相手はもういいのか？」	PRINTFORML 「其他人都没时间吗？」
PRINTFORML 「それじゃ……遊んでやるとするかな」	PRINTFORML 「那么……要一起玩吗」
PRINTFORML %CALLNAME:TARGET%は嬉しそうにニコリと笑った	PRINTFORML %CALLNAME:TARGET%开心地轻笑着。
%TEXTR(@"%TEXTS("おやつ")%を口に運びつつ/%TEXTS("おやつ")%をつまみながら/リラックスした様子で%TEXTS("おやつ")%を食べつつ")%	%TEXTR(@"一边往嘴里塞%TEXTS("おやつ")%/一边抓起一块%TEXTS("おやつ")%/一边非常放松地吃%TEXTS("おやつ")%")%
%TEXTR("時折お茶を口に運びつつ/お茶菓子をつまみながら/リラックスした様子でお茶を飲みつつ")%	%TEXTR("时不时把茶往嘴边送/一边捏着茶点心/放松地喝着茶")%
%TEXTR("黙々と/没頭した様子で/真剣な眼差しで/やる気なさそうに/如何にも暇つぶしといった様子で/無言で")%	%TEXTR("沉默地/全神贯注地/认真地/没什么干劲地/非常无聊的样子/无言地")%
PRINTFORML %TEXTR("雑誌を読んで/参考書を読んで/携帯ゲーム機で遊んで/スマホを弄って/油性ペンでお札に文字を書いて/教科書を読み込んで/予習をして")%いる	PRINTFORML %TEXTR("读着杂志/读着参考书/玩着掌机/摆弄着手机/用油性笔在纸札上写着什么/读着教科书/做着预习")%
%TEXTR(@"%CALLNAME:MASTER%に股間を観察させつつ/股間に刺さる%CALLNAME:MASTER%の視線など何処吹く風な様子で/軽く脚を開いたままの体勢で")%	%TEXTR(@"一边让%CALLNAME:MASTER%观察了自己的股间/故意装作没有察觉到%CALLNAME:MASTER%刺向股间的视线一样/换成了轻轻地打开双腿的姿势")%
%TEXT_DAILY_K2%いる	%TEXT_DAILY_K2%
PRINTFORMW （……アイツにやらせるのも面白いかもしれんな）	PRINTFORMW （……让那家伙来做的话说不定也挺有意思的）
PRINTFORML 「今は忙しい…………後に……しろ」	PRINTFORML 「现在很忙…………等等……」
PRINTFORML 「zzz……あと三十枚……うぅ～ん…………」	PRINTFORML 「zzz……还有30枚……呜嗯…………」
PRINTFORML 「いつか……もっと力を…………」	PRINTFORML 「什么时候……更多的力量…………」
PRINTFORML 「ばか…………そんなこと当然だ」	PRINTFORML 「笨蛋…………那不是当然的吗……」
PRINTFORMW 『……すぐ行く。待っていろ』	PRINTFORMW 『……马上就过去。等一下哦』
PRINTFORMW 『まぁいいが……代金は%CNAME("二人称")%持ちだからな』	PRINTFORMW 『嘛、可以吧……反正是%CNAME("二人称")%出钱』
PRINTFORML 『何かと思ったら……%CNAME("二人称")%は本当に我慢というものを知らんな』	PRINTFORML 『还以为有什么事情呢……%CNAME("二人称")%真的不知道什么是忍耐吗』
PRINTFORMW 『まぁいい。今日はそこでだな』	PRINTFORMW 『嘛好吧。今天就在那里做吧』
PRINTFORMW ゴシゴシゴシゴシ。	PRINTFORMW 咕叽咕叽咕叽咕叽。
PRINTFORMW 「あ～……いいぞ、そうそう、そこだ。 上手いじゃないか……♪」	PRINTFORMW 「啊～……很好、那里那里、就是那里。 这不是做得很好嘛……♪」
PRINTFORMW 風呂椅子に腰を下ろした%CALLNAME:TARGET%は、ご主人様の特権を持ち出して%CALLNAME:MASTER%に背中を洗わせてご満悦な様子だ	PRINTFORMW 坐在浴椅上的%CALLNAME:TARGET%、拿出了作为主人的特权命令%CALLNAME:MASTER%帮忙洗背、看起来很开心的样子
PRINTFORMW 「ん……よし、もういいぞ一回流せ。%CNAME("二人称")%と一緒に入ると本当に楽で良いな」	PRINTFORMW 「嗯……好、再冲一次。能%CNAME("二人称")%一起洗澡真的是太好了」
PRINTFORMW %CALLNAME:TARGET%は目を細めて嬉しそうに微笑みながら立ち上がり、風呂の縁に座って%CALLNAME:MASTER%に向き合った	PRINTFORMW %CALLNAME:TARGET%眯起眼睛微笑着站了起来、坐在浴池的边缘上转过身面向%CALLNAME:MASTER%
PRINTFORMW 「さ、背中は終わったし次はこっちだ……中を洗う時にはボディソープは使うんじゃないぞ？」	PRINTFORMW 「嗯、背洗完了的话接下来就是这里……洗里面的时候记得不要用沐浴露哦？」
PRINTFORMW そして、脚を軽く開いて次に洗う場所を指示しながら微笑みかけて来た……	PRINTFORMW 之后、把脚轻轻地张开微笑着指示了接下来要洗的地方……
PRINTFORMW ゴシゴシゴシ。	PRINTFORMW 咕叽咕叽咕叽。
PRINTFORMW どういう風の吹き回しか、今夜は%CALLNAME:TARGET%が%CALLNAME:MASTER%の背中を洗ってくれている……	PRINTFORMW 不知道怎么回事、今晚是%CALLNAME:TARGET%为%CALLNAME:MASTER%洗背……
PRINTFORMW 「どうだ、上手いものだろう？洗って欲しいところがあるなら遠慮なく言うがいい」	PRINTFORMW 「怎么样、很舒服吧？如果有想要洗的地方、请不要犹豫地说出来哦」
CALL PRINT_SELECT, "このまま続けてもらう/お言葉に甘えてちんこも洗って欲しいと言ってみる"	CALL PRINT_SELECT, "就这样继续/那就承蒙您的好意、能麻烦洗一下肉棒吗"
PRINTFORMW ゴシゴシゴシ……	PRINTFORMW 咕叽咕叽咕叽……
PRINTFORMW 「ふふふ、なかなか良い仕上がりだな。見ろ、スベスベになったぞ……って背中だから見えないか」	PRINTFORMW 「呼呼呼、看起来成果很不错的样子呐。看、这么光滑……啊在背后看不到吗」
PRINTFORMW %CALLNAME:TARGET%はくすくす笑いながら自画自賛し、%CALLNAME:MASTER%の背中にザバーとお湯をかけ泡を流した	PRINTFORMW %CALLNAME:TARGET%一边笑着一边夸赞着自己的成果、用热水冲走了黏在%CALLNAME:MASTER%的泡沫
PRINTFORMW 「さてそれじゃ交代と行こうか……%CNAME("二人称")%の背中に負けないよう、しっかり磨くようにな？」	PRINTFORMW 「那么来交换吧……为了要对得起私在%CNAME("二人称")%的背上的努力、要好好地洗哦？」
PRINTFORMW %CALLNAME:TARGET%は、風呂椅子に腰を下ろしている%CALLNAME:MASTER%に後ろから抱きつきながらニヤリと笑った……	PRINTFORMW %CALLNAME:TARGET%、从后面抱住了坐在浴椅上的%CALLNAME:MASTER%狡黠地笑着……
PRINTFORMW 「ぷっ！くくっ、想像はしていたが……アハハ、まさかっ、本当に口に出すとはな！」	PRINTFORMW 「噗！呼呼、虽然只是想想……啊哈哈、没想到、真的说出来了啊！」
PRINTFORMW 「%CNAME("二人称")%は本当に面白い奴だな……ふふっ、いいだろう……一回流すぞ？」	PRINTFORMW 「%CNAME("二人称")%真的是很有趣的孩子呐……呼呼、可以哦……再来洗一次吧？」
PRINTFORMW お互いの泡を洗い流した%CALLNAME:TARGET%は%CALLNAME:MASTER%を風呂の縁に座らせ、股間で隆起しているモノを楽しそうに口にしてきた	PRINTFORMW 冲掉了两人身上的泡沫之后、%CALLNAME:TARGET%让%CALLNAME:MASTER%坐到浴缸的边缘、看起来很高兴地将股间翘起来的硬物用嘴含住了
PRINTFORMW 「んむ……らすときは……ぷぁ……出すときは、%CNAME("一人称")%の口の中だぞ？」	PRINTFORMW 「嗯姆……要粗来的时候……噗啊……要出来的时候、就请在%CNAME("一人称")%的嘴里射出来哦？」
PRINTFORMW 「風呂場を無駄に汚す\@ FIND_COND("フェリシエル") ? とフェリシエルが良い顔しないからな # のは望ましくないからな \@……んぐ……」	PRINTFORMW 「把浴室弄脏了、\@ FIND_COND("フェリシエル") ? 弗理希艾尔会不高兴的 # 私可不希望那样呢 \@……嗯咕……」
PRINTFORMW 注意事項を伝えた%CALLNAME:TARGET%は%CALLNAME:MASTER%の太ももに手をついて体重を預けると、腕立てをするような動作で頭を前後させながら口でペニスを洗いはじめた……	PRINTFORMW 传达完了注意事项的%CALLNAME:TARGET%按住%CALLNAME:MASTER%的大腿把体重压了上去、用手支撑着身体前后摆动着头开始用嘴仔细地清洗阴茎……
PRINTFORMW 「んぐっ……ん、む……ゴクン。……よし、これで綺麗になったな」	PRINTFORMW 「嗯咕……嗯、姆……咕噜。……好、这样子就洗干净了」
PRINTFORMW 「ふぅ……なかなか良いものだな、二人で入る風呂というのも」	PRINTFORMW 「呼……感觉很不错呐、两个人一起入浴」
PRINTFORMW 「ところで、今日のアレだがな……」	PRINTFORMW 「说起来、今天那个……」
PRINTFORMW %CALLNAME:TARGET%は浴槽内で%CALLNAME:MASTER%に寄りかかりながらダラダラと雑談をし始めた……	PRINTFORMW %CALLNAME:TARGET%在浴缸里靠在%CALLNAME:MASTER%的身上开始了雑談……
PRINTFORML 「暇そうじゃないか。ちょっと付き合え」	PRINTFORML 「方便吗？稍微陪我一下。」
PRINTFORML 「ん？なんだ、%CNAME("二人称")%も今帰るところか」	PRINTFORML 「嗯？怎么，%CNAME("二人称")%现在就要回去了吗」
PRINTFORMW 「この店は相変わらず美味いな。餡子の格が違う」	PRINTFORMW 「这家店还是一如既往地美味。特别是点心里面的馅」
PRINTFORML 「きんつばは食べやすいのは良いのだが、もう少し食感が欲しいと思わんか？」	PRINTFORML 「金锷饼很好吃，你不想再吃一点吗？」
PRINTFORMW 「周りの皮がもっとカリッとしてたらいいと思うのだがな……」	PRINTFORMW 「如果周围的皮能结实一点就好了…………」
PRINTFORMW 「ここの栗最中が美味いのだ……%CNAME("二人称")%にも一つ奢ってやろう。ほら」	PRINTFORMW 「这里的炒栗子很好吃……%CNAME("二人称")%想吃吃看吗？」
PRINTFORML 「ふむ、なかなか美味いな……%CNAME("二人称")%のも一口よこすがいい」	PRINTFORML 「唔姆，很好吃……给%CNAME("二人称")%吃一口也可以哦」
PRINTFORMW 「もちろん%CNAME("一人称")%のも少しやろう。ほら、早くしろ」	PRINTFORMW 「当然%CNAME("一人称")%的只有一点点哦。快点吃吧」
PRINTFORMW 「あまり食い過ぎないようにな。食事を作ってくれる相手への感謝を忘れるな」	PRINTFORMW 「稍微有点吃得太饱。忘记向做饭的人表达感谢了」
PRINTFORML 「なかなか悪くないな……%CNAME("二人称")%はどう思う？くくっ」	PRINTFORML 「感觉都不错啊……%CNAME("二人称")%怎么想？呼呼」
PRINTFORMW %CALLNAME:TARGET%は%SKIRT(TARGET, "略")%を軽くたくし上げ、試着した紐ビキニを%CALLNAME:MASTER%に楽しそうに見せつけている。	PRINTFORMW %CALLNAME:TARGET%把%SKIRT(TARGET, "略")%轻轻地拿出来，试着穿上比基尼给%CALLNAME:MASTER%欣赏一番。
PRINTFORML 「さて、今年はどういうものにしたものかな……%CNAME("二人称")%はどれが良いと思う？」	PRINTFORML 「那么，今年要选什么好呢……%CNAME("二人称")%怎么想？」
PRINTFORMW 「煩悩丸出しの物でないなら、今ここで試着してやらんでもないぞ」	PRINTFORMW 「如果不是值得烦恼的东西，也就不用现在在这里试穿了。」
PRINTFORML 「どんなのを買うかだと？ふ、勿論こういうやつだ」	PRINTFORML 「买怎么样的内衣比较好呢？呵，当然还是这样的比较好呢」
PRINTFORMW %CALLNAME:TARGET%は%SKIRT(TARGET, "略")%を指でつまみ上げて、%CALLNAME:MASTER%だけに紐パンツの横紐を見せてきた。	PRINTFORMW %CALLNAME:TARGET%把%SKIRT(TARGET, "略")%拿了下来，只给%CALLNAME:MASTER%看了穿着系绳胖次的样子。
PRINTFORML 「ふ。%CNAME("二人称")%一人では、こういう場所には入りづらいだろう？感謝するがいい」	PRINTFORML 「呼。%CNAME("二人称")%一个人的话，这样的地方肯定不敢进来把？不感谢%CNAME("一人称")%吗？」
PRINTFORMW %CALLNAME:TARGET%は軽口を叩きながら%CALLNAME:MASTER%を従えての買い物を楽しんでいるようだ	PRINTFORMW %CALLNAME:TARGET%轻轻地掩住小嘴，很开心地和%CALLNAME:MASTER%一起购物。
PRINTFORML 「ふ～む……ん？どうした？%CNAME("二人称")%もやりたいのか？」	PRINTFORML 「唔~姆~……嗯？怎么了？%CNAME("二人称")%也想试试吗？」
PRINTFORMW %CALLNAME:TARGET%はパンツを穿いたトルソーの股間や尻を撫でまわして生地の肌触りを確かめている……	PRINTFORMW %CALLNAME:TARGET%穿上了胖次，对着镜子抚摸着股间和臀部，用肌肤感受着胖次的材质……
PRINTFORML 「ところで%CNAME("二人称")%はどういうのが好きなんだ？参考にしてやってもいいぞ」	PRINTFORML 「说起来%CNAME("二人称")%喜欢什么样子的内衣呢？说出来参考一下吧」
PRINTFORMW %CALLNAME:TARGET%は、他に人がいる店内では答えづらい質問を%CALLNAME:MASTER%にしながらパンツを物色している……	PRINTFORMW 在人来人往的店里%CALLNAME:TARGET%一边大方地询问%CALLNAME:MASTER%令人羞耻的问题，一边寻找着合适的内衣……
PRINTFORMW 「%GREETING%。……%CNAME("二人称")%、もしかして帰国子女か？」	PRINTFORMW 「%GREETING%。……%CNAME("二人称")%、难不成，你是归国子弟吗？」
PRINTFORMW 「いやなに、そう長生きしてる訳でもない%CNAME("一人称")%だが、こういう挨拶をされた事は無かったのでな」	PRINTFORMW 「啊呀，虽然%CNAME("一人称")%没有活了那么长时间，但也没有见过这样打招呼的方式呢」
PRINTFORMW 「ばか、やめろ……%CNAME("一人称")%に抱きつきたい気持ちは分かったが、せめて汗を拭いてからだ」	PRINTFORMW 「笨蛋、住手啊……%CNAME("一人称")%明白你想抱住%CNAME("一人称")%的心情，但至少先擦汗呀」
PRINTFORMW 「うむ、%GREETING%」	PRINTFORMW 「唔姆，%GREETING%」
PRINTFORMW %CALLNAME:TARGET%は軽く抱きつき返し、%CALLNAME:MASTER%の頭を撫でた。	PRINTFORMW %CALLNAME:TARGET%轻轻地回抱，抚摸着%CALLNAME:MASTER%的头。
PRINTFORMW 「んっ……。まるで恋人みたいだな」	PRINTFORMW 「啾……这样子就像恋人一样呢」
PRINTFORMW 「って、そういえばそうだったか。ははは」	PRINTFORMW 「啾，这样做才对嘛。嘿嘿」
PRINTFORMW %CALLNAME:TARGET%は真っ赤になって、照れ隠しに笑った。	PRINTFORMW %CALLNAME:TARGET%满脸通红，害羞地笑了。
PRINTFORMW %CALLNAME:TARGET%は%CALLNAME:MASTER%の顔を覗き込み、同じ場所にキスを返してきた。	PRINTFORMW %CALLNAME:TARGET%盯着%CALLNAME:MASTER%的脸，在同样的位置亲了回去。
PRINTFORMW 「ほう……%CNAME("二人称")%、なかなか見どころある奴だな」	PRINTFORMW 「嗯……%CNAME("二人称")%意外的是个很有趣的家伙啊」
PRINTFORMW 「今までされた挨拶の中で、面白さだけなら一番だ。褒めてやろう」	PRINTFORMW 「至今为止见过的打招呼中，这是最为有趣的。表扬一下吧」
PRINTFORMW %CALLNAME:TARGET%は愉快でたまらないといった様子で、%CALLNAME:MASTER%の頭を撫で返してきた。	PRINTFORMW %CALLNAME:TARGET%愉快地接受了侍奉，轻轻抚摸着%CALLNAME:MASTER%的头表示赞赏。
PRINTFORMW 「ふふ、変態の%CNAME("二人称")%にはそれでは物足りんだろう？」	PRINTFORMW 「呼呼，对于%CNAME("二人称")%这种变态来说，这样子还不够吧？」
PRINTFORMW %CALLNAME:TARGET%は股布をずらして\@ PENIS(TARGET) ? ペニス # アソコ \@を%CALLNAME:MASTER%に見えるように露出した。	PRINTFORMW %CALLNAME:TARGET%把胖次拉开，对着%CALLNAME:MASTER%露出了\@ PENIS(TARGET) ? 阴茎 # 阴部 \@。
PRINTFORMW 「ほら。特別に直でさせてやる……%CNAME("一人称")%に感謝しながら、犬のように舐めしゃぶれ」	PRINTFORMW 「嗯哼~直接就这样舔吧……对%CNAME("一人称")%表示感谢的同时，要像忠诚的狗狗一样prpr地舔哦」
PRINTFORMW 「よしよし。可愛い奴だな……%CNAME("二人称")%は」	PRINTFORMW 「好孩子好孩子。%CNAME("二人称")%啊……真的是很可爱呢」
PRINTFORMW %CALLNAME:TARGET%は股布をずらして\@ PENIS(TARGET) ? ペニス # アソコ \@を露出させ、%CALLNAME:MASTER%に舌での奉仕を許可した。	PRINTFORMW %CALLNAME:TARGET%把胖次拉开露出了\@ PENIS(TARGET) ? 阴茎 # 阴部 \@，允许了%CALLNAME:MASTER%用舌头进行侍奉。
PRINTFORMW 「そうだ、なかなか上手いぞ……ふふっ」	PRINTFORMW 「对了，你很擅长这个吧……呼呼」
PRINTFORMW %CALLNAME:TARGET%は上気した様子で微笑みながら、%CALLNAME:MASTER%の頬を優しく撫でている……	PRINTFORMW %CALLNAME:TARGET%兴奋地微笑着，温柔抚摸着%CALLNAME:MASTER%的脸……
PRINTFORMW 「ふっ、余程%CNAME("一人称")%のココの匂いがお気に召したようだな」	PRINTFORMW 「呼，被身为前辈的%CNAME("一人称")%那里的气味吸引过来了吗？」
PRINTFORMW 「……臭いだと？」	PRINTFORMW 「……觉得臭吗？」
PRINTFORMW 「そんな無礼な事を言うのはこの口か？ん？」	PRINTFORMW 「怎么能说这样失礼的话呢？嗯？」
PRINTFORMW %CALLNAME:TARGET%は僅かな羞恥を顔に出しつつ、%CALLNAME:MASTER%のほっぺたを捻りあげた	PRINTFORMW %CALLNAME:TARGET%带着害羞的表情，狠狠地揉搓%CALLNAME:MASTER%的脸。
PRINTFORMW 「よしよし。きちんと挨拶できたな、えらいぞ」	PRINTFORMW 「真乖真乖。好好地打招呼了呢，好孩子」
PRINTFORMW %CALLNAME:TARGET%は優しい声音で褒め言葉を口にしながら%CALLNAME:MASTER%の頭を撫でた。	PRINTFORMW %CALLNAME:TARGET%用温柔的声音进行表扬的同时抚摸着%CALLNAME:MASTER%。
PRINTFORMW 「ああ、%GREETING%。今日は何をするんだ？」	PRINTFORMW 「啊啊，%GREETING%。今天要做什么呢？」
PRINTFORMW 「ん……少し寝てたか。ふぁ～～あ～～……」	PRINTFORMW 「唔……再睡一会。哈～～啊～～……」
PRINTFORMW %CALLNAME:TARGET%はしなやかに体を反らせて、欠伸とともに伸びをした	PRINTFORMW %CALLNAME:TARGET%翻了个身，慵懒地伸了一个懒腰。
PRINTFORMW 「ふっ、まぁ当然のことだな」	PRINTFORMW 「唔姆，那是理所当然的吧」
PRINTFORMW %CALLNAME:TARGET%は……嬉しそうだ。	PRINTFORMW %CALLNAME:TARGET%……看起来很高兴的样子。
PRINTFORMW もしかして褒められるのに弱い……？	PRINTFORMW 难不成赞美还是太少了吗……？
PRINTFORMW 「くく、%CNAME("二人称")%はなかなかその気にさせるのが上手いな」	PRINTFORMW 「哼哼，%CNAME("二人称")%很懂嘛」
PRINTFORMW %CALLNAME:TARGET%は身を乗り出して%CALLNAME:MASTER%の褒め口上に耳を傾けている……	PRINTFORMW %CALLNAME:TARGET%向前探出身子，仔细倾听着%CALLNAME:MASTER%的赞美……
PRINTFORMW 「なに、%CNAME("一人称")%もまだまだだ……歩みを止めるつもりもないがな」	PRINTFORMW 「嗯，%CNAME("一人称")%还差得远呢……现在可不会停下来的」
PRINTFORMW 謙遜する%CALLNAME:TARGET%だが、その態度からは自信が溢れだしている	PRINTFORMW 强装谦逊说着话的%CALLNAME:TARGET%，言语之中强烈的自信溢了出来。
PRINTFORMW 「そうだろう、そうだろう！」	PRINTFORMW 「就是啊，嗯嗯！」
PRINTFORMW 「なかなか分かっているではないか」	PRINTFORMW 「这不是很懂嘛！」
PRINTFORMW 「……うん」	PRINTFORMW 「……唔」
PRINTFORMW 「%CNAME("一人称")%？%CNAME("一人称")%の気持ちは…………くそ、鈍い奴だなっ」	PRINTFORMW 「%CNAME("一人称")%？%CNAME("一人称")%的心情…………笨蛋……」
PRINTFORMW %CALLNAME:TARGET%は赤い顔で%CALLNAME:MASTER%の唇を奪ってきた。	PRINTFORMW %CALLNAME:TARGET%红着脸，直接夺取了%CALLNAME:MASTER%的嘴唇。
PRINTFORMW 「%CNAME("二人称")%……よくそんな恥ずかしいこと言えるな」	PRINTFORMW 「%CNAME("二人称")%……竟然说出了这样羞耻的话」
PRINTFORMW 「ああいや、勘違いするな、別に馬鹿にしてる訳じゃあないんだ」	PRINTFORMW 「啊啊……别误会了，我并没有把你当作笨蛋看待。」
PRINTFORMW %CALLNAME:TARGET%は口元が緩むのを隠すように早口で喋っている	PRINTFORMW %CALLNAME:TARGET%用手遮住不自觉向上挑起的嘴唇。
PRINTFORMW 「ふ。気づいてないのか？」	PRINTFORMW 「呼。还没有发现吗？」
PRINTFORMW 「今%CNAME("二人称")%が口にしたの、他の女相手にも使っていた文句だぞ」	PRINTFORMW 「现在%CNAME("二人称")%说的这些对其他的女孩子也说过吧，花心的家伙」
PRINTFORMW 「よくそうペラペラと口説き文句が出てくるものだな。感心するよ」	PRINTFORMW 「总能流畅地说出这些奉承的话呢。真是不得了的家伙」
PRINTFORMW 「なに？今穿いてるパンツの色だ？」	PRINTFORMW 「嗯？今天穿的胖次的颜色？」
PRINTFORMW 「……あまり冗談ばかり言わないようにな」	PRINTFORMW 「……请不要老是开这种无聊的玩笑」
PRINTFORMW 「妖狐が出来る事？まぁ……長い付き合いになれば見せる事もあるだろう、とだけ言っておこう」	PRINTFORMW 「妖狐可以做到的事情？まぁ……交往了这么长时间，给%CNAME("二人称")%看看也没有关系」
PRINTFORMW 「小腹が空いてきたな。おい、そこの戸棚に何か入ったりしてないか？」	PRINTFORMW 「肚子饿了。喂，那边的柜子里面有放什么东西吗？」
PRINTFORMW 「%CNAME("二人称")%、数学得意か？もしそうならここ教えてくれ」	PRINTFORMW 「%CNAME("二人称")%，擅长数学吗？可以的话请教教%CNAME("一人称")%。」
PRINTFORMW 「汗まみれでたまらんな、まったく」	PRINTFORMW 「不停地在出汗啊，真是的」
PRINTFORMW 「体育の後に水泳をさせたら良いと思わんか？なぁ？」	PRINTFORMW 「在运动之后去游泳的话可能好一些？呐？」
PRINTFORMW 「よしよし上手いぞ……ほら、背中もだ。服の中に手を入れて構わんぞ」	PRINTFORMW 「好啦好啦……你看，背上也是都是汗水。%CNAME("二人称")%把手伸进衣服里去擦一下吧」
PRINTFORMW %CALLNAME:TARGET%は目を細めて気持ちよさそうにしている……	PRINTFORMW %CALLNAME:TARGET%眯起眼睛。看起来很舒服的样子……
PRINTFORML 「%TEXTR("……ふーっ……生き返るようだ/♪～～♪～～～/あの教師め……生徒がみな運動部員だと勘違いでもしてるんじゃないだろうな、全く")%」	PRINTFORML 「%TEXTR("……呼—……活过来了/♪～～♪～～～/那个老师……他是不是以为所有的学生都是运动员啊?")%」
PRINTFORMW 「む。良い所に居るじゃないか」	PRINTFORMW 「姆。你住的这里真是个好地方呢」
PRINTFORMW %CALLNAME:MASTER%を見つけた%CALLNAME:TARGET%は口元を綻ばせた。	PRINTFORMW 留意到%CALLNAME:MASTER%的%CALLNAME:TARGET%嘴角绽开了一抹微笑。
PRINTFORMW 「今から髪の手入れをするところだ……手伝わせてやろう。なに、%CNAME("一人称")%の言う通りにすればいい」	PRINTFORMW 「现在正要整理头发……就让你来帮忙吧。怎么，按照%CNAME("一人称")%说的做就行」
PRINTFORMW %CALLNAME:TARGET%は椅子を動かして%CALLNAME:MASTER%の横に座り、水分を含んだ艶やかな長い黒髪を差し出してきた…	PRINTFORMW %CALLNAME:TARGET%移动椅子坐在%CALLNAME:MASTER%的边上，把湿漉漉闪着光的妖艳黑发交给了%CALLNAME:MASTER%…
PRINTFORMW 「ん？なんだ、\@ PLACE("自宅") ? 戻って # 来て \@いたのか」	PRINTFORMW 「嗯？怎么，\@ PLACE("自宅") ? 戻って # 来て \@？」
PRINTFORMW 「黙って待ってるとは%CNAME("二人称")%らしくもない……なにか有ったか？」	PRINTFORMW 「就这样安静地坐着一点都不像%CNAME("二人称")%呢……有什么事情吗？」
PRINTFORMW %CALLNAME:TARGET%は火照った体を手で扇いで冷ましつつ、湯上りの匂いをさせて%CALLNAME:MASTER%に近づいてきた…	PRINTFORMW %CALLNAME:TARGET%用手扇着风试图让发热的身体冷却下来，蒸发的体香向%CALLNAME:MASTER%飘来…
PRINTFORMW 「ま、まぁ、たまにはこういう遊びに付き合うのも面白そうだと思ってな」	PRINTFORMW 「嘛、嘛~，偶尔陪%CNAME("二人称")%玩玩也是可以的」
PRINTFORMW %CALLNAME:TARGET%は喜びを滲ませる%CALLNAME:MASTER%から、おもはゆそうに顔を背ける。	PRINTFORMW %CALLNAME:TARGET%沉浸在欢愉之中，微笑着转过脸对着%CALLNAME:MASTER%。
PRINTFORMW 「で、どうする」	PRINTFORMW 「嗯，怎么？」
PRINTFORMW 「…………%CNAME("一人称")%を眺めているだけで満足なのか？%CNAME("二人称")%は」	PRINTFORMW 「…………就这样看着%CNAME("一人称")%还不够吗？%CNAME("二人称")%真是贪心的家伙」
PRINTFORMW 「待たせたな……くくっ、嬉しそうな顔をするじゃないか」	PRINTFORMW 「久等了……哼哼，这不是很高兴的样子嘛。」
PRINTFORMW 「可愛い奴め。そういう反応されると着替えてやった甲斐があるというものだ」	PRINTFORMW 「可爱的孩子。这样的反应真是可爱呢」
PRINTFORMW %CALLNAME:TARGET%は優越感を滲ませながら、%CALLNAME:MASTER%の目の前で軽くポーズをとって見せてきた……	PRINTFORMW %CALLNAME:TARGET%享受着优越感的同时，对%CALLNAME:MASTER%摆出了撩人的姿势……
PRINTFORMW 「ああ、\@ PLACE("自宅") ? 戻って # 来て \@いたか……やはりな」	PRINTFORMW 「啊啊、\@ PLACE("自宅") ? 戻って # 来て \@了？……糟糕的状况呢」
PRINTFORMW 「くくっ……%CNAME("二人称")%はああいうのが好みなのか？ん？」	PRINTFORMW 「哼哼……%CNAME("二人称")%很喜欢这个样子吗，嗯？」
PRINTFORMW %CALLNAME:TARGET%はニヤニヤと意地の悪い笑みを浮かべつつ、湯上りの匂いをさせて%CALLNAME:MASTER%に近づいてきた…	PRINTFORMW %CALLNAME:TARGET%带着危险的笑容和蒸腾的香气一步步逼近%CALLNAME:MASTER%…
PRINTFORMW 「まったく……%CNAME("二人称")%も懲りん奴だな」	PRINTFORMW 「真是的……%CNAME("二人称")%真是一个恶劣的家伙」
PRINTFORMW 「だが、そういうところ嫌いじゃないぞ」	PRINTFORMW 「但是，并不讨厌哦」
PRINTFORMW %CALLNAME:TARGET%は着替えてはくれなかったものの、%CALLNAME:MASTER%に向けて少し楽しそうに笑いかけて来た。	PRINTFORMW %CALLNAME:TARGET%虽然没有换衣服，但是靠近%CALLNAME:MASTER%露出了微笑。
PRINTFORMW 「ふぅ。今日は随分と進んだな」	PRINTFORMW 「呼。今天的进展还蛮快的嘛」
PRINTFORMW 「……ちょっと気分転換でもするか？」	PRINTFORMW 「……稍微转换一下心情怎么样呀？」
PRINTFORMW %CALLNAME:TARGET%は凝った肩をほぐしながら、チラリと%NAMES("ベッド")%を見遣った。	PRINTFORMW %CALLNAME:TARGET%一边揉着僵硬的肩膀、一边不时地瞟向%NAMES("ベッド")%那边。
PRINTFORMW %CALLNAME:TARGET%は黙々と復習している。	PRINTFORMW %CALLNAME:TARGET%默默地进行着复习。
PRINTFORMW 「うーん……うーん………う～～ん………」	PRINTFORMW 「唔ーん……唔ーん………唔唔～～ん………」
PRINTFORMW 「おい、ちょっといいか？ここなんだが……」	PRINTFORMW 「喂、稍微打扰一下可以嘛？这里……」
PRINTFORMW 「ふん。我慢というものを知らんようだな、%CNAME("二人称")%は」	PRINTFORMW 「唔姆。难道?%CNAME("二人称")%不知道什么是忍耐吗」
PRINTFORMW 「……どうする？%CNAME("一人称")%は構わんぞ？」	PRINTFORMW 「……怎么？%CNAME("一人称")%倒是不怎么在意这种事情。」
PRINTFORMW %CALLNAME:TARGET%はチラリと%NAMES("ベッド")%を見遣った。	PRINTFORMW %CALLNAME:TARGET%盯着%NAMES("床")%。
PRINTFORMW 「どうした？……我慢できなくなったのか？」	PRINTFORMW 「怎么？……又忍耐不了吗？」
PRINTFORMW %CALLNAME:TARGET%は涼しい顔で薄く微笑みながら、%CALLNAME:MASTER%に流し目を送ってきた	PRINTFORMW %CALLNAME:TARGET%淡淡地微笑着，对%CALLNAME:MASTER%暗送秋波。
PRINTFORMW %CALLNAME:TARGET%は胸を触り続ける%CALLNAME:MASTER%にやんわりと釘を刺してきた	PRINTFORMW %CALLNAME:TARGET%继续被抚摸着胸部，用像钉子一样的目光看着%CALLNAME:MASTER%。
PRINTFORMW 「……もう少し遠慮というものを学べ」	PRINTFORMW 「……再稍微学学什么叫做思考吧」
PRINTFORMW %CALLNAME:TARGET%は、ほんの少しだけ拗ねてしまったようだ	PRINTFORMW %CALLNAME:TARGET%好像有点闹别扭的样子。
PRINTFORMW 「……握ったりはするなよ」	PRINTFORMW 「……不要抓」
PRINTFORMW 「んッ……！おいやめろ、気安く摘まむな」	PRINTFORMW 「嗯……！喂，停下，不会看气氛吗？」
PRINTFORMW 「せっかくだから頼もうか、くれぐれも変な気は起こすなよ？」	PRINTFORMW 「难得的机会就拜托你了，不要试着做奇怪的事情哦？」
PRINTFORMW 「……そう何度もするな」	PRINTFORMW 「……不要做那么多次啊」
PRINTFORMW %CALLNAME:TARGET%は少しだけ恥ずかしそうに眼を逸らした	PRINTFORMW %CALLNAME:TARGET%似乎有点害羞地移开了视线
PRINTFORMW 「んっ……」	PRINTFORMW 「嗯姆……」
PRINTFORML 「む……なるほど、世の男どもの気持ちが少し分かったよ」	PRINTFORML 「姆……原来如此，对这世界上男人的想法稍微有些理解了」
PRINTFORMW 「なかなか新鮮で良いものだな」	PRINTFORMW 「真是新鲜的体验啊」
PRINTFORMW 「……調子に乗るな。誰が頭を撫でて良いと言った？」	PRINTFORMW 「……不要得意忘形，谁让你摸头了？」
PRINTFORMW %CALLNAME:TARGET%は目を閉じて脱力し、%CALLNAME:MASTER%の膝に頭の重さを預けて気持ち良さそうにしている……	PRINTFORMW %CALLNAME:TARGET%闭着眼睛放松，把头的重量放在%CALLNAME:MASTER%的大腿上，看起来很舒服的样子……
PRINTFORMW 「おい、動くな。今の%CNAME("二人称")%は%CNAME("一人称")%の枕なんだからな」	PRINTFORMW 「喂，不要动啊。现在%CNAME("二人称")%正在为%CNAME("一人称")%做膝枕吧」
PRINTFORMW 「頂こう。ちょうど喉が渇いていたところだ」	PRINTFORMW 「私收下了。正好喉咙有些口渴」
PRINTFORMW 「……あまり乱暴にするなよ？」	PRINTFORMW 「……不要太粗鲁地摸哦？」
PRINTFORMW %CALLNAME:TARGET%は身体を一瞬ビクッとさせたが、嫌という訳ではないらしい……%CALLNAME:MASTER%にされるがままだ	PRINTFORMW %CALLNAME:TARGET%的身体一瞬间僵住了，但是好像并不是很讨厌……任由%CALLNAME:MASTER%继续抚摸着尾巴。
PRINTFORMW 「……そのぐらいにしておけ」	PRINTFORMW 「……这样摸就可以了」
PRINTFORMW %CALLNAME:TARGET%は尻尾を弄り続ける%CALLNAME:MASTER%にやんわりと釘を刺してきた	PRINTFORMW %CALLNAME:TARGET%被一直玩弄尾巴，安静地盯着%CALLNAME:MASTER%。
PRINTFORMW 「少しぐらいならと大目に見てやっていたが、触り過ぎだ」	PRINTFORMW 「稍微摸一摸的话姑且还能原谅你，现在这样就有点过头了」
PRINTFORMW 「おい、あまり持ち上げるな」	PRINTFORMW 「喂，不要往上撸尾巴啊」
PRINTFORMW %CALLNAME:TARGET%は尻尾を持たれて浮いたスカートを手で押さえた	PRINTFORMW %CALLNAME:TARGET%抓住尾巴，按住有些飘起来的裙子。
PRINTFORMW 「強く握るのは、無しだからな」	PRINTFORMW 「用力地抓，这种事情是不会被允许的啦」
PRINTFORMW %CALLNAME:TARGET%は%CALLNAME:MASTER%の様子を伺っている……	PRINTFORMW %CALLNAME:TARGET%观察着%CALLNAME:MASTER%……
PRINTFORMW 「少しだけだぞ」	PRINTFORMW 「只允许一点点哦，只有一点点…」
PRINTFORMW %CALLNAME:TARGET%は尻尾を求められる事に満更でもなさそうだ	PRINTFORMW 好像不可以随心所欲地抚摸%CALLNAME:TARGET%尾巴的样子。
PRINTFORMW 「しかしなんだ……尻尾触るの好きだな、%CNAME("二人称")%は」	PRINTFORMW 「真拿你没办法……这么喜欢摸尾巴吗，%CNAME("二人称")%这家伙」
PRINTFORMW 「……手癖の悪い奴だな」	PRINTFORMW 「……沉迷于手淫是不可以的哦」
PRINTFORMW %CALLNAME:TARGET%は尻尾に手を出す%CALLNAME:MASTER%に、困ったような嬉しいような表情を見せている……	PRINTFORMW %CALLNAME:TARGET%看着向尾巴出手的%CALLNAME:MASTER%，稍微有些困扰但是又很高兴的样子……
PRINTFORMW 「うむ。なかなか気が利くじゃないか」	PRINTFORMW 「唔姆。很聪明嘛」
PRINTFORMW 「ふん。付き合いの悪い奴だな」	PRINTFORMW 「呼嗯。真是一个不识趣的家伙呐」
PRINTFORMW 「まぁ……いいか。その代わり私の課題を手伝ってもらうからな？」	PRINTFORMW 「嘛……好吧。作为交换要帮%CNAME("一人称")%做课题哦？」
PRINTFORMW 「フ、そんなに私のパンツが見たいか。正直な奴だ」	PRINTFORMW 「呼、那么想看%CNAME("一人称")%的胖次嘛。真是诚实的家伙」
PRINTFORMW 「相変わらずだなお前は……まぁ、いいだろう」	PRINTFORMW 「真是一点都没有变呢……嘛、好吧」
PRINTFORMW 「少し早い気もするが……どうだ？」	PRINTFORMW 「虽然觉得有点早……怎么样？」
PRINTFORMW 「これは提案なのだがな」	PRINTFORMW 「这只是私的提案而已」
PRINTFORMW 「続きを……しないか？」	PRINTFORMW 「要……继续吗？」
PRINTFORMW 「……静かだな」	PRINTFORMW 「……真是安静呐」
PRINTFORMW 「ちょっと%CNAME("一人称")%と遊ぶか？」	PRINTFORMW 「要跟%CNAME("一人称")%玩一会吗？」
PRINTFORMW %CALLNAME:TARGET%はニヤリと笑いながら流し目を送ってきた	PRINTFORMW %CALLNAME:TARGET%笑眯眯地用眼神暗示着
PRINTFORMW 「どうした？暇そうじゃないか」	PRINTFORMW 「怎么了？看起来很闲的样子」
PRINTFORMW 「……ちょっと%CNAME("一人称")%と遊ぶか？」	PRINTFORMW 「……要稍微跟%CNAME("一人称")%玩一会吗？」
PRINTFORMW 「まったく……だらしのない奴だな、%CNAME("二人称")%は」	PRINTFORMW 「真是的……真是个坏孩子、%CNAME("二人称")%啊」
PRINTFORMW 「ほら、%CNAME("一人称")%に貸してみろ」	PRINTFORMW 「哼、快点把那个给%CNAME("一人称")%啦」
PRINTFORMW 「たまにはこういうのも悪くないだろう？」	PRINTFORMW 「偶尔这个样子也不错呢？」
PRINTFORMW 「なぁおい。なにかしないのか？」	PRINTFORMW 「诶。在做什么呀？」
PRINTFORMW 「退屈だな。%CNAME("二人称")%もそう思うだろう？」	PRINTFORMW 「好无聊啊。%CNAME("二人称")%也是这样想的吧？」
PRINTFORMW 「%CNAME("一人称")%の気が変わらぬうちに堪能するといい」	PRINTFORMW 「%CNAME("一人称")%就这样好好享受吧」
PRINTFORMW %CALLNAME:TARGET%は揃えた太ももをぽんぽんと叩いている…	PRINTFORMW %CALLNAME:TARGET%轻轻拍着大腿…
PRINTFORMW 「ほら、飲むがいい」	PRINTFORMW 「来，稍微喝一点吧」
PRINTFORMW 「味は……あんまり期待しないようにな」	PRINTFORMW 「味道的话……不要太期待哦」
PRINTFORMW 「ふっ、隙だらけだぞ」	PRINTFORMW 「呼，故意露出破绽」
PRINTFORMW 「それとも……%CNAME("一人称")%を誘っているのか？」	PRINTFORMW 「难道……是在诱惑%CNAME("一人称")%吗？」
PRINTFORMW 「なぁおい。なにかしないのか？」	PRINTFORMW 「嗯~不打算做些什么吗？」
PRINTFORMW 「待たせたな」	PRINTFORMW 「久等了」
PRINTFORMW 「用事を思い出した。……付いてくるなよ？」	PRINTFORMW 「稍微有点事情……不要跟过来哦？」
PRINTFORMW 「ああ、廊下が殺風景だったのでな。少し花を飾ってきた」	PRINTFORMW 「啊啊，因为走廊里面的风景不太好看。所以去“采了点花”装饰了一下」
PRINTFORMW 「しつこい」	PRINTFORMW 「烦人」
PRINTFORMW 「これ以上は怒るぞ」	PRINTFORMW 「再这样要生气了」
PRINTFORMW 「断る」	PRINTFORMW 「我拒绝」
PRINTFORMW 「そういう事は他の奴に頼め」	PRINTFORMW 「这样的事情去拜托其他孩子吧」
PRINTFORMW 「ふっ、いいだろう」	PRINTFORMW 「呼、好吧」
PRINTFORMW 「こういうのも嫌いではないし……な」	PRINTFORMW 「也不是很讨厌这种事情……呐」
PRINTFORMW 「ん？%CNAME("一人称")%のが見たくなったか？」	PRINTFORMW 「嗯？想看%CNAME("一人称")%的那个？」
PRINTFORMW 「くく、正直な奴だな」	PRINTFORMW 「呼呼、真是诚实的孩子呢」
PRINTFORMW 「…………ほら、近くに寄れ」	PRINTFORMW 「…………来、再靠近一点」
PRINTFORMW 「まだ見足りないのか」	PRINTFORMW 「还没看够吗」
PRINTFORMW 「どうせなら、見るだけでなく他の事もしておくか？%CNAME("一人称")%は構わんぞ？」	PRINTFORMW 「既然都是看、不做些其他的事情吗？%CNAME("一人称")%这样就觉得满足了吗？」
PRINTFORMW 「おい、やめろ……そこまでだ」	PRINTFORMW 「喂、住手……这样就够了吧」
PRINTFORMW 「%CNAME("二人称")%にそこまでは許していない」	PRINTFORMW 「并没有允许%CNAME("二人称")%这样做」
PRINTFORMW %CALLNAME:TARGET%に手を掴まれてしまった……	PRINTFORMW 被%CALLNAME:TARGET%用手紧紧抓住了……
PRINTFORMW 「もう結構経つが……飽きないな、本当に。ある意味感心するよ」	PRINTFORMW 「已经很久了……还没满足吗。真是的，某种意义上真的是服了」
PRINTFORMW 「分かっているとも。%TEXTR("こういうのが好きな/ここが見たい")%のだろう？」	PRINTFORMW 「知道的哦。%TEXTR("喜欢看这里/想要看这里")%吧？」
PRINTFORMW 「薄々予感してはいたが……%CNAME("二人称")%、下着が好きすぎるな」	PRINTFORMW 「隐隐地感觉到……%CNAME("二人称")%是不是很喜欢内衣啊」
PRINTFORMW 「いつかそのせいで身を亡ぼすのではないか？」	PRINTFORMW 「那什么时候因此而亡都不奇怪哦？」
PRINTFORMW 「うん？」	PRINTFORMW 「嗯？」
PRINTFORMW 「%CNAME("二人称")%にしては控えめだな……もっと近くで見ても構わんぞ？」	PRINTFORMW 「%CNAME("二人称")%这么小心啊……再近一点也没有关系哦？」
PRINTFORMW 「くく、どうやら%CNAME("一人称")%\@ CHECK_CLO("水着姿") ? の水着姿 # \@から目が離せんようだな」	PRINTFORMW 「哼哼，看起来%CNAME("一人称")%完全无法从\@ CHECK_CLO("水着姿") ? の水着姿 # \@移开眼睛呢」
PRINTFORMW 「まぁ……仕方ない事だがな。ははは」	PRINTFORMW 「嘛……这也是没有办法的事情呐。呼呼呼」
PRINTFORMW %CALLNAME:TARGET%は自分に夢中になっている%CALLNAME:MASTER%を見て上機嫌な様子だ。	PRINTFORMW %CALLNAME:TARGET%因为给仿佛沉浸于梦幻之中的%CALLNAME:MASTER%看了而心情很好的样子。
PRINTFORMW 「こんなのを見て嬉しいとは……%CNAME("一人称")%にはよく分からんな」	PRINTFORMW 「这样被看了结果很高兴什么的……%CNAME("一人称")%完全理解不了呢」
PRINTFORMW 「こういう事すると更に良かったりするのか？ん？」	PRINTFORMW 「这样如何，嗯？」
PRINTFORMW %CALLNAME:TARGET%は指で布地を引っ張って股間に食い込ませてきた！	PRINTFORMW %CALLNAME:TARGET%用手指把那布料向上拉，勒住了股间。
PRINTFORMW 下着ほど薄い生地ではないとはいえ、%CALLNAME:TARGET%の股間の凹凸が浮かび上がって%CALLNAME:MASTER%を昂らせる……	PRINTFORMW 不像内衣那么单薄，%CALLNAME:TARGET%股间的凹凸形状依旧浮现了出来，这让%CALLNAME:MASTER%更加兴奋……
PRINTFORMW 「%TEXTR("ふっ。/くくっ、/＿")%%CNAME("二人称")%は本当にこの格好が好きだな……ほら、%TEXTR("こっちに来い/ここが見たかったのだろう？/遠慮するな")%」	PRINTFORMW 「%TEXTR("ふっ。/くくっ、/＿")%%CNAME("二人称")%真的是特别喜欢这种事情啊……那么、%TEXTR("来这里吧/是想看这里吗？/不要客气")%」
PRINTFORMW %CALLNAME:TARGET%は特に恥じらう事も無く、軽く脚を開いて股間を%CALLNAME:MASTER%にじっくりと観察させた。	PRINTFORMW %CALLNAME:TARGET%一点都没有感觉到羞耻，轻轻地打开双腿让%CALLNAME:MASTER%仔细观察。
PRINTFORMW 「いきなりご挨拶だな……だがまぁ、そのぐらいなら構わんよ」	PRINTFORMW 「这样子突然地打招呼……嘛，这种程度的话就算了」
PRINTFORMW %CALLNAME:TARGET%はニヤリと笑いつつ、自らの手でスカートをめくりあげた	PRINTFORMW %CALLNAME:TARGET%妖艳地笑着，自己用手向上拉起了裙子。
PRINTFORMW 「なにせ、これから更に恥ずかしい場所を見せあう仲になる訳だしな」	PRINTFORMW 「总之，以后还有各种各样更加羞耻的深入♂♀交流吧」
PRINTFORMW 「なあ？」	PRINTFORMW 「不是嘛？」
PRINTFORMW 「ん？%CNAME("一人称")%のが見たくなったか？」	PRINTFORMW 「嗯？%CNAME("一人称")%不想看吗？」
PRINTFORMW 「ふっ、仕方のない奴だな……ほら、見るがいい」	PRINTFORMW 「呼，真是拿你这个孩子没有办法呢……嗯哼~这样视奸也没有问题哦」
PRINTFORMW %CALLNAME:TARGET%は僅かな優越感を滲ませつつ、スカートの中を%CALLNAME:MASTER%に見せつけた。	PRINTFORMW %CALLNAME:TARGET%散发着优越感，将裙下的风景展现面给%CALLNAME:MASTER%看。
PRINTFORMW 「%CNAME("一人称")%に頼み込んで手に入れたソレをどうするのかとは思っていたが、そういう事がしたかったのか」	PRINTFORMW 「对高贵的%CNAME("一人称")%苦苦哀求希望得到的，竟然是这样的东西」
PRINTFORMW 「なかなか面白いな」	PRINTFORMW 「感觉挺有趣呢」
PRINTFORMW %CALLNAME:TARGET%は興味深げに%CALLNAME:MASTER%を眺めている。	PRINTFORMW %CALLNAME:TARGET%意味深长地看着%CALLNAME:MASTER%。
PRINTFORMW 「…………ふん」	PRINTFORMW 「…………唔」
PRINTFORMW %CALLNAME:TARGET%は%CALLNAME:MASTER%の行動に思うところが有りそうだが、見て見ぬ振りをしてくれた。	PRINTFORMW %CALLNAME:TARGET%对%CALLNAME:MASTER%的行动意图有所察觉的样子，但又装作没有看到。
PRINTFORMW 「場所を変えるなり、さっそくか」	PRINTFORMW 「换个地方，快走啦」
PRINTFORMW 「……まぁ、いいだろう」	PRINTFORMW 「……嘛，可以倒是可以」
PRINTFORML 「……ふっ、仕方のない奴だな」	PRINTFORML 「……呼、真拿你这个孩子没办法呐」
PRINTFORMW 「今回は%CNAME("一人称")%が動いてやろうじゃないか……ほら、そこに寝るがいい」	PRINTFORMW 「这次让%CNAME("一人称")%来动就可以了……所以、乖乖在那边躺好就行」
PRINTFORMW 「ふむ……時には下僕を楽しませてやるのも一興か」	PRINTFORMW 「呼姆……偶尔为下仆做些事情也不错呢」
PRINTFORML 「……フ」	PRINTFORML 「……呼」
PRINTFORMW 「いいだろう、ちょうど私も暇していたところだ」	PRINTFORMW 「好吧、私正好也有些闲」
PRINTFORMW 「あー……うん…………まぁ、いいだろう」	PRINTFORMW 「啊……唔…………嘛、好吧」
PRINTFORMW 「ほら、してやるからさっさと出せ」	PRINTFORMW 「喂、会给你做的所以赶快射出来啊」
PRINTFORMW 「…………本当に元気な奴だなぁ、%CNAME("二人称")%は」	PRINTFORMW 「…………真的是很有精神的孩子呐、%CNAME("二人称")%は」
PRINTFORMW 「いま忙しいのだがな……見て分からないか？」	PRINTFORMW 「现在很忙啊……看了就知道的吧？」
PRINTFORMW 「まぁいいか説明するのもめんどくさい……ほら、勝手に使って良いぞ」	PRINTFORMW 「嘛说明起来也很麻烦……总之、擅自使用私也是可以的呐」
PRINTFORMW 「なんだ、口でされる方がいいのか？ ……変わった奴だな」	PRINTFORMW 「怎么、用嘴做就可以了嘛？ ……真是个奇怪的家伙」
PRINTFORMW 「……まぁいいだろう」	PRINTFORMW 「……嘛 可以吧」
PRINTFORMW 「……注文の多い奴だな」	PRINTFORMW 「……要求真多啊%CNAME("二人称")%这家伙」
PRINTFORMW 「……まぁいいか」	PRINTFORMW 「……嘛 好吧」
PRINTFORMW 「%TEXTR("綺麗に使うようにな/あんまり激しくするなよ？/ほら、使っていいぞ")%」	PRINTFORMW 「%TEXTR("记得要干干净净地使用哦/不要太激烈哦？/呼、虽然可以使用啦")%」
PRINTFORMW 「ちゅっ……まら……れふぇる……ん、……む」	PRINTFORMW 「啾……噗啊……咕噜……嗯、……姆」
PRINTFORMW 「んんっ、るいぶんひょ……んむ、らしふぁな……ング」	PRINTFORMW 「嗯、豪多……嗯姆、要流粗来了……嗯咕」
PRINTFORMW 「ん、む……ゴク…………ふぅ」	PRINTFORMW 「嗯、姆……咕唔…………呼」
PRINTFORMW 口の中の物を嚥下し終えた%CALLNAME:TARGET%はペロリと舌なめずりし、%CALLNAME:MASTER%のペニスにおしまいのキスをした。	PRINTFORMW 将嘴里的东西咽下去之后的%CALLNAME:TARGET%舔了舔嘴唇、最后为%CALLNAME:MASTER%的阴茎献上了表示完成的亲吻。
PRINTFORMW 「くく、随分とまぁ気持ちよさそうな顔を見せるじゃないか……可愛い奴だな、%CNAME("二人称")%は」	PRINTFORMW 「库库、看起来非常舒服的表情呢……真是可爱的孩子呐、%CNAME("二人称")%」
PRINTFORM %CALLNAME:TARGET%は%TEXTR("汗の滴る髪を手櫛で整え/自慢の黒髪を優雅にかき上げ/艶やかな髪を事後の気怠さと共に指で弄り")%つつ、	PRINTFORM %CALLNAME:TARGET%%TEXTR("用手指整理了满是汗水的头发/优雅地撩起了自满的头发/在因为事后的而感到倦怠的同时、用手指玩弄起自己美艳的长发")%、
PRINTFORMW %TEXTR("どことなく嬉しそうに微笑んだ/目を細めて満足げな顔を見せた/優越感と無邪気さの滲む笑顔を見せた")%。	PRINTFORMW %TEXTR("总觉得一副很高兴地样子在微笑着/眯起了眼睛、看起来很满足的样子/露出了充满优越感和天真的笑容")%。
PRINTFORMW 「%TEXTR(@"ん……終わったか\/……お？ようやく出たか\/……次は出来るだけ%CNAME("一人称")%の手を煩わせないようにな")%」	PRINTFORMW 「%TEXTR(@"嗯……结束了吗\/……哦？终于出来了吗\/……下次记得尽可能不要给%CNAME("一人称")%的手添麻烦了呐")%」
PRINTFORM 「%TEXTR(@"ん……終わったか\/…………ふぅ。随分と出たようだな\/……次は出来るだけ%CNAME("一人称")%の手を煩わせないようにな")%	PRINTFORM 「%TEXTR(@"嗯……结束了吗\/…………呼。真的是射了很多出来呐\/……下次记得尽可能不要给%CNAME("一人称")%添麻烦了呐")%
PRINTFORML 「しかし、なんだな。もう少し遠慮というものを知らんのか？」	PRINTFORML 「但是、总感觉。你这个家伙不知道什么叫做收敛吗？」
PRINTFORMW 「……こういう時の%CNAME("二人称")%に言っても無駄か」	PRINTFORMW 「……对这个时候的%CNAME("二人称")%说什么也没有用吗」
PRINTFORMW 「おい、腰を引き寄せるな……そんなに%CNAME("一人称")%の奥に出したいのか？」	PRINTFORMW 「喂、不要把腰扭来扭去地动啊……这么想要在%CNAME("一人称")%的身体里面射出来吗？」
PRINTFORMW 「……くくっ。相変わらずだな、%CNAME("二人称")%は」	PRINTFORMW 「……哼哼。一点都没有变呐，%CNAME("二人称")%」
PRINTFORMW 「そういう事を%CNAME("一人称")%の目の前で出来るとは、ある意味で感心するよ」	PRINTFORMW 「对着高贵的%CNAME("一人称")%提出这样的事情，某种意义上真的是很佩服」
PRINTFORML （楽しそうだなあいつら）	PRINTFORML （看起来很高兴的样子）
PRINTFORMW %CALLNAME:ARG%は%CALLNAME:MASTER%達を横目でさりげなく伺いつつ漫画を読んでいる…	PRINTFORMW %CALLNAME:ARG%一边侧目看着%CALLNAME:MASTER%们一边读漫画…