
//EVENT_K3_ツェツィーリア.ERB
どこか超然とした雰囲気のする西洋系の三年生、この国へ移住した魔法使いの親を持つ	有一种超然的感觉的西洋系の三年生、和魔法使的父母一起移居到了这个国家
一般人との人付き合いはあまりよくないが人目を引く容貌なので男子からの人気はある	虽然平常不和大家来往、但是因为容貌上佳所以在男生间很有人気
PRINTFORMW 「再生する魂？なるほど極めて興味深いね。本当だとしたら限りない可能性がある」	PRINTFORMW 「魂能够再生？原来如此那真的是让人非常有兴趣。如果是真的话那就有了无限的可能性了」
PRINTFORMW 「%CNAMET(ARG, "一人称")%の助手、いや弟子にでもなるつもりはないかな？」	PRINTFORMW 「要来当%CNAMET(ARG, "一人称")%的助手、不、来当%CNAMET(ARG, "一人称")%弟子吗？」
PRINTFORML 用意された部屋は衣装ケースが本棚に改造されており、床が凹むほどに詰め込まれている	PRINTFORML 把自己房间里的书柜改造成了书架、压的地板都凹进去了
PRINTFORML 周囲にも積まれた本で塔が出来る有様だが、ベッド周りだけは綺麗に整頓されているようだ	PRINTFORML 周囲的书堆得像塔一样、只有床旁边还算整理地干净一点
PRINTFORMW %CALLNAME%は外国の血が入った金髪碧眼の上級生である。	PRINTFORMW %CALLNAME%是流着外国人血的、金髪碧眼的上級生。
PRINTFORMW その容貌で人目を引くもクラスメイトなどとの積極的な付き合いを持とうとしない。	PRINTFORMW 被其容貌所吸引的同学们不厌其烦地以各种形式積極接近、但她从未理睬过。
PRINTFORMW どこか尊大な物言いも彼女ほどの美少女が口にすればむしろ魅力さえ感じさせるのだ。。	PRINTFORMW 像这种自傲的话语从她这样的美少女说出来反倒会让人感觉到别样的魅力。。
PRINTFORMW あなたには高嶺の花だった女性がまさかゴッコ遊びではない本当の魔法の使い手であったとは。	PRINTFORMW 不过这个在你面前的高嶺之花并不是在玩闹、而是货真价实的魔法使。
PRINTFORMW そして魂の授受というある意味で売春のような利益による関係とはいえど先輩と	PRINTFORMW 以及接受了魂的授受的同时也意味着要和前輩形成类似于売春一样的利益関係
PRINTFORMW 肉体の関係を持ち得るのだとは、かのメイドとの巡り合せなくば想像だにしなかったに違いない。	PRINTFORMW 如果没有和那个女仆相遇的话、根本无法想象能够和前輩拥有这样的肉体関係。
PRINTFORMW 「なるほど、%CNAME("二人称")%の話はわかった。再生する魂とはね」	PRINTFORMW 「原来如此、%CNAME("一人称")%明白%CNAME("二人称")%的意思了。所谓的再生魂是这种情况啊」
PRINTFORMW 「にわかには信じがたい話であるが、そちらの悪魔も保証するのならば疑う理由もあるまい」	PRINTFORMW 「虽然是令人难以置信的話、不过有那边的悪魔的保証的话也没有什么好怀疑的理由」
PRINTFORMW 「この%CNAME("一人称")%が美しいとはいえ、一つだけの魂を捧げうるほどとは自惚れてはいないさ」	PRINTFORMW 「虽然%CNAME("一人称")%的确非常美丽、但也没有到会让人奉献出自身的魂的水平」
PRINTFORMW 「極めて興味深い話だ。魂は長年探求され続けた究極のテーマの一つとさえ言っていい」	PRINTFORMW 「非常令人感兴趣。魂可以说是%CNAME("一人称")%長年不断探求的究極课题之一」
PRINTFORMW 「その再生というのがどのようなものか、何度も観察する価値がある」	PRINTFORMW 「而魂是如何再生的、有着进行多少観察都不为过的価値」
PRINTFORMW 「もちろん、私が受け取ることのできる魂そのものにも利用価値はたくさんあるがね」	PRINTFORMW 「当然、能够接收到的魂也有着各种各样的利用価値」
PRINTFORMW 「しかし勘違いするなよ、%CNAME("一人称")%は%CNAME("二人称")%に魂を乞いているのではない」	PRINTFORMW 「不要误会了、%CNAME("一人称")%并不是在向%CNAME("二人称")%讨要魂」
PRINTFORMW 「%CNAME("二人称")%という有益な実験動物から%CNAME("一人称")%がデータを収集しているのだ」	PRINTFORMW 「%CNAME("一人称")%无非只是从%CNAME("二人称")%这只有益的実験動物上収集一些数据而已」
PRINTFORMW 「が、それではあまりにも%CNAME("二人称")%の利益が薄いな」	PRINTFORMW 「嘛、只是这样的话也未免太亏待%CNAME("二人称")%了」
PRINTFORMW 「そこでなんだ、%CNAME("一人称")%の弟子になってみる気はないかね？」	PRINTFORMW 「综上所述、要来当%CNAME("一人称")%的弟子吗？」
PRINTFORMW 「なに、%CNAME("二人称")%の才能は保証するよ。%CNAME("二人称")%はすでにアムブロシアを授かっているのだからね」	PRINTFORMW 「不用担心、%CNAME("二人称")%可是早已尝过Ambrosia之人、%CNAME("一人称")%可以为%CNAME("二人称")%的才能打保票。」




//EVENT_K3_DAILY.ERB


PRINTFORMW 熱い吐息が顔に感じられるほどの距離で瞳をまっすぐあわせている%CALLNAME:ARG%の両足とお腹の筋肉を激しく使った腰つきでのザーメンおねだりに、%CALLNAME:MASTER%の睾丸は今すぐにも精を解き放ちそうだ	PRINTFORMW %CALLNAME:ARG%跨坐在%CALLNAME:MASTER%的胯上俯下身子嘴里呼出阵阵地热气瞳孔近距离的直视着对方，%CALLNAME:ARG%的两脚和腹部的肌肉激烈地摇摆着腰部想要精液能滋润饥渴的肉体，%CALLNAME:MASTER%的睾丸现在也快要释放出精液了
CALL PRINT_STR, "「おはよう_HH_」_W"	CALL PRINT_STR, "「早上好_HH_」_W"
CALL PRINT_STR, @"「夢の中の%CNAMET(ARG, "一人称")%と本物の%CNAMET(ARG, "一人称")%のどちらが素敵だったかね？_H_」_W"	CALL PRINT_STR, @"「梦中的%CNAMET(ARG, "一人称")%和真的%CNAMET(ARG, "一人称")%哪个更漂亮呢？_H_」_W"
CALL PRINT_STR, "「夢と現実双方で同時にセックスするなどと、本物のサキュバスもなかなかさせてくれないはずだよ_H_」_W"	CALL PRINT_STR, "「如果梦与现实双方同时发生性交的话，应该不会让真正的美少女战士们出现的哦。_H_」_W"
CALL PRINT_STR, "「それに夢の中ではどれだけザーメンを注ぎ込んでも本懐を遂げることはできないからね_H_」_W"	CALL PRINT_STR, "「而且无论在梦中注入多少精液，都无法实现自己的夙愿。_H_」_W"
CALL PRINT_STR, @"「%CNAMET(ARG, "二人称")%はもういつ悪いサキュバスが夢に侵入してきても軽く返り討ちにできるはずだよ_H_」_W"	CALL PRINT_STR, @"「%CNAMET(ARG, "二人称")%无论何时何地恶作剧侵入梦中,都应该可以轻易地反击哟_H_」_W"
CALL PRINT_STR, "「それはともかく、今は目覚めのキスをするといい_H_」_W"	CALL PRINT_STR, "「姑且不论那个，现在做可以觉醒过来的接吻就好了_H_」_W"
CALL PRINT_STR, "「悪い魔法使いを退治する方法だよ_HH_」_W"	CALL PRINT_STR, "「这是可以消灭恶魔使的方法哦_HH_」_W"
PRINTFORMW %CALLNAME:ARG%は情事のときのように深く舌を絡めて%CALLNAME:MASTER%をしばらく蹂躙した	PRINTFORMW %CALLNAME:ARG%犹如深情般深深地缠绕着%CALLNAME:MASTER%的舌头蹂躏着他
CALL PRINT_STR, @"「ねえ、今日は%CNAMET(ARG, "一人称")%とずっとこうしていないかい？_H_」_W"	CALL PRINT_STR, @"「喂，今天不是一直这样的吗%CNAMET(ARG, "一人称")%_H_」_W"
PRINTFORMW 「お互いのこと以外をすべて忘れて、ただひたすら口づけしてお互いの体を味わって」	PRINTFORMW 「除了彼此的事情以外，请全部忘记、只是一味地接吻品味着彼此的味道」
PRINTFORMW 「…いや、実際そうするわけにはいかないが。半分くらいは本気でそうしたいと思っている」	PRINTFORMW 「………不，实际上不能那样做的，但一半是真的想那样做」
PRINTFORMW 「目覚めのキスで体のほうが舞い上がってしまうなんて、まったく我ながら%CNAMET(ARG, "二人称")%におかしくなってしまってるよ」	PRINTFORMW 「用觉醒的接吻身体飞扬什么的，虽然完全我是我做的却%CNAMET(ARG, "二人称")%变得可笑哟」
PRINTFORMW 熱烈な奉仕に応じるように射精した%CALLNAME:MASTER%の精液を%CALLNAME:ARG%は喉奥で受け止めた	PRINTFORMW %CALLNAME:ARG%回应激烈运动而射精的%CALLNAME:MASTER%的精液，%CALLNAME:ARG%在喉咙深处里头全部接纳了下来
PRINTFORMW 「おはよう。目覚めのキスをこんな場所にする%CNAMET(ARG, "一人称")%の無礼を許してくれ」	PRINTFORMW 「早上好。请允许我把觉醒之吻放在这样的地方，还请原谅%CNAMET(ARG, "一人称")%的无礼」
PRINTFORMW 「しかし%CNAMET(ARG, "二人称")%も悪いのだよ？あんなふうに硬く勃起させているのだ」	PRINTFORMW 「可是%CNAMET(ARG, "二人称")%也有不好的地方哟？下面的硬邦邦地勃起什么的真是诱惑人呢」
PRINTFORMW 「サキュバスの真似事をして夢で奉仕した%CNAMET(ARG, "一人称")%と本物の%CNAMET(ARG, "一人称")%のどちらの口が心地よかったかね？」	PRINTFORMW 「在梦中服务的%CNAMET(ARG, "一人称")%和真正的%CNAMET(ARG, "一人称")%哪个口交更舒服呢？」
CALL PRINT_STR, @"「どうだね？%CNAMET(ARG, "二人称")%とセックスするようになってから男を喜ばせるためのモノとなりつつある乳房で起こされる気分は_H_」_W"	CALL PRINT_STR, @"「怎么样？与%CNAMET(ARG, "二人称")%发生性交后，逐渐变成令男人兴奋的乳房心情是什么样的_H_」_W"
PRINTFORMW 「もちろん、こんなふうにザーメンをたっぷり吐き出したのだから聞く必要も最早なかろうが」	PRINTFORMW 「当然，像这样舒服地吐出大量精液，所以心知肚明地没必要问吧」
PRINTFORMW 「せっかくだ、他の楽しみ方も味わってから起きるかね？」	PRINTFORMW 「好不容易可以享受这样的服务，想品尝完其他的服务之后再起来是吗？」
PRINTFORMW 「おはよう」	PRINTFORMW 「早上好」
PRINTFORMW 「起きて早々に乳房で気持ちよくなれるなんて乳幼児くらいにしか普通できない贅沢だ」	PRINTFORMW 「起床后用乳房进行按摩可以使人变得心情舒畅，这是只有婴儿才能使用的奢侈品哦」
PRINTFORMW 「もちろん、子供はこんな乳房の使い方ではなく吸って落ち着くわけだが・・・」	PRINTFORMW 「当然，婴儿并不是这样使用乳房的，而是用吸着呢……」
PRINTFORMW 「別にそうしても構わないよ。もちろん時間に遅れない程度にしてくれたまえ」	PRINTFORMW 「即使那么做也没关系。当然要注意时间不要迟到哦」
PRINTFORMW 「おはよう。なに、%CNAMET(ARG, "二人称")%がサキュバスに襲われてるかのような兆候があったものでね」	PRINTFORMW 「早上好，什么、%CNAMET(ARG, "二人称")%好像有被魔法使袭击的征兆」
PRINTFORMW 「万が一というものがあるからね、魔法使いに伝わるサキュバス退治の技法の一つを試しているのさ」	PRINTFORMW 「因为有万一这种东西，所以我们就来试试用魔法使击退萨库巴斯的技术」
PRINTFORMW 「冗談だよ？本当にサキュバスに襲われていたならもっと別のやりかたある」	PRINTFORMW 「开玩笑吧？如果真的遭到了塞库巴斯的袭击，但还有别的办法」
PRINTFORMW 「%CNAMET(ARG, "二人称")%が望むのならば…朝が来るたびに「サキュバス退治」していいけれどもね」	PRINTFORMW 「如果%CNAMET(ARG, "二人称")%希望的话…可以每次早晨来临之前都能进行“骑乘治退”哦」
PRINTFORMW %CALLNAME:ARG%は顔を真赤にしながらも微笑んでいる、%CALLNAME:MASTER%を上から犯しているいうのに	PRINTFORMW 虽然%CALLNAME:ARG%的脸红透了但还是微笑着看着%CALLNAME:MASTER%，明明是%CALLNAME:MASTER%从下往上侵犯
PRINTFORMW 「おはよう。いや、言いたいことはわかる。これではまるでサキュバスだ」	PRINTFORMW 「早上好。不，我知道你想说什么。这简直就像是骑马一样」
PRINTFORMW 「今は、今は何も言わずに受け入れてくれないかね？口づけしながらだよ」	PRINTFORMW 「现在，你什么也没说就是算接受我了吧？那一边接吻一边作哟」
PRINTFORMW 「やはり%CNAMET(ARG, "一人称")%は%CNAMET(ARG, "二人称")%とのキスが好きなようだ」	PRINTFORMW 「%CNAMET(ARG, "一人称")%还是喜欢跟%CNAMET(ARG, "二人称")%接吻」
PRINTFORMW 「月並みな表現になるが、まるである種の薬が脳を侵すかのような依存性がある」	PRINTFORMW 「虽然表达平庸，但有种被可以让人上瘾地药物侵犯脑部而产生地依赖感一样。」
PRINTFORMW 「次は%CNAMET(ARG, "二人称")%が目覚めのキスをしてくれないかね？」	PRINTFORMW 「接下来是%CNAMET(ARG, "二人称")%来吻我而让我苏醒吧？」
PRINTFORMW 「そのときはペローの童話のように野薔薇のベッドで%CNAMET(ARG, "二人称")%を待とう」	PRINTFORMW 「那个时候像童话一样在野蔷薇的地板上等待着%CNAMET(ARG,"第二人称")%」
PRINTFORMW 「もちろん、薔薇のツタは棘にまみれた厄介な障害物だが、その程度は乗り越えてくれたまえ」	PRINTFORMW 「当然，蔷薇是荆棘满满的麻烦障碍物，但请一定要跨越这个。」
PRINTFORMW 「おはよう。まったく、%CNAMET(ARG, "二人称")%にザーメンを出して貰う方法を教え込まされすぎた」	PRINTFORMW 「早上好%CNAMET(ARG, "二人称")%，呜呜……哦……噗……哈哈（舔嘴唇），出来了好多呢，我这就清理」
PRINTFORMW 「寝てる間も硬く勃起している姿を見て、つい手で触れて熱さを感じて、そのまま口で奉仕してしまうなどと…」	PRINTFORMW 「是这样的在睡觉的时候看到它那坚硬而一柱擎天的姿态，头就晕乎乎地不知不觉手就摸到了，感觉到了它那让人心里麻麻地灼热感后，就情不自禁地用嘴侍奉呢……」
PRINTFORMW 「まるでサキュバスだ。%CNAMET(ARG, "一人称")%をこんな淫らにしてどうするつもりだい？」	PRINTFORMW 「简直就像是荡妇一样。你打算对这样淫荡地%CNAMET(ARG, "一人称")%做什么呢？」
PRINTFORMW 「おはよう。いや、正直言って%CNAMET(ARG, "一人称")%も困惑しているのだ」	PRINTFORMW 「早上好，那个老实说%CNAMET(ARG, "一人称")%也很困惑」
PRINTFORMW 「まさか眠る%CNAMET(ARG, "二人称")%からザーメンを口で吐き出させるなどと・・・」	PRINTFORMW 「对睡着的%CNAMET(ARG, "二人称")%，用嘴巴接下吐出的精液什么的···」
PRINTFORMW 「体育など学ばずとも魔法使いにはなれる。%CNAMET(ARG, "二人称")%と一緒ならサボるのもやぶさかではないが」	PRINTFORMW 「即使不学体育也能当魔法使。与%CNAMET(ARG, "二人称")%一起，偷懒也不是很容易的事情呢」
PRINTFORMW 「魔法使いというのはマールスなどよりミネルウァを称賛するほうが性に合っている生き物だからね」	PRINTFORMW 「比起Marusu等魔法使，称赞Minewa更适合性生活」
PRINTFORMW 「%CNAMET(ARG, "一人称")%が先とは、なるほど悪い気分ではないね」	PRINTFORMW 「%CNAMET(ARG, "一人称")%在前面，确实也不坏呢」
PRINTFORMW 「今の時間でなにか知りたいことなどあれば可能な限り対応するが」	PRINTFORMW 「如果现在还有什么想知道的事情，我会尽可能的去对应的」
PRINTFORMW 標語を横目で確認した%CALLNAME:ARG%は水筒を取り出した	PRINTFORMW 确认了标语的%CALLNAME:ARG%取出了水壶
PRINTFORMW 「標語にもあることだし、何か飲むかね？」	PRINTFORMW 「标语里也有提示多喝水，那喝点什么呢？」
PRINTFORMW 「今日はちょうどローズヒップの持ち合わせがあってね、ビタミン補給にもなる」	PRINTFORMW 「今天正好有玫瑰，拿来泡还可以补充维生素。」
PRINTFORMW 「もちろん単に栄養分を得るだけなら水とサプリメントと塩で十分だが…」	PRINTFORMW 「当然只是单纯地获得营养成分的话，用水、营养品和盐就足够了………」
PRINTFORMW 「可能なら美味しさにもこだわるのが人間というものだろ？」	PRINTFORMW 「可能就连美味都讲究，就只有人类了吧？」
PRINTFORMW 標語を横目で確認した%CALLNAME:ARG%はどこか生真面目な表情を浮かべた	PRINTFORMW 确认了标语的%CALLNAME:ARG%浮现出一本正经的表情
PRINTFORMW 「キミが有する自らの権力性に万能感のようなものを覚えるというなら理解はするがね」	PRINTFORMW 「如果你对自己拥有的权力而感到是万能的话，那我就理解了」
PRINTFORMW 「自分が命じれば、これほどの美少女であってもいかがわしい姿を晒すのだと」	PRINTFORMW 「这是你自己发布地命令的话，即使是这样的美少女也会感到可疑的」
PRINTFORMW 「やぁ、どうだね？予習は十分に済ませてるかい？基礎的なことの反復こそ重要だぞ」	PRINTFORMW 「哎呀，怎么样？预习已经充分结束了吗？基础性的知识要重复练习才是重要的」
PRINTFORMW 「ただいま。実は%CNAMET(ARG, "二人称")%の背中を見つめながら帰ってきたと言ったら驚くかね？もちろん冗談だ、偶然に帰宅時間が重なっただけだよ」	PRINTFORMW 「我回来了。呐呐%CNAMET(ARG, "二人称")%我如果说其实是一边凝视着%CNAMET(ARG, "二人称")%你的后背一边跟随回来的话，你会感到吃惊吗？哈哈…当然这只是开玩笑的，只是碰巧回家的时间一样的而已」
PRINTFORMW 「おかえり。%CNAMET(ARG, "二人称")%の帰りをしばらく待っていたよ。そちら時間が取れれば何をしようかとね」	PRINTFORMW 「你回来了啊。在%CNAMET(ARG, "二人称")%还没有返回的时候我一直在这等候着你哟。现在如果有时间的话要做什么点呢」
PRINTFORMW ……彼女はなぜか下着姿だ	PRINTFORMW 不知她为何现在只穿着内衣
PRINTFORMW 「似合っているかね？男を性的に誘惑するための下着は」	PRINTFORMW 「很合适吧？这可是为了在性方面而诱惑男人的内衣」
PRINTFORMW 「買うのもなかなか恥ずかしかったのだよ、誰かとセックスしたいのだということが店員に一目瞭然だ」	PRINTFORMW 「买东西也挺不好意思的，店员一目了然就知道这是想和谁做爱才会准备的。」
PRINTFORMW 「もし少しでも性的興味を抱いてくれたならば、今夜ベッドに来てくれたまえ♪」	PRINTFORMW 「如果你对性爱方面有那么一点点的兴趣的话，今晚就来床上吧♪」
PRINTFORMW 「まったく、自分がこんなことをするようになるなんて夢にも思っていなかったよ」	PRINTFORMW 「真是的，做梦都没想到自己会做这样的事。」
PRINTFORMW %CALLNAME:ARG%は%CALLNAME:MASTER%に媚びるようにこちらを見つめながら、股間に顔を近づけてきた。	PRINTFORMW %CALLNAME:ARG%向着%CALLNAME:MASTER%投去献媚般地视线凝视着这边与此同时，%CALLNAME:ARG%的脸慢慢接近了%CALLNAME:MASTER%的裆下。
PRINTFORMW 「%CNAMET(ARG, "二人称")%がこんな風に調教したのが悪いのだ」	PRINTFORMW 「%CNAMET(ARG, "二人称")%都是这样调教我的好不好」
PRINTFORMW 「いつもいつも獣が自らの所有権を主張するようにオスの%TEXTR("匂い")%を刻み付けてくるから…」	PRINTFORMW 「就像野兽总是主张自己的所有权一样，都会给所有物刻上专属自己的雄性的%TEXTR("气味")%，是吧我亲爱的“野兽」
PRINTFORMW 「そのたびに%CNAMET(ARG, "一人称")%を淫らにもてあそぶから…」	PRINTFORMW 「每次%CNAMET(ARG, "一人称")%都会被淫乱地玩弄呢…」
PRINTFORMW %CALLNAME:ARG%は他人の目も気にせずあなたの汗臭いペニスを取り出そうとしている	PRINTFORMW %CALLNAME:ARG%不介意他人的眼睛，只想取出你充满汗臭的阴茎
PRINTFORMW 「気が付くと%CNAMET(ARG, "二人称")%の帰りを待っている自分がいる」	PRINTFORMW 「如果注意到自己现在自己的状态的话，自己现在正等待着%CNAMET(ARG, "二人称")%的归来」
PRINTFORMW 「時間があればまた話をしようじゃないか」	PRINTFORMW 「那有时间的话再聊吧」
PRINTFORMW 「今日は時間がとれるかい？」	PRINTFORMW 「今天有时间吗？」
PRINTFORMW 「授業中も%CNAMET(ARG, "二人称")%に何を話そうかとばかり考えていたよ」	PRINTFORMW 「上课时也老想着要对%CNAMET(ARG, "二人称")%说些什么呢」
PRINTFORMW 「もうこんなに集まっているのかね？」	PRINTFORMW 「已经在这里聚集到这么多人了？」
PRINTFORMW （%CALLNAME:ARG%は手を軽く上げて入室してきた）	PRINTFORMW （%CALLNAME:ARG%轻轻地举起手进入了室内）
PRINTFORMW （%CALLNAME:ARG%は手を軽く上げて応答した）	PRINTFORMW （%CALLNAME:ARG%轻轻地举起手回答到）
PRINTFORMW 『おはよう』	PRINTFORMW 『早上好』
PRINTFORML 「今回は\@ TALENT:オトコ ? 彼 # 彼女 \@を抱くのかい？」	PRINTFORML 「这次是\@ TALENT:男性 ? 彼 # 彼女 \@抱她吗？」
PRINTFORMW %CALLNAME:ARG%はうらやまし気に%CALLNAME:TARGET%のストリップを見ている	PRINTFORMW %CALLNAME:ARG%看着%CALLNAME:TARGET%令人羡慕的身材
PRINTFORMW %CALLNAME:ARG%は興味なさげにすぐ視線を本に戻した	PRINTFORMW %CALLNAME:ARG%马上毫无兴趣地将视线放回到了书中
PRINTFORMW 「ヴェルヴェーヌの香りが強いね、安物のハーブティーだが悪くない」	PRINTFORMW 「威尔凡纳的香味很浓，虽然是便宜的香草茶，但也不错」
PRINTFORMW %CALLNAME:ARG%はポットの飲み物ばかり口にしている。	PRINTFORMW %CALLNAME:ARG%只喝自带地保温瓶里的饮料。
PRINTFORML 「ドライフルーツで香り付けしたフレーバードティーだ」	PRINTFORML 「这是有干果香味的香草茶」
PRINTFORMW 「紅茶好きの中にはこういった代物を嫌う人間も存在するが%CNAMET(ARG, "一人称")%としてはこれはこれで好きだよ」	PRINTFORMW 「喜欢香草茶的人中也有讨厌这种的人存在，但%CNAMET(ARG, "一人称")%就喜欢这个…哼」
PRINTFORMW 「レシピ通りに仕上げたつもりだが、味は大丈夫かね？」	PRINTFORMW 「本想按食谱上的步骤来完成的，但这是我第一次制作，味道没问题吧？」
PRINTFORMW 「肉食への拒否感というものは多くの文化圏で大なり小なり見られる現象だ。もちろんこれは生命を奪うという行為について～」	PRINTFORMW 「对肉食感到厌恶在很多文化圈中也有大大小小的现象。当然这是对于剥夺生命的行为感到厌恶~」
PRINTFORMW %CALLNAME:ARG%は唐突に食事そっちのけで話を始めた	PRINTFORMW %CALLNAME:ARG%说到感兴趣的事，突然把吃的扔到一边开始说话
PRINTFORMW 「さようならだね。ちゃんと家で復習も忘れずするのだぞ？」	PRINTFORMW 「再见了。酱在家里复习也不要忘记啊？」
PRINTFORML 「%CNAME("二人称")%が%CNAME("一人称")%の旅路に加わりし者かね？」	PRINTFORML 「%CNAME("二人称")%是要加入%CNAME("一人称")%旅程的人吗？」
PRINTFORML 「%CNAME("一人称")%はあまり汗をかかない体質なのだが、ここまでだと流石に辛いな」	PRINTFORML 「%CNAME("一人称")%的体质是不怎么出汗的，但到此为止还是感到有些辛苦。」
PRINTFORML 「まったくあまり気持ちのいいものではないね」	PRINTFORML 「完全不是能让人心情好的东西呢」
PRINTFORML 寝ぼけて五芒星を空に描くという器用な真似をしている	PRINTFORML 睡眼惺忪地在空中描绘着五芒星
PRINTFORML 寝ぼけて黒魔術めいた詠唱をする器用な真似をしている	PRINTFORML 睡眼惺忪地吟唱带有黑魔术的咏唱手法地咏唱
PRINTFORML 寝ぼけて十字架を空に描くという器用な真似をしている	PRINTFORML 睡眼惺忪地在空中描画着十字架
PRINTFORML 「このまえプレゼントしてくれた服をまた着てみたよ」	PRINTFORML 「我又穿了上次你送礼给我的衣服哦」
PRINTFORML 「とはいえね、学ぶ時はしっかり師弟でいるのだぞ。メリハリが大事と言うだろ？」	PRINTFORML 「在学习的时候可要好好地当师徒啊。你说是吧很重要吧？」
PRINTFORML 「かのメイドも献身的なものだ」	PRINTFORML 「让女仆特地为了性交而建造的房间」
PRINTFORML 「学校という場にセックスのための部屋を無理してこしらえてしまうのだからね」	PRINTFORML 「在学校这个地方为了性交而勉强建造的房间。」
PRINTFORML 「はっきり言って普通にやるとなかなか真似できるものではない」	PRINTFORML 「直截了当的说，按普通的做起来也很难的」
PRINTFORML 「この部屋でいったい何人の学生を%CNAME("二人称")%の手にかけるつもりかね？」	PRINTFORML 「你打算把多少个学生抓在%CNAME("二人称")%的手上呢？」
PRINTFORML 「メイドにわざわざセックスのための部屋まで学校に作らせておいて」	PRINTFORML 「让女仆特地为了性交而建造的房间」
PRINTFORML 「それで普通の場所でもしたいだなんて、贅沢すぎるとは思わないかね？」	PRINTFORML 「那么想在普通的场所做这种事，不觉得太奢侈了吗？」
PRINTFORML 「私たちがセックスしたすぐ後に他の人が普通に使うというのに」	PRINTFORML 「我们性交后别人一般还会使用这个房间吧」
PRINTFORML 「別に%CNAME("二人称")%にとってカネを払うほどの価値があるほどの場所かね？」	PRINTFORML 「对于%CNAME("二人称")%来说，这样是值得花钱的地方吗？」
PRINTFORML 「なにせ学校の中だろうが%CNAME("一人称")%程の美少女を呼び出して性欲処理に使える身分なのだからね」	PRINTFORML 「不管怎么说在学校里面，%CNAME("一人称")%这样的美少女被叫来进行处理性欲的身份」
PRINTFORML 「しかも%CNAME("二人称")%とのセックスの後片付けを他人である清掃人にさせるなんて」	PRINTFORML 「而且在%CNAME("二人称")%的性交完成后，还要让她人进行善后工作」
PRINTFORML 「彼らが驚くくらいコンドームを使って自慢でもするつもりかね？」	PRINTFORML 「你想用避孕套来炫耀一下，想要让她们吓一跳吗？」
PRINTFORML 「フィールドワークかい？何をする？なに？別に魔法を教えてもらいたいわけではないのか…」	PRINTFORML 「田径赛吗？干什么？什么？难道你并不是想教我魔法吗……」
PRINTFORML 「まぁそうか、場を変えるというのは時に極めて重要だものね。どこへ行くんだい？」	PRINTFORML 「这样啊，换个地方有时候是极其重要的。你要去哪里？」
PRINTFORML 「わざわざ別の場所で裸に剥いてから%CNAME("二人称")%の部屋まで歩かせるなんて非効率的とは言わないよ」	PRINTFORML 「特地在别的地方脱光衣服，裸体在%CNAME("二人称")%的房间里走路不叫效率低哟」
PRINTFORML 「ハダカのままの%CNAME("一人称")%と一緒に歩いて、今からこの女とセックスするのだと知らしめるわけだ」	PRINTFORML 「和裸体的%CNAME("一人称")%一起走，现在才知道要和面前这个女人做爱吗」
PRINTFORML 「まさか外でやるわけにはいくまいが、家の中でなら%CNAME("二人称")%の征服欲に付き合おう」	PRINTFORML 「怎么可能在外面做呢，就在家里和充满征服欲地%CNAME("二人称")%交往吧」
PRINTFORML 「ふふ、%CNAME("二人称")%に今日は何に教えようか教室にいるときから楽しみにしていた」	PRINTFORML 「呼呼，%CNAME("二人称")%今天教室教了什么呢，现在有点开始期待了」
PRINTFORML 「やはりどうしても形而上学的な話にならざるを得ないときもあるが、そういうときも興味の沸きやすい題材はどんなものになるだろうかとか、教えるのもこれはこれで準備が必要なのだよ」	PRINTFORML 「有时不得不说些形式而上学的话，这时候也需要准备一些容易产生兴趣的题材，教他们这些题材」
PRINTFORML 「……それとも、%CNAME("一人称")%の言葉ではなく肉体が欲しいのかね？」	PRINTFORML 「……听了%CNAME("一人称")%的言词是她的肉体想要了吗？」
PRINTFORML %CALLNAME:TARGET%は %CALLNAME:MASTER%のベッドに仰向けに横たおり真っすぐこちらを見つめた	PRINTFORML %CALLNAME:TARGET%仰卧在%CALLNAME:MASTER%对面的地板上，笔直地看向这边
PRINTFORML 「%CNAME("二人称")%に出会う前は想像だにしなかったよ」	PRINTFORML 「在遇到%CNAME("一人称")%之前我连想都没想过」
PRINTFORML 「こうして男の部屋に入り込んで、しかも、セックスをおねだりするみたいに無防備に体を晒すなんてさ」	PRINTFORML 「像这样闯进男的房间里，而且还像要性交一样毫无防备的赤裸着全身」
PRINTFORML 「言うまでもないが誰とでも簡単にこんな関係になる人間ではないし、もしかしたら%CNAME("二人称")%が%CNAME("一人称")%にとって最初で最後の男かもしれない」	PRINTFORML 「不言而喻，和谁都不是那么容易就形成这种关系的%CNAME("一人称")%，说不定%CNAME("二人称")%对于%CNAME("一人称")%来说，这可能就是她最初也是最后一个男人」
PRINTFORML 「わざわざ別の場所で裸に剥いてから%CNAME("一人称")%の部屋まで歩かせるなんて非効率的とは言わないよ」	PRINTFORML 「特地在别的地方脱光衣服，裸体在%CNAME("二人称")%的房间里走路不叫效率低哟」
PRINTFORML %CALLNAME:TARGET%は崩れ落ちそうな本の山から器用にも奇妙なバランスを崩さないままに一冊だけ取り出して見せた	PRINTFORML %CALLNAME:TARGET%从快要崩塌的书山拿下来的，灵巧地不破坏奇怪的蔷薇序列拿出一本给你看
PRINTFORML 「今回はこの本を使おうと思っていたのだ。前回はすこし難解な部分だったからね、あれよりは%CNAME("二人称")%も面白く聞けるはずさ」	PRINTFORML 「这次我想用这本书。应该比上次那本稍微难懂要有趣，%CNAME("二人称")%要听吗？」
PRINTFORML %CALLNAME:MASTER%に話ができることにワクワクしながら前説を始めようとしている	PRINTFORML 打算开始前说，对于能与%CALLNAME:MASTER%交谈而感到兴奋。
PRINTFORML 「見ての通りあまり整理整頓できないタイプでね、本と資料の山さ」	PRINTFORML 「扫了一眼由书和资料堆积的山了，才注意到平时并不太整理的样子」
PRINTFORML 「まえはベッドも似たような感じだったのだが……%CNAME("二人称")%のためにここは片づけるようになったのだよ」	PRINTFORML 「在床上也堆积了不少，但在%CNAME("二人称")%到来之前抓紧清理吧」
PRINTFORML 「ある意味で%CNAME("二人称")%とセックスするために生活習慣の一部を変えさせられというべきかな」	PRINTFORML 「从某种意义上讲，为了与%CNAME("二人称")%发生性交，可以说是改变了一部分生活习惯吧」
PRINTFORML %CALLNAME:TARGET%は%CALLNAME:MASTER%を誘惑するようにベッドに誘い込もうとしている	PRINTFORML %CALLNAME:TARGET%想要诱惑%CALLNAME:MASTER%一样把他诱惑到床上
PRINTFORML 「あら%CNAME("二人称")%に%CNAME(CSVCALLNAME(NO:ASSI) )%？」	PRINTFORML 「哎呀%CNAME("二人称")%和%CNAME(CSVCALLNAME(NO:ASSI) )%？」
PRINTFORML 「二人してなにか用でもあるのかね？」	PRINTFORML 「两人有什么事吗？」
PRINTFORML 「%CNAME("一人称")%の助けが必要かね？」	PRINTFORML 「需要%CNAME("一人称")%的帮助吗？」
PRINTFORML 「前回の話で何か疑問でもあったかな。なるべく力になろう」	PRINTFORML 「上次的话有什么疑问吗？我想我尽可能能帮到忙吧」
PRINTFORML 「深淵を覗くのは魔術の目的の一つだが、%CNAME("二人称")%はどこを覗いてるのかね？」	PRINTFORML 「窥视深渊是魔术师的目之一，呐%CNAME("二人称")%究竟在窥视着哪里呢？」
PRINTFORML 「まぁいいさ、%CNAME("二人称")%ならばその探究心に免じて許してやろう。他の人に怒られない程度にしたまえよ」	PRINTFORML 「嘛，算了，如果是%CNAME("二人称")%的话就算看到也原谅你吧，但不要惹别人生气哦」
PRINTFORML ローライズヒップ	PRINTFORML 低腰臀圍
PRINTFORML 「なんだ、%CNAME("二人称")%はよっぽど性欲に満ち溢れてるようだね」	PRINTFORML 「怎么说呢，现在%CNAME("二人称")%好像已经充满性欲了呢」
PRINTFORML 「いや、あるいは%CNAME("二人称")%の体質がその由来なのだろうか？一考には値するかもしれないな…」	PRINTFORML 「不，或者%CNAME("二人称")%的体质是这么来的，也许这值得考虑呢？……」
PRINTFORML パンツを凝視されているのも気にせず考え込み始めた	PRINTFORML %CALLNAME:TARGET%毫不介意地被主人公凝视着胖次，开始沉思对方的体质问题
PRINTFORML 「おや、写真を撮りたかったのかね？」	PRINTFORML 「哎呀，你想偷照吗？」
PRINTFORML 「視線を意識しない姿を撮影したかったというのは理解するよ」	PRINTFORML 「我理解你想偷偷拍摄没有意识到这边地视线的样子。」
PRINTFORML 「次はうまく気づかれないように撮りたまえ」	PRINTFORML 「下次拍的时候不要被注意到了」
PRINTFORML 「%CNAME("二人称")%はひょっとしたら%CNAME("一人称")%が恥ずかしがるのを期待しているかもしれないが」	PRINTFORML 「%CNAME("二人称")%现在说不定期待着%CNAME("一人称")%会感到害羞吧」
PRINTFORML 「何度もセックスした関係なのだから、いまさらというものさ」	PRINTFORML 「都事到如今了，因为是多次性交的关系，现在不会感到害羞了哦」
PRINTFORML 「もちろん不特定多数に見られる場所でというのは難しいが」	PRINTFORML 「当然在有多数人的场所里这么作的话还是很难为情呢」
PRINTFORML 「ここにいるのは皆%CNAME("二人称")%と体の交わりを持っているのだろう？」	PRINTFORML 「在这里的所有人都和%CNAME("二人称")%的身体有过交集吧？」
PRINTFORML 「ならばお互い様というものさ」	PRINTFORML 「那就彼此彼此吧」
PRINTFORML 「どうせ屋外であっても誰かに見られないよう、なにか仕掛けをしてるのだろう？」	PRINTFORML 「反正在室外为了不让别人看见，是不是要做些什么呢？」
PRINTFORML 「こうして二人きりなのだからね」	PRINTFORML 「现在只有我们两个人了」
PRINTFORML 「こうして部屋で二人きりなのだからね」	PRINTFORML 「就这样在单间里只有两个人了」
PRINTFORML 「他の女性たちの前でこんなことをさせておいて、ベッドまで連れて行かないことはあるまいね？」	PRINTFORML 「在别的女性面前做这样的事情，不带她到床上去吗？」
PRINTFORML 「それとも、そのままココで%CNAME("一人称")%を抱いてどんな姿を見せるか晒すつもりかい？」	PRINTFORML 「还是说，你打算把%CNAME("一人称")%抱在怀里弄成什么样子呢？」
PRINTFORML 「%CNAME("一人称")%をどうか恥も外聞もない女だとは思わないでくれたまえ」	PRINTFORML 「请别以为%CNAME("一人称")%是个不害羞不体面的女人哦」
PRINTFORML 「なにしろ%CNAME("二人称")%こそがこんなことをさせている張本人なのだからね」	PRINTFORML 「毕竟%CNAME("二人称")%才是真正让%CNAME("一人称")%干这种事的罪魁祸首呢」
PRINTFORML 「さしもの%CNAME("一人称")%も%CNAME("二人称")%に出会う前はこんなことをするなど考えもしなかったよ」	PRINTFORML 「呐呐，在%CNAME("一人称")%遇到%CNAME("二人称")%之前从来没有想过要做这样的事情」
PRINTFORML 「ましてや、この行為に性的な興奮を感じさせられまでするなんてね」	PRINTFORML 「更何况，这种行为让人感到“性奋”呢」
PRINTFORML 「別に%CNAME("一人称")%は他人の目線はたいして気にならないが」	PRINTFORML 「虽然%CNAME("一人称")%并不在意别人的视线」
PRINTFORML 「外に見目麗しい女性が部屋にいる中でこんなことをしているのもどこか倒錯的だね」	PRINTFORML 「但外表漂亮的女性在房间里做这样的事情也总觉得有些不合常理的」
PRINTFORML 「なにか下着に対して注文があるならベッドで聞くが・・・必要あるかね？」	PRINTFORML 「如果对内衣有什么要求的话可以到床上问……但有必要吗？」
PRINTFORML 「こうやって%CNAME("二人称")%がパンツばかり気にするものだから下着の所有数ばかり増える」	PRINTFORML 「像这样%CNAME("二人称")%总是在意胖次，所以内衣的所有数有所会增加吧」
PRINTFORML 「%CNAME("二人称")%のための下着を収める棚を一つ作る必要があるかもしれないよ」	PRINTFORML 「说不定%CNAME("二人称")%需要制作一个收纳内衣的架子哟」
PRINTFORML 「もちろん%CNAME("二人称")%に見られるのは悪い気分ではないが」	PRINTFORML 「当然，被%CNAME("二人称")%看也不是很坏」
PRINTFORML 「%CNAME("一人称")%からなにかアピールさせたいのではないかと勘繰ってしまうよ」	PRINTFORML 「%CNAME("一人称")%会反复考虑要不要让大家看到什么呢」
PRINTFORML 「そんなに凝視するほど魅力的かね？」	PRINTFORML 「有那么吸引人的目光吗？」
PRINTFORML 「%CNAME("二人称")%の視線がどこか心地よい%CNAME("一人称")%がいる」	PRINTFORML 「%CNAME("二人称")%的视线让%CNAME("一人称")%觉得很舒服呢」
PRINTFORML 「それが、たとえこのように露骨に性的なものであったとしてもね」	PRINTFORML 「即使这是如此露骨的充满性欲的视线与那呼在内裤上的热气呢」
PRINTFORML 「それで、他の女性たちの目の前で%CNAME("一人称")%をザーメン処理に使って満足したかい？」	PRINTFORML 「那么，在其他女性面前使用%CNAME("一人称")%进行精液处理让充满征服欲的你感到满意吗？」
PRINTFORML 「これですぐ%CNAME("一人称")%以外の女性を抱いたりしたら、なんて節操のない男なのだと皆あきれてしまうよ？」	PRINTFORML 「马上去抱%CNAME("一人称")%以外的女性的话，大家都会惊讶你是个没有节操的男人哟？」
PRINTFORML 「もっとも、そうであったとしても%CNAME("一人称")%を嫌いになれなくさせられてしまっているけれどね」	PRINTFORML 「不过，即使那样，%CNAME("一人称")%也不讨厌的……哼」
PRINTFORML 「%CNAME("二人称")%のザーメンを受け止めると、体が性的快楽を強く求めてしまう」	PRINTFORML 「接受完了%CNAME("二人称")%的精液后，身体内部强烈地寻求关于性方面的快乐呢❤」
PRINTFORML 「ただ%CNAME("二人称")%の性欲を処理する一方的なものではなくて、お互いに求めるようなセックスがしたくなってしまう」	PRINTFORML 「只是%CNAME("二人称")%啊，性欲处理不是单方面的享受哦，应该是两方寻求性交的过程呢」
PRINTFORML 「仮に、たとえ%CNAME("二人称")%にとっては本当は性欲処理に過ぎなかったとしてもね」	PRINTFORML 「假设，对于%CNAME("二人称")%来说，其实只是想发泄性欲而已吧」
PRINTFORML 「まだそんなにペニスを硬いままにして、まだまだ足りないのかい？」	PRINTFORML 「现在肉棒还那么硬，难过刚刚作的还不够吗？」
PRINTFORML 「これではまたすぐに元の木阿弥になってしまいそうだ」	PRINTFORML 「这样一来又马上要变成原来的一柱擎天了呢」
PRINTFORML 「次に纏うのが%CNAME("二人称")%の体液なのか、あるいは別の誰かのものなのかは別にしてね」	PRINTFORML 「接下次上面染上的是%CNAME("二人称")%的体液，还是其他的谁的东西就另当别论了」
PRINTFORML 「%CNAME("二人称")%のペニスに性的快感を与えるために分泌される体液がこんなに漏れ出してるのがわかるかい？」	PRINTFORML 「这是%CNAME("二人称")%的肉棒给予地性快感才让下面分泌这么多淫液出来，%CNAME("二人称")%明白吗？」
PRINTFORML 「しっかり撮影するといい、%CNAME("二人称")%のペニスがどれだけ歓迎されているかの証なのだから」	PRINTFORML 「好好地摄影就好了，这是%CNAME("二人称")%的肉棒受欢迎的证据哦」
PRINTFORML 「これほどの数の見目麗しい女性を好き勝手にしているのだ」	PRINTFORML 「如此多姿多彩的女性，真是随心所欲啊」
PRINTFORML 「ひょっとして今日は誰をどうしたか写真で記録して日誌でもつけているのかい？」	PRINTFORML 「难不成今天你用照片记录下了谁的日志了吗？」
PRINTFORML 「日に日にみな%CNAME("二人称")%の「誘い方」が上達するのがよくわかるのが想像がつくよ」	PRINTFORML 「可以想象%CNAME("二人称")%的“邀请方式”每天都在进步呢」
PRINTFORML 「なにか下着に対して注文があるならベッドで聞くが・・・必要あるかね？」	PRINTFORML 「如果对内衣有什么介意的话可以到床上说……有那必要吗？」
PRINTFORML 「こうやって%CNAME("二人称")%がパンツばかり気にするものだから下着の所有数ばかり増える」	PRINTFORML 「%CNAME("二人称")%像这样总是在意胖次的，所以内衣的所有数有在增加」
PRINTFORML 「%CNAME("二人称")%のための下着を収める棚を一つ作る必要があるかもしれないよ」	PRINTFORML 「%CNAME("二人称")%说不定需要制作一个收纳内衣的架子哟」
PRINTFORML 「このまま%CNAME("二人称")%から口づけしてくれないかい」	PRINTFORML 「啊…%CNAME("二人称")%就这样开始接吻好吗？」
PRINTFORML 「手で愛撫するより先に唇で愛情表現するのが筋というものだよ」	PRINTFORML 「与其用手去爱抚，不如先用嘴唇来表达爱情这才是道理」
PRINTFORML 「自らこんなことをしていて言うのもどこか変な話だがね」	PRINTFORML 「自己做着这样的事但说出来也挺奇怪的」
PRINTFORML 「やはりこんな状態で%CNAME("二人称")%とキスすると、満足するまでしたくなってしまうね」	PRINTFORML 「果然在这种状态下与%CNAME("二人称")%接吻，变得有点欲求不满想要做爱呢」
PRINTFORML 「%CNAME("二人称")%と性欲のおもむくまま体を交えたくなってしまう」	PRINTFORML 「使命与%CNAME("二人称")%和性欲交织在一起了」
PRINTFORML %CALLNAME:TARGET%は欲求不満で高ぶった体を押し付けておねだりしてきた	PRINTFORML %CALLNAME:TARGET%因为欲求不满而将性欲高涨的身体靠向对方
PRINTFORML 「キスが問題を解決することは少ないが、問題をしばし忘れさせることはよく言われる」	PRINTFORML 「接吻很少能解决问题，但经常在一会后就忘记了问题」
PRINTFORML 「アヘンが痛みを忘れさせても流れ出る血を止める効果はないようにね」	PRINTFORML 「即使忘记了疼痛也没有止住流出的血的效果」
PRINTFORML 「%CNAME("二人称")%からキスされる前に近づく瞳の色が美しくて」	PRINTFORML 「%CNAME("二人称")%被亲吻之前瞳孔的颜色很美」
PRINTFORML 「%CNAME("二人称")%の目を見ると、ふとその情景を思い出してしまう」	PRINTFORML 「看到%CNAME("二人称")%的眼睛，会突然想起那个情景」
PRINTFORML 「そうすると、今度は%CNAME("一人称")%から%CNAME("二人称")%の光彩や瞳孔まで見える距離に近づきたくなる」	PRINTFORML 「这样的话，%CNAME("一人称")%这次想接近到%CNAME("二人称")%的光彩和瞳孔能看见的距离」
PRINTFORML 「情欲に身を任せるようなキスは好きだが、こういった親愛のキスも好きだよ」	PRINTFORML 「虽然喜欢这样任凭情欲的驱动下接吻，但也喜欢这种亲密的接吻哦」
PRINTFORML %CALLNAME:TARGET%は唇に指をあてて微笑んだ	PRINTFORML %CALLNAME:TARGET%用手指抵在嘴唇上对着你微笑
PRINTFORML 「%CNAME("一人称")%ほどの美少女に体を求められて断るなんて、つくづく贅沢な男だよ%CNAME("二人称")%は」	PRINTFORML 「%CNAME("一人称")%那样的美少女被要求身体得到了拒绝，%CNAME("二人称")%真是个非常奢侈的男人啊」
PRINTFORML 「さすがに自らを美少女なんて大っぴらに口にできる%CNAME("一人称")%も少し自信を失う」	PRINTFORML 「就连能够公开说出自己是美少女的%CNAME("一人称")%也会稍微失去自信吧」
PRINTFORML 「それとも講義のほうが聞きたいかね？ならば%CNAME("一人称")%もやりがいがあるというものだが」	PRINTFORML 「还是想听课呢？那么%CNAME("一人称")%也是很有价值的」
PRINTFORML %CALLNAME:TARGET%は射精を求めるのではなく甘えるようにゆっくりと唇をストロークしてペニス全体に唾液をまぶしている	PRINTFORML %CALLNAME:TARGET%不是为了得到射精，而是为了撒娇而使用嘴唇慢慢地在阴茎上涂满了唾液
PRINTFORML 「%CNAME("二人称")%のものをこうやって触っていると、もっと気持ちよくなってほしくなる」	PRINTFORML 「%CNAME("二人称")%的肉棒这样触摸的话，会变得更舒服吧」
PRINTFORML 「女性をこんな風にしてしまうのも%CNAME("二人称")%の力の一つなのかね？」	PRINTFORML 「让女性变成这样也是%CNAME("二人称")%的力量之一吗？」
PRINTFORML 「しばらくこうしてていいかな」	PRINTFORML 「暂时这样可以吗？」
PRINTFORML 「性欲に身を任せるのは心地よいが、こういうのも悪くない」	PRINTFORML 「任凭性欲指示摆设虽然很舒服，但这种也不错」
PRINTFORML 「このままいつものように話でもするかい？」	PRINTFORML 「就这样像往常一样说话吧？」
PRINTFORML 「見るだけで満足かい？」	PRINTFORML 「光看就满足了吗？」
PRINTFORML 「外に要望があるなら何なりと言ってみたまえ」	PRINTFORML 「如果对外表有什么要求的话，就尽管说吧」
PRINTFORML 「どれくらいの見えかたが望みかね？」	PRINTFORML 「你希望看到多少呢？」
PRINTFORML %CALLNAME:TARGET%はスカートの裾を上下させてパンツの見え方を少しずつ変えている	PRINTFORML %CALLNAME:TARGET%让裙子的上摆露出来胖次这个观点一点点的改变她
PRINTFORML 「%CNAME("二人称")%から抱きしめられるのとはまた違った心地よさがある」	PRINTFORML 「%CNAME("二人称")%的拥抱让我感觉又不一样了」
PRINTFORML 「ずっと%CNAME("二人称")%を抱きしめながら生活したくなるほどさ」	PRINTFORML 「现在想一边抱住%CNAME("二人称")%一边进行崭新的生活呢」
PRINTFORML %CALLNAME:TARGET%は自らの体を押し付けるかのように腕に力を込めてきた	PRINTFORML %CALLNAME:TARGET%像是把自己的身体强加在胳膊上似得
PRINTFORML %CALLNAME:TARGET%は頭を撫でられてどこか嬉しそうだ	PRINTFORML %CALLNAME:TARGET%的头发被抚摸着，看样子好像很高兴的样子
PRINTFORML 「両親はどんな人かって？二人とも魔法使いだよ。いろいろあってこの国に移住してきたのさ」	PRINTFORML 「父母是怎样的人？两个人都是魔法使，发生了很多事情才移居到这个国家。」
PRINTFORML 「二人の家格が釣り合わなくてね、駆け落ちしてきたらしい。ああ、存命さ」	PRINTFORML 「二人的家里条件不相称，后面好象私奔了，啊啊，现在双亲都还活着」
PRINTFORML 「あんな感じの女を孕ませたいと思ってるのかね？」	PRINTFORML 「你是想孕育出那种感觉的女人吗？」
PRINTFORML 「%CNAME("二人称")%が本当にそう思うならいろいろ協力してもよいが」	PRINTFORML 「%CNAME("二人称")%如果真的这么想的话，我可以多方协助的」
PRINTFORML 「ふふふ、冗談だと思うかい？」	PRINTFORML 「呵呵，你觉得我是在开玩笑吗？」
PRINTFORM %CALLNAME:TARGET%は	PRINTFORM %CALLNAME:TARGET%是
PRINTFORM %TEXTR("時折その金髪を手に絡めつつ/たまに独り言をつぶやきつつ/ペットボトルのお茶を飲みながら")%	PRINTFORM %TEXTR("时而将金发缠绕在手上/时而自言自语/时而喝着塑料瓶里的茶")%
PRINTFORML %TEXTR("魔法の本を読んで/外国語の本を読んで/何語かもわからない本を読んで/スマホを弄って/料理の本を読んで/教科書を読み込んで/あなたのための講義ノートを書いて")%いる	PRINTFORML %TEXTR("读魔法书/读外语书/读看不懂的书/玩手机/读料理书/读教科书/为你写笔记")%
PRINTFORMW 「ご主人様、とでも言えばいいかな？もちろん言わないがね」	PRINTFORMW 「可以称呼你为主人吗？我当然不会说的」
PRINTFORMW 「本来は仕事着であるはずのメイド服にいろいろな意味が上乗せされているのは興味深い」	PRINTFORMW 「原本应该是工作服的女仆装上载着各种各样的意义，这点很有意思」
PRINTFORMW 「制服の本来の役割、服装が「かたち」として意味を外装する効果の賜物かもしれないね」	PRINTFORMW 「制服本来的作用、服装作为“形状”的意思外装的效果或许是赐予的吧」
PRINTFORMW 「しっかり勉強した%CNAME("二人称")%ならわかるはずだ、これもある種の魔法の一形態なのだよ」	PRINTFORMW 「认真学习的%CNAME("二人称")%应该能理解，这也是某种魔法的一种形态哟」
PRINTFORML フリルで飾り立てられた人形のような衣服に身を包んでいる	PRINTFORML 身穿着用荷叶边装饰起来的像人偶一样的衣服
PRINTFORML 「この服かい？父親に無理を言って買ってもらったのだよ」	PRINTFORML 「这件衣服吗？是父亲强迫买给我的」
PRINTFORML 「好きな男ができたから、彼の目をなるべく惹きつける衣装を買ってくれとね」	PRINTFORML 「但因为有了喜欢的男人，所以要尽量买可以吸引他眼睛的衣服。」
PRINTFORML 「そうか、様々な返答の予想を立ててはいたのだがストレートに褒められるのは存外にむず痒いものだな」	PRINTFORML 「原来如此，虽然预想了各种各样的回复，但是被直接表扬还是让人出乎意料啊」
PRINTFORML 「私は許そう……」	PRINTFORML 「我会原谅的……」
PRINTFORML 「Alright, I believe you… but my Tommy gun don't!（私は信じよう。だがこいつは信じるかな！）」	PRINTFORML 「Alright, I believe you… but my Tommy gun don't!（我相信吧。但是这家伙会相信吗！）」
PRINTFORML 「だが、こいつ（自動小銃）が許すかな！」	PRINTFORML 「但是，这家伙（自动步枪）会原谅我吗！」
PRINTFORMW 「ふむ……存外に当たらないものだな。今日はこの辺で勘弁してやろうじゃないか」	PRINTFORMW 「嗯……真是出乎意料的不中啊。今天就到此为止吧」
PRINTFORML 「コスプレか、それは予想の範疇にない返答だな」	PRINTFORML 「cosplay啊，那是在预想范围内没有的回答」
PRINTFORML 「まだこの姿を見慣れないと言う意味だと、受け取っておこう」	PRINTFORML 「意思是还没看惯这个样子，那就接受吧。」
PRINTFORML 「%TEXTR("コスプレのつもりはないのだがね/コスプレではないよ")%」	PRINTFORML 「%TEXTR("没有cosplay的打算/不是cosplay哟")%」
PRINTFORML 「%TEXTR("気に入らないならそう言いたまえ/%CNAME("二人称")%はお気に召さないかな？")%」	PRINTFORML 「%TEXTR("如果你不喜欢就直说吧/%CNAME("二人称")%你不喜欢吗？")%」
PRINTFORML %CALLNAME:TARGET%はちょっとむくれて%CALLNAME:MASTER%を見つめている	PRINTFORML %CALLNAME:TARGET%用有点浮肿的眼睛凝视着%CALLNAME:MASTER%
PRINTFORM %TEXTR("まだ慣れないといった風に/あなたの目線を気にするように/動きづらそうな様子で/自分の体を見ながら/どこかしっくり来ないという表情で")%	PRINTFORM %TEXTR("还未习惯的样子/像是在意你的视线/像是行动不便的样子/看着自己的身体/露出受不了你的表情")%
PRINTFORML %TEXTR("たたずんで/姿をアピールして/落ち着かなさそうにして/ポーズを作って")%いる	PRINTFORML %TEXTR("伫立/展现身姿/看起来不沉着/做出姿势")%いる
PRINTFORM %CALLNAME:MASTER%との性的接触をしばらく離れていて不安なのか	PRINTFORM 暂且说出口没跟%CALLNAME:MASTER%进行性接触而感到不安吗
PRINTFORM %TEXTR("真面目な顔で/ペンで書きこみを入れながら/どこかしっくり来ないという表情で/無言で")%	PRINTFORM %TEXTR("一本正经的脸/在用笔写入/一副不舒服的表情/沉默地")%
PRINTFORML %TEXTR("官能小説/エッチなマニュアル/愛撫テクニック集/誘惑の指南書")%を読んでいる	PRINTFORML %TEXTR("官能小说/色情手册/爱抚技术集/诱惑指南")%を読んでいる
PRINTFORM %TEXTR("没頭と形容をすべき様子で/どこか気怠げな様子で/難しい顔をして/優しげに微笑みつつ/どこかしっくり来ないという表情で/無言で")%	PRINTFORM %TEXTR("应该形容为沉思的样子/一副懒洋洋的样子/一脸不高兴的样子/温柔地微笑/一脸不融洽的表情/沉默地")%
PRINTFORML %TEXTR("魔法の本を読んで/外国語の本を読んで/何語かもわからない本を読んで/スマホを弄って/料理の本を読んで/教科書を読み込んで/あなたのための講義ノートを書いて")%いる	PRINTFORML %TEXTR("读魔法书/读外语书/读看不懂的书/玩手机/读料理书/读教科书/为你写讲义")%いる
PRINTFORML 魔法使いの呼吸法を寝ていても続けているようだ	PRINTFORML 魔法使の呼吸法を寝ていても続けているようだ
PRINTFORMW 「まったく、一人では排泄行為さえできないなんてね」	PRINTFORMW 「真是的，一个人连排泄行为都做不到」
PRINTFORMW 「そうだろう？%CNAME("二人称")%と同年代の大半は溜まったザーメンを自分で排泄できるのだ」	PRINTFORMW 「%CNAME("二人称")%同年代的大半都能自己排泄出积蓄的精液了，是吧？」
PRINTFORMW 「それを%CNAME("二人称")%は、こんなところで私をトイレにしないといけないのだからね」	PRINTFORMW 「因为%CNAME("二人称")%必须在这种地方把我送入厕所」
PRINTFORMW 「性欲の排泄行為としてオナニーではなく私ほどの美少女の体を使うのはさぞ気分がいいだろうね」	PRINTFORMW 「作为性欲发泄地行为，这不是自慰，而是使用我这样的美少女的身体，那想必一定很舒服吧。」
PRINTFORMW 「授業まであまり時間がないね、急がないといけない」	PRINTFORMW 「离上课没多少时间了，得赶紧了」
PRINTFORMW 「もし遅刻したりしたら…遅刻して入ってきた私へ皆の目線が集まる」	PRINTFORMW 「如果迟到的话……大家都凝视着迟到进来的我们」
PRINTFORMW 「ほんの一瞬だろうが、%CNAME("二人称")%の性欲を受け止めたばかりの私が皆から見られてしまう」	PRINTFORMW 「虽然只是一瞬间，大家都会看刚刚被%CNAME("二人称")%发泄完性欲的我吧」
PRINTFORMW 「もちろん、彼らにはそんなこと知る由もないだろうけれどね」	PRINTFORMW 「当然，他们也不会知道那种事情。」
PRINTFORMW 「やはりトイレではムードに欠けるね」	PRINTFORMW 「果然在里厕所真是缺乏情趣呢」
PRINTFORMW 「コレではまるで%CNAME("二人称")%専用のザーメン便器だ」	PRINTFORMW 「不过，这样子简直是%CNAME("二人称")%专用的精液便器一样」
PRINTFORMW 「性欲が溜まったらオナニーの代わりに呼び出される女だなんて」	PRINTFORMW 「如果性欲大增，都会被叫来代替自慰的女人」
PRINTFORMW 「誰かトイレに入ってきたらどうするつもりだい？」	PRINTFORMW 「有谁进厕所的打算怎么办？」
PRINTFORMW 「他の男子が小便器に排泄してるすぐ横で、私の体にザーメンを捨てるのかな？」	PRINTFORMW 「如果有其他男生在小便器的旁边看着我，会不会把精液射到我身上呢？」
PRINTFORMW 「体育の備品がたくさんあるこの部屋は個人的には好きな場所ではないね」	PRINTFORMW 「在体育设备堆积如山的里房间对我个人来说是我喜欢的地方」
PRINTFORMW 「そして今の%CNAME("二人称")%にとって、私でさえ性欲処理用の備品なわけだ」	PRINTFORMW 「而且对于现在的%CNAME("二人称")%来说，连我都是用来处理性欲用的物品呢」
PRINTFORMW 「授業前にトイレに行くかのような気軽な性欲処理機」	PRINTFORMW 「像是上课前去厕所一样的轻松的性欲处理机」
PRINTFORMW 「壊さないように大事に使いたまえよ」	PRINTFORMW 「要小心使用，不要弄坏它哦」
PRINTFORMW 「体育の授業がある直前に性欲処理をさせるなんて」	PRINTFORMW 「在上体育课之前帮你进行处理性欲」
PRINTFORMW 「%CNAME("二人称")%の熱いオスとしての欲望を受け止めて発情した体を落ち着ける時間もない」	PRINTFORMW 「%CNAME("二人称")%没有时间接受雌性被雄性欲望而发情的身体安定下来」
PRINTFORMW 「発情させられて火照った体を公に晒して運動をすることになるのだよ？」	PRINTFORMW 「让发情的雌性公开露着火辣的身体做着抽插运动什么的」
PRINTFORMW 「どうも%CNAME("二人称")%は私との関係をよほど他人に見せつけたいのではないかと感じる」	PRINTFORMW 「总觉得%CNAME("二人称")%是想让别人看到我和他的关系吧」
PRINTFORMW 「次の体育のために誰か備品を取りに来るかもしれない」	PRINTFORMW 「为了下一个体育项目，也许有人会来取设备」
PRINTFORMW 「その時はどう言い訳するかね？跳び箱のなかで隠れてするかい？」	PRINTFORMW 「那时候该如何解释呢，你躲在跳箱里吗？」
PRINTFORMW 「まぁ本当に見られたときは「実用的」な魔法を見せることになる」	PRINTFORMW 「嘛，当你真的看到时，你将会看到‘实用’的魔法哦。」
PRINTFORMW 「だから安心して気持ちよく性欲を吐き出したまえ」	PRINTFORMW 「所以请安心舒畅地释放出性欲来吧」
PRINTFORMW 「男子更衣室で性欲処理だなんて、」	PRINTFORMW 「竟然要在男子更衣室里进行性欲处理什么的」
PRINTFORMW 「オスの汗臭い匂いがキツイ場所でも、%CNAME("二人称")%の香りははっきりわかるよ」	PRINTFORMW 「即使在充满其他难闻地雄性汗臭的地方，只有%CNAME("二人称")%那身上独特地香味清晰可见」
PRINTFORMW 「他の男を知らないから比較できないが…たぶん%CNAME("二人称")%の性臭がいちばん私を発情させる」	PRINTFORMW 「虽然臭味无法和其他的男性比较…但是%CNAME("二人称")%身上的气味是最让我发情的哦」
PRINTFORMW 「%CNAME("二人称")%が女の子を性欲処理のためだけに呼びつけるほど性力旺盛だからだろうかね？」	PRINTFORMW 「%CNAME("二人称")%是因为可以让女孩子帮你处理性欲而感到性欲旺盛吧？」
PRINTFORMW 「授業が近いのに男子更衣室で性欲を処理させるだなんて」	PRINTFORMW 「明明离上课很近了，居然还要在男更衣室里处理性欲什么的。」
PRINTFORMW 「そんなに他の男に%CNAME("一人称")%の体が誰のモノになっているか見せつけたいのかね？」	PRINTFORMW 「就那么想让其他的男人看到%CNAME("一人称")%的身体是专属谁的东西吗？」
PRINTFORMW 「…%CNAME("二人称")%とならそれも悪くないと思わされてしまってさえいるのよ」	PRINTFORMW 「…如果%CNAME("二人称")%是这样想的话，我认为这样也不错呢」
PRINTFORMW 「なるべく%CNAME("二人称")%の性欲がおさまるよう頑張って搾り取らせてもらおうか」	PRINTFORMW 「我会努力地帮忙榨取完%CNAME("二人称")%的性欲哦，加油。」
PRINTFORMW 「少しは%CNAME("二人称")%の旺盛すぎる性欲も収まったかい？」	PRINTFORMW 「%CNAME("二人称")%旺盛的性欲稍微平息了些吗？」
PRINTFORMW 「だいぶ時間はギリギリだが……」	PRINTFORMW 「虽然现在的时间很紧……」
PRINTFORMW 「もし怒られたら%CNAME("二人称")%の性欲処理をしていて遅れましたとでもいうとしよう」	PRINTFORMW 「如果被骂了，就说为了帮%CNAME("二人称")%处理性欲，所以才迟到的吧」
PRINTFORMW 「もちろん冗談だがね」	PRINTFORMW 「当然是开玩笑了」
PRINTFORMW 「さて、トイレの使い心地はどうだったかね？」	PRINTFORMW 「那么，厕所的使用感觉怎么样呢？」
PRINTFORMW 「%CNAME("二人称")%の溜まった濃ゆくて重いザーメンを注がれて…」	PRINTFORMW 「%CNAME("二人称")%积存的浓郁沉重的精液都注入到我体内了……」
PRINTFORMW 「この発情した体で薄着したまま体育で体を動かすのだ」	PRINTFORMW 「这种发情的身体穿着单薄的衣服在体育运动中活动着身体」
PRINTFORMW 「ひょっとしたら私を見て性欲を感じる男子もいるかもしれないね」	PRINTFORMW 「说不定有的男生看到我后会勃去呢」
PRINTFORMW 「%CNAME("二人称")%専用の私の体を妄想してオナニーしてしまったりしてね」	PRINTFORMW 「%CNAME("二人称")%专用的我的身体就妄想自慰了」
PRINTFORMW 「次が水泳とわかっていて中に出したのかね？」	PRINTFORMW 「明知道接下来是游泳课，所以就射到里面去了？」
PRINTFORMW 「%CNAME("二人称")%がたっぷり注ぎ込んだ濃ゆいザーメンを薄い布地だけで抑えなきゃいけなくなってしまった」	PRINTFORMW 「%CNAME("二人称")%注入大量的浓郁精液，只用单薄的布料是掩盖不了的」
PRINTFORMW 「ちょっと水で薄められてもはっきりザーメンとわかってしまうくらい濃ゆいやつが」	PRINTFORMW 「这浓郁的家伙，即使稍微用水稀释也能清楚地知道是精液吧」
PRINTFORMW 「私ほどの美少女の股ぐらから垂れてくる姿…男子はみな勃起して授業にならないかもしれない」	PRINTFORMW 「像我这样的美少女从胯下流出来什么的……男生们有可能不会专心上课了，都会看着我勃起吧」
PRINTFORMW 「相手が誰だと言われたら正直に%CNAME("二人称")%だと答えることにするよ」	PRINTFORMW 「如果对方说是谁作的话，我会老实回答说是%CNAME("二人称")%做的」
PRINTFORMW 「さて、では%CNAME("二人称")%の溜まったザーメンを受け止めた残り香を保ったまま授業に行くとしよう」	PRINTFORMW 「那么，接下来，就让射在我里面的%CNAME("二人称")%积存的精液保持着残留的香味去上课吧」
PRINTFORMW %CALLNAME:TARGET%は体に塗ったボディソープで%CALLNAME:MASTER%の体を洗っている	PRINTFORMW %CALLNAME:TARGET%用涂在身上的沐浴露清洗着%CALLNAME:MASTER%的身体
PRINTFORMW 「この後はすぐベッドに入るのかね？」	PRINTFORMW 「之后就马上上床吗？」
PRINTFORMW 「まったく%CNAME("二人称")%の性的奔放さにも困ったものだ」	PRINTFORMW 「%CNAME("二人称")%的完全性奔放也让我感到为难呢」
PRINTFORMW 「他の生徒が次の授業の準備などしてる休み時間に女性の体を蹂躙してきているのだから」	PRINTFORMW 「其他学生在准备下节课的休息时间蹂躏女性的身体」
PRINTFORMW 「そして、他の女性の体液の汚れを自ら口で奇麗にしてあげたいなどと申し出る%CNAME("一人称")%自身にもね」	PRINTFORMW 「并且，%CNAME("一人称")%自己也提出想用嘴清理干净其他的女性的体液的污垢什么的」
PRINTFORMW 「%CNAME("二人称")%のことだ、先ほどの性欲処理ではまだ足りないのだろう？」	PRINTFORMW 「是关于还没有让%CNAME("二人称")%感到舒服的事，刚才的性欲处理还不够吗？」
PRINTFORMW 「仮にこの後で他の女性を抱くならばそのままの状態ではまずかろう」	PRINTFORMW 「如果这之后再抱其他女性的话，就这种状态下就不好办了吧」
PRINTFORMW 「%CNAME("一人称")%自身の体液を%CNAME("一人称")%の口で処理しようじゃないか」	PRINTFORMW 「那么%CNAME("一人称")%就用嘴巴来处理残留着%CNAME("一人称")%自己的体液吧」
PRINTFORML %CALLNAME:TARGET%はその可憐な唇が%CALLNAME:MASTER%の睾丸の付け根に届くほど熱心に最後の一滴まで搾り取ると	PRINTFORML %CALLNAME:TARGET%那可爱的嘴唇热情地榨取着%CALLNAME:MASTER%那肉棒和根部那大大的睾丸里面的精液，直到最后一滴都不剩为止
PRINTFORMW 唇で自身の唾液をペニスからふき取るように、最後の仕上げとばかりにゆっくりと先端まで愛撫してくれた	PRINTFORMW 用嘴唇将自己的唾液从阴茎上抹掉，爱抚着直到我最后的完成为止
PRINTFORMW 「大丈夫かね？それほどの状態だ、目ざとい人ならば気づかれてしまうかもしれないよ？」	PRINTFORMW 「那你没事吧？如果这样的状态，就算是眼睛不好的人也有可能会注意到的哦？」
PRINTFORMW 「%CNAME("二人称")%が自分の性生活を周囲に自慢したいと言うのでなければ後で奇麗にしておくといい」	PRINTFORMW 「%CNAME("二人称")%如果不是想向周围的人炫耀自己的性生活的话，事后保持干净就好了」
GREETING = こんばんは	GREETING = 晚上好
GREETING = こんにちは	GREETING = 你好
GREETING = おはよう	GREETING = 早上好
PRINTFORMW 「おや、こんな挨拶をしてくるのは親以外では%CNAME("二人称")%が初めてだよ」	PRINTFORMW 「哎呀，这样招呼的除了父母以外%CNAME("二人称")%还是第一次」
PRINTFORMW 「……が、人目をもうすこし気にしたほうがいいとは思うがね」	PRINTFORMW 「………但是，我觉得还是在意别人的眼光比较好」
PRINTFORMW 「いや、その、汗がつくことを考慮してほしいのだが…」	PRINTFORMW 「不，我想让你考虑一下汗液会流出来的……」
PRINTFORMW 「とはいえ、私も似たような状態だから別に変わらないわけか」	PRINTFORMW 「也就是说，我也是相似的状态，所以没什么变化。」
PRINTFORMW 「ほら、タオルくらい貸してやろうじゃないか」	PRINTFORMW 「你看，至少借个毛巾吧」
PRINTFORMW 「それとも、私の体に%CNAME("二人称")%の体液をまとわりつかせたまま生活してほしいのかね？」	PRINTFORMW 「还是，希望我的身体留着%CNAME("二人称")%的体液生活？」
PRINTFORMW %CALLNAME:TARGET%は思わせぶりに汗のついた衣服を整えながら微笑んだ	PRINTFORMW %CALLNAME:TARGET%整理着让人意想不到的汗流浃背的衣服微笑着
PRINTFORMW 「……今日もよろしく頼むよ」	PRINTFORMW 「……今天也请多多指教」
PRINTFORMW %CALLNAME:TARGET%は微笑みつつ軽く抱きしめ返してきた。	PRINTFORMW %CALLNAME:TARGET%微笑着轻轻地拥抱了过来。
PRINTFORMW 「ん、んん…………%GREETING%」	PRINTFORMW 「嗯、嗯…………%GREETING%」
PRINTFORMW 「一般的には、挨拶のキスは頬にするものだね。キスはする場所に意味が生じるというのは有名だ」	PRINTFORMW 「一般来说，打招呼的接吻都是在脸颊上的。接吻的地方的是有讲究的」
PRINTFORMW 「せっかくだし%CNAME("二人称")%とはこちらのキスもしようじゃないか」	PRINTFORMW 「难得，%CNAME("二人称")%我们也来接吻吧」
PRINTFORMW %CALLNAME:TARGET%は頬を染め、%CALLNAME:MASTER%に愛情たっぷりのディープなキスを返してきた。	PRINTFORMW 虽然%CALLNAME:TARGET%低着头红着脸颊，但还是给了%CALLNAME:MASTER%充满爱的深吻。
PRINTFORMW 「もちろん、時代や文化圏によって行為の意味というものは得てして大きく変化するわけだがね」	PRINTFORMW 「当然，根据时代和文化圈的不同，行为的意义也会发生很大的变化。」
PRINTFORMW %CALLNAME:TARGET%は頬を染めながらも悪戯げに人差し指で%CALLNAME:MASTER%の唇をかるく抑えた	PRINTFORMW %CALLNAME:TARGET%一边红着脸颊一边用食指轻轻地压住%CALLNAME:MASTER%刚刚做完恶作剧地嘴唇
PRINTFORMW %CALLNAME:TARGET%はもっと深くとばかりに%CALLNAME:MASTER%の唇を貪るため腕を回してきた	PRINTFORMW %CALLNAME:TARGET%为了夺取%CALLNAME:MASTER%的嘴唇而拉动着对方的手臂
PRINTFORMW 「…………んっ……%GREETING%」	PRINTFORMW 「…………嗯……%GREETING%」
PRINTFORMW 「%CNAME("二人称")%にキスされると…なんだその、シたくなってしまう」	PRINTFORMW 「被%CNAME("二人称")%接吻的话…怎么会变得非常想要、想要…o(*////▽////*)q」
PRINTFORMW 「挨拶と言うにはなんだ、かなり気恥ずかしいというのは正直なところだが」	PRINTFORMW 「虽说是打招呼，但怎么说实在有些不好意思(*/ω＼*)」
PRINTFORMW 「……その、嫌いではないよ」	PRINTFORMW 「……那个，我并不讨厌…嗯」
PRINTFORMW 「…………んっ……%GREETING%」	PRINTFORMW 「……………嗯……%GREETING%」
PRINTFORMW 「%CNAME("二人称")%は本当にしょうがない男だね」	PRINTFORMW 「%CNAME("二人称")%真是让人没办法的男人啊」
PRINTFORMW 「コレを挨拶と言い張られても%CNAME("一人称")%は困るよ」	PRINTFORMW 「即使有某个人硬说这是打招呼，但%CNAME("一人称")%还是很难为情的」
PRINTFORMW %CALLNAME:TARGET%は眉をひそめるつつも従順に%CALLNAME:MASTER%に体を晒している	PRINTFORMW 虽然%CALLNAME:TARGET%轻轻地皱着眉毛，但还是顺从地将身体曝露给%CALLNAME:MASTER%看
PRINTFORMW 「夜にシャワーを浴びてから時間が経っているが、匂いとか気にならないのかい？」	PRINTFORMW 「晚上淋浴的时间过去了，你不介意有什么味道吗？」
PRINTFORMW 「いくら%CNAME("二人称")%が不肖の初弟子といえど、どうかと思うよそれは」	PRINTFORMW 「无论%CNAME("二人称")%是不是个不肖的弟子，但你为什么会这么想呢」
PRINTFORMW 「%CNAME("一人称")%が理論派といえど、偉大で恐ろしい魔法の徒だということを忘れないことだ」	PRINTFORMW 「%CNAME("一人称")%虽然是理论派，但不要忘记她是伟大而恐怖的魔法之徒」
PRINTFORMW %CALLNAME:TARGET%は厳しい目つきで不穏な空気を放っている	PRINTFORMW %CALLNAME:TARGET%的眼神严厉，周围散发着不安的气氛
PRINTFORMW 「今日もよろしく頼むよ」	PRINTFORMW 「今天也请多多指教」
PRINTFORMW %CALLNAME:TARGET%は飄々とした表情で挨拶を返してきた。	PRINTFORMW %CALLNAME:TARGET%以轻飘飘的表情回应了打招呼。
PRINTFORMW 「夏は仕方がないとはいえ暑いのは苦痛なものだ」	PRINTFORMW 「身体感到炎热还是很痛苦的，在夏天没有办法」
PRINTFORMW 「あまり汗をかかない体質だが限界というものはある」	PRINTFORMW 「虽然是不怎么出汗的体质，但还是有界限的」
PRINTFORMW %CALLNAME:TARGET%はいたずらげに笑うと首に腕を回しキスをしてきた	PRINTFORMW %CALLNAME:TARGET%的手腕抱在%CALLNAME:MASTER%的脖子上接着吻，过后还恶作剧地笑着
PRINTFORMW 「%CNAME("二人称")%の言葉はまるでネーペンテースのように悲しみも苦しみも消し去ってしまう」	PRINTFORMW 「%CNAME("二人称")%的甜言蜜语宛如黎明的阳光一般，悲伤和痛苦都消失了」
PRINTFORMW 「そうであるならば、%CNAME("二人称")%の唇で喜びも与えてほしいと思うのは%CNAME("一人称")%のワガママというわけではあるまい」	PRINTFORMW 「如果是这样的话，希望在%CNAME("二人称")%的嘴唇上给予了自己的喜悦，但并不是%CNAME("一人称")%的任性啊」
PRINTFORMW 「本質的に言葉こそ魔法なのだという一派もいるが、なるほど%CNAME("二人称")%もなかなかの魔法を使うようになったと見える」	PRINTFORMW 「虽然语言本质上也是魔法中的一派，诚然%CNAME("二人称")%也是使用了相当多可以让人心动地魔法呢」
PRINTFORMW 「もう少し鍛えれば%CNAME("一人称")%を堕落させてしまいかねないかもしれないね」	PRINTFORMW 「如果再稍微锻炼一下的话，可能%CNAME("第一人称")%也会堕落的了哦」
PRINTFORMW 「%CNAME("二人称")%はいつからそんなレートリケーに達者になったのかね？」	PRINTFORMW 「%CNAME("二人称")%是从什么时候开始达到这样的汇率风险的呢？」
PRINTFORMW 「レトリック、修辞学ともいうが、まぁ要するに聴衆の心を動かして例えば裁判などを有利に運ぶ技術だな」	PRINTFORMW 「虽然也叫修辞学，但总而言之，就是可以打动听众的心，比如有利于审判的技术。」
PRINTFORMW 「しかしプラトンになぞらえるならば、魔法使いの言葉はディアレクティケーであるべきだよ」	PRINTFORMW 「但是如果比作柏拉图的话，魔法使的语言应该是目录」
PRINTFORMW 「伝統的に色に象徴的意味が見出されることがある。例えば黄色は特に光沢などの表現がないただの黄色でも黄金の象徴だ」	PRINTFORMW 「传统的颜色有象征性的意义。比如说，黄色是没有特别的光泽等表现，单纯的黄色也是黄金的象征」
PRINTFORMW 「それで、なにの色を確認したいと言ったかね？パンツ？まったく%CNAME("二人称")%というやつは…」	PRINTFORMW 「那么，%CNAME("二人称")%你想确认胖次什么颜色呢…」
PRINTFORMW 「今は%CLOCOLOR(CSTR:パンツ, "形容詞")%ものだが、聞けて満足かね？」	PRINTFORMW 「现在是%CLOCOLOR(CSTR:胖次, "形容詞")%不过，你听起来满足吗？」
PRINTFORMW 「…………ときに、わからないからこそ意味がある場合もあるとは思わないかい？」	PRINTFORMW 「……………有时候，你难道不觉得正因为不懂才有意义吗？」
PRINTFORMW 「妖精は運命をもたらす役割を担っているのだよ。それは語源からも明らかだ」	PRINTFORMW 「妖精担负着带来命运的作用。这在语源上很明显」
PRINTFORMW 「英語のFairy、フランス語のFee、イタリア語ではFata、全てラテン語では運命の女神Fateなのさ」	PRINTFORMW 「英语中的Fairy、法语中的Fee、意大利语中的Fata、全部是拉丁语中命运的女神Fate」
PRINTFORMW 「実用上は単に現実味のなく美しいという美称であることがほとんどだがね、そう私のような」	PRINTFORMW 「在实用上几乎都是毫无现实感的美丽的名称，就像我一样」
PRINTFORMW 「バラは色の情熱性から熱い愛に意味をつなげることが現代では多いが、棘のある茨から防御や障害という意味にも繋げられる」	PRINTFORMW 「从玫瑰的颜色中有热情和热爱的意义在现代有很多，但是从带刺的荆棘中也能联想到防御和障碍的意思。」
PRINTFORMW 「他にも英語の慣用句 under the rose はローマ時代にバラで飾られた部屋を秘密の会合に用いたことから意味を繋げられたのが由来だ」	PRINTFORMW 「在其他的，英语惯用句中under the rose也是因为在罗马时代用玫瑰装饰的房间用于秘密聚会，所以也被赋予了意义」
PRINTFORMW 「このように一つのモノからも意味をつなげることで多様な結果を導くのが魔術の基本なのだよ、こじつけと言ってもいいかもしれないがね」	PRINTFORMW 「像这样通过将一个东西的意义连结起来，引导出多种多样的结果是魔术的基本哟，或许可以说是牵强附会。」
PRINTFORMW 「髪は女の命とも言うが、魔法使いにとっては特にそうだ。髪には呪力が宿る…と言われていたのだから」	PRINTFORMW 「头发也可以说是女性的生命，但对魔法使来说尤其如此。头发中寄宿着咒力……」
PRINTFORMW 「一説には成長したあとにも伸び続けるのが伝承の由来だと言われているが…だとすると%CNAME("二人称")%の髪の伸びは速そうだ」	PRINTFORMW 「有一种说法是，成长完后仍会继续增长，这是传说的由来……这样的话%CNAME("二人称")%的头发似乎长得很快」
PRINTFORMW 「いや、まあそれは冗談にせよ、%CNAME("二人称")%はどれくらいの長さにしてほしいかね？」	PRINTFORMW 「不，就算是开玩笑，呐%CNAME("第二人称")%你想要多长呢？」
PRINTFORMW 「%CNAME("二人称")%も今のうちから本棚のためのスペースを確保したほうがいいかもしれないね」	PRINTFORMW 「%CNAME("二人称")%说不定现在也最好确保足够多的书架空间」
PRINTFORMW 「なにせ本で部屋が埋まりかねないからね。%CNAME("一人称")%のような実践より理論派の魔法使いは特にそうさ」	PRINTFORMW 「因为不管怎么说，房间可能会被书所掩埋。%CNAME("一人称")%是最好的例子，但理论派的魔法使也尤其如此」
PRINTFORMW 「魔法のコツは客観を主観で上書きしてしまうような…いや本当は違うのだが初心者向けにはそう言おう」	PRINTFORMW 「魔法的要领是以客观为主观来覆盖的……不对，其实是不同的，但还是对初学者这么说」
PRINTFORMW 「そもそも主観客観を対概念とする枠組み自体がかなり後世になってからの考え方なのだよ」	PRINTFORMW 「原本以主观客观为概念的框架本身就是后世的想法」
PRINTFORMW 「本気で解説するには実体とはなにかという話から初めなければなるまい」	PRINTFORMW 「要认真地解说，必须从实体这个词开始」
PRINTFORMW 「まずギリシアの時代ではアリストテレスは…いや話す前に基本書を渡すべきか…」	PRINTFORMW 「首先，在希腊时代，爱丽丝特蕾丝……不对，在讲课之前应该先教基本书吧……」
PRINTFORMW 「%CNAME("二人称")%は何気なく呼吸をしてるだろう？しかし%CNAME("二人称")%は医者や生物学者ほどには呼吸を理解してはいまい？」	PRINTFORMW 「%CNAME("二人称")%是在无意中呼吸吧？但是%CNAME("二人称")%能像医生和生物学家那样理解呼吸吗？」
PRINTFORMW 「ところが、悪魔たちは息をするように力を使う事ができる。けれど魔法使いが彼らに劣るわけではないのさ」	PRINTFORMW 「但是，恶魔们可以像呼吸一样使用力量。但是魔法使并不比他们差」
PRINTFORMW 「何故ならば、理屈を知ることこそ魔法使いの目的にして存在意義なのだからね。少なくとも%CNAME("一人称")%はそう考えている」	PRINTFORMW 「因为，了解其中地道理是魔法使存在的意义。至少%CNAME("一人称")%是这么想的」
PRINTFORMW 「ちゃんと睡眠は取りたまえよ？睡眠不足のままではどれだけ素晴らしい頭脳とて効率的に働かせることはできないのだから」	PRINTFORMW 「去掉酱和睡眠吧？因为在睡眠不足的情况下，即使是多么出色的头脑也无法高效率地工作的」
PRINTFORMW 「いくら夜にはとびっきり魅力的な女性に好きなだけその精を捧げることができる立場だといえどね」	PRINTFORMW 「无论夜晚是多么有魅力的女性，只要是喜欢的人，就能够竭尽全力。」
PRINTFORMW 「汗を拭くというよりは愛撫と言ったほうがしっくりくるねこれは」	PRINTFORMW 「与其说是擦汗不如说是爱抚更合适呢」
PRINTFORMW 「あまり私を本気にさせないでくれよ？汗の代わりに別の体液で汚れてしまうからね」	PRINTFORMW 「不要让我太认真了，因为会被别的体液代替汗水弄脏的」
PRINTFORMW %CALLNAME:TARGET%は%CALLNAME:MASTER%を誘うように流し目を送りつつ身を委ねている	PRINTFORMW %CALLNAME:TARGET%像是在诱惑%CALLNAME:MASTER%似的，脸带春光的把身体靠了过来
PRINTFORMW 「腋の下はやめてくれないか？その、変な臭いが%CNAME("二人称")%の手につくとその、恥ずかしい」	PRINTFORMW 「能不能别把手放在我的腋下，那个，如果奇怪的臭味沾到%CNAME("二人称")%的手的话那个，怪不好意思的」
PRINTFORMW 「もちろん腋の臭いについて魔法的な講釈を述べることは簡単だが、そういう問題じゃないのだ」	PRINTFORMW 「当然，对于腋下的臭味，魔法讲解也是很简单的，但并不是那样的问题」
PRINTFORMW %CALLNAME:TARGET%は顔を赤くしつつもおとなしく%CALLNAME:MASTER%のされるがままに任せている	PRINTFORMW %CALLNAME:TARGET%毫无保留地脸红任凭着%CALLNAME:MASTER%的玩弄
PRINTFORMW 「%CNAME("一人称")%のためと言うより%CNAME("二人称")%自身の趣味だろうこれは」	PRINTFORMW 「与其说是为了%CNAME("一人称")%还不如说是为了%CNAME("二人称")%你自己的兴趣吧」
PRINTFORMW 「もちろん、%CNAME("一人称")%にとって利益がないわけでもないから受け入れるがね」	PRINTFORMW 「当然，对于%CNAME("一人称")%来说并不是没有利益，所以接受」
PRINTFORMW 「こうも暑いと汗を拭くのも面倒になるからありがたくないわけではないけれどね…」	PRINTFORMW 「这么热的话，擦汗也会变得麻烦，所以也不是不值得庆幸……」
PRINTFORMW %CALLNAME:TARGET%は暑さにまいりつつ%CALLNAME:MASTER%の好きにさせている	PRINTFORMW %CALLNAME:TARGET%一边酷暑难耐一边让喜欢地%CALLNAME:MASTER%帮自己擦着汗
PRINTFORMW 「%CNAME("二人称")%だったか。そうだろうとは思っていたが」	PRINTFORMW 「是%CNAME("二人称")%吗？我还以为是什么啊」
PRINTFORMW 湯上りで瑞々しい%CALLNAME:TARGET%の肌にまかれたバスタオルは水分をたっぷり吸って張り付き、色白な肢体がうっすらと透けて見える	PRINTFORMW 洗完澡后水灵灵的%CALLNAME:TARGET%贴在肌肤上的浴衣，充分吸取了水分，贴紧肌肤，白色的肢体透过半透明地浴衣显露了出来
PRINTFORMW 「もう少し早ければ一緒にシャワーを浴びれたのにね」	PRINTFORMW 「如果再早一点就能一起淋浴了」
PRINTFORMW 「そうすればそんな風に脱いだ下着などに手を付けなくても・・・」	PRINTFORMW 「这样一来，即使不把手贴在脱下来的内衣上……」
PRINTFORMW 「最初から%CNAME("二人称")%自身の手で一枚ずつ脱がせたりできただろう」	PRINTFORMW 「一开始就是%CNAME("二人称")%用自己的双手一件一件地脱下来了吧」
PRINTFORMW 「それとも、脱がせるのと脱いだものを漁るのはまた別腹ということかね？」	PRINTFORMW 「还是说，别人脱掉的和自己脱下的又是另外一回事吗？」
PRINTFORMW %CALLNAME:TARGET%は悪戯げに微笑みながら堂々とその金髪を拭き始めた	PRINTFORMW %CALLNAME:TARGET%用恶作剧地表情微笑着并在你面前侧着头揉搓着金发
PRINTFORMW 確かに巻いたタオルで体は隠されているが、女性的な部分がむしろ強調されてしまっているのに気付いているのかいないのか…	PRINTFORMW 确实用卷着的毛巾遮住了身体，但是突出女性的部分反而被强调了，她有没有注意到呢？
PRINTFORMW 「まったく、そんな場所に口づけするより唇にして欲しいものだね」	PRINTFORMW 「真是的，比起亲吻那样的地方，我更希望你的嘴唇。」
PRINTFORMW 「%CNAME("二人称")%が楽しいならそれはそれでいいけれど…ん、露骨に臭いを嗅ぐのはやめたまえ」	PRINTFORMW 「%CNAME("二人称")%如果快乐的话那倒也无妨……嗯，不要这么露骨地闻着气味啦」
PRINTFORMW %CALLNAME:TARGET%はそう言いつつもおとなしく受け入れている	PRINTFORMW %CALLNAME:TARGET%虽然这么说，但还是毫不客气地接受了
PRINTFORMW 「あぅ、首筋の筋肉をほぐすこの手付き、嫌いじゃないな」	PRINTFORMW 「啊，可以放松脖子肌肉的这种手势，我不讨厌啊」
PRINTFORMW %CALLNAME:TARGET%は心地よさそうに%CALLNAME:MASTER%に身を委ねている	PRINTFORMW %CALLNAME:TARGET%看起来很舒服，完全屈服%CALLNAME:MASTER%的按摩手法中
PRINTFORMW 「マッサージという行為は肉体的な気持ちよさだとか開放感を生じる」	PRINTFORMW 「按摩这种行为会产生肉体上的舒适感、开放感」
PRINTFORMW 「つまるところ「わかりやすい」効果があるわけだ。故に原初の医療行為となったわけだよ」	PRINTFORMW 「归根结底，应该有“容易理解”的效果。所以才成为了最初的医疗行为」
PRINTFORMW %CALLNAME:TARGET%は%CALLNAME:MASTER%に身体を委ねている	PRINTFORMW %CALLNAME:TARGET%舒服地将身体交给了%CALLNAME:MASTER%
PRINTFORML 「他の女もこうやって骨抜きにしているのかね？」	PRINTFORML 「其他的女人也这样按摩吗？」
PRINTFORMW %CALLNAME:TARGET%は体の力を抜いて気持ちよさそうに背中を揉まれている……	PRINTFORMW %CALLNAME:TARGET%全身放松，看起来很舒服地被%CALLNAME:MASTER%按摩着后背……
PRINTFORMW 「お礼に私も後でいろいろしてあげようじゃないか」	PRINTFORMW 「作为礼品，我待会儿也帮你多关照吧。」
PRINTFORMW 時間をかけて%CALLNAME:MASTER%との長いキス味わった%CALLNAME:TARGET%はすっかり女の顔をしている	PRINTFORMW 花了很长时间与%CALLNAME:MASTER%亲吻的%CALLNAME:TARGET%的脸完全是放荡地女人一样
PRINTFORMW 「ねぇ、ここでするかい？それともちゃんとした場所で続きをしようかな？」	PRINTFORMW 「喂，在这里做吗？还是在作为酱的场所继续吧？」
PRINTFORML 「ん……♪」	PRINTFORML 「嗯……♪」
PRINTFORMW 擦り付けられた%CALLNAME:TARGET%の体からじわりと熱い愛液が零れ落ちるのを感じた	PRINTFORMW 感觉从被摩擦的%CALLNAME:TARGET%的身体里面开始慢慢地散落出炙热的爱液
PRINTFORMW 「やっ……」	PRINTFORMW 「哎呀……」
PRINTFORMW 「軽々しくキスをしていいのかね？%CNAME("一人称")%はキスされると最後までシたくなるタイプだというに」	PRINTFORMW 「可以轻松地接吻吗？%CNAME("一人称")%想被接吻的话到最后变得想做了」
PRINTFORMW %CALLNAME:TARGET%は%CALLNAME:MASTER%を誘うように目を細めながら頬を染めている	PRINTFORMW %CALLNAME:TARGET%像是诱惑%CALLNAME:MASTER%一样眯着眼睛用染红地脸颊看向这里
PRINTFORMW 「んっ………」	PRINTFORMW 「嗯………」
PRINTFORMW 「%CNAME("二人称")%とのキスは好きだよ、%CNAME("一人称")%からもいいかね？」	PRINTFORMW 「喜欢跟%CNAME("二人称")%的接吻哟，能再多给%CNAME("一人称")%点好吗？」
PRINTFORMW %CALLNAME:TARGET%は%CALLNAME:MASTER%を強く抱きしめながらベッドでするような熱いキスを続けている	PRINTFORMW %CALLNAME:TARGET%一边紧紧地拥抱着%CALLNAME:MASTER%一边继续着热吻
PRINTFORMW %CALLNAME:TARGET%は目を細めて%CALLNAME:MASTER%の口づけを受け入れた	PRINTFORMW %CALLNAME:TARGET%眯着眼睛软下身子接受了%CALLNAME:MASTER%的接吻
PRINTFORMW 「そうかい、じゃあアイピローを取ってくれたまえ、カバンに入ってるはずだ」	PRINTFORMW 「对了，那帮我拿一下眼罩吧，应该放在包里了。」
PRINTFORML 「目を休めるというのは重要な行為だからね…それともメガネな女の子も好きかね？」	PRINTFORML 「让眼睛休息是重要的……还是说，你喜欢戴眼镜的女孩呢？」
PRINTFORMW 「お茶、teaとは本来チャノキの葉の抽出液だがね、それ以外の植物の抽出液もハーブティーと呼ぶだろ？」	PRINTFORMW 「茶、tea本来是茶叶提取液，除此之外的植物提取液也叫做香草茶吧？」
PRINTFORMW 「西洋に狭義のteaが伝わるまでtisanaというのが広義のハーブティーの呼び名だったのだ」	PRINTFORMW 「在西洋的tea流传之前，tisana是广义的香草茶的称呼」
PRINTFORMW 「それがいつの間にかチャノキの抽出液であるteaが広いカテゴリ全体を代表するようになったのさ」	PRINTFORMW 「不知何时，作为樟树提取液的tea代表了广阔范畴全体」
PRINTFORMW 「他にはたとえば朝食を朝ごはんと言うように、上位概念を下位概念が代表することをシネクドキという」	PRINTFORMW 「另外，比如说早餐叫早饭，上位概念代表下位概念叫做‘电影化」
PRINTFORMW 「この香り、レモングラスかな？飲みやすくて好きだよ」	PRINTFORMW 「这种香味，是柠檬茶吗？很好喝，我很喜欢」
PRINTFORMW %CALLNAME:TARGET%は嬉しそうにハーブティーを受け取った	PRINTFORMW %CALLNAME:TARGET%开心地喝下了柠檬香草茶
PRINTFORMW 「このハーブはロサ・ダマスケナだね？」	PRINTFORMW 「这香草是罗莎·大马士革吧？」
PRINTFORMW 「いかにも「バラの香り」という匂いが素敵だ。ダマスク香と呼ばれるのだが」	PRINTFORMW 「的确有“蔷薇的香气”感觉很棒。所以被称为大面具香」
PRINTFORMW %CALLNAME:TARGET%は目をつむって香りを楽しんでいる	PRINTFORMW %CALLNAME:TARGET%闭着眼睛享受香气
PRINTFORMW 「口づけで幸せにされた直後にこんなことをされると」	PRINTFORMW 「接吻让我感到幸福，我就这样做吧」
PRINTFORMW 「%CNAME("二人称")%にもっと甘えてしまいたくなる」	PRINTFORMW 「%CNAME("二人称")%变得更想撒娇了」
PRINTFORMW 「そうやって労わってもらえると奉仕にも充実感が増すというものだ」	PRINTFORMW 「这样做的话，服务过后也会增加充实感吧」
PRINTFORMW %CALLNAME:TARGET%は甘く愛でるような手淫を続けつつ喜んでいる	PRINTFORMW %CALLNAME:TARGET%继续着甜蜜爱情般的手淫服务
PRINTFORMW 頭を撫でられた%CALLNAME:TARGET%は嬉しそうにペニスを喉奥まで包み込んだ	PRINTFORMW 头被抚摸的%CALLNAME:TARGET%开心地把阴茎含进了喉咙的更深处
PRINTFORMW 「お掃除よくできまいた、とでも言うつもりかね？」	PRINTFORMW 「你打算说的是我打扫得很好吧？」
PRINTFORMW %CALLNAME:TARGET%はピカピカにみがかれた直後のペニスに仕上げのキスをした	PRINTFORMW %CALLNAME:TARGET%的眼睛在闪闪发光，开心了一会后又紧接着亲吻着肉棒
PRINTFORMW 「まるでペットの犬猫を愛でるような撫で方だ」	PRINTFORMW 「简直就像抚摸着喜欢的宠物一样」
PRINTFORMW 「それも、都合のいいときいつでも性欲処理に使えるね」	PRINTFORMW 「那也是，在方便的时候像宠物一样随时都可以用来处理性欲的。」
PRINTFORMW 「膝に乗せた美少女の頭を撫でるなどという「絵になる」情景を体験しているのだよ%CNAME("二人称")%は」	PRINTFORMW 「%CNAME("二人称")%摸着坐在膝盖上美少女的秀发，体验着‘变成画’的情景」
PRINTFORMW 「もっとも、どういう「絵になる」かはどこに焦点を合わせるかによるだろうがね」	PRINTFORMW 「不过，到底是什么样的‘画’，要看重点在什么地方吧。」
PRINTFORMW 「%CNAME("二人称")%に撫でられるのは心地よさを感じる」	PRINTFORMW 「%CNAME("二人称")%的抚摸让人觉得很舒服呢」
PRINTFORMW 「愛撫で与えてくれる快楽は好きだが、この心地よさも同じくらい好きだよ」	PRINTFORMW 「虽然我喜欢用爱抚给予我快乐，但是也同样喜欢这种舒适的感觉」
PRINTFORMW 「ありがとう。細かい気配りなどしなくていいのだけれども」	PRINTFORMW 「谢谢，虽然不用这么细心」
PRINTFORMW 「そろそろ風呂に入ろうと思うのだが」	PRINTFORMW 「我想差不多该进浴室了」
PRINTFORMW 「だいぶ汗をかいてしまったしシャワーでも浴びようと思うのだが」	PRINTFORMW 「我出了很多汗，现在很想洗淋浴呢」
PRINTFORMW 「よかったら%CNAME("二人称")%も一緒に入るかね？」	PRINTFORMW 「如果可以的话，%CNAME("二人称")%也想一起进入吗？」
PRINTFORMW 「いまとても%CNAME("二人称")%のキスが欲しいんだ」	PRINTFORMW 「现在非常想要%CNAME("二人称")%的吻呢，好嘛…好嘛」
PRINTFORMW 「この粘膜の細胞の一つ一つが%CNAME("二人称")%に甘えたくてうごめいてるのだよ」	PRINTFORMW 「秘穴里面的粘膜细胞每一个都是想要%CNAME("二人称")%而撒娇蠕动着呢」
PRINTFORMW 「%CNAME("二人称")%に可能な限りペニスでの快楽を感じてもらって」	PRINTFORMW 「请%CNAME("二人称")%尽情地感受着我给予阴茎的快乐吧」
PRINTFORMW 「ザーメンを子宮の奥に孕むまで注いでほしくて準備運動してしまっている」	PRINTFORMW 「子宫深处正在进行准备运动，正希望精液能注入到里面呢」
PRINTFORMW 「言っておくが、ココがこういう風になるのは%CNAME("二人称")%のためだけだからね」	PRINTFORMW 「我预先说一下，还不是%CNAME("二人称")%的所作所为才让那里变得这样的」
PRINTFORMW 「わかるかい？この布のすぐ下で%CNAME("二人称")%が欲しくて切なくなっているのが」	PRINTFORMW 「明白吗？就在这块布的下面变得想要%CNAME("二人称")%而感到燥热难耐」
PRINTFORMW 「%CNAME("二人称")%の手で裸に剥かれて、%CNAME("二人称")%に弄ばれるのを心待ちにしてるのが」	PRINTFORMW 「%CNAME("二人称")%的手正在我皮肤上游走着，期待着能被%CNAME("二人称")%的玩弄」
PRINTFORMW 「%CNAME("二人称")%がココをあんな風に見るから、セックスを期待して準備してしまっているのだよ」	PRINTFORMW 「因为%CNAME("二人称")%会这样看着我，所以很期待性交，而正在准备当中呢」
PRINTFORMW 「%CNAME("二人称")%は気持ちよくザーメンを吐き出せて満足かもしれないが」	PRINTFORMW 「%CNAME("二人称")%は気持ちよく精液を吐き出せて満足かもしれないが」
PRINTFORMW 「%CNAME("一人称")%のほうは体が一方的にセックスの準備をはじめて大変なのだよ？」	PRINTFORMW 「开始单方面地准备性交而让使用%CNAME("一人称")%的身体感到很辛苦吧？」
PRINTFORMW 「これも一種の本能なのかもしれないね。ザーメンの本来の使い方は子供を作ることなのだから」	PRINTFORMW 「这可能是一种本能吧。精液的使用方法本来就是用来孕育儿童的原材料呢」
PRINTFORMW 「せっかくだし次はもっときわどい写真でも撮るかね？」	PRINTFORMW 「难道下次还要拍更害羞的照片吗？」
PRINTFORMW 「ココが%CNAME("二人称")%のペニスに蹂躙されるのを涙を流しながら歓迎するところだとかね」	PRINTFORMW 「哼哼…这里可是被%CNAME("二人称")%的肉棒蹂躏地一边“流着泪”一边热烈欢迎着你的“妻子”哦」
PRINTFORMW 「いまどうしようもなく%CNAME("二人称")%のキスが欲しい」	PRINTFORMW 「现在我无可奈何地非常想要与%CNAME("二人称")%的接吻」
PRINTFORMW 「舌でお互いを愛撫して唾液を交換するようなキスがしたい」	PRINTFORMW 「想用舌头互相爱抚缠绕和交换对方唾液的接吻哦」
PRINTFORMW 「だからその、いま抱いてくれはしないかね？」	PRINTFORMW 「所以说，你现在不打算抱我吗？」
PRINTFORMW 「%CNAME("二人称")%といると時折この体が高ぶってたまらなくなる」	PRINTFORMW 「与%CNAME("二人称")%在一起，身体内部有时会燥热得受不了呢」
PRINTFORMW 「ほら、こんなに熱くなってるんだ。どうやって鎮めればいいか、わかるだろ？」	PRINTFORMW 「看，已经变得这么热了啊。你应该知道怎样让我镇定下来吧？」
PRINTFORMW %CALLNAME:TARGET%は%CALLNAME:MASTER%に身体を密着させて、エッチのおねだりをしている……	PRINTFORMW %CALLNAME:TARGET%用手环抱住%CALLNAME:MASTER%的脖子贴紧着身体，用发出阵阵瘙痒地秘部摩擦着对方的肉棒留下了不少的淫液，并在%CALLNAME:MASTER%的耳边呼出让耳朵酥麻地鼻息地同时用轻柔地声音发出摇人心魄地娇喘提出了要与对方做爱的要求……
PRINTFORMW 「こっちへのキスも好きだよ。我慢せずに出したまえ」	PRINTFORMW 「我也喜欢亲吻这里哦。不要忍耐了，把那可以让我舒服地“坏东西”拿出来吧」
PRINTFORMW 「%CNAME("二人称")%の体のどこに口づけしても素敵な気分だよ」	PRINTFORMW 「无论亲吻%CNAME("二人称")%的身体地哪里都感觉很棒呢」
PRINTFORMW %CALLNAME:TARGET%は悪戯げに唇から舌先を出して笑っている	PRINTFORMW %CALLNAME:TARGET%嘴唇伸出舌尖露出恶作剧般地笑容看向这边
PRINTFORMW 「んっ……いきなりキスされるのは嫌かい？」	PRINTFORMW 「嗯……讨厌突然地亲吻吗？」
PRINTFORMW 「%CNAME("一人称")%は唐突にキスされるのは嫌いじゃないけれどね」	PRINTFORMW 「但是%CNAME("一人称")%并不讨厌哦」
PRINTFORMW 「この%CNAME("一人称")%が隙あらばキスしようとするのは知ってるだろ？」	PRINTFORMW 「那个在这个间隙有打算跟%CNAME("一人称")%接吻吗？」
PRINTFORML 「それとも、誘っているのかね？」	PRINTFORML 「还是要我邀请你呢？」
PRINTFORMW %CALLNAME:TARGET%は%CALLNAME:MASTER%の頬や首筋に何度も口づけてきた	PRINTFORMW %CALLNAME:TARGET%含情脉脉地多次亲吻%CALLNAME:MASTER%的脸颊，有时还会用娇舌舔着对方地脖子
PRINTFORMW 「%CNAME("二人称")%とこうやって触れ合うのが好きだ」	PRINTFORMW 「%CNAME("二人称")%喜欢这样接触吗？」
PRINTFORMW 「こうやって甘えていると、もっとこうして軽いふれあいを続けたいと思う」	PRINTFORMW 「像这样撒娇什么的，我还想要继续这样可以让对方轻松下来地接触下去」
PRINTFORMW 「それと同じくらい、もっと激しく情欲に身を任せたいとも思う」	PRINTFORMW 「与此相同，我也想把自己置身于更激烈的地情欲中」
PRINTFORMW 「こんなふうにヨシヨシしてあげるのも嫌ではあるまい」	PRINTFORMW 「像这样约束别人也不是讨厌」
PRINTFORMW 「自分でもいきなりこんなことをするのはどうかと思うのだが…」	PRINTFORMW 「我也在想，自己会不会突然做出这种事来………」
PRINTFORMW 「%CNAME("二人称")%に気持ちよくなってほしい気持ちが溢れてたまらないんだ」	PRINTFORMW 「%CNAME("二人称")%希望心情变好的心情溢出地不得了呢」
PRINTFORMW 「枕というのは人体の骨格の構造上とても重要ゆえに古くから用いられてきた」	PRINTFORMW 「在夜晚的睡眠中枕头对人体骨骼构造上非常重要，所以自古以来就被使用了」
PRINTFORMW 「それが今のような形になったのにはだいぶ時代が下るが」	PRINTFORMW 「虽然现在这个时代已经过去很长时间了」
PRINTFORMW 「膝枕はある意味で古来からの形式が残されてると言えるかもしれないね」	PRINTFORMW 「膝枕在某种意义上可以说是保留了自古以来的传统」
PRINTFORMW 「カモミールの抽出液を飲み給え。メソポタミアの時代から薬として用いられた西洋で最も古い薬草のひとつなのだよ」	PRINTFORMW 「饮用洋甘菊茶。这是从美索不达米亚时代开始作为药物而使用的西洋最古老的药草之一」
PRINTFORMW 「あのヒポクラテスも煮出した液体を薬にしたそうだ。現代で言うハーブティーだな、そう、ちょうどこんな感じだ」	PRINTFORMW 「据说那个希波克拉底也把煮出来的液体做成了药。就是现代所说的香草茶啊，对，正好是这样的感觉」
PRINTFORMW 「わかるかい？%CNAME("二人称")%と繋がりたくて、%CNAME("二人称")%に蹂躙されたくて体が準備しているのが」	PRINTFORMW 「你明白吗？现在被%CNAME("二人称")%蹂躏的身体正想和%CNAME("二人称")%连接而准备着呢」
PRINTFORMW 「こんなことをするなんて以前の%CNAME("一人称")%は到底信じられないだろうね」	PRINTFORMW 「做这种事，如果是在以前的%CNAME("一人称")%是绝对不敢相信的吧」
PRINTFORMW 「男の膝上で腰を振って誘惑する娼婦のような真似をするなどとは」	PRINTFORMW 「在男人的膝盖上摆动屁股来诱惑雄性什么的，真像个娼妇一样」
PRINTFORMW 「まったく、よりどりみどりというわけだね」	PRINTFORMW 「真是的，原来是绿色啊。」
PRINTFORMW 「同時に複数の女性から誘惑されていることと、自らがそのような立場であること」	PRINTFORMW 「同时受到多个女性的诱惑，自己也处于这样的立场」
PRINTFORMW 「%CNAME("二人称")%はどちらに興奮しているのかな？」	PRINTFORMW 「%CNAME("二人称")%是在对哪个方面兴奋吗？」
PRINTFORMW 「どうかね？%CNAME("二人称")%はどんな下着が喜ぶだろうかと頑張って選んだのだよ」	PRINTFORMW 「怎么样呢？%CNAME("二人称")%对选择什么样的内衣而感到高兴呢」
PRINTFORMW 「%CNAME("二人称")%にはもちろん大事にされているが、それ以上に%CNAME("一人称")%のほうが献身しているのではないかな」	PRINTFORMW 「%CNAME("二人称")%当然被重视,不过，但更重要的是%CNAME("一人称")%的献身吗？」
PRINTFORMW 「年上の美少女に自らこんな"はしたない"行動をさせているのだから」	PRINTFORMW 「让年长的美少女自己做这种"狂野"的行为」
PRINTFORMW 「さて、待たせたね。おや、？%CNAME("二人称")%もかい？」	PRINTFORMW 「那么，让你久等了。哎？%CNAME("二人称")%也要吗？」
PRINTFORMW 「さて、待たせたね」	PRINTFORMW 「那么，让您久等了」
PRINTFORMW 「ついでにお茶を買ってきたよ。どっちがいい？」	PRINTFORMW 「顺便买来了茶哟。那哪个好呢？」
PRINTFORMW 「ちょっと席を外すよ」	PRINTFORMW 「我出去一下」
PRINTFORMW 「あ、ちょっと待ってくれるかい？すぐ戻る」	PRINTFORMW 「啊，能稍等一下吗？马上回来」
PRINTFORMW 「ああ、トイレに行ってきてた。それだけだよ」	PRINTFORMW 「啊，我去了趟厕所，就只是那样而已啦」
PRINTFORMW %CALLNAME:TARGET%は特にどうということはないという雰囲気で応えた	PRINTFORMW %CALLNAME:TARGET%用稀疏平常的语气回应了你的话
PRINTFORMW 「ひゃ！ひょっとして%CNAME("二人称")%は馬鹿なのかい？」	PRINTFORMW 「哎呀！说不定%CNAME("二人称")%就是个笨蛋吗？」
PRINTFORMW %CALLNAME:TARGET%は絶句してこちらを見た	PRINTFORMW %CALLNAME:TARGET%无言地看向这边
PRINTFORMW 「……ひょっとして%CNAME("二人称")%は馬鹿なのかい？」	PRINTFORMW 「……说不定%CNAME("二人称")%是个笨蛋呢？」
PRINTFORMW 「…………そんなに見たいなら見せてあげようじゃないか」	PRINTFORMW 「……………你既然那么想看，就给你看看吧」
PRINTFORMW %CALLNAME:TARGET%は顔を赤くしつつも恥ずかしい放尿を魅せてくれた	PRINTFORMW %CALLNAME:TARGET%红着脸又害羞的小便着
PRINTFORMW 「……理解はするよ。日常の単なる排泄としてのそれを見たいというのだろ？」	PRINTFORMW 「………我会理解的。这只是日常生活中单纯的排泄吧？」
PRINTFORMW 「なんだ、いつでもどこでも%CNAME("二人称")%の要望に応えられるわけではないよ」	PRINTFORMW 「什么嘛，这不是无论什么时候哪里都能满足%CNAME("二人称")%的要求呢」
PRINTFORMW %CALLNAME:TARGET%は困ったような視線で%CALLNAME:MASTER%をみつめている	PRINTFORMW %CALLNAME:TARGET%用困惑的眼光盯着%CALLNAME:MASTER%
PRINTFORMW これ以上言っても駄目そうだ……	PRINTFORMW 不行了，再说下去的话就……❤
PRINTFORMW 「すまない、もう一度言ってくれるかい？」	PRINTFORMW 「对不起，能再说一遍吗？」
PRINTFORMW %CALLNAME:TARGET%は自分が何を言われたか信じられないようだ	PRINTFORMW %CALLNAME:TARGET%好像不相信自己的耳朵听到的话
PRINTFORMW 「ベッドの上でなら許すけれども、ココでかい？」	PRINTFORMW 「如果是在床上的话是可以原谅的，但是要在这里吗？」
PRINTFORMW %CALLNAME:TARGET%は困惑した目線を向けている	PRINTFORMW %CALLNAME:TARGET%投来了困惑的目光
PRINTFORMW 「%CNAME("二人称")%専用のオナニー器具として使った穴を見たいのかね？」	PRINTFORMW 「想看作为%CNAME("二人称")%专用的肉便器而使用的秘穴吗？」
PRINTFORMW 「子宮を不要なザーメンを捨てるゴミ箱かのように使われているというのに」	PRINTFORMW 「秘穴和子宫被注射的满满地就像精液专用地肉壶一样被使用」
PRINTFORMW 「小作りのための器官を、薄いゴムの中に不要なザーメンを捨てる手伝いに使われてるのに」	PRINTFORMW 「被制作成单薄的避孕套中被用来帮忙丢弃不需要的精液的便器一样」
PRINTFORMW 「献身的にも%CNAME("二人称")%のペニスに躾けられていつでも受け入れる健気な道具だ」	PRINTFORMW 「我会献身也是被%CNAME("二人称")%的肉棒调教成能随时接待健壮肉棒的便器了呢」
PRINTFORMW 「%CNAME("二人称")%の頼みならどんな状況でも従ってしまう」	PRINTFORMW 「如果是%CNAME("二人称")%的请求，任何情况下都会服从的」
PRINTFORMW 「この部屋にいる女性は多かれ少なかれそんなところがあるが・・・」	PRINTFORMW 「在这个房间里的女性或多或少都有这样的地方……」
PRINTFORMW 「もちろん、だれがどの程度などと比較することに今はあまり意味があるまい」	PRINTFORMW 「当然，和谁比较的话也没有什么意义」
PRINTFORMW 「%CNAME("二人称")%はよほど支配欲が強いと見える♪」	PRINTFORMW 「看来%CNAME("二人称")%支配欲很强呢♪」
PRINTFORMW 「ほら、自分が言いなりにできるメスの情けない姿を見るがいい♪」	PRINTFORMW 「你看，看你那能随叫随到的可怜雌性的身姿吧♪♪」
PRINTFORMW %CALLNAME:TARGET%は酷薄な笑みを浮かべている	PRINTFORMW %CALLNAME:TARGET%露出了害羞的笑容
PRINTFORMW 「よく見えるかね？%CNAME("二人称")%に来てほしくて無意識に誘惑してしまう場所だ」	PRINTFORMW 「看得清楚吗？这里是想要%CNAME("二人称")%来而无意识地诱惑你的秘穴哦」
PRINTFORMW 「誰に対してもこれほど淫らではないのだよ」	PRINTFORMW 「啊，并不是对谁都是那么淫荡的」
PRINTFORMW 「%CNAME("二人称")%だけのための場所さ」	PRINTFORMW 「只在有%CNAME("二人称")%的地方才会这样」
PRINTFORMW 「%CNAME("二人称")%にそんなふうに臭いを嗅がれると」	PRINTFORMW 「%CNAME("二人称")%闻到那样的臭味」
PRINTFORMW 「なんだ、その、パンツを濡らしてしまうかもしれん」	PRINTFORMW 「什么！那个你的呼吸吹在胖次上了，淫液可能会弄湿胖次的」
PRINTFORMW 「匂いをかぐだけで良いのかい？」	PRINTFORMW 「只是闻一下味道就可以了吗？」
PRINTFORMW %CALLNAME:TARGET%は脇のベッドに視線を送った	PRINTFORMW %CALLNAME:TARGET%红着脸将视线投向旁边的床上
PRINTFORMW 「%CNAME("二人称")%の熱い吐息ば敏感な部分にあたって…」	PRINTFORMW 「%CNAME("二人称")%呼出的热气吹在了相当敏感的部分呢……」
PRINTFORMW 「%CNAME("一人称")%まで変な気分になるじゃないか」	PRINTFORMW 「%CNAME("一人称")%现在的心情变得好奇怪」
PRINTFORMW 「どうかな、似合ってるかい？」	PRINTFORMW 「怎么样，合适吗？」
PRINTFORMW 「ほら、どうせ%CNAME("二人称")%以外には見ることもない衣服だ」	PRINTFORMW 「你看，这件衣服除了%CNAME("二人称")%以外，别人都没有看见过哦」
PRINTFORMW 「臭いを嗅がれるのはその、流石に恥ずかしいかな」	PRINTFORMW 「让你闻到臭味儿，果然还是觉得不好意思」
PRINTFORMW 「男性の支配欲を満たす行為なのだろうね」	PRINTFORMW 「这应该是满足男性支配欲的行为吧」
PRINTFORMW 「つまり自分は女性に自ら恥ずかしい部分を晒させるほどの力があるというね」	PRINTFORMW 「也就是说，%CALLNAME:MASTER%自己拥有让女性自己暴露害羞部分的力量。」
PRINTFORMW 「その、なんだ、これはアレかね？」	PRINTFORMW 「那个，这是干什么呢？」
PRINTFORMW 「%CNAME("二人称")%は剃ってくれたほうが嬉しいといいたいのかね？」	PRINTFORMW 「哦，%CNAME("二人称")%是想说下面剃了会更开心吗？」
PRINTFORMW %CALLNAME:TARGET%は、%CLO("股間")%から食み出た陰毛で遊んでいる%CALLNAME:MASTER%に引きつった笑みを浮かべている	PRINTFORMW %CALLNAME:TARGET%露出笑容看着正在玩弄%CLO("股間")%的阴毛的%CALLNAME:MASTER%
PRINTFORMW 「ほら、ちゃんと剃ってあるだろ。%CNAME("二人称")%のためにだよ」	PRINTFORMW 「看，你看我有剃阴毛吧，怎么样干净吗，这可是为了%CNAME("二人称")%你哦」
PRINTFORMW %CALLNAME:MASTER%は剃り損ねた陰毛が%CLO("股間")%から食み出ているのを指摘した	PRINTFORMW %CALLNAME:MASTER%指着对方那湿淋淋的%CLO("股間")%还未剃干净的阴毛给%CALLNAME:TARGET%
PRINTFORMW 「では今度%CNAME("二人称")%に剃ってもらうとしよう、綺麗にしてくれたまえよ？」	PRINTFORMW 「啊哼，你真是细心呐，那么这次就请%CNAME("二人称")%剃吧，来吧请帮我弄干净吧❤」
PRINTFORMW 「そんなに熱い吐息を吹きかけられるとくすぐったいかな」	PRINTFORMW 「被那样热烈的吐息吹到，让下面觉得非常“瘙痒难耐”呢」
PRINTFORMW 「舌で直接%CNAME("二人称")%に愛撫してもらっても構わないけれどね」	PRINTFORMW 「其实不用那样的，直接用%CNAME("二人称")%的舌头来爱抚也没有关系哦」
PRINTFORMW %CALLNAME:TARGET%は太ももに当たる%CALLNAME:MASTER%の息遣いに少しくすぐったそうにしている……	PRINTFORMW %CALLNAME:MASTER%的呼吸吹到%CALLNAME:TARGET%的大腿中间感觉相当痒的样子
PRINTFORMW 「そんなに夢中になって見られると嬉しい気持ちも生じてくるね」	PRINTFORMW 「如此着迷地看着，会产生非常高兴的心情吗？」
PRINTFORMW %CALLNAME:TARGET%は自ら両足を%CALLNAME:MASTER%の見やすいように大きく開いた	PRINTFORMW %CALLNAME:TARGET%将双脚大开让%CALLNAME:MASTER%看的更清楚
PRINTFORMW 「ほら、好きなようにするといい」	PRINTFORMW 「你看吧下面都在一张一合的等着你的呢，就好好的疼爱“它”吧」
PRINTFORMW 「……ベッドでいつも好きなだけ見てるだろう？」	PRINTFORMW 「………你总是在床上看你喜欢的东西吧？」
PRINTFORMW 「まあいい、%CNAME("一人称")%ほどの美少女になると性的な目線には慣れてるさ」	PRINTFORMW 「算了，美少女%CNAME("一人称")%已经习惯了你在性爱方面的视线」
PRINTFORMW %CALLNAME:TARGET%は微笑みながら%CALLNAME:MASTER%の視姦を許している	PRINTFORMW %CALLNAME:TARGET%微笑着并肆意纵容%CALLNAME:MASTER%的视奸
PRINTFORMW 「そんなに夢中になってくれると悪い気分ではない」	PRINTFORMW 「如果你那么着迷我的话，我不会觉得不舒服哦」
PRINTFORMW 「もちろん、%CNAME("二人称")%の目線だからだけれどもね」	PRINTFORMW 「当然，虽然只是从%CNAME("二人称")%的视线来看」
PRINTFORMW %CALLNAME:TARGET%は%CALLNAME:MASTER%に見せつけるような腰つきで視姦を受け入れている……	PRINTFORMW %CALLNAME:TARGET%现在的姿态像是%CALLNAME:MASTER%接受了视奸……
PRINTFORMW 「ほうら、見たかったのだろ？」	PRINTFORMW 「看，你想看吗？」
PRINTFORMW 「他の男は幸運に恵まれればほんの一瞬だけ垣間見えるだけだが、%CNAME("二人称")%はこうやって%CNAME("一人称")%が自ら見せつけてさえくれるわけだ」	PRINTFORMW 「想看就直说嘛，如果是其他男人幸运的话，仅仅只能看到一瞬间，但如果是%CNAME("二人称")%想看%CNAME("一人称")%会掀开给你看的，看到你不想开为止」
PRINTFORMW 「どうだね？女性からパンツを自発的に見せてもらえる気分は？」	PRINTFORMW 「好看吗？能让女性主动给你看胖次的心情是怎么样的？」
PRINTFORMW 「まったくこんな美少女に見せてもらえるとは幸運な男だよ%CNAME("二人称")%は」	PRINTFORMW 「可以看到美少女的胖次，%CNAME("二人称")%真是个幸运的男人啊」
PRINTFORMW 「まったく、%CNAME("二人称")%の目つきで何を望んでるのかわかってしまうようになったじゃないか」	PRINTFORMW 「现在完全明白，%CNAME("二人称")%的眼神正在期望着什么，不是变的吗？」
PRINTFORMW 「あまつさえ、それに応えてしまうなんてさ。ほら、存分に見るといいさ」	PRINTFORMW 「甚至连这个都给你看了，你也回应我一下吧，你看，好好看看吧」
PRINTFORMW 「…ずいぶんなモーニングコールだね」	PRINTFORMW 「……早上的叫醒服务真够呛，我还没有睡够呢」
PRINTFORMW 「せっかくならキスで目覚めさせてほしかったよ……」	PRINTFORMW 「但你好不容易起来了，我用早安吻来迎接开心地新的一天吧❤……」
PRINTFORMW 「まったく%CNAME("二人称")%というやつは……」	PRINTFORMW 「%CNAME("二人称")%这个家伙真是的………」
PRINTFORMW 「%CNAME("二人称")%に対して怒りが湧いてこない自分も大概かもしれないがね」	PRINTFORMW 「对于这样的%CNAME("二人称")%，自己并不会感到生气」
PRINTFORMW 「そんなに%CNAME("一人称")%のパンツが見たかったのかい？」	PRINTFORMW 「那么想看%CNAME("一人称")%的胖次吗？」
PRINTFORMW 「挨拶代わりのパンツ視姦とは……あまり聞かない風習だね」	PRINTFORMW 「代替打招呼的胖次视奸是……在哪里都没听说过的风俗习惯啊」
PRINTFORMW 「まったく、誰かが見たらどう思うだろうね？」	PRINTFORMW 「真是的，被谁看到了人家会怎么想呢？」
PRINTFORMW 「もちろん、二人ともただの変態としか受け取ってもらえないだろうね」	PRINTFORMW 「当然，只有两个人独处才能接受这种变态的行为吧」
PRINTFORMW 「このごろは%CNAME("二人称")%のためにパンツの見た目を気にするようになってしまったよ」	PRINTFORMW 「最近为了%CNAME("二人称")%开始仔细挑选胖次的样式呢」
PRINTFORMW 「で、どうだい？こういうパンツが好きだろうと思って選んだのだがね」	PRINTFORMW 「那么，怎么样？哎！我以为你会喜欢这样样式的胖次才选这个的」
PRINTFORMW 「自分の下着の臭いを嗅ぐ姿を見るというのもある種の貴重な体験かもしれないね」	PRINTFORMW 「好闻吧，看到你闻我内衣样子，或许也是一种珍贵的体验吧」
PRINTFORMW 「別に履いたままの状態でしてくれても…そういうことではない？興味深いな」	PRINTFORMW 「即使你穿在的状态下……不是那样的事？真有趣」
PRINTFORMW 目の前で自分のパンツを使われた%CALLNAME:TARGET%は呆れたように苦笑している	PRINTFORMW 看着眼前自己的胖次被使用什么的，%CALLNAME:TARGET%露出一副吃惊一样地苦笑
PRINTFORMW 「……不思議なものだね、%CNAME("一人称")%の下着でしてくれればなどと少しでも思ってしまうなんて」	PRINTFORMW 「……真是不可思议啊，多么想知道%CNAME("一人称")%的内衣啊」
PRINTFORMW %CALLNAME:TARGET%は%CALLNAME:MASTER%の行動に複雑な表情を浮かべている	PRINTFORMW %CALLNAME:TARGET%对于%CALLNAME:MASTER%的行动露出了复杂的表情
PRINTFORMW 「……下着にしか興奮できなくなっても知らないからね」	PRINTFORMW 「……即使只有内衣也能变得兴奋什么的」
PRINTFORMW 「%CNAME("二人称")%が変態になるのを防ぐために、%CNAME("一人称")%の臭いを直接嗅ぐのを許そうじゃないか」	PRINTFORMW 「为了防止%CNAME("二人称")%变态行为，不许直接闻%CNAME("一人称")%胖次的气味哦」
PRINTFORMW 「さぞ気分がよいのだろうね、自分の女にいつでもセックスのおねだりをさせられるというのは」	PRINTFORMW 「想必一定很舒服吧，总是被自己的女人要求性爱什么的」
PRINTFORMW 「しかもこれほどの美少女のそれを写真に残してずっと記録するのだからね」	PRINTFORMW 「而且还把这么多美少女的照片记录下来」
PRINTFORMW 「とはいえその情報端末を落としたりしないでくれたまえよ、%CNAME("二人称")%だけのために見せる姿なのだから」	PRINTFORMW 「无论如何，请不要丢下那个信息终端啊，只是想为了给%CNAME("二人称")%展示自己的样子」
PRINTFORMW 「そんなに接写するより、どんな美少女のものなのかわかりやすく顔も映してはどうかね？」	PRINTFORMW 「与其这么近距离的拍摄，不如把脸拍得更清楚，让人更容易理解这是什么样的美少女呢？」
PRINTFORMW 「もちろんそんな写真が流出したら困るけれどね」	PRINTFORMW 「当然那样的照片泄露的话会很麻烦的」
PRINTFORMW 「%CNAME("二人称")%以外の男たちが私の体を妄想してザーメンを処理してしまいかねないよ」	PRINTFORMW 「%CNAME("二人称")%以外的男人可能会妄想使用我的身体处理精液呢」
PRINTFORMW 「%CNAME("二人称")%のザーメンを味わうためなら何でもする女とでも思っていないかね？」	PRINTFORMW 「之所以能品尝到%CNAME("二人称")%的精液，难道你不认为她是个什么都能干的女人吗？」
PRINTFORMW 「もっとも、そう思われても仕方がないほどには熱心に奉仕する女にされてしまったが」	PRINTFORMW 「话虽如此，被别人认为作着那种服务的女人，而感到无可奈何」
PRINTFORMW 「学校でも%CNAME("二人称")%くらいのものだろうね」	PRINTFORMW 「在学校我大概也是%CNAME("二人称")%的东西吧」
PRINTFORMW 「ムラムラしたからって膣をオナホールとして使わせてくれなんて言えるのは」	PRINTFORMW 「因为在性方面而感到躁动难忍，就用我的秘穴当c成飞机杯使用什么的，我能怎么说」
PRINTFORMW 「しかもそれを喜んで受け入れてしまう美少女がいるのだからね」	PRINTFORMW 「而且也有欣然接受的美少女呢」
PRINTFORMW 「それにしても酷い男だよ、他の女性の体液をべっとりとつけてこんなお願いをするのだから」	PRINTFORMW 「尽管如此，你是个很过分的男人，因为你把其他女性的体液都涂满肉棒上后就拜托我帮你清理干净什么的」
PRINTFORMW 「%CNAME("二人称")%ひょっとして馬鹿なのかい？」	PRINTFORMW 「%CNAME("二人称")%难道是笨蛋吗？」
PRINTFORMW 「そんな誰でもいいから性欲を処理してくれみたいな口ぶりではね」	PRINTFORMW 「用那种谁都可以使用我来处理性欲的口吻」
PRINTFORMW 「そんなに性欲が貯まっているならオナニーでもすれいいのではないかい？」	PRINTFORMW 「如果性欲如此旺盛的话，自慰一下不也很好吗？」
PRINTFORMW 「・・・%CNAME("二人称")%のためにオカズとオナホールくらいなら提供しよう」	PRINTFORMW 「为了%CNAME("二人称")%提供飞机杯什么的」
PRINTFORMW 「%CNAME("二人称")%の貯まった性欲を吐き出す、さながらザーメン搾り器だ」	PRINTFORMW 「如果让%CNAME("第二人称")%能充满释放积蓄的性欲的话，我就宛如精液榨汁器一样了呢」
PRINTFORMW %CALLNAME:TARGET%は尿道の精液を吸い取った後も愛おしそうに口で奇麗に愛撫してくれた	PRINTFORMW %CALLNAME:TARGET%吸取完尿道的精液之后，她还依依不舍地用嘴细心爱抚着我的肉棒
PRINTFORMW 「こんな目立つ場所にザーメンをぶちまけるなんて」	PRINTFORMW 「竟然会在这么显眼的地方射出精液」
PRINTFORMW 「せっかくだからこのままの姿で外を出歩いてみようかなどと脳裏に浮かんでしまう」	PRINTFORMW 「难得有这样的机会，就以这样的姿态出去走走吧，脑海中浮现出这样的想法。」
PRINTFORMW 「どんな形であれ%CNAME("二人称")%と体のつながりを持つと幸せにされてしまう」	PRINTFORMW 「无论什么形式，只要与%CNAME("二人称")%保持着身体上的联系就会变得幸福」
PRINTFORMW 「たとえ%CNAME("二人称")%にとってはただの性欲処理に過ぎなかったとしてもね」	PRINTFORMW 「即使对于%CNAME("二人称")%来说，这只是单纯的性欲处理而已」
PRINTFORMW 「こんな献身的な美少女にもっと報いようとは思わないのかい？」	PRINTFORMW 「你不认为可以这样献身的美少女会有更多的回报吗？」
PRINTFORMW 「こんなに投げやりな処理でこんな濃ゆいザーメンを吐き出すなんて」	PRINTFORMW 「如此草率的处理竟然会吐出如此浓重的精液」
PRINTFORMW 「そんなに%CNAME("一人称")%の手が気持ちよかったのかね？？」	PRINTFORMW 「那么%CNAME("一人称")%的手摸上去心情会感到很舒畅吗？」
PRINTFORMW 「まるで酪農家が家畜の精液を採取するかのような行為でも満足してしまったかね？」	PRINTFORMW 「简直就像牛奶农场采集家畜的牛奶一样的不过采出来的是精液…呵呵，你满足了吗？」
PRINTFORMW 「・・・本当にオナホールとして使われるとはね」	PRINTFORMW 「・・・真的被作为飞机杯来使用了呢」
PRINTFORMW 「まあ確かに、普通はオナニーの道具に愛の言葉を紡いだりはしないだろうけれども」	PRINTFORMW 「嘛，虽然一般不会在自慰的道具上编织出爱的语言」
PRINTFORMW 「次はもっと愛情をもって「使って」くれたまえ」	PRINTFORMW 「下次要更加用心地对我说“飞机杯过来吧”这样的话哦」
PRINTFORMW 「単なる性欲処理ではなくセックスがしたいのであれば、ちゃんと応じるつもりがあるというのにね」	PRINTFORMW 「如果不是单纯的性欲处理，而是想进行性交的话，明明有和酱回应的打算」
PRINTFORMW 「おはよう。今日は2月14日バレンタインデー…この国では所謂バレンタインチョコを贈る日というように認識されているね」	PRINTFORMW 「早上好。今天是2月14日情人节…是赠送别人情人节巧克力的好日子」
PRINTFORMW 「おはよう。今日はバレンタインデー…この国では所謂バレンタインチョコを贈る日というように認識されているね」	PRINTFORMW 「早上好。今天是情人节…在这个国家认为是赠送情人节巧克力的好日子」
PRINTFORMW 「よく知られているようにこれはバレンタインの本来の姿ではない…」	PRINTFORMW 「众所周知，这不是情人节的本来面貌……」
PRINTFORMW 「菓子販売のために企業が仕掛けたマーケティング戦略の結果そのような形になった」	PRINTFORMW 「为了贩卖点心而由企业策划的营销战略，结果就是情人节形态发生了变化」
PRINTFORMW 「とはいえ本来の形がどうだったかという話をするつもりはない…現在の姿も魔法なのだからね」	PRINTFORMW 「话虽如此，不打算说原本的情人节是怎样的……因为现在的样子也是因为魔法」
PRINTFORMW 「考えてもみたまえ？食品の本来の意味は栄養摂取のためだろう？次に味だろうか？」	PRINTFORMW 「你想想看，食物本来就是为了摄取营养吧，接下来是味道吗？」
PRINTFORMW 「しかし食品にそれ以外の意味を付与する、いわば「食の魔術」がしばしば用いられるのだ」	PRINTFORMW 「但是给食品赋予除此之外的意思，也就是使用了“食之魔术”之后。」
PRINTFORMW 「わかりやすいのが「水素水」だろうね。化学的にはただの水だろう？」	PRINTFORMW 「易懂的就是“水”吧。化学性地只有水了」
PRINTFORMW 「あれを飲んでも水分補給以外の「栄養学的意味」は生じない」	PRINTFORMW 「喝了水补充水分以外，什么「营养学的意义」也不会产生了」
PRINTFORMW 「だがアレを愛飲する人々はしばしば非科学的な意味を求めてしまっている」	PRINTFORMW 「但是爱喝那个的人们会寻求着非科学性的意义」
PRINTFORMW 「それは企業が利益のために水に対し「魔術的意味」を付与したからなのだよ」	PRINTFORMW 「那是因为企业为了利益对水赋予了“魔术意义」
PRINTFORMW 「あの手の魔術的商品を販売する企業の非科学的な広告を見たまえ。科学とは程遠い」	PRINTFORMW 「看到那些销售魔术商品的企业非科学的广告吧。与科学相去甚远」
PRINTFORMW 「そう、換言すればマーケティング戦略の担当者はある意味では「魔法使い」なのだ」	PRINTFORMW 「是的，换句话说，市场战略的负责人从某种意义上来说，就是“魔法使」
PRINTFORMW 「多数の人間に対し恣意的に都合の良い魔術的認識を与えるのだからね」	PRINTFORMW 「会给大多数人带来了随意方便的魔术认识」
PRINTFORMW 「バレンタインチョコというのはその結果の一つなわけさ」	PRINTFORMW 「情人节巧克力就是结果之一」
PRINTFORMW 「勘違いしてほしくないのは、%CNAMET(ARG, "一人称")%は別にバレンタインチョコの無根拠性を指摘しようというのではない」	PRINTFORMW 「不想让你误会的是，%CNAMET(ARG, "一人称")%并不是想指出情人节巧克力的无根据性」
PRINTFORMW 「そもそも、チョコレートに根拠がないのならば元来のバレンタインとて無根拠性が皆無とは言えない」	PRINTFORMW 「说起来，如果巧克力没有根据的话，即使是本来的情人节，也不能说毫无根据。」
PRINTFORMW 「たしかにバレンタインが祝われてきた歴史はチョコよりずっと長く続いている」	PRINTFORMW 「确实，庆祝情人节的历史比巧克力长得多。」
PRINTFORMW 「だが歴史学的に考えれば「聖ウァレンティヌス」なる人物の実在からして怪しいのだよ」	PRINTFORMW 「但是从历史学上来说，从“圣瓦伦丁”这个人物的实际存在来看，也是有点可疑的。」
PRINTFORMW 「もちろん、そんなことはバレンタインを祝う人々にとってどうでもいいのだ」	PRINTFORMW 「当然，这对于庆祝情人节的人们来说是无所谓的」
PRINTFORMW 「歴史的正しさなど彼らが祝い楽しむことができる実用性に比べれば実に些細なことだ」	PRINTFORMW 「和历史的正确性相比，他们能够享受庆祝情人节来说显得实在是微不足道。」
PRINTFORMW 「もっと範囲を広げよう。過去というのは具体的に空間上に存在するかね？」	PRINTFORMW 「再扩大范围吧，过去具体存在于空间上吗？」
PRINTFORMW 「物質世界のどこかでは過去が今なお進行中である場所が存在するわけではないだろう？」	PRINTFORMW 「物质世界的某个地方过去与至今仍在进行中的地方是不是存在呢？」
PRINTFORMW 「ではどこに過去が存在するのか。それは記録の中。そして人々の認識の中だ。」	PRINTFORMW 「那么过去在哪里存在呢？是在记录中还是在众人的认识中。」
PRINTFORMW 「結我論者はこうともいうだろう。そもそも現実そのものが人の認識中にしか究極的には存在しないのだと」	PRINTFORMW 「结论者也可以这么说吧，本来现实本身就只有在人的认识中才存在」
PRINTFORMW 「それは言い過ぎにしても、しかし水槽脳を持ち出すまでもなく真実の一面を表しているのは確かだとはおもわないかい？」	PRINTFORMW 「就算说得过头了，但用不着将水槽脑拿出来，而表现了真实的一面，难道不觉得可靠吗？」
PRINTFORMW 「話を広げすぎたが、つまり人々が今日はチョコを交換する日であるという共通認識を有している限りそれが正しいのだ」	PRINTFORMW 「话说得太多了，也就是说，只要人们有共识，今天是巧克力交换的日子，那就是正确的。」
PRINTFORMW 「そしてそのような認識を持ち合わせていなかったとしても、その共通認識を利用することはできる」	PRINTFORMW 「即使没有这样的认识，也能够利用这种共识」
PRINTFORMW 「認識の有無は外形的に何ら違いは違いをもたらすことがないのだからね」	PRINTFORMW 「因为认识的有无在外形上是不会带来任何差异的」
PRINTFORMW 「しかし%CNAMET(ARG, "一人称")%は美味しい手作りチョコなどを作ることができるタイプではないし」	PRINTFORMW 「可是%CNAMET(ARG, "一人称")%不是能做出好吃的手工巧克出来嘛」
PRINTFORMW 「その手の代物はいくらでも食べることができるだろうというのは想像に難くない」	PRINTFORMW 「其实并不难作，这种东西是可以随意作出吃的」
PRINTFORMW 「というわけで美味しくないチョコレートを作ってきたよ」	PRINTFORMW 「因此我制作出了很多好吃的巧克力哟」
PRINTFORMW 「コーヒーのようにココア豆をローストして磨り潰した粉末をシナモンとトウガラシの粉末と混ぜ合わせ、粘性を高めるためコーンミールを溶かした湯に混ぜたものを抹茶のように泡立てた原始的『ココア』だ」	PRINTFORMW 「像咖啡一样，将可可豆烘烤干后磨碎成粉末和肉桂与辣椒粉末混合在一起，为了提高粘性往融化地可可酱里加入玉米粉，用锅隔着开水加热搅拌直到像抹茶一样地起泡，就得到了原始的『可可』了」
PRINTFORMW 「極めつけに苦く粉っぽい上にココアバターのせいでひどく油っぽいが…味は問題ではなかろう？」	PRINTFORMW 「不过味道极其苦涩、粉末味十足，再往可可里加入黄油，会感的非常油腻……味道应该没有问题，那%CNAME("二人称")%就试试看吧？」
PRINTFORMW 「一説にはこのようなものをアステカの王はハーレムの女を抱く前に飲んだ、などという人もいる」	PRINTFORMW 「有一种说法是，凯里之王在抱着哈莱姆之女之前就喝过这个」
CALL PRINT_STRW, @"黄色_%CALLNAME:ARG%からチョコレートを貰いました！"	CALL PRINT_STRW, @"黄色_从%CALLNAME:ARG%那得到了巧克力！"
CALL PRINT_STRW, @"黄色_%CALLNAME:MASTER%の精力が全快しました！"	CALL PRINT_STRW, @"黄色_%CALLNAME:MASTER%的精力完全恢复了！"
PRINTFORMW 「日曜日に何か予定はあるかね？」	PRINTFORMW 「周日有什么安排吗？」
PRINTFORMW 「特にないのであれば%CNAME("一人称")%の外出に付き合いたまえ」	PRINTFORMW 「如果没有特别的事我想请%CNAME("二人称")%跟我外出交往(灬ºωº灬)」
PRINTFORMW %CALLNAME:TARGET%はさも当然とばかりに一方的に予定を伝えてきた。	PRINTFORMW %CALLNAME:TARGET%显然传达了单方面地外出预定。
PRINTFORMW 「%CNAME("二人称")%のために日曜日を使うのも悪くはない」	PRINTFORMW 「为了%CNAME("二人称")%在周日出去也不错」
PRINTFORMW 「もっとも、%CNAME("二人称")%と出会ってから%CNAME("一人称")%の時間はほとんど%CNAME("二人称")%のために費やしているようなものだが…」	PRINTFORMW 「不过，自从和%CNAME("二人称")%相遇后%CNAME("一人称")%的时间几乎都是为了%CNAME("二人称")%而耗费的……」
PRINTFORMW 「せっかく一日費やすのだから可能な限り有意義な時間になるようしてくれたまえよ？」	PRINTFORMW 「好不容易到了这一天，所以请尽可能给我安排一个有意义的一天吧？」
PRINTFORMW 「行動の詳細については%CNAME("二人称")%に一任しよう。そういう経験に乏しいからね」	PRINTFORMW 「关于行动的详细内容，就交给%CNAME("二人称")%吧。因为我缺乏这种经验」
PRINTFORMW 「時間通りだね。では行くとしよう。それで、どこに行くのかね？」	PRINTFORMW 「时间街道啊。那么去吧。然后去哪里呢？」
PRINTFORMW %CALLNAME:TARGET%は待ち合わせ場所に先着していたようだ	PRINTFORMW %CALLNAME:TARGET%似乎已经到达了约会地点
PRINTFORMW %CALLNAME:MASTER%を見つけると手をあげながら歩み寄ってきた	PRINTFORMW 看到%CALLNAME:MASTER%后就边挥着手边走了过来
PRINTFORMW 待ち合わせに先についていた%CALLNAME:TARGET%は誰かから声をかけられていたが興味なさげに無視している	PRINTFORMW 在约会之前跟着的%CALLNAME:TARGET%好像有谁对她打了声招呼，却被她毫无兴趣地无视
PRINTFORMW %CALLNAME:MASTER%を見つけると何事もなかったかのように駆け寄ってきた	PRINTFORMW 看到%CALLNAME:MASTER%后，好像发现了什么，就当什么都没发生似的跑了
PRINTFORMW 「%CNAME("二人称")%の好みの服を着せようというのだね」	PRINTFORMW 「%CNAME("二人称")%是想让对方穿着你自己喜欢的泳衣吧」
PRINTFORMW 「どうせ%CNAME("一人称")%は泳げないからね、水着など完全に%CNAME("二人称")%を楽しませるためだけの衣装だよ」	PRINTFORMW 「反正%CNAME("一人称")%也不会游泳的，泳装什么的完全是为了%CNAME("二人称")%， 穿了让你开心的泳装哟」
PRINTFORMW 「%CNAME("二人称")%が着せたい水着をどれでも選ぶといい。どんな水着だろうと文句は言わないよ。」	PRINTFORMW 「%CNAME("二人称")%想要我穿什么泳装都可以。不管你想要我穿什么泳装，我都不会抱怨的。」
PRINTFORMW 「%CNAME("一人称")%は%CNAME("二人称")%の目線の他はどうでもいいのだから」	PRINTFORMW 「%CNAME("一人称")%除了%CNAME("二人称")%视线以外都无所谓了，但还是想给你一个人看呢」
PRINTFORMW 「ところで、念のため言っておくけれども、外で出歩けるようなものにしてくれたまえよ？」	PRINTFORMW 「对了，为了慎重起见我先告诉你，你给我做个能在外面走路的东西吧？」
PRINTFORMW 「どうかね？%CNAME("二人称")%が見て楽しめるとよいのだが・・・」	PRINTFORMW 「怎么样呢？%CNAME("二人称")%，但愿你看得开心」
PRINTFORMW 「下着より布面積が狭いこの衣装でも水着だからと許されるのは面白いとは思わないかね？」	PRINTFORMW 「比起内衣，这个泳衣的布料面积狭窄，这件衣服就算是泳装也能被允许是泳衣吗，难道你不觉得有趣吗？」
PRINTFORMW 「学校の水着と似ているね。こういうのが好きなのかい？ならば授業の水泳はさぞ楽しかったろう」	PRINTFORMW 「跟学校的泳装很像呢。喜欢这样的吗？这样的话，上游泳课时穿这件一定很开心吧」
PRINTFORMW 「実用的な水着のようだね。泳げない人間だから実用的かどうかに大して関係はないが」	PRINTFORMW 「看来是实用的泳装啊。因为不会游泳，所以实际应用时也没有什么关系」
PRINTFORMW 「どれでも選びたまえとは言ったが、欲望に正直な男だね%CNAME("二人称")%は」	PRINTFORMW 「虽说哪个都可以选择，但%CNAME("二人称")%是对欲望很正直的男人呢」
PRINTFORMW 「こんな水着で%CNAME("二人称")%と手をつないで歩いた日には私たちに体の関係があることが一目瞭然だ」	PRINTFORMW 「穿着这样的泳装，和%CNAME("二人称")%牵着手走路，一目了然地知道我们双方是什么样的身体关系呢。」
PRINTFORMW 「むしろそれがいいのかい？ではいつかコレを着て一緒に歩こうか。腰に手でも回すかね？」	PRINTFORMW 「倒不如说这样很好吗，还有什么时候穿这个一起走，还要用手挽住腰部吗？」
PRINTFORMW 「どうせ水着を選びながら、どの水着を着せてセックスするのが一番楽しめるか考えていたのだろう？」	PRINTFORMW 「在选择游泳装的同时，你是不是也在考虑着穿什么泳装性交才是最快乐的呢？」
PRINTFORMW 「%CNAME("二人称")%性欲が底なしなのは今に始まったことではないが」	PRINTFORMW 「%CNAME("二人称")%无底洞般地性欲也并不是现在才开始有的」
PRINTFORMW 「求められればいつでも応じる女にさせられてしまったのだから致し方あるまい」	PRINTFORMW 「如果有要求的话，我们女生无论何时都要要求回应，所以没有办法吧」
PRINTFORMW 「さて、泳ぐわけではないがプールにおける正装としての水着を着てきたよ」	PRINTFORMW 「那么，虽然不是游泳，但还是穿上了泳池的正装泳装呢」
PRINTFORMW 「%CNAME("二人称")%のような美少女にとってはいつものことだが、なかなかに注目されてしまっているね」	PRINTFORMW 「%CNAME("二人称")%对于看着这样的美少女可以说是家常便饭了吧，但还是有点相当引人注目呢」
PRINTFORMW 「・・・・・・冗談がわかりづらかったかな？%CNAME("一人称")%とて冗談くらい言うさ」	PRINTFORMW 「・・・・・%CNAME("一人称")%的玩笑话还是很难理解吧？」
PRINTFORMW 「なかなか体とのフィット感が強くて妙な感じだ」	PRINTFORMW 「和身体非常合身，感觉很奇怪。」
PRINTFORMW 「御覧の通り、%CNAME("二人称")%が選んだ水着にちゃんと着替えたが・・・」	PRINTFORMW 「%CNAME("二人称")%在游览街道的时候，选了件泳装让她换上···」
PRINTFORMW 「更衣室で着替えた瞬間から周囲の視線を集めてしまって仕方がなかったよ」	PRINTFORMW 「在更衣室换衣服的瞬间就吸引了周围的视线，真是没办法啊」
PRINTFORMW 「%CNAME("二人称")%以外の視線など別に気になりはしないがね」	PRINTFORMW 「除了%CNAME("二人称")%以外的视线也没什么关系，但还是有点不爽，还是想被%CNAME("二人称")%一个人看才好」
PRINTFORML 「その眼つき、デートに心ときめかせる美少女の唇に口づけするという雰囲気ではなさそうだね」	PRINTFORML 「那样的眼神，好像不是亲吻正在约定而害羞地美少女的嘴唇的气氛呢」
PRINTFORMW 「わかっているとも。恋する少女の唇にザーメンをおねだりされて気持ちよくなりたいのだろう？」	PRINTFORMW 「我知道。你想被恋爱中的少女要求用嘴唇请求精液进入而心情变得舒畅吧？」
PRINTFORML 「デートにはきっとこれくらいのキスがちょうどいい」	PRINTFORML 「在约会上，这样的接吻一定正好吧」
PRINTFORMW 「あまり濃厚なキスをすると「続き」がしたくなってしまう」	PRINTFORMW 「太过浓厚的接吻会让人非常想要继续呢」
PRINTFORML 「%CNAME("二人称")%との口づけもデートという場面ではいつもよりもっと素敵に感じてしまう」	PRINTFORML 「与%CNAME("二人称")%的接吻让在约会的这个场面感觉比平时更加美好了」
PRINTFORMW 「これのためだけにデートしてもいいくらいだ」	PRINTFORMW 「只是为了这个约会也行」
PRINTFORML %CALLNAME:TARGET%は%CALLNAME:MASTER%が揉みやすいように腰と腰を密着させてきた	PRINTFORML %CALLNAME:TARGET%为了让%CALLNAME:MASTER%更容易揉搓自己的臀部，腰和腰更加紧贴在一起
PRINTFORMW 「公衆の面前で大胆だね。そんなにこのお尻が魅力的かい？」	PRINTFORMW 「你在大群广众之下还真是大胆啊，我这样的屁股就怎么有魅力吗？」
PRINTFORML 「こんな美少女とデートしているだけで目を引くには十分すぎるというのに」	PRINTFORML 「明明和这样的美少女约好见面就足够引人注目了」
PRINTFORMW 「そこまでして見せびらかしたいかね？」	PRINTFORMW 「你就那么想炫耀一下吗？」
PRINTFORMW 「%CNAME("二人称")%と二人でいるのは心地よくて、どこか名残惜しくなるよ。」	PRINTFORMW 「与%CNAME("二人称")%在一起感到很舒服，没到结束的时候总觉得有些恋恋不舍呢。」
PRINTFORMW 「…%CNAME("一人称")%も%CNAME("二人称")%といるのが心地よくて…もっと深くつながりたいと、ありていに言えばセックスしたいと思っていた。一番近い場所にしないかね？」	PRINTFORMW 「%CNAME("一人称")%和%CNAME("二人称")%在一起感到很舒服…我还想要更加深入地认识，说实话想要性交了，最近不是有可以满足欲望的地方吗？」
PRINTFORMW 「今日は楽しかったよ。こういう経験が%CNAME("二人称")%と出会うまでなかった人間だからね…何もかも%CNAME("二人称")%との経験だけで埋め尽くされてしまいそうだ」	PRINTFORMW 「今天玩得很开心。因为这样的经验是还没遇到%CNAME("二人称")%的人类的时候呢…什么都只是跟这%CNAME("二人称")%的时候经验都快要被填满了」


//EVENT_K3_SHOP.ERB

PRINTFORMW 「なにか入り用かい？」	PRINTFORMW 「需要些什么吗？」
PRINTFORMW 「たとえば下着そのものが、その着用者よりも下着のほうが好きだという人間はいる」	PRINTFORMW 「比如说比起穿着内衣本人，你更喜欢内衣吗」
PRINTFORMW 「あるいはその下着に付着した汗や尿、あるいは膣分泌液に興奮するという人間もいる」	PRINTFORMW 「或者说有人对附着在内衣上的汗、尿、或者是阴道分泌液感到兴奋呢」
PRINTFORMW 「もちろん、着用者そのものへの興奮を別にしてだよ？倒錯的だろう？」	PRINTFORMW 「当然，对于穿着者本身的兴奋另当别论。是颠倒性的吧？」
PRINTFORMW 「下着の着用者のことをより強く感じる事ができるからという場合は比較的に倒錯的ではない」	PRINTFORMW 「因为穿着内衣的人能更强烈地感受到这种情况比较不容易错过」
PRINTFORMW 「あるいはこの女に下着を脱がせることができる…なんて関係性に興奮できるのかもしれない」	PRINTFORMW 「或者可以让这个女人脱掉内衣……也许会因为关于性而感到兴奋吧」
PRINTFORMW 「もしくは単に脱いでいる姿を見たいなんて人間もいるだろうね」	PRINTFORMW 「或者说想看到单纯的把内衣脱下来的样子，这样的人也是存在的吧」
PRINTFORMW 「下着の要求という外面的発露よりも、その根底にある内面のほうが重要だとはおもわないかい？」	PRINTFORMW 「比起内衣的这种的外在，你难道不觉得穿着的人的内在更重要吗？」
PRINTFORMW 「まぁそれはそれとして・・・」	PRINTFORMW 「嘛，那暂且不提……」
PRINTFORMW 「自分でも不思議なのだけれどね…まったく、どうして%CNAME("二人称")%の横暴に逆らえなくなってしまったのか」	PRINTFORMW 「虽然自己也觉得不可思议……但真是的，为什么无法违抗%CNAME("二人称")%这样横暴的要求呢？」
PRINTFORMW %CALLNAME:TARGET%は恥ずかしそうに温かいパンツを手渡してくれた	PRINTFORMW %CALLNAME:TARGET%虽然这样说但还是给了我一个有点害羞地略带些温暖和有点湿润的胖次
PRINTFORMW 「さすがの%CNAME("一人称")%もこんな状態の物を渡すのは恥ずかしいが…」	PRINTFORMW 「不愧是%CNAME("一人称")%送出了这种状态的东西啊，还真是不好意思……」
PRINTFORMW %CALLNAME:TARGET%のパンツは吸収した体液の重さで少し重量を増している…	PRINTFORMW %CALLNAME:TARGET%的胖次吸收了不少她自己的体液稍微增加了些重量，拿到手上时感觉轻轻捏一下就会出水一样…
PRINTFORMW %CALLNAME:TARGET%はゆっくりと下着を膝まで引き下げると	PRINTFORMW %CALLNAME:TARGET%慢慢地把内衣拉到膝盖上
PRINTFORMW パンツをその位置へ固定したまま足を持ち上げて引き抜くように脱ぎ始めた	PRINTFORMW 把胖次固定在膝盖的那个位置后抬起脚像拔出来一样地开始脱下了胖次
PRINTFORMW その動作にスカートが太ももに持ち上げられて彼女の陰部まで見えそうな危うい状態になっている	PRINTFORMW 那个动作使裙子被大腿举起到了她的阴部快要能看见的危险状态
PRINTFORMW 「こういうふうに脱ぐのが良いのだろう？」	PRINTFORMW 「像这样掉去比较好吧？」
PRINTFORMW 「さて、ではこれから%CNAME("一人称")%はしばらくパンツなしでいるわけだ」	PRINTFORMW 「那么，接下来%CNAME("一人称")%下面暂时没有胖次了」
PRINTFORMW 「もしバレてしまったら…素直に言ってしまうかもしれない。%CNAME("二人称")%が持っているとね」	PRINTFORMW 「如果暴露了……可能会坦率地说出来是%CNAME("二人称")%强迫我做的哦，嘿嘿……」
PRINTFORMW %CALLNAME:TARGET%は悪戯げに笑うと脱ぎ終わったパンツを手渡してくれた	PRINTFORMW %CALLNAME:TARGET%露出恶作剧地笑容把刚刚脱下还带着体温地胖次交给了我，上面还散发出淡淡地体香
PRINTFORMW 「%CNAME("一人称")%はパンツ無しで一日過ごすことになるわけだが…」	PRINTFORMW 「%CNAME("一人称")%在没有胖次的一天中度过一切…」
PRINTFORMW 「まさかクラスメイトたちも%CNAME("一人称")%がそんなことをしているとは夢にも思うまいね」	PRINTFORMW 「自己的同班同学们没想到%CNAME("一人称")%会做着这样的事情吧，连做梦都会吃惊呢」
PRINTFORMW 「流石にそれを受け入れるのははばかられるね」	PRINTFORMW 「真不敢相信」
PRINTFORMW 「ダメ元だろうが%CNAME("二人称")%がそれを口にした行動力はある意味で称賛するけれどもね」	PRINTFORMW 「虽然不行，但%CNAME("二人称")%的行动在某种意义上是值得称赞的」
PRINTFORMW 「なんだ、その、%CNAME("二人称")%は%CNAME("一人称")%にそんなことを命令できる立場だということを自慢したいのかね？」	PRINTFORMW 「什么，那个%CNAME("二人称")%是想夸耀的能命令%CNAME("一人称")%那样的事吗？」
PRINTFORMW 「ふふ、たしかに周囲にそんなことを知らしめるのは%CNAME("二人称")%の独占欲を満たせはするだろうが、流石に生活に支障があると思わないかい？」	PRINTFORMW 「呵呵，确实，让周围的人知道这样的事情的%CNAME("二人称")%的独占欲能感到满足吧,不过，不认为对生活有障碍吧？」
PRINTFORMW %CALLNAME:TARGET%は他の人達の事を気にしている……	PRINTFORMW %CALLNAME:TARGET%很在意别人目光……
PRINTFORMW 「%CNAME("二人称")%は自分が何を言っているのかもう少し客観的に考えたほうがいい」	PRINTFORMW 「%CNAME("二人称")%还是稍微客观地考虑一下自己在说什么比较好」
PRINTFORMW 「今度は何が飲みたいのかね？」	PRINTFORMW 「这次想喝什么呢？」
PRINTFORMW 「ちなみに今日はヴェルヴェーヌの香りを楽しんでいるよ」	PRINTFORMW 「顺便说一下，今天享受的可是维尔凡纳的香草茶哦。」
PRINTFORMW %CALLNAME:TARGET%は水筒を取り出している	PRINTFORMW %CALLNAME:TARGET%取出了装着香草茶的水壶
PRINTFORMW 「弁当といっても、料理は飲み物しか作れないが構わないかね？」	PRINTFORMW 「虽说是便当，但料理只能做饮料，这也没关系吗？」
PRINTFORMW 「いわゆるお茶、つまり狭義の茶だけでなくハーブティー全般だね。そしてコーヒーが私の作れる料理のすべてになる」	PRINTFORMW 「所谓的茶，不仅仅是狭义的，香草茶也是全部。然后就是咖啡这就成为我能做的全部料理了」
PRINTFORMW 「キミも身近そうなものでは麦茶もある意味でハーブティーなのだよ」	PRINTFORMW 「你身边的麦茶在某种意义上也是香草茶哟」
PRINTFORMW 「普通のハーブ店に売っているものだけで数多くの植物が飲用にもちいられる」	PRINTFORMW 「仅仅是普通的香草店出售的植物就可以饮用」
PRINTFORMW 「本当に必要とあらば、この国では手に入りづらいコカ茶やアヤワスカ茶、マリファナ茶などでさえ用意できるが…あまりお勧めはしないね」	PRINTFORMW 「如果真的有需要的话，在这个国家很难买到的可口可乐茶和红茶甚至大麻茶都可以准备……但我不怎么推荐」
PRINTFORMW 「それと、飲み物以外はキミが作るなりメイドに用意させるなりしたまえ」	PRINTFORMW 「还有，除了饮料以外，你自己做也好让女仆准备也好」
PRINTFORMW 「分業というのは人間がここまで発展することができた理由の一つと言われているのだからね」	PRINTFORMW 「所谓分工就是人类能够发展到这种程度的理由之一」
PRINTFORMW 同棲の申し出を告げると彼女は驚いた顔でつぶやく	PRINTFORMW 告诉同居的申请的话，她以吃惊的表情嘟哝
PRINTFORMW 「なるほど。何を唐突にとおもえば、予知か推理かはわからないが…」	PRINTFORMW 「原来如此，没事就是突然想起了什么，虽然不知道是预知还是推理的……」
PRINTFORMW 「その、今朝がた母から仮に誰かの家に移り住むなら今日からでも構わないと言われていてね」	PRINTFORMW 「那个，今天早上妈妈说如果要搬到谁的家的话，从今天开始也没关系的」
PRINTFORMW 「そのかわりにその相手にこの手紙を渡せと預かっている」	PRINTFORMW 「她委托我把这封信交给他」
PRINTFORMW あなたは彼女から手渡された、メモ用紙に乱雑に書き殴られた手紙と言うには憚られる文章を読んだ	PRINTFORMW 你读了她递给自己的便条纸上胡乱书写的信，看到了让人不敢相信的文章
PRINTFORML あなたが愚蒙だとしても構いませんが、最低限度の理解力はあると信じ端的に伝えます	PRINTFORML 即使你愚蠢也没关系，但我相信你有最低限度的理解力
PRINTFORML 私の主要な研究テーマは不死、これは人類普遍の究極の目的の一つ	PRINTFORML 我的主要研究题目是不死，这是人类普遍的终极目的之一
PRINTFORML にもかかわらず、私が私らしくもなく機会を見逃しているのは娘のためです	PRINTFORML 尽管如此，我也不想我错过机会但还是因为女儿
PRINTFORML 私の行動を縛る枷はいまそれだけだと意識しなさい　以上	PRINTFORML 但我意识到这只是束缚我行动的枷锁　以上
PRINTFORMW 手紙を横から読んだツェツィーリアはめんどくさそうな表情でつぶやいた	PRINTFORMW 从侧面读了信的西莉亚用看起来很麻烦的表情嘟哝着
PRINTFORMW 「…まったく普段は放任主義のくせに変なところで干渉してくる困った母だ」	PRINTFORMW 「……明明是个放任主义却在奇怪的地方干涉什么的，真是让人头疼的母亲」
PRINTFORMW 「これは娘を泣かせたら死すら生温い目に合わせてやる程度の意味だろう」	PRINTFORMW 「这大概就是让女儿哭泣都要迎合她温柔的目光的意思」
PRINTFORMW 「母もアレで心配性なのか、過保護なのか…」	PRINTFORMW 「母亲是那种爱操心，还是过度保护……」
PRINTFORMW 「まぁなんだ、これでコレで私とその親公認で同棲できるというわけだ」	PRINTFORMW 「嘛，这样就可以和我在父母的肯定下同居了。」
PRINTFORMW 「泣いて喜ぶといい。失敗するとちょっと物騒な人間が殴り込んでくるが…」	PRINTFORMW 「哭着高兴就好。失败的话就会有稍微有点危险的人类打过来那吧…」
PRINTFORMW 「まぁキミならたぶん大丈夫だろう」	PRINTFORMW 「嘛，如果是你的话大概没问题」
PRINTFORMW 「母は研究畑で戦闘に関しちゃそれほど恐ろしくはないからね」	PRINTFORMW 「母亲都在沉迷在研究里，关于战斗什么的并没有那么可怕」
PRINTFORMW あなたは「大丈夫」というのが戦うことに対してであることに不安を感じた	PRINTFORMW 你对于“最后的结果什么样都没关系的口气”对这种战斗感到不安
PRINTFORMW 「経口避妊薬を飲んでほしいって？」	PRINTFORMW 「你想要我吃避孕药？」
PRINTFORMW 「それはつまり、コンドームを使いたくなくなったということかい？」	PRINTFORMW 「也就是说，你不想用避孕套了吗？」
PRINTFORMW 「あのメイドが買ってくるコンドームはみたところ、かなり高級で精巧な代物だ」	PRINTFORMW 「那位女仆买来的避孕套，看起来相当高级、精巧」
PRINTFORMW 「きっと物理的な快楽はつけているのもつけないのも変わらないほどの品ではないかね？」	PRINTFORMW 「这么薄在物理性上给予的快乐，戴与不戴都应该差不多的东西吧？」
PRINTFORMW 「にもかかわらず、薬を使った避妊に切り替えたい」	PRINTFORMW 「尽管如此，还是想换成使用药物来避孕是吧」
PRINTFORMW 「つまりコンドームでは実現できない行為をしたい	PRINTFORMW 「总之，想要做出避孕套都无法实现的性爱吧
PRINTFORMW 「ナマのザーメンを少女の子宮の奥まで注ぎこみたいわけだ」	PRINTFORMW 「就是这么想把肉棒里的精液注入到少女子宫的深处嘛」
PRINTFORMW 「別に断る理由はないけれども、一つ気をつけておきたまえ」	PRINTFORMW 「虽然没有拒绝的理由，但是请注意一点」
PRINTFORMW 「私が薬を飲んでいると嘘をついたなら、本当の小作りセックスをする羽目になるということをね」	PRINTFORMW 「如果我撒谎说我吃了药的话，那你就会陷入到真正的造小孩的性交地困境了。」
PRINTFORMW 「コンドームが恋しくなったかい？」	PRINTFORMW 「你想念避孕套吗？」
PRINTFORMW 「たとえばザーメンで満たされたコンドームを私に握らせて」	PRINTFORMW 「好比让我握紧那充满精液的避孕套」
PRINTFORMW 「この日は何回ザーメンを吐き出すための処理装置として使ったか写真に撮って記録したいとか」	PRINTFORMW 「这几天是作为射出精液的处理装置来使用的，你还想在照片上拍摄并记录下来」
PRINTFORMW 「それを学校に密かに流通させ、私たちがどういう関係なのかしらしめるとか・・・」	PRINTFORMW 「然后在学校里秘密流通，让他们知道我们是什么样的关系……」
PRINTFORMW 「…キミのために卑猥な本で勉強しすぎたせいか、我ながらずいぶん影響されてしまってるな」	PRINTFORMW 「…也许是因为你读了色情的书学习地过头了，连我自己都受到了很大的影响」
PRINTFORMW 「それとも……私にしっかりと健康な卵子を排卵してほしいと…」	PRINTFORMW 「还是……希望我好好排出卵健康的卵子……」
PRINTFORMW 「つ、つまり…その……よし、」	PRINTFORMW 「也就是说……那个……好(*/ω＼*)」
PRINTFORMW 「セックスの本来の目的を果たしてしまいたいわけかな？」	PRINTFORMW 「你是想要实现性交本来的目的么？」
PRINTFORMW 「キミがそう望むのであれば・・・しよう」	PRINTFORMW 「如果你那么希望的话・・・好吧」
PRINTFORMW 「本当に必要なのかい？」	PRINTFORMW 「真的有必要吗？」
PRINTFORMW 「毎日、だいたい2回は生身の相手に好き勝手に性欲をぶつけているじゃないか」	PRINTFORMW 「每天，大概不是有2次随意地使用对方处理性欲吗？」
PRINTFORMW 「それの上で休み時間にも性欲を発散したいだなんて」	PRINTFORMW 「而且在下课休息时间也想发泄性欲什么的」
PRINTFORMW 「むしろ休みたくさえ…ならないのなら仕方あるまい」	PRINTFORMW 「倒不如说是我想休息了…如果不行，那也没有办法」
PRINTFORMW 「しかし%CNAME("一人称")%の同級生たちもきっと想像もしないだろうね、さっきまで同じ部屋で授業を受けていた同級生が」	PRINTFORMW 「但是%CNAME("一人称")%的同班同学们也一定无法想象吧，刚才还在同一个房间上课的同学」
PRINTFORMW 「たった10分そこらの時間で性欲処理のために使われてザーメンを注がれて帰ってきているなんてさ」	PRINTFORMW 「仅仅在下课的10分钟内的时间被用来处理性欲，然后还满满地注入了精液回到教室吧」
PRINTFORML 「ほう、一緒に買物をしたいとはね」	PRINTFORML 「哦，竟然想让我跟你一起去买东西」
PRINTFORMW 「流石にこの姿で外出するわけにはいかないな、着替えてこよう」	PRINTFORMW 「果然不能以这种姿态外出，我去换件衣服吧」
PRINTFORMW 「これも一種のデートというべきかな？」	PRINTFORMW 「这也应该算是一种约会吧？」
PRINTFORMW 「時間の都合が合えば後で私の買い物にも付き合ってくれると嬉しいけれどね」	PRINTFORMW 「如果时间合适的话，之后陪我逛街我会很开心的」
PRINTFORMW 「買い物かい？言ってらっしゃいとでも言っておくべきかな」	PRINTFORMW 「买东西！你应该说给我听吗？」
PRINTFORMW %CALLNAME:TARGET%は恥ずかしそうに目を逸らしつつ、%SKIRT(TARGET, "略")%を%TEXTR("おずおずと/そろそろと")%たくし上げた。	PRINTFORMW %CALLNAME:TARGET%有点害臊地撇开了眼睛、%SKIRT(TARGET, "略")%を%TEXTR("怯生生地/そろそろと")%たくし上げた。
PRINTFORMW 「なるほど、%CNAME("二人称")%はパンツを履かないままの%CNAME("一人称")%を連れ歩きたいというのだね」	PRINTFORMW 「原来如此，%CNAME("二人称")%打算不让%CNAME("一人称")%穿胖次」
PRINTFORMW 「%CNAME("二人称")%はきっと可能なら%CNAME("一人称")%が性的関係にあることをアピールしたいタイプだろう？」	PRINTFORMW 「%CNAME("二人称")%如果一定要这样的话，那么应该是想要%CNAME("一人称")%表现出跟你有性关系吧？」
PRINTFORMW 「こんな美少女が自分のものなのだと自慢して回りたいのに、それは流石に難しいからこんなことで代替しようというのだ」	PRINTFORMW 「这样的美少女是自己的东西，明明是想炫耀到处给别人看吧，但毕竟还很难做到，所以就想用这种方式来代替」
PRINTFORMW 「しかしそんなことをしなくても、この膨らんだお腹が「種付け」されたことを悠然と物語っているではないかね？」	PRINTFORMW 「可是即使不做那样的事，这个膨胀的肚子「被播种」的事实，不是悠然地说明着我已经怀孕的事实吗？」
PRINTFORMW 「あるいは妊娠させてしまえば、膨らんだお腹が否応なしにそのことを周知させてしまうが」	PRINTFORMW 「或者说如果怀孕了，这个膨胀的肚子会无可否认地让大家知道这件事的。」
PRINTFORMW 「%CNAME("二人称")%がこんなことで喜ぶならば応えてみせよう」	PRINTFORMW 「%CNAME("二人称")%如果对这样的事情感到高兴的话，我会试着回应你的」
PRINTFORMW 「羞恥心がないのは嫌だと%CNAME("二人称")%は言うかもしれないけれどね、%CNAME("一人称")%とて全く恥ずかしくないわけではないのだよ？」	PRINTFORMW 「如果讨厌没有羞耻心的%CNAME("二人称")%我可能会这么说，但%CNAME("一人称")%也并不是完全不害羞哟？」
PRINTFORMW %CALLNAME:TARGET%は脱ぎたての体温が残るパンツを白い頬を染めて手渡してきた	PRINTFORMW %CALLNAME:TARGET%把刚脱下来的被爱液染地花白的胖次，红着脸递给了我，但拿到时感觉上面还残留着些许的体温
PRINTFORML 「水着姿などどう考えても変人だが、まぁギリギリ犯罪というわけでもないか」	PRINTFORML 「泳装什么的怎么想都是怪人，但也不是犯罪」
PRINTFORML 「はっきり言うと運動着というのはあまり好きな格好ではないのだけれどもね」	PRINTFORML 「说白了，虽然体操服算是运动服但还是不很喜欢这样的样子」
PRINTFORMW 「裸で買い物をさせようというのかね？」	PRINTFORMW 「是想让我裸体购物是吗？」
PRINTFORMW 「プロソパゴノジアの魔法が必要だね？ギリシャ語で顔を意味するprosoponと無知を意味するagnosiaをあわせてprosopagnosiaだ」	PRINTFORMW 「需要prosopagnosia的魔法吧？在希腊语中表示脸部的prosopon和表示无知的agnosia组合而成的prosopagnosia」
PRINTFORMW 「それなら顔見知りに見られても「顔で誰かはわからないが、裸の女」くらいまでしかわからなくなる」	PRINTFORMW 「那样的话，就算被别人感觉出是熟人，有这魔法就可以让他人看不清楚施法人的脸了，只会说“哎，这个裸体的女人是谁，感觉在那里见过”，嘿嘿厉害吧」
PRINTFORMW 「それでも警察に通報されない程度にしなければならないけれどね」	PRINTFORMW 「即便如此，也必须做到不被别人报警的程度才行」
PRINTFORML 「これでも師匠なのだけれどね？これではどちらが弟子かわかったものではないが…」	PRINTFORML 「虽然这样也算是师傅，这样的话，不知道哪边是弟子……」
PRINTFORMW 「別にいやとは言ってないよ」	PRINTFORMW 「我并没有说讨厌」
PRINTFORMW 「それで、何を買えばいいのかね？」	PRINTFORMW 「那么，买什么好呢？」
PRINTFORML 「ああ、すぐ使うから厳重な包装はしないで簡単に袋に入れるだけでいいよ」	PRINTFORML 「啊，马上就要用了，不要包装得太严格，简单地装在袋子里就行了」
PRINTFORMW 店員は%CALLNAME:TARGET%の隣に立つ%CALLNAME:MASTER%をチラチラと見ながら会計している	PRINTFORMW 店员一边用微妙地眼神看着%CALLNAME:TARGET%一边给旁边的%CALLNAME:MASTER%结账
PRINTFORML 「これを買いたいのだが」	PRINTFORML 「我想买这个」
PRINTFORMW %CALLNAME:TARGET%はわざとらしく%CALLNAME:MASTER%と手を組んで会計している	PRINTFORMW %CALLNAME:TARGET%是故意的想让%CALLNAME:MASTER%出钱结账
PRINTFORML 「実際問題として見られることはまず無かろうが、気にならないかと言えば嘘になるね」	PRINTFORML 「作为实际问题应该不会被看到，如果说不在意的话就是骗人的了。」
PRINTFORMW %CALLNAME:TARGET%は別にどうということはないという雰囲気で口にするが、手はパンツを履いていない秘所を守るようにスカートを抑えている	PRINTFORMW %CALLNAME:TARGET%虽然嘴上说没什么特别的感觉，但是手还是为了保护没穿胖次的秘部不被看到而往下拉着裙子挡住秘部
PRINTFORML %TEXTR("「……」/「ハーブだね、なんの葉だろうかな」/「いろんなゴムが並んでるが・・・やはり薄いほうがいいのかね？」/「なかなかおもしろい商品が並んでいて時間は潰せそうだ」/「流石に展示用の商品だろうねコレは」")%	PRINTFORML %TEXTR("「……」/「香草啊，是什么叶子呢」/「各种各样的避孕套排列着・・・还是轻薄的好吗？」/摆放着相当有趣的商品，时间快要用完了”/“这个果然是展示用的商品啊，这个")%
PRINTFORMW %CALLNAME:TARGET%は棚の商品%TEXTR("を手に取って眺めながら/を興味深そうに観察して/の埃を手で軽く払いつつ/の説明書きを読みながら")%時間を潰している……	PRINTFORMW %CALLNAME:TARGET%看向架子上的商品%TEXTR("拿在手上观察着/看起来很有趣地观察着/用手轻轻地拂去灰尘/读着说明书")%消磨着时间……
PRINTFORMW 「どうだったかね？年頃の女性を下着をつけさせぬまま連れ歩いた気分は」	PRINTFORMW 「怎么样，带着没穿内衣的女性出来购物，让你的恶趣味感到满足了吗」
PRINTFORMW 「なにも買うものが無かったなら、荷物もないし私の買い物にも付き合ってくれるかね？」	PRINTFORMW 「如果没有什么东西要买的话，可以陪我去买东西吗？」