//EVENT_K5_DAILY.ERB
PRINTFORMW 「%CNAMET(ARG, "二人称")%……今日は%CNAME("一人称")%が%CNAMET(ARG, "二人称")%にうーんとご奉仕しちゃうのじゃ」	PRINTFORMW 「%CNAMET(ARG, "二人称")%……今天就让%CNAME("一人称")%来侍奉%CNAMET(ARG, "二人称")%吧」
PRINTFORML 「%CNAME("二人称")%、なんでも%CNAME("一人称")%に頼るがよいぞ」	PRINTFORML 「%CNAME("二人称")%、不管什么事情都可以拜托%CNAME("一人称")%哦」
PRINTFORML 「着物が肌に張り付いて気持ち悪いのじゃ…」	PRINTFORML 「和服贴在皮肤上感觉有点不舒服…」
PRINTFORML 「…………くぁ、ぁ……」	PRINTFORML 「…………唔、哈～～～」
PRINTFORML %CALLNAME:TARGET%は時折あくびをしながらぼうっとしている……	PRINTFORML %CALLNAME:TARGET%不时打哈欠发着呆……
"ふふふ、これからは%CNAME("二人称")%と特別な間柄という訳じゃな_H_」"	"呼呼呼、从今以后就和你是特別的关系了_H_」"
CALL PRINT_STRL, @"ふふふ、これからは%CNAME("二人称")%と特別な間柄という訳じゃな_H_」"	CALL PRINT_STL, "呼呼呼、从今以后就和你是特別的关系了_H_」"
PRINTFORML 「%CNAME("二人称")%、%CALLNAME:TARGET%はこれまで以上に誠心込めてお仕えしてゆくからの」	PRINTFORML 「%CALLNAME:TARGET%会比以往更虔诚地去侍奉%CNAME("二人称")%的」
PRINTFORML 「%CNAME("二人称")%、今後は何でも%CALLNAME:TARGET%にお申し付けください、なのじゃ」	PRINTFORML 「%CNAME("二人称")%、今后请随意吩咐%CALLNAME:TARGET%」
PRINTFORML 「ひゃわっ！」	PRINTFORML 「呀！」
PRINTFORML 「%CNAME("二人称")%、い、いきなり何をするのじゃ！？」	PRINTFORML 「%CNAME("二人称")%、突、突然在干什么呀！？」
PRINTFORML 「誤解していそうだから言っておくのじゃが…%CNAME("一人称")%は毒蛇ではないぞ？」	PRINTFORML 「因为好像被误解了所以先声明一下…%CNAME("一人称")%可不是毒蛇喔？」
PRINTFORML 「マムシやハブでなく、アオダイショウじゃからの」	PRINTFORML 「不是蝮蛇或者原矛头蛇那种、应该是类似黄颔蛇的那种感觉」
PRINTFORML 「冬眠？　たしかに寒いのは苦手じゃが…今の世は暖房もこたつもあるからのう」	PRINTFORML 「冬眠？确实不擅长应对寒冷的天气呢…这个世界有暖气真是太好了」
PRINTFORML 「便利な世の中になったものじゃ」	PRINTFORML 「真是方便的世界啊」
PRINTFORML 「%CNAME("二人称")%、%CNAME("一人称")%が怖いのは甘いものじゃ」	PRINTFORML 「%CNAME("二人称")%、%CNAME("一人称")%害怕的是甜品」
PRINTFORML 「そう、例えばお饅頭や餅、せんべい、飴みたいなやつじゃ…あとはパフェとか」	PRINTFORML 「嗯、比方说饅頭啊或者餅、仙贝、加了糖的什么的…啊还有芭菲」
PRINTFORML 「ゆめゆめ、忘れるでないぞ？　『甘いもの』じゃからな？」	PRINTFORML 「绝对绝对、不要忘了噢？　是『甜品』喔？」
PRINTFORML 「%CNAME("二人称")%、その手にしている板切れは何じゃ？」	PRINTFORML 「%CNAME("二人称")%、您手里的板子是什么？」
PRINTFORML 「『すまほ』？　ふむ、それがあれば%CNAME("二人称")%といつでもお話できるのかえ！？」	PRINTFORML 「『手机』？　呼姆、有这个就能随时和%CNAME("二人称")%说话了吗！？」
PRINTFORML 「欲しい！　それ欲しいのじゃ%CNAME("二人称")%！」	PRINTFORML 「我要！%CNAME("二人称")%我想要这个！」
PRINTFORML 「%CNAME("二人称")%、『かめら』というものには注意するのじゃぞ？」	PRINTFORML 「%CNAME("二人称")%、要注意『相机』这种东西哦？」
PRINTFORML 「うっかり撮られでもしたら魂を抜かれてしまうと言うからのう…」	PRINTFORML 「要是不小心被拍到的话、会被吸走灵魂的…」
PRINTFORML （%CNAME("二人称")%に料理を作ってあげたいのじゃが…かまどがないのじゃ…）	PRINTFORML （想给%CNAME("二人称")%做料理…但是找不到灶台…）
PRINTFORML （どうやって火を起こせばよいのじゃ…？）	PRINTFORML （这个该怎么把火升起来呢…？）
PRINTFORML 「『てれび』の中の人も大変じゃのう…あーんな薄い箱に閉じ込められて…」	PRINTFORML 「『电视』里面的人应该很辛苦吧…被困在这么小的箱子里面…」
PRINTFORML 「これが『くるま』というものかえ…%CNAME("一人称")%、牛車や籠よりうんと速いのう」	PRINTFORML 「这个就是『汽车』吗…比牛车快多了」
PRINTFORML 「の、のう%CNAME("二人称")%…この『そうじき』で吸い込んだものはどこへいくのじゃ？」	PRINTFORML 「呐、呐%CNAME("二人称")%…这个『吸尘器』吸进去的东西会到哪里去呢？」
PRINTFORML 「まさか黄泉の国まで連れて行かれてしまうのかえ？」	PRINTFORML 「难道会被送到黄泉的国度吗？」
PRINTFORML 「もう…食べられないのじゃ………ﾑﾆｬﾑﾆｬ」	PRINTFORML 「已经…吃不下了………唔喵唔喵」
PRINTFORML 「ううう……まんじゅうこわい……ﾑﾆｬ」	PRINTFORML 「呜呜……好可怕……唔喵」
PRINTFORML 「んん……%CNAME("一人称")%はおねしょなど……」	PRINTFORML 「嗯……%CNAME("一人称")%尿床了什么的……」
PRINTFORML 「%CNAME("二人称")%……どこにも行かんでおくれ……」	PRINTFORML 「%CNAME("二人称")%……不要走……」
PRINTFORML 「ううう……%CNAME("一人称")%を財布に挟んでもご利益など……」	PRINTFORML 「呜啊……别把%CNAME("一人称")%放在钱包里面……」
PRINTFORML 「犯人は……%CNAME("二人称")%じゃ……」	PRINTFORML 「犯人……是%CNAME("二人称")%……」
PRINTFORMW 「儂の住んでおるところ？　もちろんあの社に決まっておろう」	PRINTFORMW 「住在哪里？当然是这间神社」
PRINTFORMW 「壊れているとはいえ、儂を祀った社には違いないからの」	PRINTFORMW 「虽然很破旧、但毕竟也是祭拜我的神社」
PRINTFORMW 「まぁ、ちょっとばかり雨漏りや隙間風があったりはするが…」	PRINTFORMW 「嘛、偶尔也会稍微漏一些风啊雨啊进来就是了…」
PRINTFORMW %CALLNAME%はあの壊れたままの社に寝泊まりしているようだ…	PRINTFORMW %CALLNAME%好像在那间破损的神社住着…
PRINTFORMW 修繕するためには$5,000ほど必要になるだろう…	PRINTFORMW 修缮大概需要$5,000的样子…
PRINTFORML そろそろ%CALLNAME%の社を修繕してあげますか？	PRINTFORML 差不多該修缮一下%CALLNAME%的神社了吧？
PRINTL [0] 修繕してあげる($5,000かかります）	PRINTL [0] 修缮神社（需要$5,000）
PRINTL [1] ひとまず保留	PRINTL [1] 暂且保留现状
PRINTL [2] 修繕しない（修繕する機会が永久に失われます！）	PRINTL [2] 不修缮（将永远无法修缮！）
PRINTFORMW 「主様本当かえ！？　主様、ありがとうなのじゃ！」	PRINTFORMW 「真的吗主人！？主人、真的十分感谢！」
PRINTFORMW %CALLNAME%は目を輝かせて喜んでいる…	PRINTFORMW %CALLNAME%开心到眼睛都在发亮…
PRINTFORMW %CALLNAME%の【金運招来】が【金運招来Ⅱ】にパワーアップ！	PRINTFORMW %CALLNAME%的【金运招来】变成【金运招来Ⅱ】了！
PRINTFORMW 得られる金額がほんの少しだけ増加した！	PRINTFORMW 能得到的金额稍稍增加了！
CALL SET_DAILY_EV, "社修繕完了"	CALL SET_DAILY_EV, "社修缮完了"
PRINTFORMW %CALLNAME%には悪いがもう少しだけ我慢してもらおう…	PRINTFORMW 虽然对%CALLNAME%有点抱歉、但稍微再忍耐一下吧…
CALL SET_DAILY_EV, "社修繕計画"	CALL SET_DAILY_EV, "神社修缮计划"
PRINTFORMW 「…くしゅんっ！」	PRINTFORMW 「…啊啾！」
PRINTFORMW %CALLNAME%はくしゃみをしている…早くお金を貯めて社を直してあげよう。	PRINTFORMW %CALLNAME%在打喷嚏…快些存钱把神社修好吧。
PRINTFORMW 式神だからといって甘やかす訳にはいかない。	PRINTFORMW 不能因为是式神就娇纵她。
PRINTFORMW 自分の問題は自分で解決するよう%CALLNAME%に言い聞かせました…	PRINTFORMW 告诉%CALLNAME%自己的事情自己解決。
CALL SET_DAILY_EV, "社修繕放棄"	CALL SET_DAILY_EV, "放弃修缮神社"
PRINTFORMW 「抱っこして挨拶するなど、%CNAME("二人称")%は甘えたがりじゃのう」	PRINTFORMW 「抱着別人打招呼什么的、%CNAME("二人称")%是想要撒娇吧」
PRINTFORMW 「ひゃわっ！　%CNAME("二人称")%っ…その、今は少しばかり汗が…」	PRINTFORMW 「呀！　%CNAME("二人称")%…那个、稍微出了点汗…」
PRINTFORMW 「自分も汗まみれだから気にするなとは、理屈になっておらぬぞ…」	PRINTFORMW 「因为自己也出汗了、所以不用在意…？」
PRINTFORMW 「まったく、仕方のない%CNAME("二人称")%じゃ」	PRINTFORMW 「真是的、拿%CNAME("二人称")%没办法呀」
PRINTFORMW 「な、何がそれがいいじゃ！　ひゃんっ！　な、舐めるでないっ！」	PRINTFORMW 「哪、哪里好了！呀！不要舔！（那不是更好吗.jpg）」
CALL PRINT_STR, @"「はうう……%CNAME("二人称")%の汗のニオイ……頭がぽーっとしてくるのじゃ…_H_」_W"	CALL PRINT_STR, @"「呜……%CNAME("二人称")%的汗味……脑袋好热…_H_」_W"
PRINTFORMW 「はわわ…%CNAME("二人称")%の腰が顔の目の前にあるのじゃ…」	PRINTFORMW 「哇…%CNAME("二人称")%的腰贴在脸上…」
PRINTFORMW 「ふふふ、%CNAME("二人称")%、%GREETING%！」	PRINTFORMW 「呼呼呼、%CNAME("二人称")%、%GREETING%！」
PRINTFORMW 「ぎゅーってするのは%CNAME("一人称")%の得意分野なのじゃぞ」	PRINTFORMW 「紧接着就是%CNAME("一人称")%最擅长的时间」
PRINTFORMW 「ちゅっ……てっ、照れてしまうのうこういうのは……」	PRINTFORMW 「啾姆……这、这样太羞恥了……」
PRINTFORMW %CALLNAME:TARGET%は真っ赤になって、尻尾で頭を掻いている…	PRINTFORMW %CALLNAME:TARGET%的尾巴缠着变得通紅的脸。
PRINTFORMW 「ちゅっ……%GREETING%、%CNAME("二人称")%」	PRINTFORMW 「啾姆……%GREETING%、%CNAME("二人称")%」
PRINTFORMW 「今日も%CNAME("二人称")%にいいことがありますように、おまじないじゃ	PRINTFORMW 「希望今天%CNAME("二人称")%也能交上好运」
PRINTFORMW 「%CNAME("二人称")%、%GREETING%！　今日の気分はどうじゃ？」	PRINTFORMW 「%CNAME("二人称")%、%GREETING%！今天的心情如何？」
PRINTFORMW 「むにゃ……もう朝かえ……？」	PRINTFORMW 「唔吶……已经早上了……？」
PRINTFORMW 「はっ！？　%CNAME("二人称")%の前で眠りこけるなど、とんだ粗相を…！」	PRINTFORMW 「哈！？　在%CNAME("二人称")%面前睡着了、多么粗心之事…！」
PRINTFORMW 「ふふふ、%CNAME("二人称")%に褒めてもらえて光栄なのじゃ！」	PRINTFORMW 「呼呼呼、能得到%CNAME("二人称")%的赞扬是我的荣幸」
PRINTFORMW 「もっと、も～っとお役に立てるよう精進せねばな！」」	PRINTFORMW 「必须更加、更加地努力才行！」」
PRINTFORMW 「んんっ、ひゃわっ！　%CNAME("二人称")%、くすぐったいのじゃ！」	PRINTFORMW 「嗯、呀！%CNAME("二人称")%、好痒！」
PRINTFORMW 「ひゃわっ！　%CNAME("二人称")%っ、こ、こそばゆいのじゃ！」	PRINTFORMW 「呀！%CNAME("二人称")%、这、这！」
CALL PRINT_STR, @"「ん、ん……ちゅ……はぅ……%CNAME("二人称")%もっと……_H_」_W"	CALL PRINT_STR, @"「嗯、嗯……啾……唔……%CNAME("二人称")%继续……_H_」_W"
PRINTFORMW %CALLNAME%はとろんと目を潤ませて続きを催促している…	PRINTFORMW %CALLNAME%湿润的眼中充满着催促…
PRINTFORMW 「んむっ！？　ふ、不意打ちはずるいのじゃ%CNAME("二人称")%…っ」	PRINTFORMW 「嗯哼！？呼、%CNAME("二人称")%不要突然袭击…啊」
CALL PRINT_STR, "「んっ…ちゅ…_H_　だ、黙らせるのに接吻するのはもっとずるいのじゃ…」_W"	CALL PRINT_STR, "「嗯…啾…_H_不要在说话的時候亲上來啊…」_W"
PRINTFORMW %CALLNAME%は顔を赤くしながらも、黙って行為を受け入れている…	PRINTFORMW %CALLNAME%红着脸、默默接受对方的行为…
PRINTFORMW 「ふふふっ、本当は%CNAME("一人称")%が%CNAME("二人称")%にしてやりたいのじゃが…」	PRINTFORMW 「呼呼呼、%CNAME("一人称")%也想对%CNAME("二人称")%这样做…」
PRINTFORMW 「これはこれで%CNAME("二人称")%に甘えられてよいのう…」	PRINTFORMW 「这样就可以对%CNAME("二人称")%撒娇了吧…」
PRINTFORMW %CALLNAME%は%CALLNAME:MASTER%のふとももに頬を擦り付け堪能している…	PRINTFORMW %CALLNAME%非常满足地蹭着%CALLNAME:MASTER%的大腿…
PRINTFORMW 「むむむ、有り難く頂くが……式が主に淹れてもらうのは本末転倒ではないか？」	PRINTFORMW 「唔唔唔、十分感谢……式主泡茶给式神不是本末倒置了吗？」
PRINTFORMW 「ううう…%CNAME("二人称")%に気を使われると式としての立場がないのじゃ…」	PRINTFORMW 「唔嗯…反过来被%CNAME("二人称")%照顾的话作为式神的立场该往哪里放啊…」
PRINTFORML 「『張形』くらい%CNAME("一人称")%でも知っておるぞ！　こういうのは昔から変わっておら…ひゃわっ！？」	PRINTFORML 「『張形』这种东西%CNAME("一人称")%还是知道的！这个从以前开始就没有变过嘛…咿呀啊！？」
GREETING = こんばんはなのじゃ	GREETING = 晚上好
GREETING = こんにちはなのじゃ	GREETING = 你好
GREETING = おはようなのじゃ	GREETING = 早上好

//EVENT_K5_SHOP.ERB
PRINTFORMW 「%CNAME("一人称")%ごときが%CNAME("二人称")%とひとつ屋根の下というには、恐れ多いのではないのかえ」	PRINTFORMW 「像%CNAME("一人称")%这样的东西和%CNAME("二人称")%住在一起、不是会很恐怖吗？」
PRINTFORMW 「%CNAME("二人称")%！　これで朝も晩も%CNAME("二人称")%にお仕えできるというわけじゃな！」	PRINTFORMW 「%CNAME("二人称")%！这样的话早晚都能为%CNAME("二人称")%服务了！」
PRINTFORMW 「%CNAME("一人称")%！　今度こそ、%CNAME("二人称")%が満足できるようお仕えいたしますのじゃ！」	PRINTFORMW 「%CNAME("一人称")%！这次、一定要为了满足%CNAME("二人称")%努力工作！」
PRINTFORMW 「ええ……%CNAME("二人称")%、%CNAME("一人称")%を常にそばに置いておくことでよいのではないのかえ？」	PRINTFORMW 「诶……%CNAME("一人称")%经常出现会影响到%CNAME("二人称")%吗？」
PRINTFORMW 「生憎材料を切らしておっての……%CNAME("二人称")%、買い物につきおうてくれるかえ？」	PRINTFORMW 「好像材料都用完了……%CNAME("二人称")%、可以一起去购物吗？」

//EVENT_K5_六華.ERB
うらぶれた社に祀られていた蛇神	被供奉在神社里的蛇神。
御神体すら朽ち果て力を失っていたが、魂を分け与えられ式神として仕えることとなった	虽然神体已经腐朽到失去力量、但又被赋予了灵魂作为式神来侍奉主人。
PRINTFORMW 「%CNAMET(FINDCHARA(NO, 1), "二人称")%、あちらをご覧ください。あの半ば崩れかけた社です」	PRINTFORMW 「%CNAMET(FINDCHARA(NO, 1), "二人称")%、那边有个破损的神社呢」
PRINTFORMW 「そこに祀られている御神体…朽ち果てた蛇の像でしょうか？　何やら力を感じます」	PRINTFORMW 「供奉在这里的神…是已经死掉的蛇神吗？感觉可能很强」
PRINTFORMW 「魂を注ぎ、名を与えれば使い魔…この国では式神というのでしょうか？」	PRINTFORMW 「将灵魂灌注进去、并赋予名字就会变成使魔…在这个国家应该叫式神吧？」
PRINTFORMW 「ともあれ便利な小間使いになりましょう」	PRINTFORMW 「总而言之会更方便呢」
PRINTFORMW ※デフォルトでは六華となっています。必要に応じて名前の変更をしてください。	PRINTFORMW ※默认名是六華。请根据需要更改名字。
PRINTFORMW 「%CNAME("二人称")%がこの%CNAME("一人称")%に魂を…？」	PRINTFORMW 「是%CNAME("二人称")%将灵魂灌注给了%CNAME("一人称")%吗…？」
PRINTFORMW 「おかげでまたこうして現界することが叶ったのじゃ」	PRINTFORMW 「多亏了你、我才能再次重现于这个世界」
PRINTFORMW 「うらぶれた蛇神に過ぎぬ我が身じゃが、%CNAMET(ARG, "二人称")%に誠心お仕えいたしようぞ」	PRINTFORMW 「让%CNAME("一人称")%这个被拯救的蛇神、诚心地来服侍%CNAMET(ARG, "二人称")%吧」
PRINTFORMW ベッドへ誘われた%CALLNAME%が%CALLNAME:MASTER%の前に三指をついて座っている。	PRINTFORMW 被邀请过来的%CALLNAME%坐在%CALLNAME:MASTER%前面。
PRINTFORMW 座っているというのは性格な表現ではない。何しろ、%CALLNAME%の下半身は蛇のそれなのである。	PRINTFORMW 非常别扭的坐姿、可能是因为%CALLNAME%那蛇一样的下半身。
PRINTFORMW 真っ白な、艷やかな鱗に覆われた尾がとぐろを巻き、童女のような上半身がその上に鎮座している。	PRINTFORMW 洁白而艳丽的鳞片覆盖在蛇躯上、如同幼女的上半身静坐在上面。
PRINTFORMW 鱗と同じ真っ白な髪、白磁の肌、そして赤い眼と舌…まるで人形のような可憐さがそこにはあった。	PRINTFORMW 像鳞片一样洁白的头发、白嫩的肌肤、还有红色的眼瞳和舌头…简直像人偶一般让人怜爱。
PRINTFORML %CALLNAME%が口を開く。	PRINTFORML %CALLNAME%张口。
PRINTFORMW ちらりと見えた長く伸びた牙と長い蛇の舌が、童女のような姿をしていてもやはり怪異の一種なのだと思い出させる。	PRINTFORMW 细长的钉齿与红润的蜜舌、即使有幼女般的外表也会让人感到怪异。
PRINTFORMW 「この%CALLNAME%、%CNAME("二人称")%に求められれば身体を開くのもやぶさかではないのじゃ」	PRINTFORMW 「呐、%CNAME("二人称")%、拜托%CALLNAME%任何事情都可以哦」
PRINTFORMW 着物の襟をはだけ、見た目の歳からは不相応な色気を漂わせながら、%CALLNAME%は続ける。	PRINTFORMW 解开和服的领子、散发出和年幼的外表完全不相称的性感的同时、%CALLNAME%继续说道。
PRINTFORMW 「%CNAME("一人称")%は%CNAME("二人称")%の式、なれば%CNAME("一人称")%の身体は…%CNAME("一人称")%の全ては%CNAME("二人称")%のもの」	PRINTFORMW 「%CNAME("一人称")%是%CNAME("二人称")%的式神、所以%CNAME("一人称")%的身体也…不…%CNAME("一人称")%的一切都是%CNAME("二人称")%的东西」
PRINTFORMW 「如何様に染めようとも、すべては%CNAME("二人称")%の自由というわけじゃ」	PRINTFORMW 「不管把%CNAME("一人称")%染上什么颜色、都是%CNAME("二人称")%的自由」
PRINTFORMW 「さぁ、この%CALLNAME%に%CNAME("二人称")%の寵愛を…いや、%CNAME("二人称")%の愛を、欲を、溺れるほどに注ぎ込むがよいぞ」	PRINTFORMW 「所以、请给予%CALLNAME%%CNAME("二人称")%的宠爱…不、%CNAME("二人称")%的爱、欲望、亦或者是其它任何东西、都全部注入进来吧」
PRINTFORMW ニタリと見た目に不相応な艷を湛えたその口の端からは、長く艷やかな蛇の舌が覗いていた…	PRINTFORMW 与外表不相符的口中、妖艳的舌头正嘶嘶吐信着…
PRINTFORMW 「%CNAME("二人称")%がこうして求めてくれて、%CALLNAME%は嬉しいのじゃ」	PRINTFORMW 「%CNAME("二人称")%这样要求、%CALLNAME%也很开心」
CALL PRINT_STR, @"「さぁ%CNAME("二人称")%、%CNAME("一人称")%の身体をたっぷりとご堪能あれ…_H_」_W"	CALL PRINT_STR, @"「来吧%CNAME("二人称")%、慢慢享受%CNAME("一人称")%的身体吧…_H_」_W"
PRINTFORMW 「%CALLNAME%は%CNAME("二人称")%のことを考えるだけで、%CNAME("一人称")%はどうにかなってしまいそうなのじゃ」	PRINTFORMW 「%CNAME("一人称")%、总是在不停的想着%CNAME("二人称")%的事情」
PRINTFORMW 「その責任、取らずに逃げればひどいのじゃぞ」	PRINTFORMW 「不承担那个责任、逃跑的话就太过分了」
CALL PRINT_STR, @"「%CNAME("二人称")%……ふふふ、%CNAME("二人称")%のこと、%CNAME("一人称")%はと～っても好いておるのじゃ_H_」_W"	CALL PRINT_STR, @"「%CNAME("二人称")%……呼呼呼、%CNAME("二人称")%的一切、%CNAME("一人称")%都很喜欢_H_」_W"
PRINTFORMW 「今からそれを、たっぷりとその身体に教えてやるからの…」	PRINTFORMW 「今天%CNAME("一人称")%会好好告诉%CNAME("二人称")%的身体知识的…」
PRINTFORMW 「もっとも、逆に%CNAME("一人称")%の方が%CNAME("二人称")%やり込められてしまうやも知れぬがな」	PRINTFORMW 「不过、说不定%CNAME("一人称")%会反过来被%CNAME("二人称")%灌输呢～」
PRINTFORMW 「%CNAME("二人称")%…%CALLNAME%がたっぷりご奉仕させてもらうのじゃ」	PRINTFORMW 「%CNAME("二人称")%…请让%CALLNAME%来侍奉您」
PRINTFORMW 「%CNAME("二人称")%…この%CALLNAME%めが褥の伴を存分に務めさせていただくのじゃ」	PRINTFORMW 「%CNAME("二人称")%…让%CALLNAME%来陪伴您入睡吧」
PRINTFORMW 「%CNAME("二人称")%、%CALLNAME%がお相手しましょうぞ」	PRINTFORMW 「%CNAME("二人称")%、让%CALLNAME%来当您的对手」
PRINTFORMW 「%CNAME("二人称")%、今日はどうするのじゃ？」	PRINTFORMW 「%CNAME("二人称")%、今天要怎么做呢？」
PRINTFORMW 「%CNAME("一人称")%などが%CNAME("二人称")%の相手をさせてもらってよいのかのう…」	PRINTFORMW 「让%CNAME("一人称")%来当%CNAME("二人称")%的对手吧…」
PRINTFORML 「こんなになるまで%CNAME("一人称")%を愛してくれるとは…」	PRINTFORML 「竟然疼爱%CNAME("一人称")%到这种地步…」
PRINTFORMW 「この%CNAME("一人称")%も式神冥利に尽きるというもの…」	PRINTFORMW 「%CNAME("一人称")%也会用上式神的全部力量来回应的…」
CALL PRINT_STR, "「今はゆるりと休むがよいぞ…儂の膝の上でな_H_」_W"	CALL PRINT_STR, @"「先在%CNAME("一人称")%的膝盖上休息会吧_H_」_W"
PRINTFORML 「まったく%CNAME("二人称")%は頑張り過ぎじゃ…」	PRINTFORML 「%CNAME("二人称")%太努力过头了…」
PRINTFORMW 「たかが式神に過ぎぬ%CNAME("一人称")%にこうまで愛を注いでくれるのじゃから…」	PRINTFORMW 「将这么多的爱意灌注在%CNAME("一人称")%区区一个式神身上…」
CALL PRINT_STR, @"「ふふっ、大好きじゃぞ、%CNAME("二人称")%_H_」_W"	CALL PRINT_STR, @"「呼呼、最喜欢你了、%CNAME("二人称")%_H_」_W"
PRINTFORML 「ひゃわっ！？」	PRINTFORML 「呀呼！？」
PRINTFORMW 「%CNAME("二人称")%っ！？　しっかりするのじゃ%CNAME("二人称")%っ！」	PRINTFORMW 「%CNAME("二人称")%！？振作起来呀%CNAME("二人称")%！」
PRINTFORMW 「そ、そんな…%CNAME("二人称")%！　息をするのじゃ、ヒッヒッフーじゃ！」	PRINTFORMW 「那、那个…%CNAME("二人称")%！　深呼吸、呼吸！」
PRINTFORMW 「ヒッヒッフー、ヒッヒッフー……なんか違う！？　え、えっと…そうじゃ人工呼吸じゃ！」	PRINTFORMW 「呼吸、呼吸……好像不行！？那、那就…做人工呼吸吧！」
PRINTFORMW ※この後ちゃんとリザレクションしました。	PRINTFORMW ※之后平安地复活了。
PRINTFORMW 「はわわっ！　か、加減を間違ったのじゃ！」	PRINTFORMW 「呀！太沉迷进去了！」
PRINTFORMW 「%CNAME("二人称")%、だっ、大丈夫かえ…？　し、死んでる……！」	PRINTFORMW 「%CNAME("二人称")%、没、没事吧…？死、死掉了……！」
PRINTFORML 「ちっ、違……%CNAME("一人称")%そんなつもりじゃ…」	PRINTFORML 「不、不要啊……%CNAME("一人称")%不是故意的…」
CALL PRINT_STR, @"「はう…さすが%CNAME("二人称")%なのじゃ…_H_」_W"	CALL PRINT_STR, @"「哈…不愧是%CNAME("二人称")%…_H_」_W"
PRINTFORMW 「本当なら%CNAME("一人称")%の方が%CNAME("二人称")%を悦ばせねばならぬのに…」	PRINTFORMW 「%CNAME("一人称")%能成为%CNAME("二人称")%的式神感到很开心…」
CALL PRINT_STR, @"「%CNAME("一人称")%はもう%CNAME("二人称")%にめろめろじゃぁ…_H_」_W"	CALL PRINT_STR, @"「%CNAME("一人称")%要为%CNAME("二人称")%努力…_H_」_W"
PRINTFORMW 「%CNAME("二人称")%…%CNAME("一人称")%の気持ちが至らなかったのかえ？」	PRINTFORMW 「%CNAME("二人称")%…%CNAME("一人称")%的心情有传达到吗？」
PRINTFORMW 「むむむ…次こそ%CNAME("二人称")%を満足させてみせるからの！」	PRINTFORMW 「唔唔唔…下次一定要让%CNAME("二人称")%也满足！」
PRINTFORMW 「はう…さすが%CNAME("二人称")%なのじゃ…」	PRINTFORMW 「哈…不愧是%CNAME("二人称")%…」
PRINTFORMW 「ふふふ、次こそは%CNAME("二人称")%を満足させてみせるのじゃ！」	PRINTFORMW 「呼呼呼…下次一定要让%CNAME("二人称")%也满足！」
PRINTFORMW 「%CNAME("二人称")%…もう良いのかえ？」	PRINTFORMW 「%CNAME("二人称")%…已经可以了吗？」
PRINTFORMW 「むむむ、次はへろっへろになるまで%CNAME("二人称")%を満足させてみせるからの！」	PRINTFORMW 「姆姆姆…下次一定要让%CNAME("二人称")%也满足！」
PRINTFORMW 「ひゃぁっ！　%CNAME("二人称")%、くすぐったいのじゃ…！」	PRINTFORMW 「呀！　%CNAME("二人称")%、好痒…！」
PRINTFORMW 「%CNAME("二人称")%に触れられておるだけで%CNAME("一人称")%はどうにかなってしまいそうじゃ…%UNICODE(0x2661)%」	PRINTFORMW 「只是被%CNAME("二人称")%触摸、%CNAME("一人称")%也会舒服…%UNICODE(0x2661)%」
PRINTFORMW 「ま、待つのじゃっ！今触れられたら気をやってしま……あぁぁっ♪」	PRINTFORMW 「等、等一下！要是现在再摸的话……啊啊啊啊♪」
PRINTFORMW （………っ♪　な、なんたる手管…っ♪　少しでも気を抜けば…ふぁぁっ♪）	PRINTFORMW （………啊♪　好、好厉害…啊♪　只是放松了一下…啊啊啊啊♪）
PRINTFORMW 「い、今は…ふぁっ♪　ま、待つのじゃっ♪　果て、果ててしま……んんっ♪」	PRINTFORMW 「要、要是…现在就♪　等、等一下♪　去、去了……嗯♪」
PRINTFORMW 「おまめっ♪　今おまめちゅこちゅこするのやめぇっ♪」	PRINTFORMW 「不要♪　不要再继续了♪」
PRINTFORMW 「そこっ♪　そこっクリちゃん虐めるのやめっ♪　やぁぁっ♪　あぁっ♪」	PRINTFORMW 「那里♪　不要再欺负豆豆了♪　呀啊♪　啊♪」
PRINTFORMW 「そ、そこっ♪　そこ摘むのダメっ♪　お豆撫でるのもダメじゃぁっ♪」	PRINTFORMW 「那、那里♪　不要再挤了♪　小豆豆也不要摸了啊啊♪」
PRINTFORMW 「んぁぁっ♪　胸ぽっちくりくりするのやめるのじゃぁっ♪」	PRINTFORMW 「嗯啊♪　胸部好涨♪」
PRINTFORMW 「とんがり乳首シコシコっ♪　それっ♪　%CNAME("一人称")%ダメになるやつぅっ♪」	PRINTFORMW 「乳头立起来了♪　那个♪　%CNAME("一人称")%要不行了♪」
PRINTFORMW 「お胸っ♪　乳首っ♪　%CNAME("一人称")%のおっぱい玩具にするでないぃっ♪」	PRINTFORMW 「胸♪　乳头♪　%CNAME("一人称")%的胸部不是玩具呀♪」
PRINTFORMW 「あぁぁっ♪　%CNAME("二人称")%っ♪　イカせてっ♪　%CNAME("二人称")%ぁっ♪」	PRINTFORMW 「啊啊啊♪　%CNAME("二人称")%♪　下面♪　%CNAME("二人称")%呀♪」
PRINTFORMW 「突いてっ♪　突きながら%CNAME("一人称")%を可愛がっておくれっ♪　%CNAME("二人称")%ぁっ♪」	PRINTFORMW 「噗啾♪　插进去尽情疼爱%CNAME("一人称")%吧♪　%CNAME("二人称")%呀♪」
PRINTFORMW 「良いっ♪　突かれながら身体弄られるの、%CNAME("一人称")%おかしくなるっ♪　もっとしとくれぇっ♪」	PRINTFORMW 「好厉害♪　边插进去边玩弄身体的话、%CNAME("一人称")%要变得奇怪了♪　再多一些♪」
PRINTFORMW 「お尻っ♪　尻穴犯しながら愛するのやめよぉっ♪」	PRINTFORMW 「屁股♪　不要边摸边插进去♪」
PRINTFORMW 「こ、こんなの…っ♪　尻穴ズボズボされながら優しくされたらおかしくなるぅっ♪」	PRINTFORMW 「这、这样子…啊♪　屁股小穴快要去了♪」
PRINTFORMW 「ひ、拡がるっ♪　%CNAME("一人称")%のお尻っ、耕されて…あぁぁ、優しく蕩かすでないぃっ♪」	PRINTFORMW 「变、变大了♪　%CNAME("一人称")%的屁股、在被耕耘…啊啊啊、要融化了♪」
PRINTFORMW 「おかしくなるっ♪　おしっこの穴おかしくなるから今はやめぇっ♪」	PRINTFORMW 「好奇怪♪　尿尿的地方好奇怪♪」
PRINTFORMW 「壊れるっ♪　%CNAME("一人称")%戻れんようになるから今はやめよぉっ♪」	PRINTFORMW 「坏掉了♪　%CNAME("一人称")%要回不去了、快停下来♪」
PRINTFORMW 「んぉぉっ♪　尿道突かれながら弄られるの凄いのじゃぁっ♪」	PRINTFORMW 「嗯噢♪　尿道被玩弄也好舒服♪」
PRINTFORMW 「ん…っ、こそばゆいのう…あっ、ひゃんっ♪」	PRINTFORMW 「嗯…啊、好害羞…啊、呀♪」
PRINTFORMW 「よ、よいぞっ♪　んんっ♪　そ、そこっ……ひぁっ♪」	PRINTFORMW 「哟、哟唔♪　嗯♪　那、那里……嘿姆♪」
PRINTFORMW 「こ、これっ！　どこを触っておるかぁっ！」	PRINTFORMW 「那、那个！　在摸哪里呢！」
PRINTFORMW 「%CNAME("一人称")%はつま先から頭まで、毛先一つに至るまで%CNAME("二人称")%のモノ…♪　さ、とくと%CNAME("一人称")%を味わうが良いぞ♪」	PRINTFORMW 「%CNAME("一人称")%从脚尖到头顶、直到发梢都是%CNAME("二人称")%的东西…♪　来吧、来好好品尝%CNAME("一人称")%♪」
PRINTFORMW 「分かっておるかえ%CNAME("二人称")%…%CNAME("一人称")%はまだ『初等部』なのじゃぞ♪」	PRINTFORMW 「您知道吗%CNAME("二人称")%…%CNAME("一人称")%还是『初等部』哦♪」
PRINTFORMW 「肌の質には自信があるのじゃ♪　白磁の柔肌が吸い付くようじゃろ？」	PRINTFORMW 「对皮肤还是有自信的♪　白色的皮肤很柔软吧？」
PRINTFORMW 「撫で回してばかりじゃのう…よいぞ、%CNAME("一人称")%の肌を存分に堪能するが良い♪」	PRINTFORMW 「只是抚摸吗…好吧、%CNAME("一人称")%的皮肤也请尽情享受♪」
PRINTFORMW 「こうして乳繰り合うだけでよいのかえ…？%CNAME("一人称")%はもっと凄いことでも受け入れるぞ♪」	PRINTFORMW 「只是摸摸就好了吗…？%CNAME("一人称")%就算是更厉害的事情也能接受哦♪」
PRINTFORMW 「くふふ、%CNAME("一人称")%の幼い肢体を撫で回してどうしたいのじゃ？」	PRINTFORMW 「库呼呼、抚摸着%CNAME("一人称")%这么幼小的身体想要干什么呢？」
PRINTFORMW 「ん、んん…%CNAME("二人称")%、もっと強くしてもよいのじゃぞ？」	PRINTFORMW 「嗯、嗯…%CNAME("二人称")%、再用力一点也可以哦？」
PRINTFORMW 「ん…その指使い…スケベじゃぞ%CNAME("二人称")%…♪」	PRINTFORMW 「嗯…手指…好色喔%CNAME("二人称")%…♪」
PRINTFORMW 「児戯よのう…ほれ、もっと欲望のまま%CNAME("一人称")%を蹂躙してみせよ♪」	PRINTFORMW 「儿戏一样的…来、就按%CNAME("二人称")%的欲望来蹂虐%CNAME("一人称")%吧♪」
PRINTFORMW 「まったく、女を悦ばせる術を知らぬようじゃな%CNAME("二人称")%は…♪」	PRINTFORMW 「真是的、%CNAME("二人称")%好像完全不知道该怎么让女孩子开心呀…♪」
PRINTFORMW 「斯様な触れ方ではままごとも同じぞ♪　ほれ、もっとイケナイ遊びを%CNAME("一人称")%に教えよ♪」	PRINTFORMW 「触摸的手法真是僵硬♪　来、把更厉害的东西教给%CNAME("一人称")%吧♪」
PRINTFORMW （………、くすっ♪　下手なりに必死な%CNAME("二人称")%は可愛ゆいのう♪）	PRINTFORMW （………库斯♪　笨手笨脚的%CNAME("二人称")%也好可爱♪）
PRINTFORMW （………、もっと気分を出して喘いでみせたほうが良いのじゃろうか？）	PRINTFORMW （………稍微喘息几声是不是会更好？）
PRINTFORMW 不良在庫の山を前に、%CALLNAME:MASTER%と%CALLNAME:TARGET%は頭を抱えた…	PRINTFORMW 在堆积成山的不良库存前、%CALLNAME:MASTER%和%CALLNAME:TARGET%抱住了脑袋…