//EVENT_K6_CHARAEVENT.ERB
PRINTFORMW 「%CNAME("二人称")%とその……するようになってからですね」	PRINTFORMW 「%CNAME("二人称")%那个……变成这样之后」
PRINTFORMW 「なんと、学校に行っても保健室に行かなくてよくなったんです」	PRINTFORMW 「哎呀、即使去学校也不去保健室就好了」
PRINTFORMW 「すごいですよね、びっくりですよ」	PRINTFORMW 「好厉害啊、吓我一跳」
PRINTFORMW 興奮した様子の%CALLNAME:TARGET%は、楽しそうに%CALLNAME:MASTER%に話しかけている。	PRINTFORMW 一脸兴奋样子的%CALLNAME:TARGET%开心地和%CALLNAME:MASTER%说着话。
PRINTFORMW 「最近いつも体調がよくって……」	PRINTFORMW 「最近身体好多了……」
PRINTFORMW 「夜眠るときも寝付きがいいんです。怖くないんですよ」	PRINTFORMW 「晚上睡觉的时候也容易入睡、不害怕哦」
PRINTFORMW 「明日もちゃんと目が覚めるかなって心配しなくていいんです」	PRINTFORMW 「不用担心明天是否也会醒来」
PRINTFORMW %CALLNAME:TARGET%は穏やかな笑みを浮かべながら、遠くを見るような目をしている。	PRINTFORMW %CALLNAME:TARGET%的脸上带着平静的笑容、眼睛望向远方。
PRINTFORMW 「この前病院に行ったんですけど、先生驚いてました」	PRINTFORMW 「上次去医院的时候医生也很惊讶」
PRINTFORMW 「しばらく様子をみて、それでもこのままなら薬も少し軽めのものに変わるみたいで」	PRINTFORMW 「虽然说是暂且观察病情、但如果只是继续这样的话、药量好象也能用稍微减轻一点」
PRINTFORMW 「ふふ、みんな%CNAME("二人称")%のおかげですね……」	PRINTFORMW 「呵呵、大家都说多亏了%CNAME("二人称")%的帮助呢」
PRINTFORMW %CALLNAME:TARGET%は%CALLNAME:MASTER%に、安心しきった笑みを向けている……。	PRINTFORMW %CALLNAME:TARGET%对%CALLNAME:MASTER%展露出了安心的笑容。
PRINTFORMW 「そうそう、このまま調子が良くなったら体育の授業に出てもいいですよって言われたんです」	PRINTFORMW 「对了对了、我听说像这样继续好转的话、就可以去上体育课了」
PRINTFORMW 「ふふ、楽しみです」	PRINTFORMW 「嘿嘿、好期待啊」
PRINTFORMW 「運動はほとんどしたことがないので、上手くはできないと思いますけど……」	PRINTFORMW 「因为几乎没有做过运动、所以我想我大概不太擅长……」
PRINTFORMW 苦笑いを浮かべながらも、%CALLNAME:TARGET%はどこか楽しそうな雰囲気だ。	PRINTFORMW 虽然脸上露出苦笑、%CALLNAME:TARGET%总觉得气氛很愉快。
PRINTFORMW 「聞いてください%CNAME("二人称")%、今日はですね――」	PRINTFORMW 「请听我说%CNAME("二人称")%、今天呢――」
PRINTFORMW 「\@ TEXTS("曜日") != "日" ? 今日は # \@授業中、こんなことがあったんですよ」	PRINTFORMW 「\@ TEXTS("曜日") != "日" ? 今日も# \@上课时、发生了这样的事
PRINTFORMW 「移動教室があったんですけど、あやうく学校で迷子になりかけました……」	PRINTFORMW 「虽然有移动教室、但好容易在学校里迷路了……」
PRINTFORMW %CALLNAME:TARGET%は\@ TEXTS("曜日") != "日" ? 今日も # \@学校で起きた出来事を楽しそうに話している……。	PRINTFORMW %CALLNAME:TARGET%は\@ TEXTS("曜日") != "日" ? 今天也 # \@愉快地谈论着在学校发生的事情……
PRINTFORMW いつも学校での出来事を楽しそうに話している%CALLNAME:TARGET%だが、今日は静かに黙っている。	PRINTFORMW 之前总是愉快地谈论着在学校发生的事情、但是、%CALLNAME:TARGET%今天安静地沉默着。
PRINTFORMW 身体の調子が悪いのだろうか……。	PRINTFORMW 是身体不舒服吗……？
PRINTFORMW 今日は多めに精液を与えた方がいいのかもしれない。	PRINTFORMW 今天也许得多给点精液比较好。
PRINTFORMW 「はぁ……」	PRINTFORMW 「哈哈……」
PRINTFORMW %CALLNAME:TARGET%は今日も相変わらず静かだ。	PRINTFORMW %CALLNAME:TARGET%今天也仍旧很安静。
PRINTFORMW よく見てみると顔が赤く上気しているようだし、息も荒いように思える。	PRINTFORMW 仔细一看、她脸色发红、看上去气喘吁吁的……
PRINTFORMW 体調が悪いのであれば、多めに魂を分けるべきだろうか……。	PRINTFORMW 如果身体不舒服的话、是不是应该再多分点灵魂呢……？
PRINTFORMW 「……んっ」	PRINTFORMW 「……唔」
PRINTFORMW %CALLNAME:TARGET%の様子は相変わらずのままだ。	PRINTFORMW %CALLNAME:TARGET%的情况还是老样子。
PRINTFORMW しかし上気した頬や吐息の色はむしろますます艶めいてきているように思える……。	PRINTFORMW 但是通红的脸颊和喘息的样子反而显得十分色气……
PRINTFORMW あなたがさくらをベッドに誘ったときから遡ること数十分前。	PRINTFORMW 主人公把樱引诱到床上之前几十分钟
PRINTFORMW （ああ……まただ）	PRINTFORMW （啊……又、又）
PRINTFORMW 顔が燃えるように熱い。心臓が激しく早鐘を打っているのを感じる。	PRINTFORMW 脸烧得火热、心脏像鹿撞一般跳着。
PRINTFORMW どくどくと鳴る鼓動はまるで嵐のようで、ただでさえ穏やかならぬ胸中をさらに激しくかき乱す。	PRINTFORMW 咚咚地跳动着仿佛暴风雨一般、让本来就不平静的胸口更加难受。
PRINTFORMW 私の身体はこのところいつもこうだ。少し前までは調子よく動いていたのに、突然へそを曲げてしまうことがある。	PRINTFORMW 我的身体最近总是这样。刚才还好好的、突然一下小腹里就有一股热流。
PRINTFORMW 昼休みの直前あたりが特にひどい。	PRINTFORMW 午休前后特别严重。
PRINTFORMW 体育でもなんでもない普通の授業なのに、息が荒くなって、頭がぼーっとして、顔が茹で上がったように真っ赤になる。	PRINTFORMW 虽然只是普通的体育课、但依旧让她气喘吁吁、头晕目眩、脸就像煮熟了一样通红……
PRINTFORMW 「はぁ……っ」	PRINTFORMW 「哈……啊」
PRINTFORMW ぼーっとするだけでなく、すこし変な気分になってしまうのだ。今のように。	PRINTFORMW 不仅是发呆、心情也会变得有些奇怪。像现在这样。
PRINTFORMW 胸の奥がむずむずする。心臓がどくんと大きく血液を送り出すたびに、先端にじわじわと熱が集まってくる。	PRINTFORMW 内心深处痒痒的。每当心脏不断往外输送血液时、热量就会慢慢地集中到乳头。。
PRINTFORMW こうなってしまうとつらい。意識しないようにしようと思えば思うほど敏感になる。	PRINTFORMW 事到如今就更难受了、越想越敏感。
PRINTFORMW まるで虫さされを見つけてしまったときのようだ、と思う。	PRINTFORMW 简直就像是有虫子叮咬一样。
PRINTFORMW 気づくまでの間はなんとも感じなかったはずなのに、意識したとたんに痒みが気になって止まらなくなる。	PRINTFORMW 在发觉之前应该没什么感觉、可一旦意识到就痒得不得了。
PRINTFORMW 意識してしまうことで感覚が研ぎ澄まされる、敏感になったことでさらに気になってしまう。そんな堂々巡り。	PRINTFORMW 意识会被感觉集中、变得更加敏感、越敏感就越在意。陷入了这样的恶性循环。
PRINTFORMW さらさらとしたブラの裏地が乳首をこする感覚。小さく収まっていた乳首がむくむくと頭をもたげて、ブラの布地にくっきりと浮かび上がる。敏感になった乳首から快感があふれ出て、胸全体がじわりと火照ったように暖かくなる。	PRINTFORMW 藏在衣服内的胸罩摩擦着乳头、小小的尖端浮肿着立了起来、透过胸前柔软的衣服可以看到明显的凸起。从大脑深处传来的快感让整个欧派变得敏感而火热。
PRINTFORMW 気持ちよさに思わず指が伸びて、ぴたりと止まる。はしたないと思う心がブレーキをかける。けれども今は誰にも見られていない。授業中とは違う。とがめられることも、恥ずかしい思いをすることもない……。	PRINTFORMW 忍不住手指慢慢地伸到胸口揉捏了起来……内心想着现在周围也没有人、也不是在上课、既不用担心被人发现也不用害羞……
PRINTFORMW 「……んぅっ」	PRINTFORMW 「……嗯」
PRINTFORMW 気づいたときには胸がすっぽりと両手に収まっていた。固く突き出ている乳首を人差し指と親指でくりくりとつまむ。ときにはぐにぐにと押し潰すように揉み、またあるときには牛の乳搾りのようにしごき上げる。	PRINTFORMW 等意识到的时候双手已经在衣服里摸着那对小白兔了、拇指和食指紧紧地捏住勃起的乳头、就像想挤奶一般拉扯揉捏着。
PRINTFORMW 「はぁっ、んく、はぁっ、はぁ……っ」	PRINTFORMW 「哈、嗯、哈、哈……啊」
PRINTFORMW 胸の鼓動はもはや離れていても聞こえてしまうのではないかというほどに激しい。荒くなった呼吸の音がうるさいほどに頭に響く。乳首をしごく指が止まらない。気持ちいい、気持ちいい、気持ちいい――けど。	PRINTFORMW 胸口的悸动已经到了即使在门口也能听到的程度。脑袋里只有激烈的喘息声。乳头上的手指停不下来啊、好舒服、好舒服、好舒服啊。但是――
PRINTFORMW 「\@ CONDS("本来の性別", MASTER) == "オトコ" ? にい # ねえ \@、さん……っ」	PRINTFORMW 「\@ CONDS("本来の性別", MASTER) == "男性" ? 欧尼 # 欧内 \@、桑……」
PRINTFORMW 情欲で染まった脳裏に%CONDS("関係", MASTER)%の顔が浮かぶ。	PRINTFORMW 在被情欲感染的脑海里、%CONDS("関係", MASTER)%的脸慢慢浮现了上来。
PRINTFORMW 「足りないですっ、こんなのじゃぜんぜん、足りない……っ」	PRINTFORMW 「还不够、这样的完全不够啊……」
PRINTFORMW %CNAME("二人称")%にしてもらわないとイけない。事情をすべて打ち明けて、%CNAME("二人称")%にイかせてもらいたい……。	PRINTFORMW %CNAME("二人称")%不是他来好像就不行。明天一定要告诉他、%CNAME("二人称")%想让他来的心情……
PRINTFORMW どんなときでもどこかに%CNAME("二人称")%がいないか探してしまう。	PRINTFORMW 无论何时何地都在寻找着%CNAME("二人称")%在哪里。
PRINTFORMW %CNAME("二人称")%と会えない時間が続くだけで、こんなにも身体が火照ってしまう。	PRINTFORMW %CNAME("二人称")%只是一段时间不在一起、身体就变得这么火热。
PRINTFORMW ずっと%CNAME("二人称")%を見ていたい。%CNAME("二人称")%と一緒にいたい。%CNAME("二人称")%とキスしたい。%CNAME("二人称")%とえっちなことをしたい。そんな風に思ってしまう気持ちを抑えられない。	PRINTFORMW 想要一直看着%CNAME("二人称")%想要一直和%CNAME("二人称")%在一起。想要亲吻%CNAME("二人称")%想和%CNAME("二人称")%做羞羞的事情。
PRINTFORMW （そんなの、だめ……）	PRINTFORMW （那种事情,不行啊……）
PRINTFORMW ……そんないやらしい子は嫌われてしまう。%CNAME("二人称")%に迷惑をかける子なんて嫌われても仕方がない。	PRINTFORMW ……这么下流的女孩是会被讨厌的、给%CNAME("二人称")%添麻烦被讨厌了的话怎么办。
PRINTFORMW 「我慢、しないと」	PRINTFORMW 「要忍耐、不然的话」
PRINTFORMW 名残惜しさをこらえて指を離す。	PRINTFORMW 忍住快感放开了手指。
PRINTFORMW 乱れた着衣を整える。ずれたブラを元通りにして上着のボタンを留める。	PRINTFORMW 整理着蓬乱的衣服。把偏离的胸罩系好,扣上了外衣的扣子。
PRINTFORMW 固くなった乳首が浮き出てしまっているのは……どうにもできないので我慢する。	PRINTFORMW 硬着的乳头顶在内衣上……好难忍耐啊。
PRINTFORMW （いつも通りの、%CNAME("二人称")%の妹の私に戻らないと……）	PRINTFORMW （和平常一样的、作为%CNAME("二人称")%的妹妹的我不回去的话……）
PRINTFORMW 部活が始まるより少し前、普通の学生はまず寄りつかない空き教室にすべりこんだ。	PRINTFORMW 在社团活动开始前、躲开其他学生钻进了没有人的空教室。
PRINTFORMW これがあと少し遅かったら、廊下のど真ん中で「やらかして」しまっていたかもしれない。	PRINTFORMW 如果再慢一点的话、说不定会忍不住在在走廊中央……
PRINTFORMW 「うぅぅ……んんっ、んくぅっ……んっ、はぁ……っ」	PRINTFORMW 「呜呜……哼、哼哼……嗯、哈……啊」
PRINTFORMW 声を抑えないと見つかってしまう――そんな思いとは裏腹に、隠しきれない発情の色はするすると口から漏れてしまう。	PRINTFORMW 从发情的身体里传出刻意压抑的色情喘息。
PRINTFORMW 夜、鍵のかかった薄暗い部屋の中。なぜ明かりがついていないのかといえば、それはもちろん、恥ずかしいから。	PRINTFORMW 躲在反锁着的昏暗房间里。要说为什么没有开灯、肯定是因为害羞呀。
PRINTFORMW こんな姿、誰にも見せられない――頭ではそう思っていても、身体は素直に反応する。	PRINTFORMW 「这样色情的样子、不能给任何人发现」、虽然脑子里这么想着、但是身体却传来阵阵快感。
PRINTFORMW どんなに抑えようとしていても、口からは艶めいた声があふれてしまう……。	PRINTFORMW 嘴里色气的喘息渐渐压抑不住、变得大声起来……。
PRINTFORMW 「%CNAME("二人称")%っ、はぁっ……あぁっ、いい……そこいいよぉっ、そこ、好き……っ」	PRINTFORMW 「%CNAME("二人称")%啊、哈……啊、好……那里好、那里、喜欢……啊」
PRINTFORMW 「好き……%CNAME("二人称")%好きです……っ、あぁっ……%CNAME("二人称")%……」	PRINTFORMW 「好棒……%CNAME("二人称")%喜欢……啊、啊……%CNAME("二人称")%……」
PRINTFORMW 脳を蕩かす絶頂の予感に、いけない、と反射的に手が動く。しかし両手でぐっと口をふさぐものの、抑えきれない嬌声はどうしてもあふれ出てしまう。	PRINTFORMW 脑子被绝顶般的快感冲晕了。就算用手紧紧地捂住艳丽的小嘴、可声音还是堵不住漏了出来。
PRINTFORMW 全身に電流のように痺れが走るのを感じる。腰が大きく跳ねあがり、勢いよく潮を吹いてしまっているのが感覚的にわかった。	PRINTFORMW 全身仿佛电流在游走一般、腰部突然死死地顶起、仿佛瀑布一般潮吹了。
PRINTFORMW まるで釣り上げられた魚のように全身がびくびくと震えて止まらない。	PRINTFORMW 浑身仿佛在岸上的鱼一般抽搐着。
PRINTFORMW 「はぁ……はぁっ、はぁ……はぁ……」	PRINTFORMW 「哈……哈、哈……哈哈……」
PRINTFORMW さっきまでが嘘のように全身がぐったりしている。身体はまるで糸の切れた人形のようで、動かそうとするたびに今だるいと返事が返ってくる気がした。	PRINTFORMW 直到刚才为止全身都筋疲力尽。身体简直就像断了线的玩偶、每次想动都觉得浑身乏力。。
PRINTFORMW 「はぁぁ……またやっちゃった……」	PRINTFORMW 「啊……又做了……」
PRINTFORMW 重たい身体に鞭打って起き上がる。大きくはだけた胸元が目に入り、口からは自然とため息がこぼれ出た。	PRINTFORMW 撑着沉重的身体站起来、拉起漏出整个胸部半脱着的衣服、发出了叹息。
PRINTFORMW 「はぁ、もう……学校でこんなことしたらいけないのに……」	PRINTFORMW 「啊、我已经……学校里做这样的事的话不行啊……」
PRINTFORMW そう呟きながら、乱れた着衣を整える。	PRINTFORMW 一边嘟哝着、一边整理着凌乱的衣服。
PRINTFORMW （あ、でもよく考えたらいつも部室で似たようなことしてると言えなくも……）	PRINTFORMW （唉、但是仔细一想、也不能说我经常在教室做类似的事情……）
PRINTFORMW 「……いやいや、やっぱりダメですし」	PRINTFORMW 「……不、果然不行」
PRINTFORMW 「つい盛り上がっちゃったけど、大丈夫かな今の……」	PRINTFORMW 「不知不觉就忍不住想做、现在终于好了……」
PRINTFORMW 乱れた着衣を整える間、つい独り言が出てしまう。	PRINTFORMW 一边整理凌乱的衣服、一边自言自语着。
PRINTFORMW （うぅ……%CNAME("二人称")%に聞こえてないといいんですけど……）	PRINTFORMW （啊……不被%CNAME("二人称")%知道就好了……）
PRINTFORMW 「……いや、%CNAME("二人称")%以外もダメでしょ%CNAME("一人称")%」	PRINTFORMW 「……不对、除了%CNAME("二人称")%以外的人也不行的吧%CNAME("一人称")%」
PRINTFORMW \@ COND("昼") ? 隣の鞄から # 部屋のタンスから\@新しい下着を取り出す。今まで履いていたパンツはぐっしょりと濡れてしまっていて、とても履けるような状態ではなかった。	PRINTFORMW \@ COND("昼") ? 从旁边的包里 # 社团的柜子里\@拿出新的内衣、胖次都已经湿透了。
PRINTFORMW 「はぁ……でも%CNAME("二人称")%にしてもらってるって思うと、なんだかすごくすっきりするんですよね……」	PRINTFORMW 「哈……但是一想到被%CNAME("二人称")%做这样那样的事情就忍不住……」
PRINTFORMW 「最近はむしろ、%CNAME("二人称")%にされてる設定じゃないと全然収まらないっていうか……」	PRINTFORMW 「最近只要%CNAME("二人称")%没有对我做H的事情、身体完全没有办法平息……」
PRINTFORMW 「うぅ、悪化してるなぁ、%CNAME("一人称")%……」	PRINTFORMW 「呜、恶化了啊、%CNAME("一人称")%……」
PRINTFORMW 「……ってダメダメ、%CNAME("二人称")%のことばっかり考えてるとまたしたくなっちゃうっ」	PRINTFORMW 「……不行不行、想着%CNAME("二人称")%的事情又想做了」
PRINTFORMW 「今度……この身体のこと、フェリシエルさんに相談してみようかな……」	PRINTFORMW 「这次……要不要试着和弗理希艾尔聊一下关于这个身体的事呢……」
PRINTFORMW そしてもうひとつ。	PRINTFORMW 还有一件事。

//EVENT_K6_DAILY.ERB
CALL PRINT_STR, "「……来ちゃった_H_」_W_"	CALL PRINT_STR, "「……高潮来了_H_」_W_"
CALL PRINT_STR, "「ふふっ_H_　", CNAMET(ARG, "二人称"), "が悪いんだよ……？　", CNAMET(ARG, "一人称"), "をこんなになるまで放っておくから……_H_」_W_"	CALL PRINT_STR, "「呼呼_H_是", CNAMET(ARG, "二人称"), "不好呦……？　把", CNAMET(ARG, "一人称"), "放置到这种程度……_H_」_W_"
PRINTFORMW 「んくっ、んくっ――ぷはっ」	PRINTFORMW 「嗯咕、嗯咕――噗哈」
CALL PRINT_STR, "「おはようございます、", CNAMET(ARG, "二人称"), "。今朝もごちそうさまでした_H_」_W"	CALL PRINT_STR, "「早安、", CNAMET(ARG, "二人称"), "。今天早上也多谢款待我好吃的_H_」_W"
PRINTFORMW 「おはようございます、%CNAMET(ARG, "二人称")%」	PRINTFORMW 「早安、%CNAMET(ARG, "二人称")%」
CALL PRINT_STR, "「はぁぁ……_H_　朝からとっても元気がいいですね、", CNAMET(ARG, "二人称"), "……_H_」_W"	CALL PRINT_STR, "「嘿嘿……_H_　从早上开始就很有精神呢、", CNAMET(ARG, "二人称"), "……_H_」_W"
PRINTFORML 「ええと、今日は確か%CNAMET(ARG, "二人称")%、体育でしたよね……」	PRINTFORML 「嗯、我记得今天%CNAMET(ARG, "二人称")%应该是、要上体育课吧……」
PRINTFORMW 「替えの肌着とタオル、ここに置いておきますから忘れず持って行ってくださいね」	PRINTFORMW 「替换的内衣和毛巾放在这里、请不要忘记拿喲」
PRINTFORMW 「%CNAMET(ARG, "一人称")%は基本的に見学ですけど、一応体操服には着替えるので、男の子たちの視線が気になります……」	PRINTFORMW 「%CNAMET(ARG, "一人称")%基本上是在旁边看,不过、因为要换体操服、很在意男孩子的视线……」
PRINTFORMW 「おはよう%CNAMET(ARG, "二人称")%。今日はお休みなのにずいぶん早いですね」	PRINTFORMW 「早上好%CNAMET(ARG, "二人称")%。今天是休息日、但起得好早啊」
PRINTFORMW 「すぐに朝ご飯用意しますから、一緒に食べましょうね」	PRINTFORMW 「我马上准备早饭、一起吃吧」
PRINTFORMW 「%CNAMET(ARG, "二人称")%、おはようございます。朝ご飯できてますよ」	PRINTFORMW 「%CNAMET(ARG, "二人称")%、早上好。早饭做好了哦」
PRINTFORMW 「えへへ……♪　こういう普通の%NAMES("兄弟")%みたいなやりとり、実はあこがれてたんです」	PRINTFORMW 「哎嘿嘿……♪　像这样普通%NAMES("兄弟")%之间的对话、老实说很向往呢」
PRINTFORMW 「あれ、まだ誰も来てないのかな？」	PRINTFORMW 「咦、还没有人来吗？」
CALL PRINT_STR, "「二人だけの貸し切り……ですね_H_」_W"	CALL PRINT_STR, "「只有两个人的包场……对吧_H_」_W"
PRINTFORMW %CALLNAME:ARG%はぺろりと唇を舐め胸に手を伸ばすと、きっちりと着こなしていた制服の胸元を軽くはだけた……。	PRINTFORMW %CALLNAME:ARG%舔了一下嘴唇、把手伸向胸口、轻轻地脱下了穿戴整齐的制服……
PRINTFORMW 「まだ誰も来てないみたいです」	PRINTFORMW 「好像还没有人来呢」
PRINTFORMW 「二人きりのときくらい%CNAMET(ARG, "二人称")%に甘えても……いいですよね♪」	PRINTFORMW 「只有两个人的时候、%CNAMET(ARG, "二人称")%对你撒娇的样子……不错吧♪」
PRINTFORMW 堂々と張り出された標語を確認すると、%CALLNAME:ARG%は頬を染めつつ%CALLNAME:MASTER%の横で制服を脱いだ……。	PRINTFORMW 在确认了光明正大地贴出来的標語之后、%CALLNAME:ARG%脸上飞起红霞%CALLNAME:MASTER%在旁边脱下制服……
PRINTFORMW 「ただいま帰りました」	PRINTFORMW 「我回来了」
PRINTFORMW 「あ、%CNAMET(ARG, "二人称")%。先に帰ってたんですね」	PRINTFORMW 「啊、%CNAMET(ARG, "二人称")%。你先回来了啊」
PRINTFORMW 「%CNAMET(ARG, "二人称")%、今日も一日おつかれさま」	PRINTFORMW 「%CNAMET(ARG, "二人称")%、今天也辛苦了」
PRINTFORMW 「ああ、でも%CNAMET(ARG, "二人称")%の夜は、まだまだこれからなのかな……？」	PRINTFORMW 「啊、但是%CNAMET(ARG, "二人称")%的夜晚、从现在才刚刚开始吗……？」
CALL PRINT_STR, "「実はちょっと、お腹がすいてるんです。できれば", CNAMET(ARG, "一人称"), "のこと、お部屋に呼んでくれると嬉しいなぁって_H_」_W"	CALL PRINT_STR, "「其实稍微有点饿了。如果可以的话、", CNAMET(ARG, "一人称"), "能到房间里来、我会很开心的_H_」_W"
PRINTFORMW 「お夕飯の準備もう少しかかるから、お部屋で着替えてきてくださいね」	PRINTFORMW 「晚饭还要准备一段时间、请先在房间换衣服吧」
PRINTFORMW 部屋着にエプロン姿の%CALLNAME:ARG%は、そう言うとキッチンへ戻っていった……。	PRINTFORMW 穿着居家服装、围着围裙的%CALLNAME:ARG%这样说着、就回到厨房去了。
PRINTFORMW 「%CNAMET(ARG, "二人称")%はコーヒーがいいですか？　それとも紅茶？　緑茶や麦茶もありますよー」	PRINTFORMW 「%CNAMET(ARG, "二人称")%喝咖啡可以吗？还是红茶？也有绿茶和麦茶喲」
PRINTFORMW 「お茶請けはお煎餅とクッキーのどっちがいいかな……」	PRINTFORMW 「茶点的话煎饼和曲奇哪个好呢……」
PRINTFORMW 「%CNAMET(ARG, "二人称")%はコーヒーにお砂糖……いくつでしたっけ？　ミルクも使うのかな……」	PRINTFORMW 「%CNAMET(ARG, "二人称")%咖啡加糖……你几岁了？还喝牛奶的吗……」
PRINTFORMW %CALLNAME:ARG%は独り言をつぶやきながらコーヒーを入れている……。	PRINTFORMW %CALLNAME:ARG%一边嘟囔着一边泡咖啡。
PRINTFORMW 「%CNAMET(ARG, "二人称")%、%CNAMET(ARG, "対象")%と一緒だったんですね」	PRINTFORMW 「%CNAMET(ARG, "二人称")%、跟%CNAMET(ARG, "対象")%在一块啊」
PRINTFORMW 表面的には普段と変わりないように見えるが、わずかに棘を感じるのは気のせいだろうか……。	PRINTFORMW 表面上看起来和平时没什么变化、但感觉到微微的异样、难道是心理作用吗……
PRINTFORMW 「あ、%CNAMET(ARG, "二人称")%。お先にお邪魔してます」	PRINTFORMW 「啊、%CNAMET(ARG, "二人称")%、我先告辞了」
PRINTFORMW （いいなぁ……）	PRINTFORMW （真好啊……）
PRINTFORMW %CALLNAME:ARG%は口説かれている%CALLNAME:TARGET%をうらやましそうに眺めている。	PRINTFORMW %CALLNAME:ARG%羡慕地望着被说着情话的%CALLNAME:TARGET%。
PRINTFORMW 「%CNAMET(ARG, "二人称", "どもり")%…………な、なに、してるの？」	PRINTFORMW 「%CNAMET(ARG, "二人称", "どもり")%你……在、在干什么呀？」
PRINTFORMW 股を開いた%CALLNAME:TARGET%の前で跪く%CALLNAME:MASTER%の姿に、%CALLNAME:ARG%は目を白黒させている……。	PRINTFORMW 看着%CALLNAME:MASTER%跪在岔开大腿的%CALLNAME:TARGET%面前的姿态、%CALLNAME:ARG%惊得目瞪口呆……
PRINTFORMW （う、うわぁ……とんでもないところに出くわしちゃいましたよ）	PRINTFORMW （呜哇……碰到了意想不到的地方）
PRINTFORMW （けど、%CNAMET(ARG, "一人称")%もちょっとああいうことされてみたいかも……）	PRINTFORMW （但是、%CNAMET(ARG, "一人称")%心里还是有点期待她那样做的）
PRINTFORMW 下着をわずかに濡らしながら、%CALLNAME:ARG%は熱に浮かされたような目で%CALLNAME:MASTER%を陰から覗いている……。	PRINTFORMW 内衣慢慢湿透的同时、%CALLNAME:ARG%被热气笼罩的眼睛看着%CALLNAME:MASTER%……
PRINTFORMW %CALLNAME:TARGET%の股間を満足げに眺める%CALLNAME:MASTER%の姿に、%CALLNAME:ARG%は目を白黒させている……。	PRINTFORMW 向%CALLNAME:TARGET%的股间眺望的%CALLNAME:MASTER%的姿势、%CALLNAME:ARG%惊得目瞪口呆……
PRINTFORMW 「え、えぇ……なにしてるの%CNAMET(ARG, "二人称")%……」	PRINTFORMW 「哎、哎……你在干什么%CNAMET(ARG, "二人称")%……」
PRINTFORMW 「%CNAMET(ARG, "二人称")%って本当にえっちですよね」	PRINTFORMW 「%CNAMET(ARG, "二人称")%真的是很H呢」
PRINTFORMW 「あ、%CNAMET(ARG, "二人称")%もう来てたんですね。待っててくださいね、すぐお茶入れますから」	PRINTFORMW 「啊、%CNAMET(ARG, "二人称")%已经来了吧。请稍等、我马上泡茶」
PRINTFORMW 「おじゃましまーす……」	PRINTFORMW 「打扰您了……」
PRINTFORMW 「あれ？　%CNAMET(ARG, "二人称")%どこ行ったんだろう……帰っちゃったのかな？」	PRINTFORMW 「咦？　%CNAMET(ARG, "二人称")%去哪儿了呢……回去了吗？」
PRINTFORMW こっそりと抜け出した%CALLNAME:MASTER%に、%CALLNAME:ARG%は気がつかなかったようだ……。	PRINTFORMW 悄悄溜出去的%CALLNAME:MASTER%、似乎没有被%CALLNAME:ARG%注意到……
PRINTFORMW 「あ、%CNAMET(ARG, "二人称")%……と、%CNAMET(ARG, "対象")%」	PRINTFORMW 「啊！%CNAMET(ARG, "二人称")%……和、%CNAMET(ARG, "対象")%」
PRINTFORMW 「……むぅ～」	PRINTFORMW 「……唔~」
PRINTFORMW %CALLNAME:ARG%は誰が見てもわかるほどにふくれていたが、それ以上は何も言うことなく%CALLNAME:MASTER%を見送った。	PRINTFORMW %CALLNAME:ARG%挺着无论让人来评判都是毫无疑问的雄伟的胸部、目送着一句话都不说%CALLNAME:MASTER%。
PRINTFORMW 「えっと、その……。ご、ごゆっくり？」	PRINTFORMW 「那个……请慢慢看」
PRINTFORMW %CALLNAME:MASTER%たちを目ざとく見つけた%CALLNAME:ARG%は、顔を真っ赤にして%CALLNAME:MASTER%の前から去っていった。	PRINTFORMW %CALLNAME:MASTER%看着%CALLNAME:ARG%、脸通红地从%CALLNAME:MASTER%面前跑掉了。
PRINTFORMW %CALLNAME:TARGET%の最近の弁当は、妙に苦かったり渋かったりする味付けが多い……。	PRINTFORMW %CALLNAME:TARGET%最近做的便当、有种怪异的苦涩味道……
PRINTFORMW 「え？　最近お弁当の味が変わった……ですか？」	PRINTFORMW 「诶？　最近便当的味道变了……是吗？」
PRINTFORMW 「今日のは美味しくできたかなって思ってたんですけど……苦手なものとかあったら教えてくださいね」	PRINTFORMW 「本来以为今天做的很好吃……有不喜欢的东西的话请告诉我哦」
PRINTFORMW 「そうですね、言われてみれば生野菜が多いかも……」	PRINTFORMW 「是啊、说起来生蔬菜可能很多……」
PRINTFORMW 「ええ、ちょっと最近凝ってて。もともとは青臭い野菜ってあんまり得意じゃなかったんですけど」	PRINTFORMW 「嗯、最近有点凝固。本来我不太擅长吃蔬菜」
CALL PRINT_STR, "「最近あんまり気にならなくなって……。んっ、美味しい_H_」_W_"	CALL PRINT_STR, "「我也不太在意……嗯、很好吃_H_」_W_"
PRINTFORMW 今日のおかずは大学芋、だし巻き卵、そして照り焼きチキン。どれも甘めの味付けになっている。	PRINTFORMW 今天的菜是糖汁浇油炸红薯、鸡蛋卷、还有照烧鸡肉。每一种都带有甜味。
PRINTFORMW 「%CNAME("二人称")%は甘いお料理って大丈夫な人ですか？　苦手な人もいるそうなので一応……どうでしょう」	PRINTFORMW 「%CNAME("二人称")%喜欢甜食吗？因为也有人不太喜欢、所以姑且问一下……怎么样？」
PRINTFORMW 「ところでちょっと小耳に挟んだんですけど、精液の味って食べたもので変わるそうですね」	PRINTFORMW 「话说回来、偶然听到过、听说精液的味道和吃的东西有关联」
PRINTFORMW さらっと会話に混ざった爆弾発言に、%CALLNAME:MASTER%は食べかけのお弁当を吹き出しかけた……。	PRINTFORMW 在谈话中混杂的炸弹发言让%CALLNAME:MASTER%把吃了一半的便当喷了出来……
CALL PRINT_STR, "「んっ……_H_」_W"	CALL PRINT_STR, "「嗯……_H_」_W"
PRINTFORMW まるのままのソーセージを大きく口を開けて頬張ると、%CALLNAME:ARG%は鼻にかかった艶っぽい声をあげた。	PRINTFORMW 张开嘴大口含着整根香肠的%CALLNAME:ARG%、从鼻腔里发出了色气的声音。
CALL PRINT_STR, @"「ふふっ……_H_　美味しいですね、%CNAMET(ARG, "二人称")%_H_」_W"	CALL PRINT_STR, @"「呵呵……_ H_真好吃啊、%CNAMET(ARG, "二人称")%_H_」_W"
PRINTFORMW ぱりっ、と乾いた音を立てながら、指よりも太いモノが噛みきられる。	PRINTFORMW 与此同时、干脆地一口咬断了香肠……
PRINTFORMW いろんな意味でそういうことはやめてほしい――と思いながら、%CALLNAME:MASTER%と%CALLNAME:ARG%の昼休みは過ぎていった……。	PRINTFORMW 希望在各种意义上不要做那种事——这样想的同时、%CALLNAME:MASTER%和%CALLNAME:ARG%的午休时间过去了。
PRINTFORMW 今日の%CALLNAME:ARG%のお弁当は、よく見るとひとつひとつの具材が妙に大きい。疑問に思った%CALLNAME:MASTER%が尋ねてみると、	PRINTFORMW 今日%CALLNAME:ARG%的便当、仔细一看、每种食材都特别大。有些好奇的%CALLNAME:MASTER%问着原因。
CALL PRINT_STR, @"「なんだか%CNAMET(ARG, "一人称", "かな")%最近、これくらいの大きさのほうが美味しく感じられるようになったみたいで……_H_」_W"	CALL PRINT_STR, @"「总感觉%CNAMET(ARG, "一人称", "かな")%最近好像做成这样大小会觉得更好吃……_H_」_W"
PRINTFORMW 「あっ、でもあんまり見ないでくださいね。口いっぱいに頬張ってる顔なんて、みっともないですし」	PRINTFORMW 「啊……但是不要盯着我看啊、张大嘴的样子好难看的」
PRINTFORMW %CALLNAME:MASTER%は少し苦労しながら、%CALLNAME:ARG%のお弁当を平らげた……。	PRINTFORMW %CALLNAME:MASTER%有些尴尬的同时、%CALLNAME:ARG%的便当吃完了。
PRINTFORMW 「今日はデザートにバナナを持ってきたんです。%CNAMET(ARG, "二人称")%も食べますか？」	PRINTFORMW 「今日的甜点是香蕉哦、%CNAMET(ARG, "二人称")%要吃吗？」
PRINTFORMW 「れろ……んっ、ちゅっ……んくっ、んっ……」	PRINTFORMW 「咧啰（张嘴）……嗯、啾……嗯库、嗯……」
CALL PRINT_STR, "「ふぅ……美味しいです_H_」_W"	CALL PRINT_STR, "「呼……真好吃。_H_」_W"
PRINTFORMW 食事をしているとは思えない水音を聞きながら、%CALLNAME:MASTER%はバナナをかじった。	PRINTFORMW 发出不像是在吃东西的水声的同时、%CALLNAME:MASTER%把香蕉吃掉了。
PRINTFORMW 「はい、あーんして%CNAMET(ARG, "二人称")%」	PRINTFORMW 「来、“啊”~%CNAMET(ARG, "二人称")%」
CALL PRINT_STR, @"「憧れてたんです、こういうの。仲の良い%NAMES("兄弟")%ならこれくらい普通ですよね_H_」_W"	CALL PRINT_STR, @"「很憧憬这样的关系。感情特别好的%NAMES("兄弟")%话这种程度是很普通喲_H_」_W"
PRINTFORMW 「大勢でご飯を食べるのって楽しいですよね」	PRINTFORMW 「很多人一起吃饭很开心吧」
PRINTFORMW 「%CNAMET(ARG, "一人称")%はだいたい個室で一人だったので……」	PRINTFORMW 「%CNAMET(ARG, "一人称")%一般都是一个人在房间里……」
PRINTFORMW 「あっ、%CNAMET(ARG, "二人称")%それは%CNAMET(ARG, "一人称")%が処分するのだから食べちゃダメですっ」	PRINTFORMW 「啊、%CNAMET(ARG, "二人称")%、这个的话因为要由%CNAMET(ARG, "一人称")%来处分掉所以你不能吃」
PRINTFORMW じゃりじゃりと苦い食感に舌を刺されるものの、曇りかけていた空気は吹き飛んだようだった。	PRINTFORMW 虽然口里充满苦涩的味道、但阴霾的空气好像被吹跑了。
PRINTFORMW 「えへへ♪　今日はどれも失敗せずにできたんです」	PRINTFORMW 「诶嘿嘿♪　今天什么都没有失败就完成了」
PRINTFORMW 「このハンバーグとかどうですか？　あとは唐揚げとか、タコさんウインナーもありますよ」	PRINTFORMW 「这个汉堡肉怎么样？还有炸鸡肉和维也纳章鱼香肠哦」
PRINTFORMW どれも美味しいが、弁当箱の中身が子供向けに偏っているように見えるのは気のせいだろうか……。	PRINTFORMW 无论哪个都很好吃、但看起来便当盒的内容偏向于儿童、可能是心理作用吧……
;実際の子供時代に食べたことがなかったので	;实际上是因为孩提时代没吃过
PRINTFORML 「えっと、えっと……その……」	PRINTFORML 「嗯、嗯……那个……」
PRINTFORML 「ふ、ふつつかものですがっ！　よろしくお願いしましゅ！」	PRINTFORML 「虽、虽然不太清楚！请多关照！」
PRINTFORML 肝心なところで噛んだ%CALLNAME:TARGET%が、涙目になりながら\@ COND("夜") ? %CALLNAME:MASTER% # 部室 \@のベッドの上でガチガチに固まっている……。	PRINTFORML 咬住了关键地方的%CALLNAME:TARGET%、一边流着眼泪一边在\@ COND("夜") ? %CALLNAME:MASTER% # 部室 \@的床上非常僵硬地僵住了……。
PRINTFORML 「今日は体育だったので汗かいちゃいました……」	PRINTFORML 「因为今天运动了一下所以出汗了……」
PRINTFORML 「……ちょっとそこの%CNAME("二人称")%、言われたそばから%TEXTS("匂い")%を嗅がないのっ」	PRINTFORML 「……那边的%CNAME("二人称")%、不要因为说到了这个话题就过来闻%TEXTS("气味")%啊」
PRINTFORML 「……ふわ、ぁ……ぁふ……」	PRINTFORML 「……呃、啊……哈……」
PRINTFORML 「んん……寝ちゃいました……いま何時……？」	PRINTFORML 「嗯……睡着了……现在几点……？」
PRINTFORML 「あの、%CNAME("一人称")%にとって%CNAME("二人称")%は\@ TALENT:MASTER:オトコ ? 男の子 # 女の子\@になっても%CNAME("二人称")%だというか……」	PRINTFORML 「那个、对%CNAME("一人称")%来说就算%CNAME("二人称")%变成\@ TALENT:MASTER:オトコ ? 男孩子 # 女孩子 \@也还是%CNAME("二人称")%不是吗……」
PRINTFORML 「でも……%CNAME("二人称")%が呼んでほしいなら……いいですよ」	PRINTFORML 「但是……如果%CNAME("二人称")%想被这么称呼的话……可以喲」
PRINTFORML 「お……お\@ TALENT:MASTER:オトコ ? 兄 # 姉\@ちゃんっ」	PRINTFORML 「欧……欧\@ TALENT:MASTER:オトコ ? 尼 # 内 \@酱」
PRINTFORML 「……ふーん」	PRINTFORML 「……哼——嗯」
PRINTFORML 「%CNAME("二人称")%は%CNAME("一人称")%に%CNAME("二人称")%って呼ばれてるだけじゃ満足できないんですね」	PRINTFORML 「%CNAME("二人称")%光是被%CNAME("一人称")%称呼为%CNAME("二人称")%、还不够满足呢」
PRINTFORML 「いっぱい呼んでもらえるといいですね？　お・\@ TALENT:MASTER:オトコ ? に・い # ね・え\@・ちゃん？」	PRINTFORML 「叫到你满足为止就好了吧？　欧・\@ TALENT:MASTER:オトコ ? 尼 # 内 \@・酱？」
PRINTFORML 「ん、なにか聞きたいことがあるんですか%CNAME("二人称")%。……好きなものは何か、ですか？」	PRINTFORML 「嗯、有什么想问的吗？%CNAME("二人称")%……喜欢的东西是什么？」
PRINTFORML 「うぅ、それはその、えーっと……」	PRINTFORML 「呜、那就是那个、那个……」
PRINTFORML 「%CNAME("二人称", "どもり")%ですけど……」	PRINTFORML 「%CNAME("二人称", "どもり")%啦……」
PRINTFORML 「――え、聞いてる意味が違う？　人じゃなくて、もの？」	PRINTFORML 「——诶、没听清问题吗？不是说人、而是喜欢的东西？」
PRINTFORML 「わ、忘れてください……」	PRINTFORML 「哇、请忘掉刚才我说的……」
PRINTFORML 「……どうして%CNAME("二人称")%を好きになったかですか？」	PRINTFORML 「……为什么喜欢上%CNAME("二人称")%？」
PRINTFORML 「うぅ、忘れてって言ったのに……」	PRINTFORML 「呜、明明说过请忘了的……」
PRINTFORML 「とりあえず、小さかったころに%CNAME("二人称")%とお話したのがきっかけだと言っておきます……」	PRINTFORML 「总而言之、是小时候和%CNAME("二人称")%一起说过的话相关的事情啦…………」
PRINTFORML ふと視線を感じて周囲を探ると、%CALLNAME:TARGET%がこちらを見ながらにこにこと微笑んでいた……。	PRINTFORML 忽然察觉到目光、发现是%CALLNAME:TARGET%笑嘻嘻地看着这边……。
PRINTFORML 「……あ、ごめんなさい%CNAME("二人称")%。気になりますか？」	PRINTFORML 「……啊、对不起%CNAME("二人称")%。会介意吗？」
PRINTFORML %CALLNAME:TARGET%はソファに腰掛けて本を読んでいる。	PRINTFORML %CALLNAME:TARGET%坐在沙发上看书。
PRINTFORML ぱっと見た感じ、それはどうやら%TEXTR("文庫本/新書/雑誌/漫画本/参考書")%のようだ……。	PRINTFORML 发现看的是%TEXTR("文库本/新书/杂志/漫画/参考书")%的样子……
PRINTFORML %CALLNAME:TARGET%はヘッドホンを付けて携帯ゲーム機で遊んでいるようだ。	PRINTFORML %CALLNAME:TARGET%戴着头戴式耳机、好像在玩手机游戏。
PRINTFORML いつもの%CALLNAME:TARGET%とは思えない俊敏さで指が高速移動している……。	PRINTFORML 与平时的%CALLNAME:TARGET%意想不到的敏捷手指在高速移动着……。
PRINTFORML %CALLNAME:MASTER%がふらふらと視線をさまよわせていると、ぼーっと宙を眺めている%CALLNAME:TARGET%と目があった。	PRINTFORML %CALLNAME:MASTER%的视线随便飘来飘去的时候、正好对上了正看着天空不知道在想些什么的%CALLNAME:TARGET%。
PRINTFORML 視線に気がついた%CALLNAME:TARGET%は笑顔でこちらに手を振っている……。	PRINTFORML 感觉到视线的%CALLNAME:TARGET%笑着朝这边招手。
PRINTFORML 窓際に腰掛けた%CALLNAME:TARGET%は、外を眺めながら満足そうに微笑んでいる。	PRINTFORML 坐在窗边%CALLNAME:TARGET%一边眺望着外面、一边满足地微笑着。
PRINTFORML %CALLNAME:TARGET%はソファに座って本を読んでいるようだ。	PRINTFORML %CALLNAME:TARGET%好像正坐在沙发上看书。
PRINTFORM 表紙には『	PRINTFORM 封面上写着『
PRINTFORML %TEXTR("はじめてのおかあさん/キラキラしすぎない　ほどよい子供の名付け方/母乳で育てる　はじめての授乳マッサージ/発達心理学の世界/子どもの健やかな発達/３歳までの子育て科学/はじめてママの美容入門　妊娠線ケアから産後まで")%』と書いてある。	PRINTFORML %TEXTR("初次的妈妈/不要过于夸张了　小孩起名的基本法/母乳哺育第一次的哺乳按摩/心理学的世界/孩子健康成长/三岁前小孩的教育/妈妈的美容入门　从妊娠线护理到产后")%』这个标题。
PRINTFORML ページをめくる%CALLNAME:TARGET%の表情は真剣そのものだ……。	PRINTFORML 翻着书页的%CALLNAME:TARGET%表情非常严肃认真……
PRINTFORML %TEXTR("マンタの夏/ガラス玉のお姫様/フォルナム戦記/トルク歩き/幻視砲塔/南の島のエイリアン/竜虎伝")%』と書いてある。	PRINTFORML %TEXTR("蝠鲼的夏天/纤弱的公主殿下/弗鲁南戦記/トルク歩き/幻視砲塔/南島的異乡人/龍虎傳")%』这个标题。
PRINTFORML %CALLNAME:TARGET%は楽しげな笑みを浮かべながら、文庫本のページをめくっている……。	PRINTFORML %CALLNAME:TARGET%一边脸上挂起了开心的表情、一边翻着文库本……
PRINTFORML %TEXTR("金の海、銀の狼/うちの妹があまりにも可愛すぎる/砂糖とスパイスと素敵な爆弾/勇者さまは時給千円！/幸福の王子は笑わない/エルフのご主人様/追憶の空")%』と書いてある。	PRINTFORML %TEXTR("金之海与银之狼/我家的妹妹可爱过头了/砂糖与香料与超级炸弹/勇者大人时薪1千円！/幸福王子不会笑/精灵的主人/追忆之空")%』这个标题。
PRINTFORML %TEXTR("おかしな世界の取り替え子/嘘つきたちの壊れた世界/私の彼氏/図書館司書と機関銃/メイガス・フィールド/白陽天動乱/断章ナイトメア")%』と書いてある。	PRINTFORML %TEXTR("奇怪世界的交换者/骗子们的破碎世界/我的男友/图书馆司书与机关枪/梅加斯・菲尔德/白陽天動乱/零碎梦魇")%』这个标题。
PRINTFORML %TEXTR("猿でもわかる人間関係入門/明日からぐっと可愛くなる大人のメイク/カレの胃袋をがっちりつかむ　デキる女の家庭料理/男の子はココを見ている　女子力アップ大作戦/恋愛上手になるための七つの秘密/引っ込み思案なあなたのための服選び/召しませ乙女の愛情手料理")%』と書いてある。	PRINTFORML %TEXTR("猴子也能看懂的人际关系入门/从明天开始瞬间变成可爱大人的秘诀/抓住他的胃　能干女性的家庭料理/请注意男孩子的这里　女子力UP大作战/变得擅长恋愛的七大秘密/为了心仪的他的服装选择/招待少女的爱情手工料理")%』这个标题。
PRINTFORML %TEXTR("古典/数学/英語/物理/化学/世界史/日本史")%』と書いてある。教科書のようだ。	PRINTFORML %TEXTR("古典/数学/英語/物理/化学/世界史/日本史")%』这样的标题。好像是教科書的样子。
PRINTFORML 本腰を入れて勉強しているというよりは、ぱらぱらと流し見ている様子だ……。	PRINTFORML 与其说是认真学习、倒不如说是当小说一般看着。
PRINTFORML 「すや……すや……」	PRINTFORML 「嘶唿zzz……嘶唿zzZ……」
PRINTFORML 「ん……それは……だめですよぉ……」	PRINTFORML 「嗯……那里……不可以哦……」
PRINTFORML 「%CNAME("二人称", "かな")%……そっちは、崖だよ……zzz」	PRINTFORML 「%CNAME("二人称", "かな")%……那边是、悬崖喲……zzz」
PRINTFORML 「しょうがないなぁ……%CNAME("二人称", "かな")%は……ふふ……」	PRINTFORML 「真是没办法呢……%CNAME("二人称", "かな")%……呼呼……」
PRINTFORML 「%CNAME("二人称", "かな")%は……ほんとに……えっちですねぇ……」	PRINTFORML 「%CNAME("二人称", "かな")%……真的是……好色呃……」
PRINTFORML 「あたり……もう一発……」	PRINTFORML 「大致……再来一发……」
PRINTFORML 「6月24日は……全国的に……UFOの日……」	PRINTFORML 「6月24日是……全国性的……UFO日……」
PRINTFORML 「犯人は……メイドの……ゲートベル……」	PRINTFORML 「犯人是……女仆的……门铃……」
PRINTFORML 「おっくれて……るぅ……」	PRINTFORML 「迟到了……呜……」
PRINTFORML 「あと……1ターンだけ……」	PRINTFORML 「再……就一回合……」
PRINTFORML 「あ、入れてくれるんですか？　ありがとう%CNAME("二人称")%」	PRINTFORML 「可以让我也进来吗？谢谢%CNAME("二人称")%」
PRINTFORMW （実は折りたたみ傘持ってきてるけど……ふふ、このまま黙っておこっと）	PRINTFORMW （其实我有带折叠伞……心里默默地想着）
PRINTFORML 「今日は折りたたみ傘忘れてきちゃいました。ドジですね、私ったら」	PRINTFORML 「我今天忘了带折叠伞。真糟糕呢」
PRINTFORMW 「……？　入れてくれるんですか？　やったっ」	PRINTFORMW 「……？　可以进来吗？　太好了。」
PRINTFORML 「お料理の本はいっぱい読みましたから、レパートリーは豊富ですよ」	PRINTFORML 「因为看超级多的菜谱、所以我会做的菜非常多哦」
PRINTFORMW 「……実際に作ってみる経験はまだまだこれからですけど」	PRINTFORMW 「……虽然实际烹饪经验一次都没有……」
PRINTFORML 「お菓子はレシピ通りに作るのが大事なので、普通の料理とは違った難しさがあるんですよね……」	PRINTFORML 「点心的制作在料理里面跟其他菜不太一样、非常有难度……」
PRINTFORMW 「今度は何にしようかな。%CNAME("二人称")%はリクエストとかあります？」	PRINTFORMW 「这次买什么好呢。%CNAME("二人称")%有什么特别想吃的吗？」
PRINTFORMW 「%CNAME("二人称")%って好きなものなら毎日続いても大丈夫なタイプですか？　それとも飽きます？」	PRINTFORMW 「%CNAME("二人称")%是喜欢的东西每天都吃也没关系的类型？还是会觉得腻呢？」
PRINTFORMW 「%CNAME("一人称")%ですか？　%CNAME("一人称")%は……ふふ、どっちでしょうね」	PRINTFORMW 「%CNAME("一人称")%吗？　%CNAME("一人称")%是哪一种呢？」
PRINTFORML 「以前買ったブラですけど、やっぱりきついから新しいのが欲しくて……」	PRINTFORML 「以前买的胸罩、果然太紧了、想要新的……」
PRINTFORMW 「……だめですか？」	PRINTFORMW 「……不行吗？？」
PRINTFORML 「最近ブラがきつくなってきたから新しいのに替えたいんですよ」	PRINTFORML 「最近胸罩紧了所以想换新的喲」
PRINTFORMW 「%CNAME("二人称")%が好きなの、選んでもらえませんか……？」	PRINTFORMW 「哥哥喜欢哪一种、可以帮我选一下吗……？」
「あの……これ大きすぎてぶかぶかなんですけど……え、なんですか、見えてるって？」	「这个……这个太大了啦……嗯？怎么了？看见了？」
「こ、こんなのつけて歩いたら痴女じゃないですかっ、だめっ、だーめーでーすっ！」	「这、这样穿着走在街上不是跟痴女一样！不行、绝ー对ー不ー行！」
「な、なんですかこの小さいのはっ！　見えたらいけないとこまで見えちゃいますよこれ」	「什、什么！怎么选这么小的、会被看到不可以看到的地方」
「……え、ただの普通のビキニじゃないかって？　いや、そんなこと言われても……」	「……这、这不就是小号比基尼吗？不、就算你这么说……」
「しょうがないじゃないですか、普通の人よりだいぶ大きいんですから……これじゃ乳首しか隠れませんよ」	「没办法不是吗、比普通人大太多了……这样只能遮住乳头……」
「あの、%CNAME("二人称")%……考え直しませんか？」	「那个、%CNAME("二人称")%……不再重新考虑一下吗？」
CALL PRINT_SELECT, "ベッドに押し倒す！/おやすみ"	CALL PRINT_SELECT, "推倒在床上！/晚安"
PRINTFORMW 「冬はやっぱり、のんびりこたつでみかんですねぇ……」	PRINTFORMW 「冬天果然就该在被炉里悠闲地吃橘子啊……」
PRINTFORMW 「はい、剥けましたよ%CNAME("二人称")%」	PRINTFORMW 「是、剥橘子喲%CNAME("二人称")%」
PRINTFORMW 「うぅぅ、こたつから出たくないです」	PRINTFORMW 「嗯、不想从被炉里出来」
PRINTFORMW 「ふわぁ……眠くなってきましたけど、ここで寝ちゃったら風邪引いちゃいますよね……」	PRINTFORMW 「呵呵……变得困了,不过、在这里睡着了感冒喲……」
PRINTFORMW 「……%CNAME("二人称")%に部屋まで送ってもらいたいなぁ、なんて」	PRINTFORMW 「……%CNAME("二人称")%可以送我到房间里去吗。」
PRINTFORMW 「……あれ、%CNAME("二人称")%起きてます？　寝ちゃいました？」	PRINTFORMW 「……哎呀、%CNAME("二人称")%睡着了？」
PRINTFORMW 「これはもしかして添い寝チャンスでは……？　でもこんなところで寝たら二人とも風邪引くかも……」	PRINTFORMW 「这也许是在旁边一起睡的机会……？但是在这种地方睡的话、两个人可能都会感冒……」
PRINTFORMW 「うぅ、%CNAME("一人称", "かな")%は一体どうすれば……」	PRINTFORMW 「呜、%CNAME("一人称", "かな")%怎么办呢……」
PRINTFORMW 「エアコン動いてるのに、なんでこんなに蒸し暑いんでしょう……？」	PRINTFORMW 「空调开着、怎么还这么闷热啊……？」
PRINTFORMW 「うぅ、ちょっと冷蔵庫からアイス取ってきます……%CNAME("二人称")%はどれにします？」	PRINTFORMW 「嗯、我去冰箱里拿冰淇淋……%CNAME("二人称")%要哪个？」
PRINTFORMW 「……最近の地球は人間に何か恨みでもあるんでしょうか」	PRINTFORMW 「……最近地球是对人类有什么怨恨吗？」
PRINTFORMW 「この暑さは殺意を感じます……うぅぅ、あーつーいー、とけるぅ……」	PRINTFORMW 「这种炎热让人感到杀意……呜呜、呜呜、要熔化了……」
PRINTFORMW 「夏場は動いてなくてもちゃんと水分とってくださいね」	PRINTFORMW 「夏季就算不活动也请好好补充水分」
PRINTFORMW 「汗で塩分も出ていっちゃうのでそっちも忘れずに補給しましょう」	PRINTFORMW 「因为出汗盐分也出来了、也不要忘记补给哦」
PRINTFORMW 「……ということでよく冷えた麦茶と塩飴持ってきましたよ。はい、どうぞ」	PRINTFORMW 「……所以我带了冰镇的麦茶和咸糖。请」
PRINTFORMW 「……ふふ」	PRINTFORMW 「……呼呼」
PRINTFORMW 「あ、ごめんなさい急に笑ったりして」	PRINTFORMW 「啊、不好意思、突然笑出来了」
PRINTFORMW 「%CNAME("二人称")%とこうやってのんびり過ごせる時間が、ずーっと続けばいいなぁって思ってたんです」	PRINTFORMW 「和%CNAME("二人称")%这样悠闲度过的时间、能一直持续下去就好了」
PRINTFORMW 「この時期は過ごしやすくていいですねぇ……」	PRINTFORMW 「这段时间可真舒服呀……」
PRINTFORMW 「ちょっと油断すると\@TEXTS("季節") == "春" ? 寝坊しちゃったり # 食べすぎちゃったり \@するのは注意しないとですけど」	PRINTFORMW 「稍微大意一点的话\@TEXTS("季節") == "春" ? 就会睡过头 # 就会吃得太多 \@的、所以不多注意可不行」
PRINTFORMW 「もうすっかり暖かくなってきましたね」	PRINTFORMW 「已经完全暖和起来了呢」
PRINTFORMW 「せっかくですし、今度の休みはお花見にでも行きませんか？」	PRINTFORMW 「难得来一次、这次假期一起去赏花吧？」
PRINTFORMW 「夏も終わってようやく涼しくなってきましたね……」	PRINTFORMW 「夏天也结束了、总算凉快起来了」
PRINTFORMW 「ちょっと前に%TEXTR("ぶどう/りんご/みかん/梨/柿")%が安かったから買ってきたんですけど、一緒に食べません？」	PRINTFORMW 「之前因为%TEXTR("葡萄/苹果/橘子/梨/柿")%很便宜所以买了不少、要一起吃吗？」
PRINTFORMW 「……え、%CNAME("二人称")%これからまた寝るんですか？」	PRINTFORMW 「……嗯、哥哥、现在要睡吗？」
PRINTFORMW 「ふわぁぁ、わたしもちょっと眠くて……一緒にお昼寝します？」	PRINTFORMW 「哇、我也有点困了……一起睡午觉可以吗？」
PRINTFORMW 「お疲れですねぇ……夜更かしはあんまりしすぎないほうがいいですよ」	PRINTFORMW 「累了啊……熬夜还是不要熬太久比较好哦」
PRINTFORMW 「%CNAME("二人称")%ったら、お休みだからって昼間からだらけてますね……」	PRINTFORMW 「%CNAME("二人称")%真是的、因为是休息日所以白天就懒洋洋的」
PRINTFORMW 「ん……あふっ、%CNAME("一人称")%も一緒にお昼寝しようかなぁ……」	PRINTFORMW 「嗯……啊哈……%CNAME("一人称")%一起睡午觉吧……」
PRINTFORMW 「昼間からこうやってのんびりできるのは日曜ならではですよねぇ……」	PRINTFORMW 「在白天就能这样悠闲自在、只有周日才有机会吧……」
PRINTFORMW 「はふ……せっかくですしお茶とお菓子持ってきましょうか……」	PRINTFORMW 「哈哈……特意拿了茶和点心带过来哦」
PRINTFORMW 「あら、お疲れですね%CNAME("二人称")%……」	PRINTFORMW 「啊、好累哦%CNAME("二人称")%……」
PRINTFORMW 「……昨日の夜はその、なんというか……遅くまでしちゃいましたからね」	PRINTFORMW 「……昨天晚上、怎么说呢……因为到很晚了」
PRINTFORMW 「あら%CNAME("二人称")%、お疲れですか？」	PRINTFORMW 「あら%CNAME("二人称")%、觉得累吗？」
PRINTFORMW 「%CNAME("二人称")%のことですからどうせ昨日夜更かしでもしたんで……あ」	PRINTFORMW 「%CNAME("二人称")%昨天晚上做到那么晚……啊！」
PRINTFORMW 何かに気づいた様子のさくらは、言いかけたまま顔を赤くしてうつむいてしまった……。	PRINTFORMW 樱说了一半就红着脸低头了。
PRINTFORMW 「暑いからってあんまりクーラーの風に当たってばかりいるとよくないです」	PRINTFORMW 「虽说很热、但是光吹冷气也不好。」
PRINTFORMW 「ほら%CNAME("二人称")%、こっちにきたら扇風機で涼しくしてあげますよ？　ぱたぱたぱた」	PRINTFORMW 「%CNAME("二人称")%、到这里用电风扇给你凉快一点吧？啪嗒啪嗒」
PRINTFORMW 扇風機と言っているが、単にさくらが扇子であおいでいるだけである……。	PRINTFORMW 虽说是“电风扇”、但樱只是用扇子扇着……
PRINTFORMW 「はぁ、今年の冬も冷えますねぇ」	PRINTFORMW 「啊、今年的冬天也很冷呢」
PRINTFORMW 「%CNAME("二人称")%とぴったりくっついてたら……あ、暖かいですね」	PRINTFORMW 「和%CNAME("二人称")%紧贴在一起……好暖和啊」
PRINTFORMW 「これはいいですね、落ち着きます」	PRINTFORMW 「这样不错呢、很安心」
PRINTFORMW 「%CNAME("二人称", "ー")%、そんなところで寝てると風邪引きますよー。%CNAME("二人称", "ー")%？」	PRINTFORMW 「%CNAME("二人称", "ー")%、在那种地方睡觉会感冒的哦。%CNAME("二人称", "ー")%？」
PRINTFORMW 「しょうがないなぁ、何か掛けるもの持ってきましょうか……」	PRINTFORMW 「真没办法、我给你拿点盖的东西吧」
PRINTFORMW 「いつもおつかれさまです%CNAME("二人称")%」	PRINTFORMW 「一直以来辛苦了你了%CNAME("二人称")%」
PRINTFORMW 「……その、よかったらですね、膝とか貸しましょうか……？」	PRINTFORMW 「……那个、如果可以的话、我把膝盖借给你吧……？」
PRINTFORMW 「……え、あの、%CNAME("二人称")%？　ここまで来てやることは寝るだけなんですか？」	PRINTFORMW 「……嗯、那个、%CNAME("二人称")%？来这里只是睡觉吗？」
PRINTFORMW 「えぇー……このやり場のない気持ちはどうすればいいんですか……」	PRINTFORMW 「哎……这种无处可去的心情该怎么办呢……」
PRINTFORMW 「あっ%CNAME("二人称")%……えっ、ええっ？」	PRINTFORMW 「啊%CNAME("二人称")%……咦、咦？」
PRINTFORMW 「あのぅ……うちの挨拶はいつの間に欧米式になったんですか？」	PRINTFORMW 「那个……我们的打招呼是什麽时候变成了欧美式？」
PRINTFORMW 「まぁその、嫌いでは、ないですけど。……%GREETING%、%CNAME("二人称")%」	PRINTFORMW 「嘛、那个、虽然不讨厌。……%GREETING%、%CNAME("二人称")%」
PRINTFORMW 「あら、%CNAME("二人称")%も汗だくですね」	PRINTFORMW 「哎呀、%CNAME("二人称")%流了好多汗呢」
PRINTFORMW 「%CNAME("一人称")%、今まではこんなになるまで運動した経験ってなくて……」	PRINTFORMW 「%CNAME("一人称")%、到现在为止没有做过这样的运动……」
PRINTFORMW 「……えへへ。おそろいですね」	PRINTFORMW 「……嘿嘿、都运动到了呢」
PRINTFORMW %CALLNAME:TARGET%は常人から少しズレたポイントで喜んでいる。	PRINTFORMW %CALLNAME:TARGET%在有些偏离常人的点上感到高兴。
PRINTFORMW 「もぅ……汗びっしょりで抱きつくから濡れちゃったじゃないですか」	PRINTFORMW 「已经……被汗水湿透了、抱这么紧、不就把你也弄湿了吗？」
CALL PRINT_STR, "「はぁ、午後の授業、集中できるかな……_H_」_W_"	CALL PRINT_STR, "「啊、下午的课还能集中精神吗……_H_」_W_"
CALL PRINT_STR, "「けどこれはこれで、安眠できそうかも……_H_」_W_"	CALL PRINT_STR, "「不过也许可以睡得更好呢……_H_」_W_"
PRINTFORMW あなたに聞こえない程度の声で、%CALLNAME:TARGET%は小さくつぶやいている。	PRINTFORMW 以主人公听不见的程度的声音、%CALLNAME:TARGET%小声嘟哝着。
PRINTFORMW 「きゃっ！？　やっ、なんか濡れて――」	PRINTFORMW 「哎呀！？哎呀、好像被弄湿了——」
PRINTFORMW 「うぅぅー、わかっててやりましたね……」	PRINTFORMW 「明明知道会这样的吧……」
PRINTFORMW 「もうっ、しょうがないですね%CNAME("二人称")%は」	PRINTFORMW 「哎呀、真是没办法啊%CNAME("二人称")%」
PRINTFORMW 「えへへ、%GREETING%」	PRINTFORMW 「嘿嘿、%GREETING%」
PRINTFORMW 「%CNAME("二人称")%にぎゅーってしてもらうの、好きですよ」	PRINTFORMW 「%CNAME("二人称")%喜欢被人紧紧地抱着喲」
PRINTFORMW 「ふふ……こっちからもおかえしです」	PRINTFORMW 「哼哼……这是回礼呦。」
CALL PRINT_STR, @"%CALLNAME:TARGET%にぎゅっと抱き返され、\@ TALENT:巨乳 ? たわわに実った # 押しつけられた \@胸のむにゅりとした感触を味わった。_W_"	CALL PRINT_STR, @"%CALLNAME:TARGET%紧紧地被抱住、\@ TALENT:巨乳 ? 柔软的丰满 # 直接压了上来 \@、品味着胸部的柔软感触。_W_"
PRINTFORMW 「んぅっ！？　……んむ、ん……っ、ふっ、むぅ……っ」	PRINTFORMW 「嗯！？……嗯、我……啊,哼,呜……！」
PRINTFORMW 「――ぷはぁっ。い、いきなり何なんですか、どうしたんですか」	PRINTFORMW 「――突然就亲过来、怎么了嘛？」
CALL PRINT_STR, @"目を白黒させている%CALLNAME:TARGET%に、\@ (COND("昼") || COND("夜") ) ? %GREETING% # おはよう \@と挨拶をする。_W_"	CALL PRINT_STR, @"翻着白眼%CALLNAME:TARGET%、\@ (COND("昼") || COND("夜") ) ? %GREETING% # 早上好 \@这么打着招呼。_W_"
PRINTFORMW 「え……？　あ、はい、%GREETING%」	PRINTFORMW 「诶……？　啊、是、%GREETING%」
PRINTFORMW 「……挨拶のキスって普通はほっぺたにするものなんですよ？　%CNAME("一人称")%はその……これでもいいですけど」	PRINTFORMW 「……打招呼的接吻一般都是在脸颊上亲的啊、那个……虽然这样也可以、不过……」
PRINTFORMW 事情が飲み込めた%CALLNAME:TARGET%は、顔を赤く染めながら、なおも小さな声でぼそぼそとつぶやいている。	PRINTFORMW 掌握了情况的%CALLNAME:TARGET%脸变红了的同时、还小声嘟哝着。
PRINTFORMW 「……んっ、ちゅ……ちゅる、んっ……ぷはっ」	PRINTFORMW 「……哼、啾……啾嚅、嗯……噗哈」
PRINTFORMW 「%GREETING%。もう、%CNAME("二人称")%は本当にいたずらっ子ですねぇ……」	PRINTFORMW 「%GREETING%。真是的、%CNAME("二人称")%真是个淘气鬼呢……」
PRINTFORMW 「%CNAME("二人称")%、ちょっとこっち向いてください」	PRINTFORMW 「%CNAME("二人称")%、请稍微往这边一点」
PRINTFORMW 「……ちゅっ」	CALL PRINT_STR, "「……啾_H_」_W_"
PRINTFORMW 「ふふ、%GREETING%。今日は%CNAME("一人称")%の方が先でしたね」	PRINTFORMW 「嘿嘿、%GREETING%。今天比%CNAME("一人称")%要早呢」
PRINTFORMW 「えへへ、そんなに褒めても何も出ませんよ」	PRINTFORMW 「嘿嘿、就算你那么夸我、我可没有什么能给你哦」
PRINTFORMW 「あ、そうだ。食後のデザートがあるんですけど、食べますか？」	PRINTFORMW 「啊、对了。有饭后甜点、要吃吗？」
PRINTFORMW 「はい、お粗末さまでした♪」	PRINTFORMW 「啊、已经吃饱了♪」
PRINTFORMW 「いえいえ、%CNAME("二人称")%のお口に合ったようで何よりです」	PRINTFORMW 「不不、只要合%CNAME("二人称")%胃口的话就行了」
PRINTFORMW 「あ、そうだ。お茶菓子があるんですけど、食べますか？」	PRINTFORMW 「啊、对了。有茶点、要吃吗？」
PRINTFORMW 「こういうの好きでしたか？　ふふっ、%CNAME("一人称")%もです」	PRINTFORMW 「你喜欢这样的吗？呵呵、%CNAME("一人称")%也是」
PRINTFORMW 「……えへへ。幸せな気分になりますね」	PRINTFORMW 「……哎嘿嘿。幸福的感觉」
PRINTFORMW 「うぅ、そうやって面と向かって褒められると恥ずかしくなってきました……」	PRINTFORMW 「嗯、这样面对面被表扬、好害羞的……」
PRINTFORMW 「え？　肌が綺麗……ですか？　それは、その、ありがとうございます」	PRINTFORMW 「诶？皮肤很好……是吗？那个、那个、谢谢」
PRINTFORMW 「やっ、もう……じろじろ見てたんですね、%CNAME("二人称")%のえっち……」	PRINTFORMW 「哎呀、真是的……一直盯着看呢。%CNAME("二人称")%真H……」
PRINTFORMW 「してもらった方なのに褒められるってなんだか変な気分です……」	PRINTFORMW 「明明是受表扬的人却觉得很奇怪……」
CALL PRINT_STR, "「ふふっ_H_　上手にできてましたか？」_W_"	CALL PRINT_STR, "「呼呼_H_　我做的好吗？」_W_"
CALL PRINT_STR, @"「どういたしまして。%CNAME("二人称")%もいつも通り\@ SIZE("ペニス", MASTER) >= 2 ? 大きくて立派 # 可愛かった \@ですよ_H_」_W_"	CALL PRINT_STR, @"「该怎么���啊。%CNAME("二人称")%和平常一样\@ SIZE("阴茎", MASTER) >= 2 ? 又大又厉害 # 非常可爱 \@呦_H_」_W_"
PRINTFORMW 「や、やめてくださいよもう、恥ずかしいです……」	PRINTFORMW 「够、够了吧、好难为情啊……」
CALL PRINT_STR, @"%CALLNAME:MASTER%が%CALLNAME:TARGET%の\@ PENIS(TARGET) ? ペニス # アソコ \@を褒めると、%CALLNAME:TARGET%は火がついたように真っ赤になった……。_W"	CALL PRINT_STR, @"%CALLNAME:MASTER%一对着%CALLNAME:TARGET%的\@ PENIS(TARGET) ? 阴茎 # 阴部 \@夸奖、%CALLNAME:TARGET%的脸变得像着火一样红……_W"
PRINTFORMW 「うー、うぅー、うぅぅぅー……%CNAME("二人称")%はえっちの権化です、化身です……」	PRINTFORMW 「呜、呜、呜呜……%CNAME("二人称")%是H的化身……」
PRINTFORMW 「そんなところを褒められてもー……なんて返せばいいんですか、もぅ……」	PRINTFORMW 「姑且当是被表扬了……但是该怎么回复比较好啊、真是的……」
PRINTFORMW 「せ、セクハラですよそういうこと言うのっ、訴えられたら負けちゃうんですよっ」	PRINTFORMW 「喂、说这种话性骚扰、被告的话肯定会输哦」
PRINTFORMW 「普段見えない部分にも気を遣うのがオシャレだとは言いますけどね……」	PRINTFORMW 「平时看不到的地方也要注意、这样才算时尚……」
PRINTFORMW 「いちおう褒められているはずなのに、複雑な気分……」	PRINTFORMW 「明明是受到表扬、心情却很复杂……」
PRINTFORMW 「はぁ、%CNAME("二人称")%おっぱい揉むの好きですもんね……おかげでこんなに大きくなっちゃいましたけど」	PRINTFORMW 「唉、%CNAME("二人称")%还真是喜欢揉胸部呢……托你的福都长这么大了」
PRINTFORMW 「%CNAME("二人称")%は……これくらいの大きさが好きなんですか？」	PRINTFORMW 「%CNAME("二人称")%……这种尺寸的喜欢吗？」
PRINTFORMW 「セクハラされて褒められてもー。あ、でも、けなされたら立ち直れないかも……」	PRINTFORMW 「就算你这样夸我……但是你这种还是属于性骚扰哦。啊、啊、那样的话要站不住了……」
PRINTFORMW 「嬉しいような恥ずかしいだけのような……%CNAME("二人称")%のえっち」	PRINTFORMW 「像是高兴又害羞的样子……%CNAME("二人称")%真H呢」
PRINTFORMW 「ふふっ、%CNAME("二人称")%はこういうの、好きそうだと思ってました」	PRINTFORMW 「嘿嘿、%CNAME("二人称")%这种样子、我想应该会喜欢的吧」
PRINTFORMW 「もっと……したほうがいいですか？」	PRINTFORMW 「继续……做比较好吗？？」
PRINTFORMW 「すごく恥ずかしいのに、ちょっと気持ちよくなっちゃう自分がいます……」	PRINTFORMW 「真难为情……这样子好H」
PRINTFORMW 「うーん、なんだかよくわからないですけど、ありがとうございます？」	PRINTFORMW 「嗯、总觉得不太明白,不过、谢谢？」
PRINTFORMW 「何のことでしょう……？　でも悪い気はしませんね。えへへ」	PRINTFORMW 「什么事啊……？但是没有恶意。诶嘿嘿」
PRINTFORMW 「『褒めて伸ばす』って、いい言葉ですよね」	PRINTFORMW 「『附加的奖励』真是个好词呢」
PRINTFORMW 「な、なんですかもう、急に……」	PRINTFORMW 「什、什么啊、突然……」
PRINTFORMW 「わたしだって%CNAME("二人称")%のこと、大好き……ですよ」	PRINTFORMW 「我也是最喜欢%CNAME("二人称")%了」
PRINTFORMW 「もう%CNAME("二人称")%ったら、そういうのは妹に言うことじゃないと思うんですけど……」	PRINTFORMW 「真是的%CNAME("二人称")%、这样的话不应该是对妹妹说的哦、不过……」
PRINTFORMW 「でも……悪い気はしませんよ。ありがとうございます、%CNAME("二人称")%」	PRINTFORMW 「但是……我觉得这样也不坏。谢谢、%CNAME("二人称")%」
PRINTFORMW 「そういうことは、未来の彼女さんに言ってあげてくださいね」	PRINTFORMW 「这种话、还请说给未来的女朋友听吧」
PRINTFORMW 「本と%CNAME("二人称")%のどっちが好きか、ですか？」	PRINTFORMW 「书和%CNAME("二人称")%你比较喜欢哪个？」
PRINTFORMW 「うーん、それは難しい問題ですねぇ……」	PRINTFORMW 「嗯、这个问题挺难呢……」
PRINTFORMW 「……なんて冗談ですよ。%CNAME("二人称")%の方が好きです」	PRINTFORMW 「开玩笑的。最喜欢%CNAME("二人称")%了」
PRINTFORMW 「ふぅーっ、つかれましたぁ……」	PRINTFORMW 「呼……好累啊……」
PRINTFORMW 「あ……ちょっと古めの海外文学を読んでたんです」	PRINTFORMW 「啊……读了点外国古典文学」
PRINTFORMW 「片方でも読みづらくなる要素が両方あわさると結構すごくて……でも面白さは万国共通ですね」	PRINTFORMW 「一方面很难掌握到外国文学真正想表达的那个点、但是觉得精彩这种事情、全世界都是共通的」
PRINTFORMW 「ゲームですか？　いいですよ、何しましょうか」	PRINTFORMW 「游戏吗？好啊、要玩什么呢？」
PRINTFORMW 「%TEXTR("パズル/音楽ゲーム/レースゲーム/クイズゲーム/ストラテジー")%ですか？　ふふっ、そういうの得意ですよ」	PRINTFORMW 「%TEXTR("益智游戏/音乐游戏/竞速游戏/解密游戏/战略游戏")%是吗、这个我很擅长哦」
PRINTFORMW 「%TEXTR("格闘ゲーム/アクション/FPS")%ですか？　むむ、%CNAME("一人称")%が苦手なところ選んできましたね……」	PRINTFORMW 「%TEXTR("格斗游戏/动作游戏/第一人称射击游戏")%吗？　姆姆（鼓嘴）、选了%CNAME("一人称")%不擅长的呢……」
PRINTFORMW 「えっ、%TEXTR("RPG/STG/シミュレーション/アドベンチャー/ローグライク")%ですか？　それって一人用なのでは……」	PRINTFORMW 「诶、%TEXTR("RPG/STG/模拟游戏/冒险游戏/Roguelike")%吗？这种不是一个人玩的吗……」
PRINTFORMW 「ごめんなさい今とってもいいところなのであと10分、いえ5分だけ」	PRINTFORMW 「啊、不好意思、我现在正玩到关键地方、10分钟、啊不、再给我5分钟」
PRINTFORMW 「犯人は……ええっ、執事のヴォルフ？　けど彼には鉄壁のアリバイと、二重密室の謎が残って……」	PRINTFORMW 「犯人……咦、管家的保尔夫？但是他留下了完美的不在场证明和双重密室之谜……」
PRINTFORMW 「%CNAME("二人称")%は静かなのって得意ですか？　苦手ですか？」	PRINTFORMW 「%CNAME("二人称")%对于静下心来是擅长呢？　还是不擅长？」
PRINTFORMW 「%CNAME("一人称")%は……わりと得意な方かもですね」	PRINTFORMW 「%CNAME("一人称")%呢……或许是比较擅长的那类吧」
PRINTFORMW 「うん？　どうしたんですか%CNAME("二人称")%？　――呼んでみただけ？」	PRINTFORMW 「唔嗯？　怎么了%CNAME("二人称")%？　――只是试着叫我？」
PRINTFORMW 「そうですか……えへへ、%CNAME("一人称")%は今日も元気ですよ」	PRINTFORMW 「是这样吗……嘿嘿、%CNAME("一人称")%今天也很精神哦」
PRINTFORMW 「フェリシエルさんっていい人ですよね」	PRINTFORMW 「弗理希艾尔真是个好人啊」
PRINTFORMW 「だってほら、魂が欲しいだけなら%CNAME("一人称")%のことを助ける必要はなかったんですよ」	PRINTFORMW 「你看、如果只是想要魂的话就不会帮%CNAME("一人称")%了。」
PRINTFORMW 「仮に一時的な収支がプラスでも競争相手が増えるわけですから……総合的には損にしかならないですし」	PRINTFORMW 「就算一开始能拿到足够的魂、多了一个也需要魂的……对她来说其实是损失呢」
PRINTFORMW 「昔、風邪を引いたときとかにも、こうしてもらったことがありましたよね」	PRINTFORMW 「以前感冒的时候、也有过这样的情况吧」
PRINTFORMW 「でも%CNAME("二人称")%の方は……子供のころとは全然違うみたいですけど」	PRINTFORMW 「但是%CNAME("二人称")%这边……和小时候完全不一样呢」
PRINTFORMW %CALLNAME:MASTER%の軽く盛り上がった股間を、%CALLNAME:TARGET%はジト目で指摘してきた。	PRINTFORMW %CALLNAME:MASTER%慢慢凸起的股间、被%CALLNAME:TARGET%发现了。
PRINTFORMW 読書中の%CALLNAME:TARGET%は何事もなかったかのようにページをめくっている。	PRINTFORMW 看着书的%CALLNAME:TARGET%好象什么事也没注意到一样继续翻着书页。
PRINTFORMW 胸を揉んだり乳首をつまんでもまるで反応がない。	PRINTFORMW 揉胸和捏乳头也没反应。
PRINTFORMW 「飽きたら離してくださいね」	PRINTFORMW 「玩够了就请放开我」
PRINTFORMW 気づいていないわけではないようだが、反応がなさすぎて面白くない……。	PRINTFORMW 看来只是不太在意而已……
PRINTFORMW 「えーと、%CNAME("二人称")%」	PRINTFORMW 「嗯、%CNAME("二人称")%」
PRINTFORMW 「今%CNAME("一人称", "かな")%勉強中で、手にはシャーペンを持っているんですけど……」	PRINTFORMW 「现在%CNAME("一人称", "かな")%在努力学习中、但是手里拿着自动铅笔喲……」
PRINTFORMW 「そういういたずらっ子がどうなるか、知りたいですか？」	PRINTFORMW 「像你一样淘气的小孩会被怎么样呢、想知道吗？」
PRINTFORMW 表情は笑顔だが、声がまったく笑っていない……。	PRINTFORMW 脸上明明是在笑、却一点都不像在开玩笑的样子……
PRINTFORMW 「ん……っ、もうっ、%CNAME("二人称")%ったら……」	PRINTFORMW 「嗯……啊、已经、%CNAME("二人称")%不要啦」
PRINTFORMW 「%CNAME("二人称")%がそうやって気軽におっぱい揉むから、ついに制服のボタンが留められなくなっちゃったんですよ。太ってないのに……」	PRINTFORMW 「%CNAME("二人称")%一直这样地揉着、制服的纽扣已经绷坏了好多个了……明明不胖的说」
PRINTFORMW 「ブラもお店だとサイズがないことばっかりですし……もーっ」	PRINTFORMW 「内衣也是店里买不到的尺码……哎」
PRINTFORMW 「もう、%CNAME("二人称")%ったら……そうやって気軽に揉むのやめてくださいってば……」	PRINTFORMW 「已经、%CNAME("二人称")%真是的……哎呀……请不要再揉了啊」
PRINTFORMW 「今の大きさでも普段すごく大変なんですよ……？」	PRINTFORMW 「现在这种大小我平时已经很辛苦了的说……」
PRINTFORMW 「そんなに大きいのが好きなら自分のおっぱいを揉\@ (BASE:MASTER:カップ + BASE:MASTER:カップ成長) > 6 ? め # んで大きくすれ \@ばいいじゃないですかっ」	PRINTFORMW 「如果喜欢大的、就揉自己的\@ (BASE:MASTER:カップ + BASE:MASTER:カップ成長) > 6 ? 胸部 # 胸部让它变大 \@不就行了吗」
PRINTFORMW 「最近、だんだん胸のところのボタンを留めるのがキツくなってきたんですよ」	PRINTFORMW 「最近、胸口的扣子越来越紧了」
PRINTFORMW 「外を歩いててもなんだか周りの人たちからじろじろ見られてる気がしますし……」	PRINTFORMW 「即使走在外面、总觉得被周围的人盯着看……」
PRINTFORMW 「……%CNAME("二人称")%以外の人に見せる趣味なんてないのに」	PRINTFORMW 「……明明不想给%CNAME("二人称")%以外的人看的说」
PRINTFORMW さくらはぽつりと小さく呟いたが、あなたの耳には届かなかった……。	PRINTFORMW 樱小声地嘟哝着、但是没有传到你的耳朵里。
PRINTFORMW 「――ひゃんっ！？　えっ、誰っ、%CNAME("二人称")%？」	PRINTFORMW 「――诶诶诶、谁啊、%CNAME("二人称")%？」
PRINTFORMW 「やぁっ、いきなりなんなんですか？」	PRINTFORMW 「哎呀、突然干嘛啊？」
PRINTFORMW 「えーと……%CNAME("二人称")%ですよね？　何するんですかいきなり」	PRINTFORMW 「那个……%CNAME("二人称")%是吗？突然做什么呢」
PRINTFORMW 「あの、突然やってきたかと思えばいきなり何を……？」	PRINTFORMW 「那个……突然想干嘛……？」
PRINTFORMW 「堂々としていれば胸に触ってもいいなんてことありませんからね」	PRINTFORMW 「堂堂正正的话给你摸摸胸部也没关系哦」
PRINTFORMW 「えっと、あの、どうしたんですか……？」	PRINTFORMW 「那个、啊、怎么了吗……？」
PRINTFORMW %CALLNAME:TARGET%はそれからしばらく戸惑っていたものの、	PRINTFORMW %CALLNAME:TARGET%虽然有点不知所措、
PRINTFORMW %CALLNAME:MASTER%がこれ以上のことをするつもりがないのがわかると肩の力を抜いた。	PRINTFORMW 但发现我不打算继续下去后、就放松了下来。
PRINTFORMW 両手にかかるずっしりと柔らかな重みが気持ちいい……。	PRINTFORMW 两手沉甸甸的柔软重量让人心情舒畅……
PRINTFORMW 五指を押し返してくるぷにぷにとした弾力が心地いい……。	PRINTFORMW 把五指压回去,软绵绵的弹力很舒服……。
PRINTFORMW 「わっ、%CNAME("二人称")%ったらもう……すぐそういういたずらするんですから」	PRINTFORMW 「哇！%CNAME("二人称")%、真是的。你还是这么淘气」
PRINTFORMW 「ふふ……でも、いつまでそうしていられるでしょうね？」	PRINTFORMW 「呼呼……但是、这样被托着我感觉也轻松不少」
PRINTFORMW 「ほらほら、そろそろ腕がつらくなってきたんじゃないですかー？」	PRINTFORMW 「你看、手腕是不是越来越累了？」
PRINTFORMW 「突然何をするかと思えば……もう」	PRINTFORMW 「突然想要做什么啊、真是的」
PRINTFORMW 「%CNAME("二人称")%がえっちなのは今に始まったことではないですけれど……」	PRINTFORMW 「%CNAME("二人称")%现在想做H的事情吗……」
PRINTFORMW 「……%CNAME("一人称", "かな")%以外の人にこんなことしたらだめですからね。怒られますよ」	PRINTFORMW 「……要是%CNAME("一人称", "かな")%对别人这样做可不行哦。我会生气的」
PRINTFORMW 小さくつぶやくと、%CALLNAME:TARGET%は力を抜いて身体を%CALLNAME:MASTER%に預けた……。	PRINTFORMW 小声嘟哝着的%CALLNAME:TARGET%放松身体任%CALLNAME:MASTER%摆布。
PRINTFORMW 「ん……っ、あんまり運動とかはしないので、そんなには凝ってないと思うんですが」	PRINTFORMW 「嗯……啊、因为不怎么运动、所以我觉得肩膀不怎么舒服」
PRINTFORMW 「ところでどうして肩ばっかり……？」	PRINTFORMW 「可是为什么老是肩膀……？」
PRINTFORMW 「確かに肩は凝りやすいですけどね……。ん、ありがとうございます、%CNAME("二人称")%」	PRINTFORMW 「确实肩膀容易酸痛……。嗯、谢谢%CNAME("二人称")%」
PRINTFORMW 「重たい本を長時間読むこともあるので、それで肩が凝っているんでしょうか……」	PRINTFORMW 「是一直长时间看书所以肩膀不舒服吗……」
PRINTFORMW 「%CNAME("二人称")%って激しいから、たまに腰にくるんですよね……」	PRINTFORMW 「都是%CNAME("二人称")%做得太激烈啦、腰有时会不舒服呢……」
PRINTFORMW 「腰が痛くなることはまだあんまりないですね……さすがに」	PRINTFORMW 「腰疼的情况一直不太好呢……在怎么说也」
PRINTFORMW 「え？　お腹がふとい……？」	PRINTFORMW 「诶？　肚子粗……？」
PRINTFORMW 「な、ないです！　そんなことないですから！」	PRINTFORMW 「没、没有！　没有那样的事！」
PRINTFORMW 「それは赤ちゃんがいるからですっ、嘘じゃありませんー！」	PRINTFORMW 「那是因为有宝宝在、才不是赘肉啦！」
PRINTFORMW 「よ、よよよ余計なお世話ですっ！　%CNAME("二人称")%のばかっ」	PRINTFORMW 「多、多多多管闲事！　%CNAME("二人称")%大笨蛋！」
PRINTFORMW 「うぅぅ、ほんとにもぅほんとにもぅっ、しかたのない人なんですから……」	PRINTFORMW 「呜呜呜、真的是真的是、拿你没办法啦……」
PRINTFORMW %CALLNAME:TARGET%は真っ赤に茹で上がった顔を両手で隠している……。	PRINTFORMW %CALLNAME:TARGET%双手捂着煮得通红的脸……。
PRINTFORMW 「ん、なんですか%CNAME("二人称")%。え、腰が細い？」	PRINTFORMW 「嗯、怎么了吗%CNAME("二人称")%。诶、腰好细？」
PRINTFORMW 「えへへ、それはどうも。ありがとうございます♪」	PRINTFORMW 「嘿嘿、那谢谢了。非常感谢喲♪」
PRINTFORMW 「……あの、ところで%CNAME("二人称")%。お尻は凝らないと思うんですけれども」	PRINTFORMW 「……那个……%CNAME("二人称")%。我觉得屁股大概是不会觉得僵硬的吧」
PRINTFORMW 「えっ、そんなことない？　腰が痛くなる原因になったりする？　本当ですか……？」	PRINTFORMW 「咦、没那种事？腰痛的原因是这个？真的吗……？」
PRINTFORMW 「ちゅ……んっ、れろ……」	PRINTFORMW 「啾……嗯、咧啰（张嘴）……」
PRINTFORMW 「まだ離れちゃだめです、今度は%CNAME("一人称")%から……」	PRINTFORMW 「还不可以这样子、这次就由%CNAME("一人称")%来……」
PRINTFORMW %CALLNAME:MASTER%と%CALLNAME:TARGET%は繰り返しキスをし続けている……。	PRINTFORMW %CALLNAME:MASTER%和%CALLNAME:TARGET%热烈地亲吻着……。
PRINTFORMW 「どうしたんですか突然。……急に恋しくなっちゃいました？」	PRINTFORMW 「怎么了？突然就这样……想我了？」
PRINTFORMW しょうがない%CNAME("二人称")%ですね――と口では言いつつも、%CALLNAME:TARGET%はまんざらでもない様子だ。	PRINTFORMW 「真是拿%CNAME("二人称")%没办法啊」、嘴上虽然这么说着、%CALLNAME:TARGET%并没有太介意的样子。
PRINTFORMW 「えっ、あれ、%CNAME("一人称")%がされる方なんですか？」	PRINTFORMW 「诶、啊咧、%CNAME("一人称")%总是被膝枕的那方？」
PRINTFORMW 「ん……。なんだか小さかったころを思い出しますね」	PRINTFORMW 「嗯……。总觉得想起了小时候呢」
PRINTFORMW %CALLNAME:TARGET%は目を閉じて、遠い思い出に浸っているようだ。	PRINTFORMW %CALLNAME:TARGET%合上眼眸，仿佛沉浸在遥远的回忆中。
PRINTFORMW 「あっ、ありがとうございます、いただきますね」	PRINTFORMW 「啊、多谢款待、那我就不客气了」
PRINTFORMW 「……美味しい。%CNAME("二人称")%って意外と上手だったんですね」	PRINTFORMW 「……好吃。%CNAME("二人称")%意外地很擅长这个呢」
PRINTFORMW 意外は余計だ、と%CALLNAME:MASTER%は軽くツッコミを入れた	PRINTFORMW “意外”是多余的、%CALLNAME:MASTER%这么吐槽着
PRINTFORMW 「あら、ありがとうございます%CNAME("二人称")%」	PRINTFORMW 「啊啦。谢谢你%CNAME("二人称")%」
PRINTFORMW 「%CNAME("二人称")%、えっと、その……しません、か？」	PRINTFORMW 「%CNAME("二人称")%、那个……不做吗？？」
PRINTFORMW 「おあずけされてばかりだと、つらくて……」	PRINTFORMW 「总被拜托这样的事情、好害羞啊……」
PRINTFORMW 「%CNAME("一人称")%をこんな身体にしたの、%CNAME("二人称")%ですよね……？」	PRINTFORMW 「%CNAME("一人称")%就是这样H的身体、%CNAME("二人称")%是吧……？」
PRINTFORMW 「んっ……責任取って、ください……」	PRINTFORMW 「嗯、要负责哦……」
PRINTFORMW 「ふふ……いい子いい子」	PRINTFORMW 「呼呼……乖孩子乖孩子」
PRINTFORMW 「大人しくしてたら、もっと撫でてあげますよ……？」	PRINTFORMW 「如果乖乖的话、我就继续帮你摸哦」
PRINTFORMW 「……すりすり」	PRINTFORMW 「……嘶哩嘶哩」
PRINTFORMW 「ふれあってるとそれだけで落ち着くのは、どうしてなんでしょうね」	PRINTFORMW 「仅仅是被摸到心情就会平静下来」
PRINTFORMW 「満足したら、今度は%CNAME("一人称")%にもしてくださいね？」	PRINTFORMW 「满足的话、下次也请交给%CNAME("一人称")%哦」
PRINTFORMW 「まさかこうやってお返ししてあげられる日が来るなんて……思ってもいませんでした」	PRINTFORMW 「怎么也没有想到会有这么一天」
PRINTFORMW 「……ありがとう、%CNAME("二人称", "かな")%」	PRINTFORMW 「……谢谢、%CNAME("二人称", "かな")%」
PRINTFORMW 「どうですか……？　気持ちいいですか？」	PRINTFORMW 「怎么样……？舒服吗？」
PRINTFORMW 「こんな幸せが、ずっと続くといいですよね、%CNAME("二人称")%……」	PRINTFORMW 「这样的幸福、如果能一直持续下去就好了、%CNAME("二人称")%……」
PRINTFORMW 「ちょうどいいですし、耳掃除でもしておきましょうか」	PRINTFORMW 「正好、耳朵也清理一下吧」
PRINTFORMW 「……はい、こっちおしまい。反対側どうぞ」	PRINTFORMW 「……好、这边好了、翻个身吧」
PRINTFORMW 「って、寝転がったまま顔をお腹のほうに向けないでくださいっ」	PRINTFORMW 「真是的、请不要把脸朝着肚子的方向」
PRINTFORMW 恥ずかしいなぁ……と言いながらも、%CALLNAME:TARGET%はそのまま耳掃除を続けてくれるようだ。	PRINTFORMW 这样好害羞啊……嘴上虽然这么说、%CALLNAME:TARGET%还是就这样继续清洁着耳朵。
PRINTFORMW 「どうぞ%CNAME("二人称")%、お茶ですよ」	PRINTFORMW 「%CNAME("二人称")%、请喝茶」
PRINTFORMW 「ふーふーして冷ましてほしい、ですか？　もう、しょうがないですね……」	PRINTFORMW 「想凉一点再喝吗……啊啦、真没办法」
PRINTFORMW 「お茶入れてこようと思うんですけど、%CNAME("二人称")%は緑茶と紅茶とコーヒー、どれがいいですか？」	PRINTFORMW 「我准备泡茶啦、%CNAME("二人称")%绿茶、红茶和咖啡、要喝哪个？」
PRINTFORMW 「%CNAME("二人称")%、お茶が入りましたよー」	PRINTFORMW 「%CNAME("二人称")%、茶来了」
PRINTFORMW 「……なんですか？　お茶ばかり飲んでいるとトイレが近くなるって？」	PRINTFORMW 「……什么？喝太多茶的话、会想上厕所的哦」
PRINTFORMW 「それはそうですけど……。うぅ、デリカシーないなぁ……」	PRINTFORMW 「话虽这么说……但是茶也很好喝……」
PRINTFORMW 「あれ？　%CNAME("二人称")%も今……。っとと、なんでもない、なんでもないですよ」	PRINTFORMW 「诶？%CNAME("二人称")%现在也……没什么、没什么」
PRINTFORMW 「戻りましたよー。……ん、あれ、何か言いたげですね%CNAME("二人称")%」	PRINTFORMW 「我回来了。嗯、咦、我之前想说什么来着%CNAME("二人称")%」
PRINTFORMW 「……あ、ちょっとごめんなさい%CNAME("二人称")%」	PRINTFORMW 「……啊、对不起%CNAME("二人称")%」
PRINTFORMW 「やぁ、もぅ……そういうのは気づいても黙っていてくださいっ」	PRINTFORMW 「哎呀、已经……即使发现了、也不要说出来」
PRINTFORMW 「うぅー……。%CNAME("二人称")%、それはさすがにデリカシーがなさすぎると思うんですけど……」	PRINTFORMW 「呜ー……。%CNAME("二人称")%、再怎么说这也太不注意了……」
PRINTFORMW 「ふふふ。親しき仲にも礼儀あり……って言葉、知ってますよね？」	PRINTFORMW 「哪怕再亲密、最基本的礼貌也要懂哦」
PRINTFORMW 表情は笑顔だが、裏で静かに燃える怒気を感じる……。	PRINTFORMW 虽然表情是笑脸、但却能感觉到背后静静燃烧着的愤怒……
PRINTFORMW 「はぁ……んっ、くぅっ……あ、でる……っ」	PRINTFORMW 「哈……唔、唔……啊、出来了……」
CALL PRINT_STR, "「イくっ、はぁぁぁっ、おしっこ出しながらイっちゃう……っ_H_」_W_"	CALL PRINT_STR, "「要去了、真是啊啊啊啊啊啊啊、尿尿要高潮了唔……_H_」_W_"
PRINTFORMW 「トイレに行くたびにこれじゃ、んぅ、困っちゃう……っ」	PRINTFORMW 「每次上厕所都这样、嗯呜、好困扰啊……」
CALL PRINT_STR, "「んぅぅぅっ_H_　ふっ、ふぅっ、はぁ……」_W_"	CALL PRINT_STR, "「恩呜呜呜_H_　哼、呼呜、哈啊……」_W_"
PRINTFORMW 放尿と同時に絶頂した瞬間、%CALLNAME:TARGET%の目の前でトイレのドアが開いた。	PRINTFORMW 在同時小便与高潮的瞬间、%CALLNAME:TARGET%厕所的门在眼前开了。
PRINTFORMW 「きゃあああああっ！？」	PRINTFORMW 「啊啊啊啊啊啊！？」
PRINTFORMW 「……ぐすっ」	PRINTFORMW 「……抽泣」
PRINTFORMW 「やだぁぁ……%CNAME("二人称", "かな")%におしっこしてるとこ見られたぁ……」	PRINTFORMW 「讨厌啊啊……%CNAME("二人称", "かな")%看到尿尿的地方了」
PRINTFORMW 「うわぁぁぁぁん」	PRINTFORMW 「呜哇啊啊啊~」
PRINTFORMW 「えっ、やだっ！？　うそっ、%CNAME("二人称")%っ！？」	PRINTFORMW 「哎、讨厌！？　这不是真的、%CNAME("二人称")%！？」
PRINTFORMW 「ひぅっ！？」	PRINTFORMW 「哇！？」
PRINTFORMW 「……そこで、なに……してるの？」	PRINTFORMW 「……你、在那里……干什么？」
PRINTFORMW 「…………え？　ええ？　なにこれ？　どうなってるの？」	PRINTFORMW 「…………诶？啊？这是什么？会变成怎样呢？」
PRINTFORMW 「……出てって。いいから、早く、今すぐに」	PRINTFORMW 「……出去！快点、立刻出去！」
PRINTFORMW 「うぅ……やだもう、何度言われても嫌ですよ……」	PRINTFORMW 「唔……讨厌、不管你要求多少次我都讨厌……」
PRINTFORMW 「だっていつ他の人が通りがかるかもわからないんですよ？」	PRINTFORMW 「不知道会不会有其他人经过这里？」
PRINTFORMW 「えっと、その……ベッドの上で二人だけのときなら、いいですから……ね？」	PRINTFORMW 「如果……只是两个人在一起的时候……呐？」
PRINTFORMW 「な、なに言ってるんですか突然……」	PRINTFORMW 「什……你突然在说什么啊」
PRINTFORMW 「だって、ほら、いつも見てるじゃないですか。それまで待てないんですか？」	PRINTFORMW 「你之前不是有看过吗。非得要现在看？」
PRINTFORMW 「我慢できないなら仕方が……うぅ、でも恥ずかしいですし……」	PRINTFORMW 「如果实在无法忍住想看的心情……呜、但是好害羞啊……」
PRINTFORMW 「やっぱりダメですっ、今夜かせめてそこのベッドまで我慢してくださいっ」	PRINTFORMW 「果然还是不行……忍耐一下等晚上只有两个人的时候吧」
PRINTFORMW 「や、あ……んんっ、押し込まないでくださ……ひぅっ」	PRINTFORMW 「呀、啊……嗯、请不要塞进去……呀！」
PRINTFORMW 「かきまわすのもダメですってばぁっ」	PRINTFORMW 「不要动啊！！」
PRINTFORMW 「そ、そろそろやめてもらえませんか……？」	PRINTFORMW 「那么、差不多可以停下来了吧……？」
PRINTFORMW 「やぁ、もうっ、深呼吸なんてしないでくださいっ！」	PRINTFORMW 「呀！真是的、深呼吸什么的也停下！」
PRINTFORMW 「綺麗にしているとは言っても恥ずかしいものは恥ずかしいので、そろそろ……」	PRINTFORMW 「虽说有用心打扮得很漂亮、但是毕竟是害羞的地方、还是觉得好难为情啊、差不多该……」
PRINTFORMW 「う、うぅー……ちょっと腰つかまないでくださいってば、離してくださいっ」	PRINTFORMW 「呜、呜……请不要把腰抓的这么紧、稍微放开一点啦」
PRINTFORMW 「ん……どうですか、見えてますか？」	PRINTFORMW 「嗯……怎么样、能看清楚了吗？」
PRINTFORMW 「ちゃんと%CNAME("二人称")%の言いつけ通り、一日中寝てるときでも入れたままなんですよ」	PRINTFORMW 「我有好好听%CNAME("二人称")%的话、在街上和睡觉的时候都有放进去哦」
PRINTFORMW 「いつも奥までぐりぐりされっぱなしで大変なんですからね、もう……」	PRINTFORMW 「总被放在里面、身体忍耐的好辛苦哦、真是的……」
PRINTFORMW 「%CNAME("二人称")%が綺麗にしたらだめだって、言うから……うぅ」	PRINTFORMW 「有听%CNAME("二人称")%的话剪成好看的样子……唔」
PRINTFORMW 「んっ、そんな顔近づけちゃ……。%TEXTS("匂い")%なんて嗅がないでくださいっ」	PRINTFORMW 「额……脸慢慢靠近了。请不要这样闻%TEXTS("气味")%啦」
PRINTFORMW 「はぅ……。やだぁ、もう……」	PRINTFORMW 「嗯……好讨厌啊、真是的……」
PRINTFORMW 「一応、いつも綺麗にはしていますけど……」	PRINTFORMW 「姑且、有剪成好看的样子……」
PRINTFORMW 「うぅ……大丈夫ですか？　変な%TEXTS("匂い")%とかしてませんか……？」	PRINTFORMW 「唔……如何？没有什么奇怪的%TEXTS("气味")%吧……？」
PRINTFORMW 「……ちょっと%CNAME("二人称")%こっち来てください、こっち」	PRINTFORMW 「……那个、%CNAME("二人称")%、稍微靠过来一点、过来这边」
PRINTFORMW 「ここなら大丈夫かな……？　はい、どうぞ。ちょっと狭いですけど」	PRINTFORMW 「这里的话没关系吗……？　啊、是、没关系。虽然稍微有点窄」
PRINTFORMW %CALLNAME:TARGET%は隠れることに集中しているせいか、露わになった股間のすぐそばに%CALLNAME:MASTER%の顔があることに気が回っていないようだ……。	PRINTFORMW %CALLNAME:TARGET%好像是因为在隐藏起来的位置很集中的缘故、尽管股間没有暴露出来、但还是非常在意%CALLNAME:MASTER%的脸碰到的地方……
PRINTFORMW 「どうして%CNAME("二人称")%はそんなにパンツが好きなんですか？」	PRINTFORMW 「为什么%CNAME("二人称")%就这么喜欢胖次啊？」
PRINTFORMW 「%CNAME("一人称")%は別に%CNAME("二人称")%のパンツになんて興味は――」	PRINTFORMW 「%CNAME("一人称")%对%CNAME("二人称")%的胖次就没什么兴趣」
PRINTFORMW 「……ないですよ。ええ、ありませんったらありません」	PRINTFORMW 「……没有。是的、没有就是没有。」
PRINTFORMW 「もう……汚したりしないでくださいね」	PRINTFORMW 「真是的、别弄脏了啊」
PRINTFORMW 「穴が開くほど見るっていうのはこういうことを言うんでしょうか」	PRINTFORMW 「想看看张开小穴的样子？」
PRINTFORMW 「……いえ、まぁ、開いてますけどね、穴……」	PRINTFORMW 「……不、嘛、虽然给你看一下也没什么呢……」
PRINTFORMW 「もし穴が開いたら、%CNAME("二人称")%にも一緒に買いに行ってもらいますからね？　ふふっ」	PRINTFORMW 「小穴给你看的话、%CNAME("二人称")%就陪我一起去买东西、可以吗？嘿嘿」
PRINTFORMW 「もうっ、何がそんなに楽しいんでしょうか……」	PRINTFORMW 「哎呀、真有那么开心吗……」
PRINTFORMW 「まぁ、その、%CNAME("二人称")%が満足ならいいんですけど」	PRINTFORMW 「嘛、那个、%CNAME("二人称")%满足了就好」
PRINTFORMW 「……言い間違えました。良くはないですよ」	PRINTFORMW 「……总感觉做了错事。不太好呦」
PRINTFORMW 「ほどほどにしておいてくださいね……？」	PRINTFORMW 「请适可而止哦……」

//EVENT_K6_SHOP.ERB
PRINTFORMW 「今日はいったい『どっちの%CNAME("一人称")%』へのお願い事ですか、%CNAME("二人称")%？」	PRINTFORMW 「今天是『哪个%CNAME("一人称")%』的请求吗、%CNAME("二人称")%？」
PRINTFORMW 「%CNAME("一人称")%にできることだといいんですけど……どうしたいんですか？」	PRINTFORMW 「%CNAME("一人称")%如果能帮到忙就好啦、%CONDS("関係", MASTER)%打算怎么做？」
PRINTFORMW %CALLNAME:MASTER%が想いを伝えると、%CALLNAME:TARGET%の頬から大粒の涙がはらりとこぼれ落ちた。	PRINTFORMW %CALLNAME:MASTER%的爱意传达给了%CALLNAME:TARGET%、%CALLNAME:TARGET%大颗的泪珠从脸颊上扑簌而出。
PRINTFORMW 「%CNAME("一人称", "かな")%も……ずっとずっと前から、お%CONDS("関係", MASTER)%ちゃんのこと、大好きです」	PRINTFORMW 「%CNAME("一人称", "かな")%也……从很久以前开始就喜欢%CONDS("関係", MASTER)%了」
PRINTFORMW 「でも%CNAME("一人称", "かな")%たち%NAMES("兄弟")%だから、お%CONDS("関係", MASTER)%ちゃんを不幸にするだけだから、我慢しなきゃいけないって――」	PRINTFORMW 「但是%CNAME("一人称", "かな")%们是%NAMES("兄弟")%、只有%CONDS("関係", MASTER)%一个人在不幸什么的、不能不继续坚持忍耐下去――」
PRINTFORMW 「や、やだ……すごくうれしいのに、本当に、ほんとにうれしいのに、涙が……止まらな……っ」	PRINTFORMW 「讨、讨厌……明明很高兴、真的、真的很高兴、却流下了眼泪……停不下来啊」
PRINTFORMW \@ FIRSTCOM(6) == 0 ? 初めて味わう # 泣き笑いの表情を浮かべる \@%CALLNAME:TARGET%の唇は、少し塩辛い味がした。	PRINTFORMW \@ FIRSTCOM(6) == 0 ? 第一次尝到的味道 # 脸上哭着漏出了笑容 \@%CALLNAME:TARGET%的嘴唇、有一点咸咸的味道。
PRINTFORMW 「え、ええっ！？　%CNAME("一人称", "かな")%たち%NAMES("兄弟")%ですよ？」	PRINTFORMW 「哎、哎！？　%CNAME("一人称", "かな")%是%NAMES("兄弟")%哦？」
PRINTFORMW 「%CNAME("二人称")%のことはもちろん好きですけど」	PRINTFORMW 「%CNAME("二人称")%当然是喜欢的」
PRINTFORMW 「でもこういうのってお話だと周囲に猛反対されて駆け落ちしちゃったり、思い詰めて心中しちゃったりとか大変なことに……」	PRINTFORMW 「但是这样会被周围人反对的、后面只能私奔也会十分辛苦的哦……」
PRINTFORMW 「それに、その……まだ良くなると決まったわけでもないので……」	PRINTFORMW 「而且、那个……我还没有想好……」
PRINTFORMW 「えっと……その、ごめんなさい%CNAME("二人称")%。今はちょっと都合が悪くて……」	PRINTFORMW 「那个....对不起啊%CNAME("二人称")%、今天有点不方便……」
PRINTFORMW 「ぱ、パン――っ！？　そ、そんなことできるわけないじゃないですか%CNAME("二人称")%っ」	PRINTFORMW 「胖、胖——！？那、那怎么可能！%CNAME("二人称")%」
PRINTFORMW 本気で怒らせてしまったのか、頬を真っ赤にしながら拒否されてしまった……	PRINTFORMW 也许是真的生气了、脸蛋通红地拒绝了……
PRINTFORMW 「あのですね、お弁当はちょっと……今はまだ、ダメです」	PRINTFORMW 「那个啊、准备便当的话、稍微有点……现在还不行哦」
PRINTFORMW 「えっ、理由ですか？　それはその、えっと」	PRINTFORMW 「咦、理由呢？那个、那个」
PRINTFORMW 「練習中なんです……」	PRINTFORMW 「还在练习中……」
PRINTFORMW 「えっと、これがさっき%CNAME("二人称")%が言っていたものですか？」	PRINTFORMW 「那个、这个是%CNAME("二人称")%的要求吗？」
PRINTFORMW %CALLNAME:TARGET%は目の前のシールを眺めたりさわったりしながら観察している。	PRINTFORMW %CALLNAME:TARGET%看着眼前的贴纸默默地观察着。
PRINTFORMW 「不思議ですね、手で直接触れると少し色が変わります……なんだか生き物みたい」	PRINTFORMW 「好神奇啊、用手直接触摸的话会稍微变色……总觉得像生物一样」
PRINTFORMW 「これをつけると、その、簡単にえっちな気分になるようになっちゃうんですよね……」	PRINTFORMW 「戴上这个的话、就很容易变得H……」
PRINTFORMW ごくりと生唾を飲み込むように、さくらの喉が上下する。	PRINTFORMW 有点紧张地咽下了口水、%CALLNAME:TARGET%的喉咙动了一下。
PRINTFORMW やめておくかと改めて尋ねるあなたに、	PRINTFORMW 「真的要贴吗？」
PRINTFORMW 「……いいえ、%CNAME("二人称")%のしたいようにして、ください……」	PRINTFORMW 「……算了、%CNAME("二人称")%就按你说的做吧……」
PRINTFORMW %CALLNAME:TARGET%は瞳を潤ませながら答えるのだった……。	PRINTFORMW %CALLNAME:TARGET%湿润着眼睛回答道。
PRINTFORMW 「また付けてしまいました……」	PRINTFORMW 「又要加上新的纹路吗……」
PRINTFORMW 「%CNAME("二人称")%は見ているだけですからいいんでしょうけど」	PRINTFORMW 「光是让%CNAME("二人称")%看看的话也不是不可以……」
PRINTFORMW 「付けてる側は結構大変なんです……よっ」	PRINTFORMW 「缠人的那一方可是相当不容易的……呦」
PRINTFORMW さくらがまだ言い切らないうちに、シールが鎮座する腹部を撫でていた%CALLNAME:MASTER%の手がするりと下へ動いた。	PRINTFORMW %CALLNAME:TARGET%还没说完、手就开始摸着有着淫紋的腹部。%CALLNAME:MASTER%的手慢慢向下移动。
PRINTFORMW 腰骨をなぞり、鼠径部をつぅっと撫で、指先は恥丘へするりと流れていく。	PRINTFORMW 从腰部、盆骨一直抚摸着、手指向着耻丘慢慢摸去。
PRINTFORMW 「んぅっ？　やだっ、指入れちゃ、んっ、ぁぅ……」	PRINTFORMW 「嗯？哎呀、手指插进去了、哼、呜……」
PRINTFORMW 「えっ、やだちょっと%CNAME("二人称")%？　脱がせないで……やっ、指がっ」	PRINTFORMW 「诶、感觉有些微妙、%CNAME("二人称")%？啊不要脱……手指……」
PRINTFORMW くちゅりと卑猥な水音をたてながら、あなたの指はさしたる抵抗もなくするりと飲み込まれていく。	PRINTFORMW 发出一阵下流水声的同时、手指毫无抵抗地被小穴吞噬。
PRINTFORMW まるで湯の中かと思うような愛液の熱さ、指をしゃぶるように吸い付いてくる柔らかな膣肉の感触を味わいながら天井を軽く一撫でする。	PRINTFORMW 仿佛在热水中一般、爱液的热度、就像在吮吸手指一般、一边品味着柔软的阴道内壁的触感、一边轻轻地触摸着子宫口。
PRINTFORMW 指の動きにつられてびくりと腰が突き出すように跳ねる。	PRINTFORMW 随着手指的活动、%CALLNAME:TARGET%也一蹿一蹿地挺着腰。
PRINTFORMW あなたに向けて献上するかのように差し出された下腹部では、貼り付けたばかりの淫紋が脈打つように淡い光を放っている。	PRINTFORMW 仿佛是为了向你献上自己一样、在下腹部、刚刚贴上的淫纹像脉搏一样散发着淡淡的光芒。
PRINTFORMW ちゅうちゅうと名残惜しげな膣から指を引き抜くと、奥からこぽりと粘性の音を立てながら愛液があふれ出し、あたりに甘酸っぱい少女の性の%TEXTS("匂い")%が満ちる。	PRINTFORMW 小穴好像舍不得手指离开一般、从里面发出粘稠的水声、爱液随着手指的抽出、发出少女酸甜的%TEXTS("气味")%。
PRINTFORMW 「ん……っ、どう、でした……？」	PRINTFORMW 「嗯……啊、好了吗……？」
PRINTFORMW 淫紋の出来を確認した%CALLNAME:MASTER%は、熱い吐息をこぼしている%CALLNAME:TARGET%に対し満足げに頷いてみせるのだった。	PRINTFORMW %CALLNAME:MASTER%确认淫纹附好后、%CALLNAME:TARGET%散发着热烈的呼吸对此满足地点了点头。
PRINTFORML 「……%CNAME("二人称")%と一緒にお買い物ですか？」	PRINTFORML 「……%CNAME("二人称")%一起去购物吗？」
PRINTFORML 「わっ、行きます行きますっ、一緒にお出かけなんて久しぶり……」	PRINTFORML 「哇、当然要去啊、好久没一起出门了」
PRINTFORMW 「それじゃ、ちょっと着替えてきますね」	PRINTFORMW 「那么、稍微换一下衣服吧」
PRINTFORML 「お買い物に行くんですか？」	PRINTFORML 「一起去购物吗？」
PRINTFORMW 「わかりました、ちょっと待っててくださいね」	PRINTFORMW 「我明白了、稍等一下」
PRINTFORML 「なんですか%CNAME("二人称")%。え、お買い物？　私とですか？」	PRINTFORML 「什么啊%CNAME("二人称")%。诶、买东西？和我吗？？」
PRINTFORMW 「もちろん行きますっ、今すぐ用意しますねっ」	PRINTFORMW 「当然要去了、现在马上准备哦」
PRINTFORML 「あ……%CNAME("二人称")%。お買い物ですか？」	PRINTFORML 「啊……%CNAME("二人称")%。去买东西吗？」
PRINTFORMW 「いいですよ、今日はどこに行きましょうか」	PRINTFORMW 「好、今天去哪里？」
PRINTFORMW 「出かけるんですか？　はい、行ってらっしゃい」	PRINTFORMW 「要出门吗？请慢走」
PRINTFORMW 「あの、えっとその、うぅ」	PRINTFORMW 「那个、那个、呜」
PRINTFORMW 「は、履いてないんです……けど……」	PRINTFORMW 「不穿吗……但是……」
PRINTFORMW 「%CNAME("二人称")%は……本当にこう、もう、なんていうか……」	PRINTFORMW 「%CNAME("二人称")%、真、真的要这样吗……」
PRINTFORMW 「わかりました……どうぞ」	PRINTFORMW 「我明白了……给、给你」
PRINTFORMW 「……言われる気がしていたので、脱いでおきました」	PRINTFORMW 「……确实觉得挺麻烦的、那就脱了吧」
PRINTFORMW %CALLNAME:TARGET%から手渡された下着はしっとりと湿っている……。	PRINTFORMW %CALLNAME:TARGET%的手递过来已经湿透了的胖次。
PRINTFORMW 「あの、そんなに見られてると脱ぎづらいんですけど」	PRINTFORMW 「那个……你一直看着的话很难脱掉诶」
PRINTFORMW 「うぅ……脱ぎましたよ、どうぞ……」	PRINTFORMW 「唔……脱下来了、给……」
PRINTFORMW 「え？　このまま……？」	PRINTFORMW 「诶？就这样……？」
PRINTFORMW 「やっ、ちょっと%CNAME("二人称")%ダメですってばっ、『いける！』じゃないですよむーりーでーすー！」	PRINTFORMW 「呀、我说%CNAME("二人称")%、不行的啊、『没关系！』才怪啊！不行不行！」
PRINTFORMW 「あっだめっ、そんなに強く引っ張ると脱げっ、あっ、ああー……」	PRINTFORMW 「啊！那么用力拉的话衣服要掉下来了……」
PRINTFORMW 「えっ、この格好のまま行くんですか？」	PRINTFORMW 「咦、穿这身打扮去吗？？」
PRINTFORMW 「大丈夫、ですか……？　あんまりそうは思えないんですけど……」	PRINTFORMW 「不要紧的吧……大概」
PRINTFORMW 「このまま、行くんですか……？」	PRINTFORMW 「就这样去吗……？」
CALL PRINT_STR, "「……んっ_H_」_W"	CALL PRINT_STR, "「……嗯_H_」_W"
PRINTFORMW 「そしたら、その、み、見られちゃうんですよね、たくさんの人に……」	PRINTFORMW 「这样去的话会被好多人看的……」
CALL PRINT_STR, "「あ……。んっ、はい、行きましょうか……_H_」_W"	CALL PRINT_STR, "「嗯……真是的、走吧……_H_」_W"
PRINTFORMW 「えっ？　私が買ってくるんですか？」	PRINTFORMW 「咦？我来买吗？？」
PRINTFORMW 「いいですけど……なんでカゴ隠すんですか？　やっ、ちょっと見せてくださいったら」	PRINTFORMW 「可以……为什么要藏起来呢？哎呀、买了什么请让我稍微看一下吧」
PRINTFORMW 「……まぁ、いちおう、覚悟してきたからいいですけど」	PRINTFORMW 「……嘛、我做好觉悟了」
PRINTFORMW 「%CNAME("二人称")%はいつも楽しそうでいいですね……はぁ……」	PRINTFORMW 「%CNAME("二人称")%总是看起来很开心很棒呢……哈哈……」
PRINTFORML 「あのっ、これお願いしますっ」	PRINTFORML 「那个、请给我这个」
PRINTFORMW 「え、スタンプカード？　うぅ、%CNAME("二人称")%のお財布だからどれがどれだか……」	PRINTFORMW 「啊、印章卡？呜、呜、我看看%CNAME("二人称")%的钱包、是哪一张？……」
PRINTFORMW （う、うぅ……これ私が使うと思われてるんだろうなぁ……）	PRINTFORMW （呜、呜……这应该是打算给我用的吧……）
PRINTFORMW 「あの、その、紙袋でお願いします……」	PRINTFORMW 「那、那个、用纸袋包起来、拜托了……」
PRINTFORML 「まだかかりそうですか……？」	PRINTFORML 「还需要别的吗……？」
PRINTFORMW 周囲で物音がするたびに、%CALLNAME:TARGET%はびくびくと過敏に反応している……。	PRINTFORMW 每当周围有响动、%CALLNAME:TARGET%就紧张地看向那边……。
PRINTFORML %TEXTR("「……」/「これ、何に使うのかな……？」/「うわ、すご……私の腕より太い……」/（何だろこれ、家畜用って書いてあるけど……）/（えぇー……こんなの誰が使うの……？）")%	PRINTFORML %TEXTR("「……」/「用这个做什么……？」/「哇、好厉害……比我的胳膊还粗……」/（这是什么啊、上面写着家畜用的……）/（哎……这是准备给谁用的……？）")%
PRINTFORMW 棚の商品を見るたびに、さくらの顔に赤みが増していくのが傍目にもよくわかる。しばらく放っておけばゆでだこのようになっていることだろう……。	PRINTFORMW 从旁人看来、每当看到架子上的商品、樱的脸上就会变得更红。感觉就像放点盐就已经可以吃了……
PRINTFORMW さくらは棚を見ないようにしていたが、それでも目に入ってくる商品が気になってしまうようだ……。	PRINTFORMW 虽然%CALLNAME:TARGET%刻意地不去看货架、但还是很在意那些映入眼帘的商品……
PRINTFORMW 並べられた数々の道具を眺めていたさくらは、それを自分に使われることを想像したのか一瞬ぶるりと身を震わせた……。	PRINTFORMW 看着排列在一起的各种道具的%CALLNAME:TARGET%、一瞬间颤抖着身体、大概是想象到被用在自己身上的样子了吧……
PRINTFORMW 「はぁ……。恥ずかしすぎて私もう倒れちゃうかと思いました……」	PRINTFORMW 「哈啊……太难为情了……我差点要晕过去了……」
PRINTFORMW %CALLNAME:TARGET%は手渡されたパンツの感触に、長めの溜息を吐いた……	PRINTFORMW %CALLNAME:TARGET%感觉着空荡荡的股间、发出了叹息……
PRINTFORMW 「あれ、目当てのものは売ってなかったんですか？」	PRINTFORMW 「咦、没有想买的东西吗？？」
PRINTFORMW 「はぁ、無事に帰ってこられました……」	PRINTFORMW 「哈、平安无事地回来了……」
PRINTFORMW 「すれ違った人たち、みんなこっち見てましたよね……」	PRINTFORMW 「擦肩而过的人们、都在看我吧……」
PRINTFORMW 「ふぅ、これでおしまいですね」	PRINTFORMW 「呼、这就结束了」
PRINTFORMW 「それじゃあ……ちょっと寄り道して帰りませんか？」	PRINTFORMW 「那么……稍微绕点路回去吧？」

//EVENT_K6_さくら.ERB
;兄さんのことが大好きな病弱でむっつりな妹	;最喜欢哥哥的病弱妹妹
;○はじめに	;○开头
; この口上は男あなた（及びそこから派生した性転換あなた、ふたなりあなた）以外の主人公を想定していません。ごめんなさい。	; 这个口上没有假定你是男性(包括性转换或者扶她)以外的主人公。实在是很抱歉。
; あなた以外の調教者に関しては別途対応予定です……。	; 关于你以外的调教者、计划另外处理……
;◯コンセプト	;◯概念
; 母性ロリ。年下だけどとにかく甘やかしてくれる優しい子の予定。（……のはずだが現状そういうコマンドには未着手）	; 母性萝莉。虽然比我年纪小、但是会娇惯我的温柔孩子。（……预定是这样但现状这种指令还未着手。）
; 見た目は清楚だが実は妄想癖のある倒錯的なマゾヒストで、自慰経験が多い。	; 外表清秀、但实际上却有着妄想癖的倒错性瘫痪症、自慰经验很丰富。
; 他人との交流の機会が少なく、賢い一方で物知らずな面あり。自慰を覚えた際、膣口と間違えて尿道を開発してしまった経験があるということで尿道経験がある。	; 跟他人交流的机会很少、一方面很聪明、另一方面也有不懂事的一面。由于有在自慰的时候、与阴道口搞混结果开发了尿道这样的事、有尿道经验。
; メタ的に言うと尿道キャラってそうそういないのでニッチを埋めた感じ。	; 本来只是单纯的想弥补一下尿道系角色的缺口。
; 実妹ということで背徳的なえっち成分を多めに入れられたらいいな。	; 作为亲妹妹、如果能多加入一些不道德的色情成分就好了。
; 当初の彼女は人間だが、一定以上の魂を集めた後、悪魔や淫魔といった人外に転生して健康体になれるイベントを入れたい。	; 一开始她是人类，在收集到一定以上的灵魂之后，就会发生转生到恶魔或者淫魔之类的健康身体的事件。
; 比較的無垢な女の子をあなた好みに作り替えよう。	; 把相对纯洁的女孩子调教成你喜欢的样子吧。
; （もちろん人間のままに留め置く選択も用意しますが、その場合身体についてはどうしよう……？）	; （当然也准备了保持人类状态的选择、这种情况下身体会怎么样呢……？）
;◯バックストーリー	;◯背景故事
; あなたの妹は、生まれたときから身体が弱く入退院を繰り返している。	; 你的妹妹从出生开始就身体病弱、反复住院出院。
; ことの起こりは主人公がフェリシエルと契約を交わしてしばらくした頃、入院していた妹が一時退院し家に帰ってきたときのことだ。	; 事情的起因是在主人公与弗理希艾尔签订契约后不久、住院的妹妹暂时出院回到家的时候。
; 玄関をくぐる妹の姿をのぞき見ていたフェリシエルがぼそりと呟く。――あの方の身体、人間の医学では治りませんね。	; 弗理希艾尔偷偷地看着穿过大门的妹妹、喃喃自语道：「那个人的身体、用人类的医学是治不好的」
; 耳ざとくその呟きを拾い上げ、ではどうすればいいのかと問いかけるあなた。	; 咬着耳朵轻轻呢喃，问着该如何是好呢的你。
; その問いに対する返事は、妹を吸精体質にしたのち、あなたが魂を注ぎ込むという背徳的なものだった……。	; 对于这个问题的回答、是在将妹妹培养成吸精体质之后、由你注入灵魂这种不道德的做法……
;◯イメージ	;◯印象
; （素質デフォルトの場合）	; （默认素质情况下）
; １つ年下のあなたの妹。病院にいることの方が多いため人付き合いの経験があまりなく、人擦れしていない。	; 小你一岁的妹妹。因为待在医院的时间比较多、所以没有与人交往的经验、不容易与人来往。
; 小学生と間違われるくらいの身長（140cm強～145cmくらいのイメージ）だが、年齢的には高校生なので胸はそこそこ発育済で巨乳。	; 和小学生差不多的身高（140cm到～145cm左右的感觉）、但是从年龄上来说、因为是高中生、所以胸部早已发育完毕、成了巨乳。
; 食は細いものの筋肉の量が少なく運動しないため、ガリガリではなくそれなりに脂肪が乗った身体つきをしている。	; 因为食量较小、身体比较纤细、而且不怎么运动、所以不是那种过于纤细而是有相应的正常程度的脂肪的身体。
; 髪型は黒のストレートロング。透けるような白い肌と相まって、深窓の令嬢的な雰囲気が漂う。	; 发型是黑色直发、与透明的白色肌肤相结合、给人一种深闺千金般的印象。
; 暇な時間のほとんどを読書に費やしているほどの読書家で、いわゆる官能小説にも多数手を出している耳年増タイプ。	; 闲暇时间几乎都花在读书上的读书家、也是多次涉猎官能小说的性知识丰富的类型。
; 好きなジャンルは恋愛もので、特にロマンチックな展開に目がなく、自分を主人公やヒロインに置き換えるような妄想に浸ることもしばしば。	; 喜欢的类型是恋爱小说、尤其是浪漫的展开、常常会沉浸在把自己置换成主人公或女主角的妄想中。
; 普段はしっかりしており兄に対しても丁寧な口調で話すが、実は甘えたがりで地が出ると若干幼い口調になる。	; 平时很稳重、对哥哥也用礼貌的语调说话、但实际上因为想撒娇而露出本性时语气会稍显幼稚。
LOCALS = 私_わたし	LOCALS = 我_我
LOCALS = 兄さん_にいさん	LOCALS = 哥哥_哥哥
LOCALS = 姉さん_ねえさん	LOCALS = 姐姐_姐姐
LOCALS = お母さん_おかあさん	LOCALS = 母亲_母亲
LOCALS = あなた_あなた	LOCALS = 你_你
LOCALS = %CALLNAME:ASSI%さん_%CALLNAME:ASSI%さん	LOCALS = %CALLNAME:ASSI%桑_%CALLNAME:ASSI%桑
%CALLNAME:MASTER%によくなついている病気がちな妹	%CALLNAME:MASTER%那经常生病的妹妹
長期の入院を繰り返していたため学校で彼女を知る人は少ないが、	由于长期往返于医院和学校之间、所以学校认识她的人很少。
STR:3 = 一部の\@ (TALENT:外見年齢 == 1 || TALENT:小柄) ? _-_ロリコン気味な_ # \@男子からの人気が高い	STR:3 = 在一部分", \@ (TALENT:TARGET:外見年齢 == 1 || TALENT:TARGET:娇小) ? -_萝莉控癖好的 # \@, "男生那人气很高
CALL PRINT_STR, @"それは今をさかのぼること\@ COND("昼") ? 数 # 十数 \@時間前、今朝のことである。_L_"	CALL PRINT_STR, @"那可以追溯到\@ COND("昼") ? 数 # 十几个 \@小时前、是今天早上发生的事情。_L_"
PRINTFORMW 「えっと……その、わたしの身体、治るかもしれないんですか？」	PRINTFORMW 「嗯……那个、我的身体、说不定能治好？」
PRINTFORMW 女の子らしく可愛らしいものにあふれているものの、しかし同時にあまり生活感のない部屋の中。	PRINTFORMW 房间里虽然充满了女孩子般可爱的东西、但同时也没有生活感。
PRINTFORMW その部屋の窓際、ベッドの上で横たわる少女――%CALLNAME:MASTER%の妹である%NAME:ARG%が、ベッドの脇に立つ女性、%CALLNAME:FINDCHARA(NO, 1)%に向けて問いかける。	PRINTFORMW 在房间的窗边、躺在地板上的少女――%CALLNAME:MASTER%的妹妹%NAME:ARG%、听到站在床边的%CALLNAME:FINDCHARA(NO, 1)%这样和自己说。
PRINTFORMW 少しの期待と、それ以外を占める諦念。それらが入り混じった視線を受けて、%CALLNAME:FINDCHARA(NO, 1)%が答える。	PRINTFORMW 感觉得到那死了心一般的眼神里夹着的一丝微弱的期望、%CALLNAME:FINDCHARA(NO, 1)%回答。
PRINTFORMW 「そうだ――といえばそうなのですが、厳密にいえば違うともいえます」	PRINTFORMW 「是的——虽然这么说、但严格来说不是用医疗的手段」
PRINTFORMW はっきりとしない、煮え切らない答えに、かすかに灯りかけていた光が曇る。そして、	PRINTFORMW 模糊不清、暧昧不清的回答、微微点亮的光也随之阴暗下来。%CALLNAME:FINDCHARA(NO, 1)%接着说道。
PRINTFORMW 「あなたの身体を治すことは、私の力をもってしても容易なことではありません」	PRINTFORMW 「要治好她的身体、就算拥有我的力量也不容易」
PRINTFORMW 追い打ちをかけるかのようにはっきりと告げられる。	PRINTFORMW 像落井下石一般被告知。
PRINTFORMW 見るからに消沈する%NAME:ARG%を尻目に、――簡単に説明しましょう、と%CALLNAME:FINDCHARA(NO, 1)%は教鞭を執るようなポーズを取る。	PRINTFORMW 对着看上去就很消沉的%NAME:ARG%――简单说明一下吧、%CALLNAME:FINDCHARA(NO, 1)%摆出一副拿着教鞭般的教师模样。
PRINTFORMW 「わかりやすく話しますと……あなたの身体は、たとえ安静にしていても徐々に生命力が漏れ出てしまう身体なのです」	PRINTFORMW 「用通俗易懂的方式来说……她的身体、即使是一直静养、也会慢慢地泄露生命力」
PRINTFORMW 「この生命力というものは普通の人間であっても日々少しずつ漏れていくものです。人はそうして徐々に老い、弱り、やがて死に至ります」	PRINTFORMW 「生命力就是普通人类每天一点点泄漏的东西。人类就这样渐渐老去、衰弱、不久就会死亡」
PRINTFORMW 「しかしあなたの場合はそれがあまりにも早い。このままの状態を放置すれば、遠からずその身体の生命力は尽きてしまうでしょう」	PRINTFORMW 「但她的情况就是泄漏得太快了。如果就这样放任不管的话、不久那个身体的生命力就会耗尽吧」
PRINTFORMW 「この体質を直接治すことができるのであれば、それに越したことはないのですが――」	PRINTFORMW 「如果能直接治好这个体质的话、那是最好不过。」
PRINTFORMW 言葉を切った%CALLNAME:FINDCHARA(NO, 1)%が、目蓋をすっと伏せる。	PRINTFORMW 「不过——」、%CALLNAME:FINDCHARA(NO, 1)%微微闭上了眼睛。
PRINTFORMW 「魂の一つや二つ分程度では、生命を左右するほどの奇跡は起こせないのです」	PRINTFORMW 「只是把灵魂分给她的话、是不会发生能左右生命的奇迹的」
PRINTFORMW 「そういった願いは単純に労力が大きくなるのですよ。一つの命を救うために、その数倍から数十倍以上の魂が必要になってしまうのです」	PRINTFORMW 「那不是像体力劳动一样简单的事情。为了拯救一个生命、需要数倍甚至数十倍以上的灵魂」
PRINTFORMW 「魂を消費することによって得られるものは、その魂が持っていた価値よりもかならず少ない……」	PRINTFORMW 「通过消费灵魂所得到的东西、一定比其灵魂所拥有的价值更少……」
PRINTFORMW 「私のような悪魔が実際に存在しているにもかかわらず、この世の中では奇跡が起きず、悲しみが絶えないことには……そういった理由があるのです」	PRINTFORMW 「尽管有像我这样的恶魔存在、但在这个世界上是没有奇迹的、悲伤不断……就是因为这样的理由」
PRINTFORMW 「そして残念ながら、今の人間の医学はこの問題を解決するどころか、認識することすら不可能……」	PRINTFORMW 「虽然很遗憾、但现在的人类医学不仅解决不了这个问题、甚至连认知到都不可能…」
PRINTFORMW 言いかけ、言葉を切った%CALLNAME:FINDCHARA(NO, 1)%がくいっと腰をひねり、	PRINTFORMW 说到这里、%CALLNAME:FINDCHARA(NO, 1)%把腰一扭。
PRINTFORMW 「ですがここに抜け道があります」	PRINTFORMW 「但是、这里有个捷径」
PRINTFORMW 「いま私がしようとしていること、それはあなたを『吸精体質』にすることなのですよ」	PRINTFORMW 「现在我要做的事、就是把她变成“吸精体质”」
PRINTFORMW サキュバスのように、と%CALLNAME:FINDCHARA(NO, 1)%が付け加える。	PRINTFORMW 宛如魔女一样、%CALLNAME:FINDCHARA(NO, 1)%补充道。
PRINTFORMW 「要は発想の転換です。器からは徐々に水が漏れる。そして器を直すことは難しい。けれども――」	PRINTFORMW 「总之就是换个思路、一个不停漏水的容器、想修理好是很难的。但是」
PRINTFORMW 「……器に、新たな水を注ぐことはできるのですよ。こぼれてしまった水は、また汲めばいいのです」	PRINTFORMW 「只要不停的往容器里注入新的水、把漏掉的水不停补上就好了」
PRINTFORMW それが可能ならば簡単な話ですね。とつぶやいて、%CALLNAME:FINDCHARA(NO, 1)%は%CALLNAME:MASTER%の方を見る。	PRINTFORMW 如果想要的话、那很简单啊。自言自语、%CALLNAME:FINDCHARA(NO, 1)%向%CALLNAME:MASTER%的方向看来。
PRINTFORMW 「そしてその水源となるのは……もう、言わなくてもおわかりですよね、ご主人様？」	PRINTFORMW 「然后要成为那个水源的就是……已经不用说了也明白吧、主人？」
PRINTFORMW 「……フフ、どうですかこのプラン。諸手を挙げて賞賛していただいてもよろしいのですよ」	PRINTFORMW 「……呵呵、这个计划怎么样？可以举双手赞赏哦」
PRINTFORMW ということで……と、%CALLNAME:FINDCHARA(NO, 1)%がこほんと咳払いをする。	PRINTFORMW 因此、%CALLNAME:FINDCHARA(NO, 1)%剧烈咳嗽起来
PRINTFORMW 「ご主人様には、妹さんとセックスをしていただきます。魂の授受は性交を通じて行うのがもっとも手軽ですからね」	PRINTFORMW 「请主人和妹妹做爱。灵魂的授受通过性交进行是最简单的」
PRINTFORMW 「――とはいえ実のご%NAMES("兄弟")%です。抵抗はあって当然ですし、心を決めるのに多少時間は必要でしょう」	PRINTFORMW 「――话是这么说毕竟是现实的%NAMES("兄弟")%。有心理上的抵触是肯定的、下决心多少还是要点时间」
PRINTFORMW 「ですので今回は特別に、私が少しだけ手助けをしてあげます。当面の生命力に関してはご心配なく」	PRINTFORMW 「所以这次我特别帮你。目前的生命力您不必担心」
PRINTFORMW 「ですがご主人様？　覚悟はお早めに決めたほうがよろしいですよ。色々な意味で……フフ」	PRINTFORMW 「但是主人？你最好早点下决心。各种意义上呢……哼哼」
PRINTFORMW 「……あの」	PRINTFORMW 「……那个」
PRINTFORMW 「えっと、その、わ、わたしは気にしませんから、%CNAME("二人称")%さえ……よければ」	PRINTFORMW 「那个、我、我不介意的、%CNAME("二人称")%……如果可以的话」
PRINTFORMW 「わたしに……えっちなこと、してください……」	PRINTFORMW 「对我……做H的事情、可以哦……」
PRINTFORMW 「……おっといけません、忘れるところでしたご主人様」	PRINTFORMW 「……哎呀、差点忘了告诉主人」
PRINTFORMW 「生命力を注ぎ込むにはペニスが必要ですので、その点お忘れなきようお願いしますね」	PRINTFORMW 「注入生命力需要肉棒、这一点请不要忘记哦」
PRINTFORMW 「どうすればいいか……ですか？　ええ、魂を少々いただければ私がすぐに用意いたしますので、その点はご心配なく」	PRINTFORMW 「怎么办才好呢……是吗？是的、如果您能给我一点灵魂、我会马上准备好的、这一点您不必担心。」
PRINTFORMW %CALLNAME:ARG%は%CALLNAME:MASTER%の"実妹"であると共に、"同棲中"となります。	PRINTFORMW %CALLNAME:ARG%以%CALLNAME:MASTER%“亲妹妹”的身份、变成“同居中”的状态了。
PRINTFORML 一見、淡い色使いの家具で統一された女の子らしい部屋で、小さいころ買ってもらった人形やぬいぐるみが今でも飾られている。	PRINTFORML 乍一看、在用淡色的家具装饰起来的女孩子风格的房间里、还装饰着小时候买的玩偶和布娃娃。
PRINTFORML だがよく見ると部屋の壁は三面どこを見ても本棚が並んでいて、目隠しの裏は色とりどりの背表紙がぎっしり詰まっている……。	PRINTFORML 但是、仔细一看、房间的三面墙壁都是书架、障眼法的书套的里面藏着的花花绿绿的见不得人的书籍……。
PRINTFORMW 深夜。草木すらも静かに眠る丑三つ時の%CALLNAME:MASTER%の部屋に、三つの人影があった。	PRINTFORMW 深夜。万籁俱寂的半夜三更的%CALLNAME:MASTER%卧室、有三个人影在。
PRINTFORMW 窓から見える月は真円。こころなしか赤みを帯びた妖しげな月光に紅々と照らし上げられ、室内には異様な空気が立ちこめている。	PRINTFORMW 窗外的月亮正圆。被赤红色的妖异月光映照得通红，室内笼罩着异样的气氛。
PRINTFORMW まだ日も高い昼休み。休み時間を謳歌する学生たちの喧噪から魔術的に切り離された%CALLNAME:MASTER%の部室は、真っ暗な暗闇に包まれていた。	PRINTFORMW 太阳高照的午休时间。%CALLNAME:MASTER%的部室被魔术性地从歌颂休息时间的学生们的喧嚣中分离出来，笼罩在一片漆黑的黑暗中。
PRINTFORMW すべての窓には真っ黒な遮光カーテンが重々しく下ろされ、光の射し込む隙間はどれも、偏執的な几帳面さでもってぴっちりと目張りをされている。	PRINTFORMW 放下黑色厚实的遮光窗帘盖住所有窗户，光能照进去的缝隙，都因为偏执而一丝不苟的紧闭着。
PRINTFORMW 「さぁ、ちゃっちゃと始めましょうか」	PRINTFORMW 「那么、让我们开始吧。」
PRINTFORMW ロウソクに火をともしながら、雰囲気をまるで意に介さない声をあげたのは%CALLNAME:FINDCHARA(NO, 1)%だ。	PRINTFORMW 点燃蜡烛的同时、%CALLNAME:FINDCHARA(NO, 1)%发出了对气氛毫不介意的声音。
PRINTFORMW 「うぅぅ……緊張します……」	PRINTFORMW 「呜呜~……我很紧张……」
PRINTFORMW 小動物のように縮こまり、言葉の端々を震えさせているのは%CALLNAME:MASTER%の妹の%CALLNAME:TARGET%。	PRINTFORMW 像小动物一样蜷缩、话里话外都颤抖着的是%CALLNAME:MASTER%的妹妹、%CALLNAME:TARGET%。
PRINTFORMW 床に敷かれた巨大なＡ０版の紙とそこに刻まれた魔方陣の中心に、彼女は全裸で横たわっていた。	PRINTFORMW 一张巨大的A0纸铺在地板上、上面刻着的魔方阵的中心、她全身赤裸的躺在其上。
PRINTFORMW ロウソクの淡い光を浴びて輝く裸体には、いわゆる黒魔術的な文様が全身に刻まれている。	PRINTFORMW 闪耀着光辉的裸体沐浴在淡淡的烛光中、全身都刻着所谓的黑魔术般的花纹。
PRINTFORMW %CALLNAME:MASTER%がその滑らかな肌に見とれていると、%CALLNAME:FINDCHARA(NO, 1)%が小さく口を開き、静かに語り始めた。	PRINTFORMW %CALLNAME:MASTER%被那光滑的稚嫩肌肤所吸引、%CALLNAME:FINDCHARA(NO, 1)%微微张开嘴巴，开始低语起来。
PRINTFORMW 何を喋っているのかはよくわからない。日本語でも英語でもない知らない言葉だが、ときおり既知の言葉が混ざっているかのように聞こえることもあった。	PRINTFORMW 听不懂在说什么。既不是日语也不是英语、有时听起来像是混杂着已知的语言。
PRINTFORMW それが十数分も続いたころだろうか。彼女はやにわに口を閉じると、	PRINTFORMW 那大概是持续了十几分钟的时候吧。她突然闭上嘴、
PRINTFORML 「……めんどくさいので以下省略です。えいっ」	PRINTFORML 「……因为太麻烦了以下省略。哎！」
PRINTFORMW おかしなことをのたまった。	PRINTFORMW 发生了诡计的景象呢。
PRINTFORMW 子供向けの魔法少女のようなポーズを取る彼女の姿に、ツッコミも忘れてずっこける。	PRINTFORMW 看着她摆出面向小孩的魔法少女的姿势、我忘记吐槽的摔倒在地。
PRINTFORMW 「そ……そんなことしていいんですか？」	PRINTFORMW 「这……这样就行了？」
PRINTFORMW %CALLNAME:TARGET%も同様だったのか、胸や股間を隠すことも忘れた呆然とした表情で一言。	PRINTFORMW %CALLNAME:TARGET%也有同感吗、忘记遮挡胸前和股间、目瞪口呆地说着。
PRINTFORMW その質問に対して%CALLNAME:FINDCHARA(NO, 1)%の方はといえば悪びれもせず、	PRINTFORMW 对于质问、%CALLNAME:FINDCHARA(NO, 1)%毫不羞愧地回答：
PRINTFORMW 「ええ、今までやってたのはただのサービスでして。せっかくの機会ですので悪魔らしいところを少しお見せしておきましょうか、と」	PRINTFORMW 「哎、到现在为止我做的只是服务。机会难得、要不让你们见识一下恶魔的样子吧、这样」
PRINTFORMW ――本当は必要な魂さえあれば一瞬なんですけどね。などと、にこやかにそう言ってのける。	PRINTFORMW ――本来的话、有必要的灵魂只需要一瞬间就可以了。等等，笑嘻嘻地这么说着。
PRINTFORMW そうだった……この悪魔はどうにもこう天然というか、お茶目なところがあるのだった……。	PRINTFORMW 没错……这个恶魔怎么也算是天然呆、有着爱开玩笑的一面……。
PRINTFORMW 言われて思い返してみれば、今までのお願いではこんな大がかりなことをしたことはない。	PRINTFORMW 被这么一说，回想起来，至今为止的愿望中还没有这样程度的。
PRINTFORMW 重い沈黙があたりに満ちる。頭を抱えたい気分だった。	PRINTFORMW 沉静充斥在周围。好想抱头啊。
PRINTFORMW 「あ、でも全くの無駄ではないんですよ？」	PRINTFORMW 「啊、但是这并不完全是浪费喲？」
PRINTFORMW 「%CALLNAME:TARGET%さんに刻んだ文様のおかげで、リーズナブルな量の魂で術を施せましたから」	PRINTFORMW 「多亏了铭刻在%CALLNAME:TARGET%身上的花纹、能用合理数量的灵魂来施术」
PRINTFORMW そう言われて%CALLNAME:TARGET%を見てみれば、身体をびっしり埋め尽くしていたはずの模様が綺麗さっぱりなくなっている。	PRINTFORMW 这么一说，看向%CALLNAME:TARGET%、发现本来布满全身的花纹消失干净了。
PRINTFORMW 「さぁ、今使った分はツケにしておいてあげますから、なるべく早いうちに魂を注ぎ込んであげてくださいね」	PRINTFORMW 「好了、现在用的东西我会付清的、请尽早给她注入灵魂吧。」
PRINTFORMW とん、と背中を押され前につんのめる。なぜか力が抜けた膝がカクンと折れて、座り込んだままの%CALLNAME:TARGET%を押し倒すような形になった。	PRINTFORMW 扑通、被推着背往前。不知为何膝盖弯曲下去、变成了把坐起来的%CALLNAME:TARGET%推倒的姿势。
PRINTFORMW 「まさか%CNAME("二人称")%とこんなことをする関係になるなんて……」	PRINTFORMW 「没想到会和%CNAME("二人称")%发生这种事……」
PRINTFORMW 「か、考えたこともありません、でしたよ？」	PRINTFORMW 「啊、我从没想过、的喲？」
PRINTFORMW 何故そこで詰まって目をそむける、と心で突っ込みを入れながら%CALLNAME:MASTER%は%CALLNAME:TARGET%に覆い被さった。	PRINTFORMW 为何在那里嘟的转过眼去、%CALLNAME:MASTER%一边在心里吐槽，一边压向%CALLNAME:TARGET%。
PRINTFORMW 「や、やさしくしてくださいね……」	PRINTFORMW 「请、请温柔一点哦……」
PRINTFORMW 「%CNAME("二人称")%にこうやって優しくされてると、変になっちゃいそうです……」	PRINTFORMW 「%CNAME("二人称")%这样温柔的话、我会变得奇怪起来的……」
PRINTFORMW 「いけないことしてるって、どんどんおかしくなっちゃってるってわかってるのに……」	PRINTFORMW 「明明知道自己在做不应该做的事、变得越来越奇怪了……」
PRINTFORMW 「もっともっとしてほしいって思っちゃうんです」	PRINTFORMW 「就会想渴望更多更多这样」
PRINTFORMW 「ほら……私の胸、触ってみてください、今もこんなにどきどきして……」	PRINTFORMW 「嚯啦……我的胸口、请摸摸看、现在也这么扑通扑通的……」
PRINTFORMW 「――ひゃうっ！？」	PRINTFORMW 「――呀啊！？」
PRINTFORMW 「あ……えっと、ごめんなさい。こういう風に触られるのって、慣れてなくって」	PRINTFORMW 「啊……那个、对不起。像这样被摸着、我不太习惯」
PRINTFORMW 「うぅ、ちょっとしばらく顔は見ないでください……恥ずかしい……」	PRINTFORMW 「呜、请暂时不要盯着脸看……很难为情……」
PRINTFORMW 「ずっと撫でられてるだけなのに、こんな、イっちゃいそうになるなんてこと……」	PRINTFORMW 「明明只是一直被抚摸着、这样、要变糟糕了……」X﹏X
PRINTFORMW 「わたし、そんないやらしい子じゃないもん……。んぅっ、はぁ……っ」	PRINTFORMW 「我、才不是那种放荡的孩子呢……。呜、啊……啊」
PRINTFORMW 「んぅっ！」	PRINTFORMW 「呜嗯！」o((⊙﹏⊙))o
PRINTFORMW 「そこだめっ、お腹の印さわるのだめですっ」	PRINTFORMW 「那里不行、不可以摸肚子上的印」
CALL PRINT_STR, @"「やっあっ、あっ、あっあっあっ、あぁっ、んくぅぅっ_H_」_W"	CALL PRINT_STR, @"「呀啊、啊、啊啊啊、啊啊、呜嗯~_H_」_W"
PRINTFORMW 下腹部に\@ MARK:淫紋 >= 2 ? 刻まれた淫紋 # 貼られたシール \@を軽く撫でただけで、%CALLNAME:TARGET%は全身をびくびくと快感に震わせてしまっている……。	PRINTFORMW 只是轻轻地抚摸在下腹部\@ MARK:淫紋 >= 2 ? 刻下的淫纹 # 贴上的贴纸 \@、%CALLNAME:TARGET%就全身颤抖得直哆嗦……。
PRINTFORMW （あぁ……っ！　%CNAME("二人称")%の手すっごくいいよぉ……）	PRINTFORMW （啊……啊！　%CNAME("二人称")%的手好棒……）
PRINTFORMW （好き、好きっ、%CNAME("二人称")%大好きっ！　もっと、もっともっと%CNAME("一人称")%のこと気持ちよくしてぇっ！）	PRINTFORMW （喜欢、喜欢、最喜欢%CNAME("二人称")%了！　更多、请让%CNAME("一人称")%更加更加舒服！）
PRINTFORMW 「%CNAME("二人称")%にしてもらうって考えただけで、わたし……」	PRINTFORMW 「只是想着%CNAME("二人称")%、我……」
PRINTFORMW 「さっきから心臓がどきどきして、頭がぼーっとなって、胸がきゅーってなるんです……」	PRINTFORMW 「从刚才开始心脏就扑通直跳、头昏脑胀、胸口紧绷绷的……」
PRINTFORMW 「どうしちゃったのかな……わたし、おかしくなっちゃったのかな……」	PRINTFORMW 「到底是怎么了……我、是不是变得奇怪了……」
PRINTFORMW 「やっ、わたしの身体っ、こんなに敏感じゃなかったはずなのに……っ」	PRINTFORMW 「呀、我的身体、应该没有这么敏感的……呼」
PRINTFORMW 「ちがっ、わたしっ、こんないやらしくなんか……んぅぅっ！？」	PRINTFORMW 「不对、我、这么淫荡的吗……唔嗯！？」
PRINTFORMW （たりない、よぉ……っ、もっと、もっとめちゃくちゃにしてほしいよぉっ）	PRINTFORMW （不够、喲……啊~、更多、想要更加乱七八糟喲）
PRINTFORMW （やぁっ！　だめ、だめだめこんなこと絶対言っちゃだめっ！　我慢しなきゃいけないのにぃ……っ）	PRINTFORMW （呀啊！　不要、不行不行绝对不能说这种话！　必须忍耐才行啊……呼）
PRINTFORMW 「%CNAME("一人称")%のこと、ん……っ、慣らしてくださいっ」	PRINTFORMW 「%CNAME("一人称")%的这里、唔……~、习惯起来啊」
PRINTFORMW 「%CNAME("二人称")%のお好きなように……。だってわたし、%CNAME("二人称", "かな")%専用、ですから……っ」	PRINTFORMW 「随%CNAME("二人称")%喜欢的那样……。因为我是、%CNAME("二人称", "かな")%专用、的啦……~」
PRINTFORMW 「んく……っ、ふぅっ、ふっ、はぁっ」	PRINTFORMW 「嗯哼……、呼嗯、呼、哈啊」
PRINTFORMW 「あんまり、見ないでください……。恥ずかしい、ですっ」	PRINTFORMW 「太激烈了、请不要看……。好难为情、的说」
PRINTFORMW %CALLNAME:MASTER%が%CALLNAME:TARGET%に向けて両手を伸ばすと、びくんと%CALLNAME:TARGET%の身体が震えた。	PRINTFORMW %CALLNAME:MASTER%向着%CALLNAME:TARGET%伸出双手、%CALLNAME:TARGET%的身体稍微的在颤抖。
PRINTFORMW 「あの、ごめんなさい……」	PRINTFORMW 「那个、对不起……」
PRINTFORMW 「%CNAME("二人称")%のことは好きですし、信じているんですけど、身体が勝手にびくっとしちゃって……」	PRINTFORMW 「%CNAME("二人称")%的这个是喜欢的、虽然相信着、但身体却擅自吓了一跳……」
PRINTFORMW 「大丈夫です。%CNAME("二人称")%のこと、信じてますから……」	PRINTFORMW 「没问题的。%CNAME("二人称")%的这个、我相信……」
PRINTFORMW 「%CNAME("二人称")%はいつだって、%CNAME("一人称")%のことを大事に思ってくれているって」	PRINTFORMW 「%CNAME("二人称")%总是这样、一直都很珍视着%CNAME("一人称")%」
PRINTFORMW 「だから%CNAME("一人称")%のこと、%CNAME("二人称")%の好きなように、していいんですよ……」	PRINTFORMW 「所以说、%CNAME("一人称")%的这里、随%CNAME("二人称")%喜欢的那样做也可以喲……」
PRINTFORMW 「おしりで気持ちよくなるなんて、おかしなことなのに……っ」	PRINTFORMW 「用屁股舒服什么的、明明是很奇怪的事情……」
PRINTFORMW 「はぁ……んくっ、あっ……んっ、くふっ」	PRINTFORMW 「哈啊……嗯库、啊……嗯、库哼~」
PRINTFORMW 「やだぁっ、もっと……してほしくなっちゃ……んぅっ」	PRINTFORMW 「讨厌、更多……变得想要了……呃嗯」
PRINTFORMW 「ふっ……んっ、はぁっ、ふっ、んぅっ……」	PRINTFORMW 「哼……嗯、哈啊、哼、嗯呜……」
PRINTFORMW 「これを続けてたら……んっ、お尻に%CNAME("二人称")%のおちんちんが入るようになるんですか……？」	PRINTFORMW 「继续这样的话……嗯哼、%CNAME("二人称")%想把鸡鸡放进屁股里吗……？」
PRINTFORMW 「%CNAME("二人称")%が喜んでくれるなら、わたしは……いい、ですけど」	PRINTFORMW 「%CNAME("二人称")%喜欢的话、我……可以的、但是说」
PRINTFORMW 「い、いっぱいえっちなことしないといけないですもんね……。これは仕方のないことなんです……」	PRINTFORMW 「必、必须做更多色色的事情呢……。这是没办法的事……」
PRINTFORMW 口ではそう言うものの、%CALLNAME:TARGET%の細い喉がごくりと生つばを飲み込んだのを%CALLNAME:MASTER%は見逃さなかった……。	PRINTFORMW 虽然嘴上那么说、%CALLNAME:TARGET%纤细的喉咙咕噜地吞咽了一下，%CALLNAME:MASTER%并没有看漏……。
PRINTFORMW 「ひゃあぁっ！？」	PRINTFORMW 「咿呀啊！？」
PRINTFORMW 「%CNAME("二人称", "どもり")%っ！？　どこっ、いまっ、今どこさわりました！？」	PRINTFORMW 「%CNAME("二人称", "どもり")%！？　哪里、现在、现在在摸哪里！？」
PRINTFORMW 「えっと、えっと、あの、お尻の……お尻の穴っ、さわりましたよねっ」	PRINTFORMW 「那个、那个、那里、屁股的……屁眼、你摸了是吧？」
PRINTFORMW 「だめですよもぅ、そんなきたないところ……」	PRINTFORMW 「不行的啊、那种肮脏的地方……」
PRINTFORMW 「うぅ……いえ、確かに知識としてはそういうことも知ってはいますけど……」	PRINTFORMW 「呜……不是、确实作为知识那样的事也知道，不过……」
PRINTFORMW 「お尻であれば赤ちゃんができる心配もないですけど……」	PRINTFORMW 「虽然屁股的话也不用担心会怀孕……」
PRINTFORMW 「うー、うぅー、うぅぅぅー」	PRINTFORMW 「呜ー、呜呜ー、呜呜呜ー」
//段落
//PRINTFORM 顔を	PRINTFORM 把脸
//PRINTFORM 枕にうずめて	PRINTFORM 埋在枕头里
//PRINTFORM 両手で覆って	PRINTFORM 用双手覆盖
PRINTFORMW うめき声をあげ始めた%CALLNAME:TARGET%をよそに、%CALLNAME:MASTER%は固く閉じた尻穴を丹念にほぐし続けた……。	PRINTFORMW 不顾开始呻吟的%CALLNAME:TARGET%、%CALLNAME:MASTER%继续仔细地蹂弄着紧闭的屁股穴……。
PRINTFORMW 「おかしいですよね、順序が逆ですよね」	PRINTFORMW 「很奇怪的吧、顺序颠倒了吧」
PRINTFORMW 「普通こういう風に細い指から徐々に慣らしてから大きいものを入れるべきですよね」	PRINTFORMW 「一般来说，先从小点的手指开始习惯，然后放入更大的东西是吧」
PRINTFORMW 「そもそもお尻にものを入れること自体が普通じゃないですけど……」	PRINTFORMW 「话说回来，在屁股里放东西本身就是不寻常的……」
PRINTFORMW 「いつ、までっ、してるんですかぁ……」	PRINTFORMW 「一直、一直、做下去吗……」
PRINTFORMW 「あぅ……んんっ、はっ……あっ、あぁっ」	PRINTFORMW 「啊呜……嗯嗯、哈……啊、啊啊」
PRINTFORMW 「おしりがじんじんしてきて……もうっ、だめですっ、変な気分になっちゃいますからぁっ」	PRINTFORMW 「屁股里抽搐着……已经、不行了、心绪变得奇怪了啊」
PRINTFORMW 「う、うぅ……はしたない子だって、思わないでくださいね……っ」	PRINTFORMW 「呜、呜呜……请不要认为我是不捡点的孩子哦……っ」
PRINTFORMW 「んぅ……っ、くっ、あ……あっ、あぅぅっ」	PRINTFORMW 「呜嗯……、库、啊……啊啊、啊啊啊」
PRINTFORMW 「%CNAME("二人称")%の指が……奥まで、ぐりぐりって……あぁっ」	PRINTFORMW 「%CNAME("二人称")%的手指……到深处了、咕哩咕哩的……啊啊~」
PRINTFORMW 「やぁ……んっ、腰が勝手に動いちゃ……はぁぁっ」	PRINTFORMW 「呀啊……嗯哼、腰擅自动起来了……哈啊啊~」
PRINTFORMW 「あ……！　はっ、んぅ……っ、はっ、あぅ……」	PRINTFORMW 「啊……！　哈啊、嗯……、哈啊、呜嗯……」
PRINTFORMW 「は、あぁ……っ、こんなところで気持ちよくなるなんて、普通じゃないはずなのに……」	PRINTFORMW 「啊、啊啊……、没想到这种地方也会变得舒服、明明是不正常的……」
CALL PRINT_STR, @"「%CNAME("二人称")%にされてるって思うと、それだけで、もう……んぅぅっ_H_」_W"	CALL PRINT_STR, @"「一想到被%CNAME("二人称")%这样对待、仅仅如此、已经……嗯嗯~_H_」_W"
PRINTFORMW 「わたしっ、そんなえっちな子じゃないのに……っ」	PRINTFORMW 「我、明明不是那么色的孩子……的」
PRINTFORMW 「おしりの穴がっ、なんだかびりびりして……っ」	PRINTFORMW 「屁股的小穴、总觉得麻麻的……っ」
PRINTFORMW 「やぁっ、これ以上いじられたら、変な気分になっちゃいそうですっ」	PRINTFORMW 「呀啊、如果再被这样欺负的话、感觉会变得很奇怪」
PRINTFORMW 「一応、綺麗にはしているつもりですけど……。うぅ、やだもう恥ずかしい……」	PRINTFORMW 「姑且、本来是打算弄干净的……。呜嗯、讨厌、好害羞……」
PRINTFORMW 「抜いたらすぐに手を拭いて、終わったらちゃんと洗ってくださいね」	PRINTFORMW 「拔掉后马上擦手、结束后请好好洗哦」
PRINTFORMW 「匂いとかかいだら絶対ダメですからね、いくら%CNAME("二人称")%でも許しませんよ」	PRINTFORMW 「品尝什么的绝对不行、就算是%CNAME("二人称")%也不可以喲」
PRINTFORMW 「うぅぅ、%CNAME("一人称")%のお菊门、どうなっちゃうんでしょう」	PRINTFORMW 「呜呜~、%CNAME("一人称")%的屁眼、会变成什么样呢」
PRINTFORMW 「いずれどんどん大きくなって、そのうち閉じなくなっちゃったりとか……」	PRINTFORMW 「会渐渐地越来越大、不久就关不上什么的……」
PRINTFORMW 「それは困ります、すごく困ります……」	PRINTFORMW 「那会很困扰的、非常困扰……」
PRINTFORMW 「ん……そうですよね。まさか%NAMES("兄弟")%でその、赤ちゃんができるようなことをするわけにもいきませんし」	PRINTFORMW 「呜……也是啊。万一%NAMES("兄弟")%的那个、做了会生小孩的事情的话」
PRINTFORMW 「お尻でもできるようにしたいんですか？　もう、しょうがないですね……」	PRINTFORMW 「想让屁股也能做吗？　已经、拿你没办法啦……」
PRINTFORMW 「いいですよ%CNAME("二人称")%。%CNAME("一人称")%のお尻、使えるようにしてください……」	PRINTFORMW 「可以喲%CNAME("二人称")%。%CNAME("一人称")%的屁股、请尽情使用吧……」
PRINTFORMW 「けど、できたらその、お手柔らかにお願いします」	PRINTFORMW 「但是、如果可以的话、请手下留情」
PRINTFORMW 「ん……っ、ふっ、んくっ、はっ、ふっ、はぁっ」	PRINTFORMW 「嗯……、呼、嗯库、哈、呼、哈啊」
PRINTFORMW 「あぅっ、あっ、んっ、んふっ……あぁっ、あっ、あっ……」	PRINTFORMW 「啊呜、啊、嗯、嗯哼……啊啊、啊、啊……」
PRINTFORMW 「やぁ、これ以上はだめです……っ、もう見ないでくださ……あっ、あぁっ！」	PRINTFORMW 「呀啊、别这样……、不要再看下去了……啊、啊啊！」
PRINTFORMW （%CNAME("二人称")%に見られてるっ、私が両手でおまんこぐちゅぐちゅして、びゅーびゅーあふれてるとこ見られてるぅっ！）	PRINTFORMW （被%CNAME("二人称")%看见了、我双手欺负着的小穴、哔哔地流水的这里被看见了！）
PRINTFORMW （だめっ、いつもとぜんぜんちがうのっ、指が止まらな……あぅっ！？）	PRINTFORMW （不行、和平时完全不一样、手指停不下来……啊呜！？）
PRINTFORMW 「あっ、あっ、やだきちゃうっ！　すごいのっ、一人でするよりずっとすごいのきちゃうぅっ！」	PRINTFORMW 「啊、啊、讨厌呀！　好棒、比一个人做要更加舒服呜呜！」
PRINTFORMW 「みないでっ、みないでぇっ！　やぁっ、こんなのだめぇっ！」	PRINTFORMW 「不许看、不许看啊！　呀啊、不行了呜！」
CALL PRINT_STR, @"「あっ、あぁっ……あっ、あぅっ……んぅぅぅぅぅ～～っ_H_」_W"	CALL PRINT_STR, @"「啊、啊啊……啊、啊呜……嗯呜呜呜呜呜～～_H_」_W"
PRINTFORMW 「――んはぁっ、はっ、はふっ、はぁ……はぁ……っ」	PRINTFORMW 「嗯……哈啊、哈、哈呼、哈啊……哈啊……」
PRINTFORMW 「あ……あぁ、ぁ……やだぁ……おしっこ、でちゃってる……ぅ……」	PRINTFORMW 「啊……啊啊、啊……不要啊……尿、尿出来了……唔……」
PRINTFORMW 「なんでっ、こんなっ、やぁ……%CNAME("二人称")%の視線が……あっ、あぁ……っ」	PRINTFORMW 「为什么会、这样的、呀啊……%CNAME("二人称")%的视线……啊、啊啊……」
PRINTFORMW 「見ないでください……っ、見られてるところが、熱くて……はぁっ」	PRINTFORMW 「请不要看……被盯着看的地方、好烫……哈啊」
CALL PRINT_STR, @"「視線だけでイっちゃう、えっちな子になっちゃうよぉ……んぅぅっ_H_」_W"	CALL PRINT_STR, @"「光是视线就要去了、色色的孩子要去了喲……嗯呜呜_H_」_W"
PRINTFORMW 「え、ええっ？　%CNAME("一人称")%が自分で、その……してるところ、見たいんですか？」	PRINTFORMW 「哎、哎哎？　%CNAME("一人称")%自己的、那个……正在做的地方、想看？」
PRINTFORMW 「だめっ、だめですよそんなのっ、恥ずかしすぎて死んじゃいます……」	PRINTFORMW 「不行、那可不行喲、羞死人了……」
PRINTFORMW 「そんなに見たいんですか？　どうしても……？」	PRINTFORMW 「那么想看吗？　无论如何也要……？」
PRINTFORMW 「う、うぅー、うぅぅー」	PRINTFORMW 「唔、唔唔ー、呜呜呜ー」
PRINTFORMW 「わかりました……。見せてあげますから、そんながっかりした顔しないでください……」	PRINTFORMW 「明白了……。会给你看啦、请不要一脸失望的表情……」
PRINTFORMW 「ん……っ」	PRINTFORMW 「嗯……」
PRINTFORMW 「あ、そういえば……%CNAME("一人称", "かな")%ヘンなことしてませんよね？」	PRINTFORMW 「啊、话说……%CNAME("一人称", "かな")%并不是做奇怪的事情吧？」
PRINTFORMW 「昔一度間違えて、おしっこの穴に指を入れちゃったことがあって……」	PRINTFORMW 「以前一度搞错、曾把手指放进尿尿的洞里去……」
PRINTFORMW 「カテーテルを入れた経験は何度かあったので、それでつい」	PRINTFORMW 「导尿管插入过几次这样、不知不觉就……」
PRINTFORMW 「……あ」	PRINTFORMW 「……啊」
PRINTFORMW 「いや、いやいやそんなに昔じゃないですよ最近です最近。昔からえっちなことばかりしてたなんてことは決して」	PRINTFORMW 「不是、不是不是、并不是很久以前、最近啦最近。绝不是很早以前就开始做这样色色的事情呢」
PRINTFORMW 「入れる先を間違えたのもカテーテル入れるのが気持ちよかったとかいうことではなくて」	PRINTFORMW 「并不是说之前搞错进入尿道的导管感觉很舒服啦」
PRINTFORMW 「うぅ、%CNAME("二人称")%が信じてない顔をしてます……」	PRINTFORMW 「呜呜、%CNAME("二人称")%一脸不信的样子……」
PRINTFORMW 喋るたびに墓穴を掘る姿を眺めながら、%CALLNAME:MASTER%は%CALLNAME:TARGET%の自慰を楽しんだ……。	PRINTFORMW 看着她每次发言总是自掘坟墓的姿态、%CALLNAME:MASTER%欣赏着%CALLNAME:TARGET%的自慰PLAY……。
CALL PRINT_STR, @"「%CNAME("二人称", "かな")%……んぅっ_H_　まだ続けなきゃ、だめですか……？_H_」_W"	CALL PRINT_STR, @"「%CNAME("二人称", "かな")%……嗯唔_H_　还得继续下去吗……？_H_」_W"
CALL PRINT_STR, @"「はい、わかりました……っ_H_　もっといっぱい、イきます……ね……_H_」_W"	CALL PRINT_STR, @"「是、我知道了……_H_　还要更多、开始……吧……_H_」_W"
PRINTFORMW （%CNAME("二人称")%がえっちな目で見てる……固くなってる乳首も、\@TALENT:ふたなり ? ガチガチのおちんちんも、#\@ぐちゅぐちゅいやらしい音してるあそこも、みんな見られてる……）	PRINTFORMW （被%CNAME("二人称")%色色的目光看着……变硬的乳头、\@TALENT:ふたなり ? 还有硬邦邦的鸡鸡、#\@咕洽咕洽的发出下流声音的那里也、全都被看见了……）
PRINTFORMW （いつも一人でしてるときの、だらしない顔も……んんっ）	PRINTFORMW （一直自慰时的不检点表情也……嗯嗯）
PRINTFORMW （%CNAME("二人称")%もわたしで興奮してくれてるのかな、やらしい気分になってくれてるのかな……）	PRINTFORMW （%CNAME("二人称")%也变兴奋了吧、会觉得我很下流吧……）
PRINTFORMW 「ふっ、はぅっ……あっ……はぁぁっ」	PRINTFORMW 「哼、哈呜……啊……哈啊啊」
CALL PRINT_STR, @"「はぁっ、%CNAME("二人称")%に見られてる以外……いつもとなにも変わらないはずなのに……んっ_H_」_W"	CALL PRINT_STR, @"「哈啊、除了被%CNAME("二人称")%看着以外……明明和平时一样的……嗯_H_」_W"
CALL PRINT_STR, @"「こんなのっ、へんですっ、おかしいです……！　あぁぁっ_H_」_W"	CALL PRINT_STR, @"「这样的、好奇怪、太反常了……！　啊啊啊_H_」_W"
PRINTFORMW （あぁ……ぁ……だめ、%CNAME("二人称")%にお願いされると断れないよぉ……）	PRINTFORMW （啊啊……啊……不行、被%CNAME("二人称")%请求的话无法拒绝喲……）
PRINTFORMW （%CNAME("二人称")%の言うとおりにすれば、後でいっぱい気持ちよくしてもらえるもん……）	PRINTFORMW （照%CNAME("二人称")%说的做的话、之后也会变得很舒服吧……）
PRINTFORMW 「やぁっ……まだ触ってもないのに身体が勝手にぞくぞくしちゃう……」	PRINTFORMW 「呀啊……明明还没摸身体却擅自颤抖起来了……」
PRINTFORMW （こんなのだめ……見られて濡れちゃうなんて、%CNAME("二人称")%にいやらしい子だって幻滅されちゃいます……）	PRINTFORMW （这样不行……被看着就湿了什么的、被%CNAME("二人称")%知道我是下流女孩的话会幻灭的……）
PRINTFORMW 「だめです%CNAME("二人称")%っ……やぁっ、お願いですから見ないでくださいっ」	PRINTFORMW 「不要啊%CNAME("二人称")%……呀啊、求你了请不要看」
PRINTFORMW （いけないのにっ、どうしてこんな……指が止まらないの……？）	PRINTFORMW （明明不可以的、为什么却那么……手指停不下来……？）
PRINTFORMW 「ぅん……っ、ふっ、はっ、はぁ……っ」	PRINTFORMW 「呜嗯……、呼、哈、哈啊……」
PRINTFORMW 「い、いつまでしてたらいいんでしょう？　なんだかちょっと指がふやけてきた気がするんですけど……」	PRINTFORMW 「做、做到什么时候才好？　然而不知为何总觉得手指变得有点泡涨了……」
PRINTFORMW 「もうちょっと？　わかりました、しょうがないですね……んんっ」	PRINTFORMW 「还要一会儿？　知道了、真拿你没辙啊……嗯嗯」
PRINTFORMW 「そんなにまじまじと見られると……その、やりづらいです」	PRINTFORMW 「还要一会儿？　知道了、真拿你没辙呢……嗯嗯」
PRINTFORMW 「そんなにまじまじと見られると……その、やりづらいです」	PRINTFORMW 「那么目不转睛盯着的话……那个、很难做啊」
PRINTFORMW 「うぅぅ、とっても恥ずかしいんですけど……」	PRINTFORMW 「呜呜呜、会很害羞的……」
PRINTFORMW %CALLNAME:TARGET%は顔を赤くしながら、ぎこちない手つきで自慰を続けた……。	PRINTFORMW %CALLNAME:TARGET%脸颊羞红着、以僵硬起来的手势继续自慰……。
PRINTFORMW 「%CNAME("二人称", "どもり")%？　なんだか目が血走ってないですか……？」	PRINTFORMW 「%CNAME("二人称", "どもり")%？　总觉得眼睛是不是充血了……？」
PRINTFORMW 「んっ、やだもう……男の子ってみんなこうなんでしょうか」	PRINTFORMW 「呜嗯、讨厌……男孩子都是这样的吗？」
PRINTFORMW 「%CNAME("二人称")%以外の男性には特に興味ないですけど……うっ、何言ってるんでしょう%CNAME("一人称")%ったら」	PRINTFORMW 「对%CNAME("二人称")%以外的男性没有兴趣……呜、说什么呢%CNAME("一人称")%真是的」
PRINTFORMW 「恥ずかしいですけど……」	PRINTFORMW 「虽然很羞耻……」
PRINTFORMW 「%CNAME("二人称")%がそんな%CNAME("一人称")%を見たいと思ってくれてることは、ちょっと嬉しいです」	PRINTFORMW 「%CNAME("二人称")%想看到那样的%CNAME("一人称")%、稍微有点开心」
PRINTFORMW 「う、でもあんまりじろじろ見るのはだめですからね」	PRINTFORMW 「呜、但是不要老是盯着看啊」
PRINTFORMW ちょっとですよ、と%CALLNAME:TARGET%は%CALLNAME:MASTER%に念を押した。	PRINTFORMW 有点那个、%CALLNAME:TARGET%向%CALLNAME:MASTER%叮嘱着。
PRINTFORMW （ダメ、ダメだってばそんなことしたら……）	PRINTFORMW （不行、不行啊那样做的话……）
PRINTFORMW （でもっ、でも我慢するのつらいの……%CNAME("二人称")%に入れたいよぉっ）	PRINTFORMW （可、可是我忍耐得好辛苦……想让%CNAME("二人称")%的进来喲）
PRINTFORMW 「ごめんなさい%CNAME("二人称")%っ、もうだめ……っ」	PRINTFORMW 「对不起%CNAME("二人称")%、已经不行……了」
PRINTFORMW （まさか%CNAME("二人称")%に舐めてもらえる日が来るなんて）	PRINTFORMW （没想到有一天%CNAME("二人称")%会帮我舔鸡鸡）
PRINTFORMW （んんっ、あぁ……想像してたのよりずっと、気持ちいいよぉ……）	PRINTFORMW （嗯嗯、啊啊……比想像中的还要、舒服喲……）
PRINTFORMW 「だめっ……もう%CNAME("一人称")%っ、我慢できないです……っ！」	PRINTFORMW 「不行……了%CNAME("一人称")%、已经忍不住了……呜！」
PRINTFORMW 「やっ、ダメです%CNAME("二人称")%っ！　そんなの汚いですから……」	PRINTFORMW 「呀、不要啊%CNAME("二人称")%！　那里很脏的……」
PRINTFORMW （あぁ……%CNAME("二人称")%の中、柔らかくて、暖かくて、気持ちいい……）	PRINTFORMW （啊啊……%CNAME("二人称")%的里面、好柔软、好暖和、好舒服……）
PRINTFORMW （いつもいつも我慢してるのに、こんなことされたらっ、歯止めがきかなくなっちゃう……）	PRINTFORMW （明明一直一直忍耐着、那样的话、要控制不住了啊……）
PRINTFORMW 「ごめんなさい、%CNAME("二人称")%……%CNAME("一人称")%もう、我慢できなくって……」	PRINTFORMW 「对不起、%CNAME("二人称")%……%CNAME("一人称")%已经、忍不住了……」
PRINTFORMW 「んっ……！　あぁっ、%CNAME("二人称")%のお口におちんちん入れちゃいましたっ」	PRINTFORMW 「嗯……！　啊啊、鸡鸡进到%CNAME("二人称")%的嘴里去了」
PRINTFORMW 「はぁっ、あったかくて気持ちいい……腰が勝手に動いちゃいそうです……」	PRINTFORMW 「哈啊、暖暖的好舒服……腰自己动起来了好像……」
PRINTFORMW 「%CNAME("二人称")%に面と向かって見せるのはちょっと恥ずかしいというか……」	PRINTFORMW 「感觉跟%CNAME("二人称")%面对面看着有点难为情……」
PRINTFORMW 「え？　小さいころにしょっちゅう見た……って、いえその確かにそうではあるんですけど」	PRINTFORMW 「呃？　小时候经常能看到……不、虽然说是这样没错……」
PRINTFORMW 「う、うぅ……普通じゃないものを持って生まれた妹の気持ちをちょっとは察してください……」	PRINTFORMW 「呜、呜呜……请稍微体谅一下异于常人的妹妹的心情……」
PRINTFORMW 「しかもその、舐めるんですよね……？　%CNAME("一人称")%のを……」	PRINTFORMW 「而且那个、要舔是吧……？　%CNAME("一人称")%的那个……」
PRINTFORMW 「%CNAME("一人称")%だって舐めてる、ですか？　それは%CNAME("二人称")%のだったから気にならなかっただけですし……」	PRINTFORMW 「%CNAME("一人称")%也舔过你的、是吗？　那只是因为是%CNAME("二人称")%的所以不在意啦……」
PRINTFORMW 「……もう、気分が悪くなったらすぐにやめていいですからね」	PRINTFORMW 「……好吧、要是觉得恶心的话可以马上停下来哦」
PRINTFORMW 「……こういうことがしたくて%CNAME("一人称")%におちんちん付けたんですか？」	PRINTFORMW 「……你是为了做这种事情才给%CNAME("一人称")%附上肉棒的吗？」
PRINTFORMW 「%CNAME("二人称")%ったらほんとにもう……」	PRINTFORMW 「%CNAME("二人称")%真是的……」
PRINTFORMW 「……え？　%CNAME("一人称", "どもり")%は期待なんてしてませんでしたよ？　本当ですよ？」	PRINTFORMW 「……呃？　%CNAME("一人称", "どもり")%从来没有期待过喲？　是真的喲？」
PRINTFORMW 「ひゃっ……！？　やぁっ、だめですそこっ、よすぎるから……んぅぅっ！」	PRINTFORMW 「吓……！？　呀啊、那里不可以喲、因为太舒服了……嗯呜呜！」
PRINTFORMW （%CNAME("二人称")%にしてもらうの、自分の手でするより何倍も気持ちよくて……）	PRINTFORMW （让%CNAME("二人称")%口的话、比自己手冲还要舒服好几倍……）
PRINTFORMW （思わずもっと激しくしてって言いそうになっちゃう……）	PRINTFORMW （忍不住要发出更激烈的声音了……）
PRINTFORMW 「んくぅっ、はぁっ、あっ、んふぅっ、はぁ……」	PRINTFORMW 「嗯库、哈啊、啊、哼唔、哈啊……」
PRINTFORMW 「うぅ……男の子って、みんなこんなものをつけて生活してるんですか……？」	PRINTFORMW 「呜……男孩子啊、都是带着这种东西生活的吗……？」
PRINTFORMW （我慢なんてできないよぉっ、気持ちよすぎておかしくなっちゃう……）	PRINTFORMW （忍耐什么的做不到了、太舒服了要变奇怪起来了……）
PRINTFORMW 「%CNAME("二人称")%そこっ、そこすごくいいですっ、もっと……っ」	PRINTFORMW 「%CNAME("二人称")%的那、那里面好舒服、还要……」
PRINTFORMW （喉の奥まで全部飲み込んでほしい……激しくごしごししてもらいたい……）	PRINTFORMW （好想全部进到喉咙深处为止……然后激烈地使劲抽插……）
PRINTFORMW （ってだめだめっ！　いけないいけない……思わず口走りそうになっちゃった）	PRINTFORMW （这不行不行啊！　不好不好……差点就说出来了）
PRINTFORMW 「あぅ……だめ、だめですこんなの……」	PRINTFORMW 「啊呜……不、不要啊这样的……」
PRINTFORMW 「%CNAME("二人称")%が舐めてくれてるって思うだけで、%CNAME("一人称", "かな")%っ、イっちゃ……」	PRINTFORMW 「只是想到%CNAME("二人称")%在给我口、%CNAME("一人称", "かな")%就要、去了……」
PRINTFORMW （%CNAME("二人称")%が%CNAME("一人称")%のおちんちんを一生懸命舐めてくれてる……）	PRINTFORMW （%CNAME("二人称")%在努力舔%CNAME("一人称")%的鸡鸡……）
CALL PRINT_STR, @"（あぁ……%CNAME("二人称")%いいよぉ……すきっ、%CNAME("二人称")%っ、だいすき……っ_H_）_W"	CALL PRINT_STR, @"（啊……%CNAME("二人称")%好棒喔……喜欢、%CNAME("二人称")%、最喜欢了……_H_）_W"
PRINTFORMW 「%CNAME("二人称")%に舐めてもらうの、自分でするよりずっと気持ちいいです……」	PRINTFORMW 「被%CNAME("二人称")%舔的话、比自己做舒服多了……」
PRINTFORMW 「……え？　自分のおちんちんを舐めたことがあるのかって……？」	PRINTFORMW 「……呃？　有没有舔过自己的鸡鸡……？」
PRINTFORMW 「な、なな、ないです！　自分でするのはその、手ですから！　考えたこともないです！」	PRINTFORMW 「没、没、没有啊！　要是自己做的话、用手啦！　也从来没有想过！」
PRINTFORMW 「ん、うぅ……っ、%CNAME("二人称")%上手です……なんでこんなに……ひぅっ」	PRINTFORMW 「嗯、唔……、%CNAME("二人称")%好会舔……为什么这么熟练……呼唔」
PRINTFORMW 「やぁっ、さきっぽぐりぐりするのだめぇ……」	PRINTFORMW 「呀啊、不要咕哩咕哩地旋转着舔前头啊……」
PRINTFORMW 「%CNAME("二人称")%にしてもらうの気持ちよくって……すぐに出ちゃいそうですっ」	PRINTFORMW 「被%CNAME("二人称")%舔着好舒服……马上就要出来了」
PRINTFORMW 「うぅぅ、やらしい子だって思わないでくださいね……」	PRINTFORMW 「呜呜呜、请不要认为我是下流女孩哦……」
PRINTFORMW 「%CNAME("一人称", "かな")%女の子なのにっ、おちんちんでこんな、気持ちよくなっちゃってっ」	PRINTFORMW 「明明%CNAME("一人称", "かな")%是女孩子、鸡鸡却是那么、那么舒服啊」
PRINTFORMW 「やぁ……おかしくなっちゃいそうです……」	PRINTFORMW 「呀啊……要变得很奇怪了……」
PRINTFORMW 「あっ……そこいいですっ、もっと……っ」	PRINTFORMW 「啊……那里好舒服、我还要……」
PRINTFORMW 「はぁっ、うっ、くぅっ……。あと、もうちょっと奥まで、お願いします……んぅっ」	PRINTFORMW 「哈啊、呜、库呜……。之后、再含深一点、求你了……哼呜」
PRINTFORMW 「ん……っ、やだ、あんまり見ないでください」	PRINTFORMW 「嗯……、不要、不要这样盯着看啊」
//段落
//PRINTFORM 「%CNAME("一人称", "かな")%	PRINTFORM 「%CNAME("一人称", "かな")%
//PRINT 乳首	PRINT 乳头
//PRINT も	PRINT 和
//PRINT 乳輪	PRINT 乳晕
//PRINT も	PRINT 都
//PRINT 大きいし、	PRINT 太大了、
//PRINT しかも陥没してるし、	PRINT 而且还是陷没的、
//PRINT の	PRINT 的
//PRINT おっぱい	PRINT 欧派
//PRINT も	PRINT 也
//PRINT 乳首が陥没してるし、	PRINT 乳头陷进去了、
//PRINT 大きすぎるから	PRINT 大得
//PRINT 小さいから	PRINT 小得
//PRINT あんまりないし	PRINT 空旷得
//PRINTW 恥ずかしいです……」	PRINTW 让我很难为情……」
PRINTFORMW 「うぅ……やだ、顔から火が出そう……」	PRINTFORMW 「呜……不行了、脸像被火烧一样……」
PRINTFORMW 「さっきからずっとっ、おっぱい、ばっかり……っ」	PRINTFORMW 「从刚才开始就一直没停过、欧派、就要……」
PRINTFORMW 「んんんっ！　だめ……っ、乳首だめですっ！　わたし、そこ……っ、弱いからぁっ」	PRINTFORMW 「嗯嗯嗯！　不行……、乳头不可以！　因为我、那里……、很敏感啊」
PRINTFORMW （あぁ……%CNAME("二人称")%に揉まれて、またおっぱい大きくなっちゃう……）	PRINTFORMW （啊啊……被%CNAME("二人称")%揉来揉去、奶子又要变大了……）
PRINTFORMW 「%CNAME("二人称")%が好きだって言ってくれるなら、どんな大きさになったっていいですよ……」	PRINTFORMW 「要是%CNAME("二人称")%说喜欢那样的话、变得多大都可以喲……」
PRINTFORMW 「大きくなるときの胸の奥があったかくなるような感じ、好きです」	PRINTFORMW 「变大的时候感觉奶子里暖暖的、好喜欢」
PRINTFORMW 「%CNAME("二人称")%の気持ちが伝わってくるような、そんな気がして……」	PRINTFORMW 「好像是%CNAME("二人称")%的感情传达进来了、感觉是那样……」
PRINTFORMW 「%CNAME("二人称")%好みになれるの、嬉しいです……」	PRINTFORMW 「会成为%CNAME("二人称")%的嗜好吧、我很高兴喲……」
PRINTFORMW 「%CNAME("二人称")%にもらったピアス、今日もつけてますよ」	PRINTFORMW 「从%CNAME("二人称")%那得到的乳环、今天也带着喲」
PRINTFORMW 「これを付けているとですね……んっ、いつでも%CNAME("二人称")%に乳首をいじられてるような、そんな気分になって……」	PRINTFORMW 「这个得戴上呢……嗯、无论什么时候都被%CNAME("二人称")%玩弄着乳头、带着这种心情……」
PRINTFORMW 「ふふっ、もっと他にも%CNAME("二人称")%の好きなところにつけてくれていいんですよ……？」	PRINTFORMW 「呼呼、更多%CNAME("二人称")%喜欢的其他地方也可以给我戴上喲……？」
PRINTFORMW 「んん……っ、今だって、他のえっちなとことか、%CNAME("二人称")%にさわられてるような感じがして……あぁっ」	PRINTFORMW 「嗯嗯……、即便是现在、其他Ｈ的地方、感觉都被%CNAME("二人称")%夺走那样……啊啊」
PRINTFORMW 「んぅぅっ！？　はぁ、あぁぁっ！　だ、だめっ……乳首がっ、ちくびがとけちゃうぅっ」	PRINTFORMW 「嗯呜呜！？　哈啊、啊啊啊！　不、不行……乳头、乳头去了呜呜」
PRINTFORMW （なに、これ……？　%CNAME("一人称", "かな")%のおっぱい、なんでこんなに敏感になっちゃってるの……？）	PRINTFORMW （什么呀、这个……？　%CNAME("一人称", "かな")%的欧派、为什么变得这么敏感的呢……？）
PRINTFORMW 「はぁーっ、はっ、はぁっ、んぅぅっ……。ま、待って……私おかしくなっちゃいます……」	PRINTFORMW 「哈啊ー、哈、哈啊、嗯呜呜……。停、停一下……我变得奇怪起来了……」
PRINTFORMW 「あぅっ……んっ、そこっ、そこいいですっ、乳首っ、ちくびこりこりするの好きっ、好きですっ」	PRINTFORMW 「啊呜……嗯、那里、那里好好、乳头、奶头硬硬的好舒服、好喜欢」
PRINTFORMW （もっと、もっといっぱい触ってほしい……気持ちよくしてほしい……）	PRINTFORMW （还、还想要多的抚摸……好想变得更加舒服……）
PRINTFORMW （でも%CNAME("二人称")%にはしたない子だなんて思われるなんて絶対やだ……%CNAME("一人称", "かな")%どうしたらいいの……？）	PRINTFORMW （但是被%CNAME("二人称")%认为是不知羞耻的女孩什么的绝对不行……%CNAME("一人称", "かな")%该怎么办好呢……？）
PRINTFORMW 「あっ、あぁぁぁっ！　ふ……ぅんっ、やぁ……%CNAME("二人称")%、おっぱいいじるの上手すぎですっ」	PRINTFORMW 「啊、啊啊~！　呼……呜嗯、不要……%CNAME("二人称")%、好会玩奶子」
PRINTFORMW （%CNAME("二人称")%にしてもらうと自分でするのと全然違って……なんでこんなに気持ちいいの……？）	PRINTFORMW （被%CNAME("二人称")%弄和自己弄的感觉完全不一样……为什么会这么舒服呀……？）
CALL PRINT_STR, @"（もっとっ、もっといろんなことされたいよぉっ_H_　もっとすごいこと、いっぱいしてほしい……_H_）_W"	CALL PRINT_STR, @"（好、好想更多的被各种各样的玩弄_H_　好想被用更厉害的玩法、更加满足……_H_）_W"
PRINTFORMW 「さっきからずっとおっぱいぷにぷにしてますけど」	PRINTFORMW 「从刚才开始就一直沉迷在软绵绵的欧派里呢」
PRINTFORMW 「ふふ……しょうがない%CNAME("二人称")%ですね。赤ちゃんみたいですよ？」	PRINTFORMW 「哼哼……真拿%CNAME("二人称")%没办法呢。好像小宝宝那样喲？」
PRINTFORMW 「ふふ、どうです。重たいでしょう？　%CNAME("二人称")%がここまで大きくしたんですよ？」	PRINTFORMW 「呼呼、怎么样。很重吧？　这里已经变那么大了喲%CNAME("二人称")%？」
PRINTFORMW 「肩こったりとかいろいろ大変ですけど、でも%CNAME("二人称")%がこれがいいって言うならその、私は……」	PRINTFORMW 「虽然肩膀酸痛之类的很辛苦、但是%CNAME("二人称")%要是说喜欢这样的话、我就……つ﹏⊂」
PRINTFORMW 「あぁ……んもぅ、また成長しちゃってますね……」	PRINTFORMW 「啊啊……嗯麼呜、又成长了呢……」
PRINTFORMW 「はぁ、元々ただでさえ大きすぎるくらいだったのに……%CNAME("二人称")%がおっぱいばかりいじるせいですよ？」	PRINTFORMW 「哈啊、本来就已经很大的了……都是%CNAME("二人称")%老是玩奶子的错喲？」
PRINTFORMW 「毎日大変なんですからね……もうっ、しょうがないなぁ……」	PRINTFORMW 「每天都很辛苦的呢……真是的、拿你没办法啊……」
PRINTFORMW 「あの、%CNAME("二人称")%。いくらなんでもこれは大きくしすぎじゃないですか……？」	PRINTFORMW 「那个、%CNAME("二人称")%。不管怎么说这也太大了吧……？」
PRINTFORMW 「授業中とか、普通に座ると机に何も置けなくなっちゃうんですよ……」	PRINTFORMW 「比如说上课的时候、变得正常坐着的话桌子上什么也放不下了的情况喲……」
PRINTFORMW 「ふふ、どうです？　%CNAME("二人称")%好みになれてますか？」	PRINTFORMW 「呼呼、怎么样？　满足%CNAME("二人称")%的喜好了吗？」
PRINTFORMW 「このまま揉まれてたら、もっともっと大きくなるんでしょうか……」	PRINTFORMW 「要是就这样揉来揉去的话、会变得越来越大的吧……」
PRINTFORMW 「%CNAME("二人称")%がもっと大きくしたいっていうなら……いいですよ、お付き合いします」	PRINTFORMW 「要是%CNAME("二人称")%说想要更大的话……可以喲，我会配合你的」
PRINTFORMW 「えへへ……どうですか？　大きくなったと思いませんか？」	PRINTFORMW 「哎嘿嘿……怎么样？　不觉得我的变大了吗？」
PRINTFORMW 「これもきっといつも%CNAME("二人称")%が揉んでくれているおかげですよね……ふふ」	PRINTFORMW 「这也一定是多亏了%CNAME("二人称")%一直以来的揉弄呢……呼呼」
PRINTFORMW 「ん……あれ、どうしたんです？　……ピアスが気になりますか？」	PRINTFORMW 「嗯……啊咧，怎么了？　……在意乳环吗？」
PRINTFORMW 「おっぱい触るのに邪魔だったらごめんなさい、でもその……せっかくの%CNAME("二人称")%からのプレゼントですし」	PRINTFORMW 「要是这样妨碍了摸奶子的话抱歉，但是那个……是特意为了%CNAME("二人称")%的礼物」
PRINTFORMW 「できるだけ外さずにいたいな……って」	PRINTFORMW 「想尽量不要摘下那……样」
PRINTFORMW 「どうですか？　%CNAME("二人称")%的に『あり』ですか、このおっぱい……？」	PRINTFORMW 「怎么样？　是%CNAME("二人称")%的『菜』吗，这个奶子……？」
PRINTFORMW 「うぅ、だって%CNAME("一人称")%って学校に行くことがほとんどなかったですし、他の子たちのことってよく知らなくて……」	PRINTFORMW 「呜呜，因为%CNAME("一人称")%呢很少去学校嘛，不太了解其他男生……」
PRINTFORMW 「お、おかしくないですよね……？」	PRINTFORMW 「这、这不奇怪吧……？」
PRINTFORMW 「元々は%CNAME("一人称")%の問題なのに、当の%CNAME("一人称")%が怯えていたら、%CNAME("二人称")%は気を悪くしますよね……」	PRINTFORMW 「本来就是%CNAME("一人称")%的问题，现在的%CNAME("一人称")%要是胆怯的话，%CNAME("二人称")%会不愉快的吧……」
PRINTFORMW 「慣れるまでしばらくかかるかもしれませんけど……。お願いします、%CNAME("二人称")%」	PRINTFORMW 「可能要花一段时间才能习惯……。请谅解、%CNAME("二人称")%」
PRINTFORMW 「%CNAME("一人称", "どもり")%のおっぱい……さわって、ください」	PRINTFORMW 「%CNAME("一人称", "どもり")%的欧派……请、摸」
PRINTFORMW 「えと、その、どうですか？」	PRINTFORMW 「嗯、那个、怎么样？」
PRINTFORMW 「妹のおっぱいですし変な気分かもしれませんけどけど、%CNAME("二人称")%が満足してくれるなら」	PRINTFORMW 「用妹妹的奶子也许会觉得很奇怪，但是、但是为了满足%CNAME("二人称")%的话」
PRINTFORMW 「う、嬉しいです……」	PRINTFORMW 「很、很愉快……」
PRINTFORMW 「ん……っ、ちゅ、ちゅる……っ、んっ、ぷはっ」	PRINTFORMW 「嗯……、啾、啾噜……、嗯、噗哈~」
PRINTFORMW 「やぁ、%CNAME("二人称", "かな")%もっと……っ」	PRINTFORMW 「呀啊、%CNAME("二人称", "かな")%我还要……」
PRINTFORMW 「んむ……んちゅっ、れろ……ん、ふっ、はぁぁ……っ」	PRINTFORMW 「嗯姆……嗯啾、咧啰（张嘴）……嗯、呼、哈啊啊……」
PRINTFORMW 「ふふ、小さかったころからの夢が、ひとつ叶いました……」	PRINTFORMW 「呼呼，小时候的梦想，实现了一项……」
PRINTFORMW 「ありがとう%CNAME("二人称")%。約束守ってくれて……嬉しかったですよ」	PRINTFORMW 「谢谢%CNAME("二人称")%。遵守了约定……我好开心喲」
PRINTFORMW 「小さいころ、%CNAME("二人称")%のお嫁さんになるんだって言ってたことを思い出しました……」	PRINTFORMW 「回想起小时候，曾经说过要成为%CNAME("二人称")%的新娘什么的……」
PRINTFORMW 「お嫁さんになるのはいけないことでも……キスくらいなら、許してくれますよね」	PRINTFORMW 「虽然不能做新娘，但是……只是接吻的话，就可以原谅吧？」
PRINTFORMW 「ん……っ、もっといっぱい、%CNAME("二人称")%とキスしたいです……」	PRINTFORMW 「嗯……再多一点，想和%CNAME("二人称")%接吻……」
PRINTFORMW 「離れちゃいやです……」	PRINTFORMW 「不要分开……」
PRINTFORMW 「%CNAME("二人称")%、%CNAME("一人称", "かな")%キスってしたことないんですよ」	PRINTFORMW 「%CNAME("二人称")%、%CNAME("一人称", "かな")%还是初吻喲」
PRINTFORMW 「……以前おちんちんにしてしまったのはですね、ノーカウントです。忘れてください」	PRINTFORMW 「……从前有亲过肉棒什么的、不算数啦。请忘了它吧」
PRINTFORMW 「だからですね、あれは無効なので、その」	PRINTFORMW 「所以说、因为那不算、那么」
PRINTFORMW 「お願いします。思い出の上書きをさせてください、%CNAME("二人称", "かな")%……」	PRINTFORMW 「拜托了。请留在回忆里好吗、%CNAME("二人称", "かな")%……」
PRINTFORMW 「ようこそ%CNAME("二人称")%。そこはあなたのおちんちんが既に通過した場所ですよ」	PRINTFORMW 「请用、%CNAME("二人称")%。那里是你的小鸡鸡早就通过了的场所喲」
PRINTFORMW 「……なーんて。ごめんなさい、ちょっと意地が悪かったですよね」	PRINTFORMW 「……什么的。对不起、稍微有点坏心眼啊」
PRINTFORMW 「その、初めてのやり直しをお願いします」	PRINTFORMW 「那个、第一次的接吻请重新来过吧」
PRINTFORMW 「できればですね……小説の主人公がお姫さまにするみたいに、ロマンチックに」	PRINTFORMW 「如果可以的话……请像小説的主人公对公主那样、罗曼蒂克的吻我」
PRINTFORMW 「んちゅ……ん……っ、%CNAME("二人称", "かな")%、もっと……はむ、ん……っ、ちゅ……」	PRINTFORMW 「嗯啾……嗯……、%CNAME("二人称", "かな")%、再多一点……哈姆、嗯……、啾……」
PRINTFORMW 「はなれちゃやだ……んっ、ちゅっ、もっといっぱいキスするっ、%CNAME("二人称")%といっぱいキスする……っ！」	PRINTFORMW 「不许分开……嗯、啾、再多吻我一些、跟%CNAME("二人称")%一起满满地接吻……！」
PRINTFORMW 「キスするだけだったら……んっ、ちゅっ……何も問題なんて、ないですよね……んっ」	PRINTFORMW 「如果只是接吻的话……嗯、啾……什么问题也、没有的吧……嗯」
PRINTFORMW （セックスしちゃってるわけじゃないんだから、誰に文句を言われることもないはずだよね）	PRINTFORMW （因为我们是不可以做爱的、如此就不会有流言蜚语的吧）
PRINTFORMW （%CNAME("二人称")%とキスするの気持ちいいよぉ……もっとっ、もっとしたい、すごいことしたい……）	PRINTFORMW （和%CNAME("二人称")%接吻好舒服呢……更多、还要更多、想要更厉害的……）
PRINTFORMW 「……ぷはっ」	PRINTFORMW 「……噗哈」
PRINTFORMW 「はふぅ……ずっとキスしてると息が続かなくて……あたまがふわふわしてます……」	PRINTFORMW 「哈呼呜……一直吻着就呼吸不下去了……脑袋里感觉轻飘飘的……」
PRINTFORMW （ほんとはもっとしてほしいけど……。あぁっ、%CNAME("二人称")%だめっ、私いけない子になっちゃいそうです……）	PRINTFORMW （虽然说真的很想要更多……。啊啊、%CNAME("二人称")%不行、我好像要变成坏孩子了……）
PRINTFORMW 「ちゅっ、んっ、んちゅ……っ、はぁっ、キスするのきもちいいよぉ……っ、はむ、ふむぅっ、ちゅ……」	PRINTFORMW 「啾、嗯、嗯啾……、哈啊、接吻很舒服喲……、哈姆、呼姆呜、啾……」
CALL PRINT_STR, @"（すき……っ_H_　%CNAME("二人称")%すきっ、すきっ、だいすきっ_H_　もっとキスしたいっ、ずっとキスしてたいよぉっ_H_）_W"	CALL PRINT_STR, @"（喜欢……_H_　%CNAME("二人称")%喜欢、喜欢、最喜欢_H_　想要更多接吻、好想一直吻下去喲_H_）_W"
PRINTFORMW 「ふぅ……んっ、れろ……ちゅ……んんっ、んぅ……っ、ぷはっ！」	PRINTFORMW 「呼呜……嗯、咧啰（张嘴）……啾……嗯嗯、嗯呜……、噗哈！」
PRINTFORMW 「はぁっ、はぁっ……ふぅっ」	PRINTFORMW 「哈啊、哈啊……呼呜」
PRINTFORMW 「こうやってずっとキスしてると……ときどき、今までどうやって息してたのかわからなくなっちゃいます」	PRINTFORMW 「像这样一直吻着……纠缠不休地、至今是如何呼吸下去的已经不知道了」
PRINTFORMW 「えへへ……。%CNAME("二人称")%とキスするの、好きです」	PRINTFORMW 「诶嘿嘿……。跟%CNAME("二人称")%接吻、好喜欢」
PRINTFORMW 「ほんとは%NAMES("兄弟")%でこんなことをするのは、いけないんでしょうけど」	PRINTFORMW 「亲%NAMES("兄弟")%做这种事情的话、或许是不对的吧」
PRINTFORMW 「でも%CNAME("一人称", "かな")%、後悔なんてぜったいにしませんよ……」	PRINTFORMW 「但是%CNAME("一人称", "かな")%、绝对不会后悔的……」
PRINTFORMW 「%CNAME("二人称")%とキスしてると、なんだか頭がぼーっとしてきて、身体が熱く……」	PRINTFORMW 「一和%CNAME("二人称")%接吻、总觉得头昏沉沉的、浑身发热……」
PRINTFORMW 「ふわ……。なんだか頭がクラクラしちゃいます」	PRINTFORMW 「呼哇……。总感觉头晕晕的」
PRINTFORMW 「こうやってキスしてるだけで、イっちゃいそうなくらい……」	PRINTFORMW 「只是这样接吻着、就要去了……」
PRINTFORMW 「ん……っ、キスしてると頭がぼーっとしてきて、溶けちゃいそうです」	PRINTFORMW 「嗯……、接吻的时候脑袋轻飘飘的、就要融化了」
PRINTFORMW 「%CNAME("二人称")%も同じように感じてくれてますか？」	PRINTFORMW 「%CNAME("二人称")%也有同样的感觉吗？」
PRINTFORMW 「一緒に気持ちよくなってくれていたら、とっても嬉しいな……って」	PRINTFORMW 「一起变舒服起来的话、也会很开心……的」
PRINTFORMW 「う……うぅ、やっぱりそこ気になるんですね、%CNAME("二人称")%……」	PRINTFORMW 「呜……呜呜、果然对那里有意啊、%CNAME("二人称")%……」
PRINTFORMW 「えっと、その、さわるだけで満足してくれるなら、いいですけど」	PRINTFORMW 「呃、那个、如果只是摸一下就能满足的话、倒是可以」
PRINTFORMW 入れちゃダメですよ？　とさくらはさらに念押ししてきた……。	PRINTFORMW 不可以进去哦？　%CALLNAME:TARGET%进一步叮嘱道……。
PRINTFORMW 「やぁっ、んぅっ、%CNAME("二人称")%の指、はげしいです……っ」	PRINTFORMW 「呀啊、嗯呜、%CNAME("二人称")%的手指、太激烈了……」
PRINTFORMW 「だめなのにっ、%CNAME("二人称")%とだけは、ここで気持ちよくなったら、いけないのに……っ」	PRINTFORMW 「明明不行的、只是和%CNAME("二人称")%在一起、这里就变得好舒服、明明不可以的……」
PRINTFORMW 「んぅっ！　はっ、あぅっ！　や、ぁ、あぁ……はぁぁ……っ」	PRINTFORMW 「嗯呜！　哈、啊呜！　呀~啊、啊啊……哈啊啊……」
PRINTFORMW 「だ、めぇ……っ、はっ、ふっ、あぅっ、%CNAME("一人称", "かな")%っ、ばかになっちゃうよぉ……」	PRINTFORMW 「不、行……、哈、呼、啊呜、%CNAME("一人称", "かな")%、要变成笨蛋了……」
PRINTFORMW 「%CNAME("二人称")%にもらったこのピアスのせいで、%CNAME("一人称")%いつも大変なんですよ……？」	PRINTFORMW 「都是%CNAME("二人称")%给我戴上阴蒂环的错啦、平时%CNAME("一人称")%一直都忍得很辛苦喲……？」
PRINTFORMW 「つけてるクリトリスはずっと大きくなったままですし、歩いてるだけでもこすれて気持ちよくなっちゃったり……」	PRINTFORMW 「因为穿环阴蒂都越来越大了、光是走路时的摩擦就变得好舒服什么的……」
PRINTFORMW 「――んぅっ！？　やっ、そうやってピアスはじくのだめっ、よすぎるから……っ」	PRINTFORMW 「――嗯呜！？　呀、不可以那样弄阴环、感觉太强力了……」
PRINTFORMW 「ん……っ、あんまりかちゃかちゃさせないでくださ……やぁっ」	PRINTFORMW 「嗯……、请别把我那里弄得那么黏糊糊的……呀啊」
PRINTFORMW 「ひぅっ！？　あ、あぁっ、そこつーってなぞるのだめっ、ピアスひっぱるのはもっとだめぇっ」	PRINTFORMW 「嗬呜！？　啊、啊啊、不要描摹那里啊、拉阴环更加不行」
PRINTFORMW （%CNAME("一人称", "かな")%のあそこ、いやらしい形にされちゃう……）	PRINTFORMW （%CNAME("一人称", "かな")%的那里、变成下流的形状了呜……）
PRINTFORMW 「は、あぁ……っ、んっ、やだっ、そこだめっ、そんなぐちゅぐちゅさせないで……んぅぅっ」	PRINTFORMW 「哈、啊啊……、嗯、讨厌、那里不行、别那样咕啾咕啾的……嗯呜呜」
PRINTFORMW （うぅ……%CNAME("一人称")%のあそこ、ぐちゅぐちゅってすごい音たててる……）	PRINTFORMW （呜呜……%CNAME("一人称")%的那里、发出咕啾咕啾的响声了……）
PRINTFORMW （やぁっ、とまって……とまってよぉ……%CNAME("一人称", "かな")%、そんなえっちな子じゃ……っ）	PRINTFORMW （呀啊、停下……快停下啊……%CNAME("一人称", "かな")%、不是这么好色的孩子……）
PRINTFORMW 「ひぁっ！　あっ、んっ、ぁ、あっ……やっ、くるっ、きちゃうっ、おっきいのきちゃう……あぅぅっ！」	PRINTFORMW 「嗬啊！　啊、嗯、啊、啊……呀、来了、要来了、好多的来了……啊呜呜！」
PRINTFORMW （おまんこきゅんきゅんするよぉっ、せつないよぉっ、%CNAME("二人称")%のおちんちんで奥までじゅぽじゅぽかき回してほしいよぉ……）	PRINTFORMW （小穴一跳一跳的哎、好难受哦、好想让%CNAME("二人称")%的肉棒在深处里啾啵啾啵地搅拌啊……）
PRINTFORMW （でもだめっ、だめなのっ、そんなこと言ったらいけないんだからぁ……っ）	PRINTFORMW （但是不行、不行的啊、那种事说出来的话就糟糕了……）
PRINTFORMW 「んはっ、ぁくっ……あっ、ああっ、ぞくぞくきて……んぅっ」	PRINTFORMW 「嗯哈、啊咕……啊、啊啊、一抖一抖的来了……嗯呜」
PRINTFORMW 「やぁ……もどかしいですっ、もっとっ、もっとはげしく……んっ、はぁっ」	PRINTFORMW 「呀啊……受不了了、更加、更加激烈点……嗯、哈啊」
PRINTFORMW （%CNAME("一人称", "かな", "どもり")%何言っちゃってるの……でもっ、でももっとしてほしいよぉ……っ���	PRINTFORMW （%CNAME("一人称", "かな", "どもり")%在说什么呀……但是、但是好想要更多啊……）
PRINTFORMW 「やぁ、あぁぁぁっ、だめですっ、これ以上されたら、%CNAME("一人称", "かな")%、もう……っ」	PRINTFORMW 「呀啊、啊啊啊~、不行不行、如果再这样下去的话、%CNAME("一人称", "かな")%、已经……」
PRINTFORMW （おなかの奥がじんじんして……やぁっ、%CNAME("二人称")%のおちんちん欲しくなっちゃうよぉ……）	PRINTFORMW （肚子的深处麻麻的……呀啊、变得好想要%CNAME("二人称")%的肉棒了……）
PRINTFORMW （あぁっ、%CNAME("二人称")%っ、%CNAME("二人称", "甘え")%っ！　いいよぉ……っ）	PRINTFORMW （啊啊~，%CNAME("二人称")%、%CNAME("二人称", "甘え")%！　可以喲……）
PRINTFORMW 「はぁ……っ、ぁ、あぁっ、ふ、きゅぅ……っ、んぁっ、あぁぁ……っ」	PRINTFORMW 「哈啊……、啊、啊~呜、呼、啾呜……、嗯啊、啊啊~……」
CALL PRINT_STR, @"「くるっ、きちゃうぅっ！　やぁっ、だめぇ……っ、おまんことけちゃうぅっ_H_」_W"	CALL PRINT_STR, @"「来了、要来了呜！　呀啊、不要……、小穴融化了呜呜~_H_」_W"
PRINTFORMW 「だめ、です……。こんなにねちっこく、んんっ、いじられ続けたらっ」	PRINTFORMW 「不行、的啊……。如此没完没了的、嗯嗯、继续被欺负的话」
PRINTFORMW 「お腹の奥が、きゅんって……。やぁっ、だめなのっ、だめなんですってばぁ……」	PRINTFORMW 「肚子深处、有感觉了……。呀啊、不行哦、都说了不行的啊……」
PRINTFORMW 「だめです……っ、そんな、ピアス引っぱったら……んんっ」	PRINTFORMW 「不行啊……、那样、拉阴环的话……嗯嗯」
PRINTFORMW 「やぁっ、そこ敏感だからつらいんですっ！」	PRINTFORMW 「呀啊、那里因为很敏感的好难受啊！」
PRINTFORMW 「むー……」	PRINTFORMW 「姆ー……」
PRINTFORMW 「このびらびらしたとこが伸びちゃったら、%CNAME("二人称")%のせいなんですからねっ」	PRINTFORMW 「如果这个被穿环的阴唇变长的话、都是因为%CNAME("二人称")%的错啊」
PRINTFORMW 「……%CNAME("二人称")%がそういう風にしたいって言うなら止めませんけど」	PRINTFORMW 「……虽然说%CNAME("二人称")%要是说想要那种风格的话、我也不会阻止的啦」
PRINTFORMW 「うぅ……こんなところを見せるの、とっても恥ずかしいんですよ」	PRINTFORMW 「呜呜……那部位被这么看着、真的好难为情啊」
PRINTFORMW 「ましてや%CNAME("二人称")%にさわらせるだなんて……はぅ」	PRINTFORMW 「更何况是让%CNAME("二人称")%去摸那里什么的……哈呜」
PRINTFORMW 「て、手加減してくださいね？」	PRINTFORMW 「下、下手轻点哦？」
PRINTFORMW 「%CNAME("二人称", "どもり")%？　なんだか手つきがすごく、いやらしい感じなんですけど」	PRINTFORMW 「%CNAME("二人称", "どもり")%？　总觉得手的动作好厉害、虽然感觉很下流」
PRINTFORMW 「あのその、それにさっきから鼻息も少し荒いような」	PRINTFORMW 「这个那个、而且从刚才开始鼻息也稍微有点粗暴的样子」
PRINTFORMW 「うぅ、なんだかちょっと怖いんですけど……」	PRINTFORMW 「呜呜、总觉得有点可怕……」
PRINTFORMW 「ここまでで我慢してくれるなら……いいですよ、%CNAME("二人称")%」	PRINTFORMW 「至今一直忍耐着的话……可以喲、%CNAME("二人称")%」
PRINTFORMW 「%CNAME("一人称")%の恥ずかしいところ、満足するまで好きなだけいじってください」	PRINTFORMW 「%CNAME("一人称")%那羞耻的部位、到满足为止请随意玩弄吧」
PRINTFORMW 「ごめんなさい%CNAME("二人称")%。我慢できなくなっちゃいました……」	PRINTFORMW 「对不起%CNAME("二人称")%。我要无法忍耐了……」
PRINTFORMW 「ほら、触ってみてください。もうこんなに固く……何が当たっているか、わかりますよね？」	PRINTFORMW 「来、请摸摸看。已经这么硬了……是什么导致的呢、你知道的吧？」
PRINTFORMW 「ふふっ、これを%CNAME("二人称")%の手でいっぱい気持ちよくしてほしいんです……」	PRINTFORMW 「呼呼、这个好想让%CNAME("二人称")%用手撸到爽爆……」
PRINTFORMW 「小さいときはよく一緒にお風呂に入ったりしましたよね」	PRINTFORMW 「小时候经常一起去洗澡的吧」
PRINTFORMW 「あのころは無邪気に%CNAME("二人称")%とおそろいだって思っていましたけど……」	PRINTFORMW 「虽然那个时候幼稚地认为会和%CNAME("二人称")%在一起……」
PRINTFORMW 「うぅ、あんまり見ないでください……。昔とはもう全然形が違いますし、恥ずかしい……」	PRINTFORMW 「呜呜、请不要那样盯着看……。和过去的形状完全不一样了、太羞耻了……」
PRINTFORMW 「これが男の人の感覚……なんですよね」	PRINTFORMW 「这就是男人的感觉……吧」
PRINTFORMW 「いざ触られるとなると、ちょっとその、勇気が……」	PRINTFORMW 「一旦被摸着就、稍微有点那个、勇气……」
PRINTFORMW 「や、やさしくお願いしますね？　あんまり強くしちゃいやですよ……？」	PRINTFORMW 「请、请对它温柔点可以吗？　不要太用力喲……？」
PRINTFORMW 「自分でするより、ずっといいです……んっ」	PRINTFORMW 「比起自己来、要更舒服……嗯」
PRINTFORMW 「%CNAME("二人称")%はなんでこんな……ぁっ、上手なんですか……？」	PRINTFORMW 「%CNAME("二人称")%为什么这么……啊、这么会弄呀……？」
PRINTFORMW 「%CNAME("一人称")%におちんちんがついていて、それを%CNAME("二人称")%がこうして、気持ちよくしてくれる……」	PRINTFORMW 「%CNAME("一人称")%身上附着的鸡鸡、那里被%CNAME("二人称")%这样做的话、太舒服了……」
PRINTFORMW 「なんだかすごく不思議な感じです……」	PRINTFORMW 「总感觉很不可思议……」
PRINTFORMW 「う、うぅ……わざと大きな音たててませんか……？」	PRINTFORMW 「呜、呜呜……不会是特意弄那么大声的吧……？」
PRINTFORMW 「ぐちゅぐちゅって……やだ、%CNAME("一人称")%そんないやらしい子じゃ……」	PRINTFORMW 「咕啾咕啾地……讨厌、%CNAME("一人称")%才不是那种下流的孩子……」
PRINTFORMW 「やぁっ！　だめですっ、そんな激しくするの……」	PRINTFORMW 「呀啊！　不行啊、那么激烈的话……」
PRINTFORMW 「腰がぞくぞくって、こんなのすぐ出ちゃいます……ひぅっ！？」	PRINTFORMW 「腰颤簌簌地、这样马上就要出来了……哼呜！？」
PRINTFORMW 「%CNAME("二人称")%にしてもらうの、好きです……」	PRINTFORMW 「%CNAME("二人称")%帮我做吗、太好了……」
PRINTFORMW 「はぁっ、ぬるぬるがどんどんあふれてきて……やっ、出ちゃう……」	PRINTFORMW 「哈啊、黏糊糊的不断溢出来了……咿、出来了呜……」
PRINTFORMW 「なんで%CNAME("二人称")%はもともと男の人なのにそんな大きなおっぱい付けてるんですか、もう」	PRINTFORMW 「为什么明明%CNAME("二人称")%本来是男人的，却有这么大的胸部啊？真是的。」
PRINTFORMW 「はぁ……無駄に気持ちいいのが悔しいです……」	PRINTFORMW 「哈啊……不中用地感到好舒服、真不甘心……」
PRINTFORMW 「%CNAME("二人称")%のおっぱい、気持ちいいんですけど……むむ」	PRINTFORMW 「%CNAME("二人称")%的胸部好舒服、可是……姆姆~」
PRINTFORMW 「あらためて考えてみてもやっぱりすごくおかしいですよね、この状況……」	PRINTFORMW 「这个状況、不管怎么想果然是很奇怪的吧……」
PRINTFORMW 「え、%CNAME("一人称")%におちんちんが生えてるのも普通じゃない？　それもその、そうなんですけど……」	PRINTFORMW 「诶、%CNAME("一人称")%长出小鸡鸡也并不正常？　那个嘛、虽然说是这样……」
PRINTFORMW 「はぁ、%CNAME("二人称")%はおっぱい大きくていいですよね……」	PRINTFORMW 「哈啊、%CNAME("二人称")%的胸部这么大真好啊……」
PRINTFORMW 「%CNAME("一人称")%も%CNAME("二人称")%くらい大きいのが欲しかったな……」	PRINTFORMW 「%CNAME("一人称")%曾经也希望像%CNAME("二人称")%那样大的呢……」
PRINTFORMW 「はぁっ、%CNAME("二人称")%のおっぱいを好きにできるなんて夢みたい……」	PRINTFORMW 「哈啊、能够随心所愿的使用%CNAME("二人称")%的胸部，简直像做梦一样……」
PRINTFORMW 「本当のことを言うと%CNAME("一人称")%、ずっと前からこうしてみたかったんです」	PRINTFORMW 「说实话、%CNAME("一人称")%很久以前就想这样试试了」
PRINTFORMW 「んっ……ふわふわしてて、まるでおちんちんに吸い付いてくるみたいです……」	PRINTFORMW 「嗯……轻飘飘地、宛如小鸡鸡被吸住了一样……」
PRINTFORMW 「%CNAME("二人称")%のおっぱいにおちんちんを挟むだなんて……」	PRINTFORMW 「%CNAME("二人称")%的胸部夹住小鸡鸡什么的……」
PRINTFORMW 「あの、本当にいいんですか？　入れちゃいますよ……？」	PRINTFORMW 「那个、真的好吗？　进入了喲……？」
PRINTFORMW 「……んっ、%CNAME("二人称")%のおっぱい、ふかふかで気持ちいいです……」	PRINTFORMW 「……嗯、%CNAME("二人称")%的胸部、软绵绵的好舒服……」
PRINTFORMW 「はぁ……%CNAME("二人称")%のおっぱい、やわらかくて気持ちいい……」	PRINTFORMW 「哈啊……%CNAME("二人称")%的胸部、又软又舒服……」
PRINTFORMW 「%CNAME("一人称")%、女の子なのに……%CNAME("二人称")%のおっぱいでおちんちんごしごししちゃって……んぅっ」	PRINTFORMW 「%CNAME("一人称")%、明明是女孩子……%CNAME("二人称")%的胸部这样咯哧咯哧的使劲、小鸡鸡要去了……哼呜~」
PRINTFORMW 「あぁ……%CNAME("一人称")%のおちんちん、食べられちゃいました……」	PRINTFORMW 「啊啊……%CNAME("一人称")%的胸部、在吃……」
PRINTFORMW 「……んっ、%CNAME("二人称")%のおっぱい……すべすべして、やわらかくて……あぁっ」	PRINTFORMW 「……嗯、%CNAME("二人称")%的胸部……细腻、又柔软……啊啊」
PRINTFORMW 「やぁっ、こんなの……すぐに出ちゃうじゃないですか……」	PRINTFORMW 「呀啊、这样的话……不就很快要出来了吗……」
PRINTFORMW 「%CNAME("二人称")%のおっぱいの%TEXTS("匂い")%と、私のおちんちんの%TEXTS("匂い")%が合わさって……」	PRINTFORMW 「%CNAME("二人称")%胸部的奶香、和我的小鸡鸡的气味混合在一起了……」
PRINTFORMW 「やだ……すごくえっちな%TEXTS("匂い")%がします……」	PRINTFORMW 「讨厌……变成非常色情的气味了……」
PRINTFORMW 「うぅ……どう、ですか……？　見えてますか……？」	PRINTFORMW 「呜呜……怎、怎么样……？　看见了吗……？」
PRINTFORMW （%CNAME("二人称")%に見られてるっ、%CNAME("一人称")%のいやらしいところ、いっぱい見られちゃってるよぉ……）	PRINTFORMW （被%CNAME("二人称")%看见了、%CNAME("一人称")%那下流的场所、纤悉无遗的都被看见了喲……）
PRINTFORMW （あ……んんっ、やだ……っ、%CNAME("一人称", "かな")%っ、見られて濡れてきちゃってる……っ）	PRINTFORMW （啊……嗯嗯、不行……、%CNAME("一人称", "かな")%、被看着就湿了……）
PRINTFORMW 「そ、そんなにじーっと、見つめないで、ください……はずかしいです……」	PRINTFORMW 「请、不要那、那么一直、盯着看啊……太羞耻了……」
PRINTFORMW 「その、まじまじと見られるとすっごく恥ずかしいです……」	PRINTFORMW 「那个、被目不转睛地盯着实在是太羞耻了……」
PRINTFORMW 「%CNAME("二人称")%も男の子ですし、見てみたいというのはわかりますけど、うぅ」	PRINTFORMW 「怎么说%CNAME("二人称")%也是男孩子、虽说想这样看我也能理解但是、呜呜」
PRINTFORMW 「はぁ、%CNAME("一人称")%も%CNAME("二人称")%のものに興味あったし、おあいこなのかなぁ……あ」	PRINTFORMW 「哈啊、%CNAME("一人称")%也对%CNAME("二人称")%的东西感兴趣、已经不相上下了吗……啊」
PRINTFORMW 「な、なんでもないですよ、何も言ってませんっ」	PRINTFORMW 「什、什么也没有喲、什么也没说」
PRINTFORMW （もう、だめ……%CNAME("二人称")%に見られてるだけで、%CNAME("一人称", "かな")%イっちゃいそうだよぉ……）	PRINTFORMW （已经、不行了……只是被%CNAME("二人称")%看着、%CNAME("一人称", "かな")%好像就要去了喲……）
PRINTFORMW （はやく……はやく終わってぇ……あぁ……っ）	PRINTFORMW （快点……快点结束吧……啊啊……）
PRINTFORMW 「見えてますよね、%CNAME("一人称", "かな")%の初めて……。誰ともしたことなんてないですから、当たり前ですけど……」	PRINTFORMW 「看到了吧、%CNAME("一人称", "かな")%的处女地……。因为和谁都没有做过、虽然是理所应当的……」
PRINTFORMW （%CNAME("一人称", "かな")%の処女、ほんとは%CNAME("二人称")%にあげたいけど……ダメだよね……）	PRINTFORMW （%CNAME("一人称", "かな")%的処女、虽然真的很想给%CNAME("二人称")%……但是不行的吧……）
PRINTFORMW （あぁっ、でも、でもやっぱり%CNAME("一人称", "かな")%……%CNAME("二人称")%がいいよぉ……っ）	PRINTFORMW （啊啊、可是、可是%CNAME("一人称", "かな")%果然是……%CNAME("二人称")%可以喲……）
PRINTFORMW 「みえ、ますか？　わたしの子宮……赤ちゃん作るとこ……。%CNAME("二人称")%は使っちゃだめ……ですよ？」	PRINTFORMW 「看、见了吗？　%CNAME("一人称", "かな")%的子宮……生孩子的地方……。%CNAME("二人称")%不可以使用……的喲？」
PRINTFORMW （ああ……%CNAME("一人称", "かな")%、見せちゃいけないとこまで見せちゃってる……）	PRINTFORMW （啊啊……%CNAME("一人称", "かな")%的、到不可以被看见的地方为止都被看见了……）
PRINTFORMW （ほんとは%CNAME("二人称")%のおちんちん入れてほしい……っ、%CNAME("二人称")%の赤ちゃんほしいよぉ……）	PRINTFORMW （真的好想让%CNAME("二人称")%的鸡鸡放进去……、%CNAME("二人称")%的孩子好想要哦……）
PRINTFORMW 「……え？　あっ、うん……。ピアスを引っぱって拡げればいいんですか……？」	PRINTFORMW 「……诶？　啊、唔……。拉住阴唇环来扩张就可以了吗……？」
PRINTFORMW 「ん……っ、ど、どうですか……？　できればその、あんまり……うぅ」	PRINTFORMW 「嗯……、是、是这样吗……？　可以的话那个、太……呜呜」
PRINTFORMW （う……%CNAME("一人称", "かな")%の処女膜、ばっちり見られちゃってるよね……）	PRINTFORMW （呜……%CNAME("一人称", "かな")%的処女膜、被彻底看见了吧……）
PRINTFORMW （すーすーする……んんっ、はぁ、ぁ……子宮まで見えちゃってるのかなぁ……）	PRINTFORMW （看——看——看了……嗯嗯、哈啊、啊……到子宫为止都被看见了吧……）
PRINTFORMW （あっ、やだっ、尿道まで広がっちゃって……んっ、んん……っ、だめ、締まらないよぉ……）	PRINTFORMW （啊、讨厌、连尿道也扩张开了……嗯、嗯嗯……、不行、合不上了啊……）
PRINTFORMW （はぁ……っ、ピアスに引っぱられて……んぅっ、やだぁっ、すごいえっちな形になっちゃう……）	PRINTFORMW （哈啊……、被阴唇环拉着……嗯呜、讨厌啊、要变成超级色的形状了……）
PRINTFORMW 「は、ぅ……、んっ、ふ……ぅ……ぁ、はぁ……っ」	PRINTFORMW 「哈、呜……、嗯、哼……呜……啊、哈啊……」
PRINTFORMW （なにもされてないのに……見られてるだけなのに……どうして、こんなにきもちいいの……？）	PRINTFORMW （明明什么也没做……只是被看着而已……怎么会、这么舒服的……？）
CALL PRINT_STR, @"（%CNAME("二人称")%……っ、もっといっぱい、えっちなとこ……%CNAME("一人称", "かな")%のいやらしいとこ、見て……_H_）_W"	CALL PRINT_STR, @"（%CNAME("二人称")%……、更彻底的、色色的地方……%CNAME("一人称", "かな")%那不检点的场所、看啊……_H_）_W"
PRINTFORMW 「わたしの恥ずかしいとこ、%CNAME("二人称")%がそんなに見たいって言うなら……。んっ、どうぞ……」	PRINTFORMW 「我的羞耻部位、如果说%CNAME("二人称")%那么想看的话……。嗯、请吧……」
PRINTFORMW （やぁ……%CNAME("二人称")%、すごい目で見てるっ、%CNAME("一人称", "かな")%のあそこ、全部見られちゃう……）	PRINTFORMW （呀啊……%CNAME("二人称")%、好厉害的目光、%CNAME("一人称", "かな")%的那里、全部被看见啦……）
PRINTFORMW （いつもいじってるクリトリスも、びらびらも、おしっこの穴も、おまんこの中も全部見られちゃうよぉ……）	PRINTFORMW （总是玩弄着的小豆豆也好、花瓣也好、尿尿的洞也好、小穴的里面也全部都被看光了哦……）
PRINTFORMW 「ほんとは、だめなんですから、ね……？　妹のこと、えっちな目でなんて、見たら……」	PRINTFORMW 「因为真的、是不可以的、吧……？　妹妹的这儿、用色色的目光、看的话……」
PRINTFORMW （でも……っ、%CNAME("二人称")%にだったら、えっちなことされたい……して、ほしい……）	PRINTFORMW （但是……、如果是%CNAME("二人称")%的话、想让你做色色的事情……好想、做啊……）
CALL PRINT_STR, @"（%CNAME("一人称", "かな")%のおまんこ、めちゃくちゃにして……子宮の中にびゅーびゅーってせーえきだしてほしいよぉっ_H_）_W"	CALL PRINT_STR, @"（%CNAME("一人称", "かな")%的小穴……好想被弄得乱七八糟的、在子宮的里面哔ー哔ー地射精喲_H_）_W"
PRINTFORMW 「えっと、あの……いつまでやっていればいいんでしょう……？」	PRINTFORMW 「呃、那个……要这样到什么时候才好呢……？」
PRINTFORMW 「恥ずかしいのもありますけど、手が疲れてきて……」	PRINTFORMW 「虽然也很羞耻、但主要是手累了……」
PRINTFORMW 「%CNAME("一人称")%の処女膜、見てるんですよね……？」	PRINTFORMW 「%CNAME("一人称")%的処女膜、看见了吧……？」
PRINTFORMW 「はぅ……っ。顔から火が出そうです……」	PRINTFORMW 「哈呜……。脸上火辣辣的……」
PRINTFORMW 「あの、その、%CNAME("一人称", "かな")%ってそういうこと、したことないので」	PRINTFORMW 「这个、那个、%CNAME("一人称", "かな")%从来没做过、那种事情」
PRINTFORMW 「自然になくなる人もいるらしいとは聞きますけど」	PRINTFORMW 「但是我听说有些人会自然消失掉」
PRINTFORMW 「……見えますか？　ちゃんと膜、残ってますよね……？」	PRINTFORMW 「……能看见吗？　完好的膜、还留着吧……？」
PRINTFORMW 「いくら%CNAME("二人称")%でも……。あ、いえ逆ですね」	PRINTFORMW 「就算是%CNAME("二人称")%也……。啊、不对、说反了」
PRINTFORMW 「%CNAME("二人称")%とだけはここで、しちゃいけないんですから」	PRINTFORMW 「这里唯独%CNAME("二人称")%不可以用、因为那是不允许的」
PRINTFORMW 「見るだけで満足してくださいね？　他のことなら……その、してあげますから」	PRINTFORMW 「请只是看看就满足吧？　其他事情的话……那个、我会帮你做的啦」
PRINTFORMW 「ん……。どうですか、%CNAME("二人称")%……？」	PRINTFORMW 「嗯……。怎么样呀、%CNAME("二人称")%……？」
PRINTFORMW 「特におかしなところはないと思うんですけど……」	PRINTFORMW 「虽然我觉得没什么特别奇怪的地方……」
PRINTFORMW 「え？　クリトリスが大きい？」	PRINTFORMW 「诶？　小豆豆很大？」
PRINTFORMW 「そ、そこは関係ないじゃないですかっ」	PRINTFORMW 「那、那里不是于你无关吗」
PRINTFORMW 「う、うぅ……%CNAME("二人称")%の視線がちょっとこわいです……」	PRINTFORMW 「呜、呜呜……%CNAME("二人称")%的视线有点吓人……」
PRINTFORMW 「あんまり見ないでくださいね」	PRINTFORMW 「请不要看太过哦」
PRINTFORMW 「別にそんなに変わったものが付いているわけでもないですし。ない……ですよね？」	PRINTFORMW 「并没有存在什么特别奇怪的东西吧。没有……的吧？」
PRINTFORMW 「これで見えますか……？」	PRINTFORMW 「这里看见了吗……？」
PRINTFORMW 「本当はこんなことするの、恥ずかしいんですからね……。%CNAME("二人称", "かな")%のえっち」	PRINTFORMW 「真的这么看着、因为太羞耻了啦……。%CNAME("二人称", "かな")%好色哦」
PRINTFORMW 「恥ずかしいからあんまり見ないでくださいね」	PRINTFORMW 「因为太羞耻了、请不要看太过哦」
PRINTFORMW 「うぅ、なんだか別の生き物みたいに口が開いたり閉じたりしていて……」	PRINTFORMW 「呜呜、总觉得穴口一张一翕的像别的生物似的……」
PRINTFORMW 「すごくえっちな形になっちゃった気がします……」	PRINTFORMW 「感觉变成非常色气的形状了……」
PRINTFORMW 「どんどんいやらしい形になっていくような……」	PRINTFORMW 「形状好像变得越来越下流了的样子……」
PRINTFORMW 「大丈夫でしょうか、これ……」	PRINTFORMW 「没问题的吧、这里……」
PRINTFORMW 「%CNAME("二人称")%にこんな趣味があったなんて知りませんでしたけど」	PRINTFORMW 「我都不知道%CNAME("二人称")%还有这种趣味」
PRINTFORMW 「……他の人にまでこんなことさせたらだめですよ」	PRINTFORMW 「……不可以和其他人做这种事哦」
PRINTFORMW 「%CNAME("二人称")%に言われるままにしていたら、とんでもないことに……」	PRINTFORMW 「都是因为听从%CNAME("二人称")%才这样的啦、如此想都不敢想……」
PRINTFORMW 「うぅぅ、本当に恥ずかしいんですからね、これ」	PRINTFORMW 「呜呜呜、因为实在是太羞耻了哦、这里」
PRINTFORMW 「がんばったら元に戻せるんでしょうか……」	PRINTFORMW 「小穴被扩大成这样、努力的话会恢复原状吗……？」
PRINTFORMW 「これ、元に戻るんでしょうか……」	PRINTFORMW 「这里、会恢复原状吗……」
PRINTFORMW 「%CNAME("一人称", "かな")%個人としては、その、以前の方が」	PRINTFORMW 「就%CNAME("一人称", "かな")%个人而言、那个、还是以前那样好」
PRINTFORMW 「でも%CNAME("二人称")%はこっちの方が好きだから、こうしたんですよね……？」	PRINTFORMW 「可是%CNAME("二人称")%更喜欢现在这样、是这样的吧……？」
PRINTFORMW 「%CNAME("二人称")%って本当にしょうがない人ですよね」	PRINTFORMW 「%CNAME("二人称")%真是个无可救药的人啊」
PRINTFORMW 「もう……。これで満足ですか？」	PRINTFORMW 「真是的……。这样满足了吗？」
PRINTFORMW 「ここまでやって満足してくれなかったら……それは、ちょっと悲しいです」	PRINTFORMW 「如果这样还不满足的话……那可真是、有点可悲啊」
PRINTFORMW 「えーっと、あの、もう一回お願いします」	PRINTFORMW 「呃——嗯、那个、请再说一遍」
PRINTFORMW 「聞き間違いじゃなかったらおしっこの穴に指を入れるって言われた気がするんですが」	PRINTFORMW 「如果我没听错的话、你是说想把手指放入尿尿的小穴里去吗？」
PRINTFORMW 「尿道や膀胱って基本的に無菌だから、逆に言えば菌が入ると病気にもなりやすいところなんですけど……」	PRINTFORMW 「因为尿道或者膀胱基本上都是无菌的、可是反过来说、细菌进入的话也容易生病……」
PRINTFORMW 「うぅ、せめて指は綺麗にしてから入れてくださいね……」	PRINTFORMW 「呜呜、请至少把手指弄干净再进去哦……」
PRINTFORMW 「んっ、んぅぅっ、やっ、あっ、はぁっ」	PRINTFORMW 「嗯、嗯呜呜、呀、啊、哈啊」
PRINTFORMW 「あぅっ……！？　%CNAME("二人称", "かな")%っ、はげしすぎ……ですよぉっ」	PRINTFORMW 「啊呜……！？　%CNAME("二人称", "かな")%、太激烈……了喲」
PRINTFORMW 「%CNAME("一人称", "かな")%のおしっこの穴、あんなに大きく広がっちゃって……んっ」	PRINTFORMW 「%CNAME("一人称", "かな")%的尿尿洞、扩张成那么大了……嗯」
PRINTFORMW 「やぁっ、見せなくていいですからっ」	PRINTFORMW 「呀啊、不用展示给我看的啦」
PRINTFORMW 「確かにもう痛くはないですけど、それはそれで別のことが心配になります……」	PRINTFORMW 「虽然说确实已经不痛了、所以现在我更担心其他事情……」
PRINTFORMW 「%CNAME("二人称")%だっておしっこ垂れ流しの子が妹なんてイヤですよね？」	PRINTFORMW 「即便是%CNAME("二人称")%、小便失禁的孩子是妹妹什么的也会讨厌的吧？」
PRINTFORMW 「うぅ、イヤって言ってくださいよぅ……」	PRINTFORMW 「呜呜、请说讨厌的啊……」
PRINTFORMW 「んぅっ、ぐっ、くぅっ……あぅっ」	PRINTFORMW 「嗯呜、咕、库呜……啊呜」
PRINTFORMW 「はっ、はっ、はぁっ、はぁ……っ、もっとゆっくり……んぐぅぅっ」	PRINTFORMW 「哈、哈、哈啊、哈啊……、再慢慢地……嗯咕呜呜~」
PRINTFORMW 「や……っ、やだっ、やめてくださいっ！」	PRINTFORMW 「咿……、讨厌、请不要啊！」
PRINTFORMW 「そんなの……入らな……いﾞぎぅっ！？」	PRINTFORMW 「那种东西……进去的话……去了呜！？」
PRINTFORMW 「――かはっ、げほっ、ごほっ。あぁ……だめ、です……こわ、れﾞっ！？」	PRINTFORMW 「――咔哈、咳嚯、啯嚯。啊啊……不、不行啊……坏、坏掉了！？」
PRINTFORMW 「ぐっ、あﾞぅっ、あﾞぁっ、う……あぁ……」	PRINTFORMW 「咕、阿呜、阿啊、呜……啊啊……」
PRINTFORMW 「いたぁ……っ、ん……んぐっ、はぁっ」	PRINTFORMW 「疼啊……、嗯……嗯咕、哈啊」
PRINTFORMW 「冷たいのが、入ってくる……っ、やだ、いやだよ、%CNAME("二人称")%……っ」	PRINTFORMW 「冷冰冰的东西、进来了……讨厌、好讨厌喲、%CNAME("二人称")%……」
PRINTFORMW 「ほんとは……%CNAME("二人称", "かな")%に、あげたかったのに……」	PRINTFORMW 「本来……是想给%CNAME("二人称", "かな")%的……呜~」
PRINTFORMW 「この文章が出たらバグです」	PRINTFORMW 
PRINTFORMW 「そんなに痛くはないですけれど……んんっ」	PRINTFORMW 「虽然不是很痛、但是……嗯嗯」
PRINTFORMW 「この、固くて大きいものに押しのけられてる感じが……慣れなくて」	PRINTFORMW 「被这个、又硬又大的东西押入的感觉……很不适应」
PRINTFORMW 「ん……っ、これくらいだったら、なんとか……」	PRINTFORMW 「嗯……、如果是这种程度的话、怎么说呢……」
PRINTFORMW 「痛みもあまりないですし、太さも大丈夫です」	PRINTFORMW 「痛倒不是很痛、粗细也没什么问题」
PRINTFORMW 「……その、%CNAME("二人称")%のもので慣らしてもらいましたから、ね」	PRINTFORMW 「……那个，因为用的是%CNAME("二人称")%的东西，已经可以习惯了、吧」
PRINTFORMW 「さっきから何を用意しているんですか？」	PRINTFORMW 「从刚才开始，就有在预谋什么吗？」
PRINTFORMW 「なんだかすごく大きいですけど……」	PRINTFORMW 「但是感觉也太大了吧……」
PRINTFORMW 「えっ？」	PRINTFORMW 「诶？」
PRINTFORMW 「おしりにこれを入れる？　え、あの、%CNAME("二人称")%のですか？」	PRINTFORMW 「把这个放进屁股里去？　诶、那个，是指%CNAME("二人称")%的吗？」
PRINTFORMW 「……違う？　%CNAME("一人称", "かな")%のおしり？」	PRINTFORMW 「……不对？　是%CNAME("一人称", "かな")%的屁股？」
PRINTFORMW 「ええっ、ちょ、ちょっと待ってください%CNAME("二人称")%」	PRINTFORMW 「诶诶，请、请等一下啊，%CNAME("二人称")%」
PRINTFORMW 「お尻って出すところですよ、入れるところじゃないんですよ？」	PRINTFORMW 「屁股用来排出的、不是用来吞入的场所喲？」
PRINTFORMW 「それに、その、これ……普段お尻を通ってるものよりずっと太いんですけど……	PRINTFORMW 「而且啊、这个……比平时通过屁股的东西粗太多了啦……」
PRINTFORMW 「う、うぅ……そういうことをする人がいるとは聞いたことありましたが、でも……」	PRINTFORMW 「呜、呜呜……我听说过也有做这种事的人呢、但是……」
PRINTFORMW 「こういうのを入れられるようになるには、訓練が必要じゃないんですか……？」	PRINTFORMW 「想让这种东西放进去的话、不是有必要训练的吗……？」
PRINTFORMW 「やっ、できませんよぉっ、お尻の才能なんてないですってばっ」	PRINTFORMW 「呀、不可以喲、屁股的才能什么的才没有啦」
PRINTFORMW 「つめたっ！？　やぁっ、おしつけないでっ、腰おさえるのもやめてくださ――」	PRINTFORMW 「我冷淡！？　呀啊、不要强迫我、也请不要摁着腰啦――」
PRINTFORMW 「痛っ！？　む、無理ですっ、こんなの入りませんから、はなしてー！」	PRINTFORMW 「好痛！？　办、办不到的、这样的进不去的啦、放开我ー！」
PRINTFORMW 「あの、%CNAME("二人称")%……」	PRINTFORMW 「请问、%CNAME("二人称")%……」
PRINTFORMW 「確かにいくらかお尻の経験は積みましたよ、積みましたけど……」	PRINTFORMW 「屁股确实多少积累了一些经验吧、虽然说积累了……」
PRINTFORMW 「でもこれは無理じゃないかなって思うんですよ」	PRINTFORMW 「但是，我觉得这个是不可能的喲」
PRINTFORMW 「もうちょっと、その、小さいのをよく濡らしてからですね」	PRINTFORMW 「再稍微，那个、换个小号的，再好好地润滑的话」
PRINTFORMW 「あの%CNAME("二人称")%？　聞いてますか？　ないですね？」	PRINTFORMW 「那个%CNAME("二人称")%？　你在听吗？　没有啊？」
PRINTFORMW 「離してっ、離してくださいってばー！」	PRINTFORMW 「放开我、都说了请放开我啦ー！」
PRINTFORMW 「はっ、はっ……ふんっ、んぅっ……んはぁっ」	PRINTFORMW 「哈、哈……哼嗯、嗯呜……嗯哈啊」
PRINTFORMW %CALLNAME:TARGET%の尻からひり出された巨大なバイブは、ずしんと大きな音を立てて\@ COND("室内") ? 床 # 地面 \@に転がった。	PRINTFORMW 从%CALLNAME:TARGET%的屁股里不合理地弹出的巨大震动棒，滚落在\@ COND("室内") ? 地板 # 地面 \@上仍旧震动着，因为撞击发出巨大的声响。
PRINTFORMW 「うわ、今ものすごい音がしましたけど……\@ COND("室内") ? 。床大丈夫ですか……？ # \@」	PRINTFORMW 「呜哇、现在也在发出好厉害的声音……\@ COND("室内") ? 。地板没事吧……？ # \@」
PRINTFORMW 「はぁ……いつ見ても大きいですねぇ」	PRINTFORMW 「哈啊……几时看都好大呃」
PRINTFORMW 「こんな大きなものが%CNAME("一人称")%のお腹に入ってたんですね……」	PRINTFORMW 「这么大的东西进到%CNAME("一人称")%的肚子里呢……」
PRINTFORMW 「はぁ……今更こんな普通の大きさじゃ……」	PRINTFORMW 「哈啊……事到如今这么普通的大小已经……」
PRINTFORMW 「……あっ」	PRINTFORMW 「……啊」
PRINTFORMW 「%CNAME("二人称", "どもり")%、今の聞こえてました……？」	PRINTFORMW 「%CNAME("二人称", "どもり")%、刚才的听到了……？」
PRINTFORMW 「んっ、もう抜いていいんですか……？」	PRINTFORMW 「嗯、已经可以拔出来了吗……？」
PRINTFORMW 「はぁ……お尻にこんなもの入れて気持ちよくなっちゃうなんて……」	PRINTFORMW 「哈啊……这种东西进到屁股里去，会变得舒服什么的……」
PRINTFORMW 「はっ、はっ、はっ……んっ、んんっ」	PRINTFORMW 「哈、哈、哈……嗯、嗯嗯」
PRINTFORMW 「やだ……こんなにおっきいのにっ、根本までするっと入っちゃう……」	PRINTFORMW 「讨厌……明明那么大的说、连根没入了呜……」
PRINTFORMW 「はぁ……なんだかもう、すごいことになってますよね……」	PRINTFORMW 「哈啊……总觉得真的是、做了很厉害的事情啊……」
PRINTFORMW 「大きすぎてお腹が……ほらここ、わかります？　膨らんじゃって……」	PRINTFORMW 「肚子太大了……看这里、明白了？　都膨胀起来啦……」
PRINTFORMW 「この広げられていく感じ……結構、好きです……」	PRINTFORMW 「这种被扩张的感觉……真棒、我很喜欢……」
PRINTFORMW 「んっ……あぁ、奥まで来ました……」	PRINTFORMW 「嗯……啊啊、到深处来了……」
PRINTFORMW 「お腹の中がいっぱいで……もう入らないです……っ」	PRINTFORMW 「肚子里面满满的……已经不能再深入了……」
PRINTFORMW 「はぁっ……この圧迫感、気持ちいい……」	PRINTFORMW 「哈啊……这种圧迫感、好舒服……」
PRINTFORMW 「ん……すんなり入っちゃいました」	PRINTFORMW 「嗯……很顺利地进来了」
PRINTFORMW 「なんだか%CNAME("一人称")%、慣れてきちゃってますね……」	PRINTFORMW 「总觉得%CNAME("一人称")%、已经习惯了呢……」
PRINTFORMW 「これくらいの大きさなら、もうそんなにキツくなくなりましたね」	PRINTFORMW 「这种程度的大小的话、已经不那么难受了呢」
PRINTFORMW 「はぁ、%CNAME("二人称")%にこのまま付き合ってたら、この先どうなっちゃうんでしょう……」	PRINTFORMW 「哈啊、要是就这样和%CNAME("二人称")%交往的话、今后会变成怎样呢……」
PRINTFORMW 「はぁーっ、はぁーっ……あぅっ、ぐぅっ、ひっ、ぃぎ……っ！」	PRINTFORMW 「哈啊ー、哈啊ー……啊呜、咕呜、嗬、呿……了！」
PRINTFORMW 「さけ……るっ、おしりも、おなかもっ、さけちゃう……ぅぐっ！？」	PRINTFORMW 「坏掉……了、屁股也、肚子也、坏掉了……嗬呜！？」
PRINTFORMW 「だめ……っ、こんなのっ、入らないです……っ！」	PRINTFORMW 「不行……、这样的、进不去的啦……！」
PRINTFORMW 「あぐっ、いﾞっ、ふぅっ……あっ、ぅあっ、あぁっ！」	PRINTFORMW 「啊咕、咿、哼呜……啊、呜啊、啊啊！」
PRINTFORMW 「い……っ、たぁ……」	PRINTFORMW 「好……痛啊……」
PRINTFORMW 「う、うぅ……。今のでお尻裂けちゃったんじゃないですか……？」	PRINTFORMW 「呜、呜呜……。刚刚那样屁股都裂开了不是吗……？」
PRINTFORMW 「ほら、私のおちんちんはここですよ%CNAME("二人称")%。そのままゆっくり……」	PRINTFORMW 「看啊、我的鸡鸡在这里喲%CNAME("二人称")%。就这样慢慢地……」
PRINTFORMW 「……んぅっ、思ってたよりひんやりしてますね、これ……」	PRINTFORMW 「……嗯呜、比想象中更冰凉呢、这个……」
PRINTFORMW 「ふふっ、気持ちよくしてくださいね……」	PRINTFORMW 「呼呼、请让我舒服哦……」
PRINTFORMW 「……？　なんですか%CNAME("二人称")%、そのぷにぷにしたの」	PRINTFORMW 「……？　这是什么啊%CNAME("二人称")%、那个柔软Q弹的」
PRINTFORMW 「おちんちんを入れるものなんですか……？　え、使ってみろって？　……ひゃんっ！？」	PRINTFORMW 「是用来套住小鸡鸡的东西是吗……？　诶、让我试试看？　……吓！？」
PRINTFORMW 「うぅ、冷たくて思わず変な声が……んんっ」	PRINTFORMW 「呜呜、凉凉的不由得发出奇怪的声音了……嗯嗯」
PRINTFORMW 「あっ、またそれ使うんですね」	PRINTFORMW 「啊、还要使用那个呢」
PRINTFORMW 「え？　やだ何言ってるんですか、クセになんて……」	PRINTFORMW 「诶？　讨厌、你在说什么啊、癖好什么的……」
PRINTFORMW 「……なって、ない、ですよ？」	PRINTFORMW 「……没有、没有、喲？」
PRINTFORMW 「ひぅ……っ、さきっぽがぞりぞりして……んっ」	PRINTFORMW 「嗬呜……龟头哧溜哧溜地……嗯」
PRINTFORMW 「やだっ、そんな早くしないでくださ……っ、はふぅっ！？」	PRINTFORMW 「讨厌、请不要那么快……哈唿！？」
PRINTFORMW 「うぅっ、またこれですか」	PRINTFORMW 「呜呜、又要用这个吗」
PRINTFORMW 「そんなに私がおちんちんから精液びゅるびゅる出すところが見たいんですか……？」	PRINTFORMW 「就那么想看从我的鸡鸡里哔哔地射出精液的样子吗……？」
PRINTFORMW 「もう、しょうがないなぁ%CNAME("二人称")%は……」	PRINTFORMW 「真是的、真拿你没辙啊%CNAME("二人称")%……」
PRINTFORMW 「%CNAME("一人称", "かな")%のお尻……ついに、%CNAME("二人称")%のおちんちんが入っちゃうんですね……」	PRINTFORMW 「%CNAME("一人称", "かな")%的屁股……终于、%CNAME("二人称")%的鸡鸡进来啦……」
PRINTFORMW （しょうがないよね、だっておまんこにはおちんちん入れられないんだし……）	PRINTFORMW （没办法的吧、因为不能让鸡鸡进到小穴里去啊……）
PRINTFORMW （どれくらい気持ちいいのかな、すぐイっちゃうくらいすごいのかな……んんっ、まだかな……？）	PRINTFORMW （有多舒服呢、厉害到马上就要去了的程度呢……嗯嗯、还没好么……？）
CALL PRINT_STR, @"「あっ……んくっ、ぅぁ、おちんちんきたぁ……っ_H_　ぁ、はぁ……っ、すごく熱くてっ、びくびくしてる……」_W"	CALL PRINT_STR, @"「啊……嗯库，呜啊，鸡鸡来了……_H_　啊、哈啊……好烫，一颤一颤地……」_W"
PRINTFORMW 「うぅ……こ、怖いですけど、でも……%CNAME("二人称")%がしたいなら、%CNAME("一人称", "かな")%は、入れてあげたいです……」	PRINTFORMW 「呜呜……虽、虽然很害怕，可是……如果是%CNAME("二人称")%想要的话，%CNAME("一人称", "かな")%、想给你进来……」
PRINTFORMW （%CNAME("二人称")%のおちんちん、すっごく硬くなってる……そ、そんなに%CNAME("一人称")%に入れたかったのかなぁ）	PRINTFORMW （%CNAME("二人称")%的鸡鸡、变得超级硬了……就、就那么想进入%CNAME("一人称")%的身体么）
PRINTFORMW （ふふ、それは結構うれし……ん、んぐぅっ！？　あぁっ、きたっ、おちんちんきたぁ……っ！）	PRINTFORMW （呼呼、那可太令我高兴了……嗯、嗯咕呜！？　啊啊、来了、鸡鸡来了啊……！）
PRINTFORMW 「あぅっ……ぁ、う゛ぅ……んはぁ、はぐっ……んう゛ぅぅっ！？」	PRINTFORMW 「啊呜……啊、唔呜……嗯哈啊、哈咕……嗯唔呜呜！？」
PRINTFORMW 「は……っ、はっ、はいっ……たぁっ、%CNAME("二人称")%のおちんちん、全部おしりに入りましたぁ……」	PRINTFORMW 「哈……哈、哈好……疼啊、%CNAME("二人称")%的鸡鸡、全部进到屁股里去啦……」
PRINTFORMW 「%CNAME("二人称")%の計画もついに大詰め、というわけですね」	PRINTFORMW 「%CNAME("二人称")%的计划终于到最后阶段了、这是当然的呢」
PRINTFORMW 「まさか%CNAME("二人称")%のおちんちんをお尻に入れることになるなんて……。これは考えなかったですよ、さすがに」	PRINTFORMW 「想不到让%CNAME("二人称")%的鸡鸡进入屁股这种事会实现什么的……。这种事从来没有想过的喲、真的没有」
PRINTFORMW 「なるべく力を抜くようにがんばりますけど、キツかったらごめんなさい」	PRINTFORMW 「我会尽量努力放松下来的啦、要是太紧的话、对不起」
PRINTFORMW 「……さ、どうぞ」	PRINTFORMW 「……萨、请吧」
PRINTFORMW 「……っ、う、うぅ……んんっ、%CNAME("二人称")%のおちんちん、ものすごく硬いんですけど……」	PRINTFORMW 「……呜、呜呜……嗯嗯、%CNAME("二人称")%的鸡鸡、好硬啊……」
PRINTFORMW 「こ、興奮しすぎじゃないですか？　そんなに、その、%CNAME("一人称", "かな")%のお尻に入れたいんですか……？」	PRINTFORMW 「但是，是不是太兴奋了？　就那么、想进入%CNAME("一人称", "かな")%的屁股吗……？」
PRINTFORMW 「うぅ……こんなの入れたら裂けちゃいそうなんですけど……」	PRINTFORMW 「呜呜……就那样进来的话会裂开的说……」
PRINTFORMW 「そもそもここって外から何か入るようなところじゃないですし……あっやっ、入れようとしないでっ、ちょ、ちょっと待っ――」	PRINTFORMW 「说起来，这本来就不是排出物以外的东西能进入的场所呀……啊、呀、别进来啊。等、等一下――」
PRINTFORMW 「や、ぁぁ……たりないっ、これじゃ、たりないです……っ」	PRINTFORMW 「呀、啊啊……不够、这样的话、不够啊……」
PRINTFORMW 「もうちょっと、なのに……っ、あぁっ……ん、ぅぅ……やぁ……っ」	PRINTFORMW 「就差一点、就能去了的说……啊阿……嗯、唔唔……呀阿……」
PRINTFORMW 「%CNAME("二人称", "かな")%の……っ、いじ、わるぅ……っ、はぁ、ぁぁっ……」	PRINTFORMW 「%CNAME("二人称", "かな")%……好、坏心眼……哈阿、阿阿……」
PRINTFORMW 「んう゛……っ、ぁ……くぅっ、きつぅ……ぁっ、あぁっ」	PRINTFORMW 「呼譕……阿……库唔、好紧唔……阿、啊阿」
PRINTFORMW 「はぁっ、はっはっ、は……あぅっ、さけちゃい、そう……」	PRINTFORMW 「哈啊、哈、哈、哈……啊唔、要去了、那样……」
PRINTFORMW 「んん――っ、く、はぁっ、ふっ、ふぅっ……%CNAME("二人称")%の、おっきい……っ」	PRINTFORMW 「嗯嗯――、库、哈啊、呼、哼呜……%CNAME("二人称")%的、好大……」
PRINTFORMW 「ふふ……%CNAME("二人称")%、%CNAME("一人称", "かな")%の好みに合わせてくれるんですか……？」	PRINTFORMW 「呼呼……%CNAME("二人称")%、能迎合%CNAME("一人称", "かな")%的嗜好吗……？」
PRINTFORMW 「そうやって優しくしてくれる%CNAME("二人称")%、好きですよ……」	PRINTFORMW 「就这样对我温柔的%CNAME("二人称")%、好喜欢喲……」
PRINTFORMW 「激しくされるの好きです、%CNAME("二人称")%に求められてる感じがして」	PRINTFORMW 「喜欢被激烈地对待、被%CNAME("二人称")%索取的那种感觉」
PRINTFORMW 「たまには%CNAME("一人称")%が主導権握っちゃおうかな……なんて」	PRINTFORMW 「偶尔让%CNAME("一人称")%来掌握主导权吧……什么的」
PRINTFORMW 「んっ……%CNAME("一人称", "かな")%、この格好でするの好きです……」	PRINTFORMW 「嗯……%CNAME("一人称", "かな")%、喜欢这个姿势……」
PRINTFORMW 「%CNAME("二人称")%に抱きしめてもらってる感じがして……」	PRINTFORMW 「被%CNAME("二人称")%紧紧拥抱着的感觉……」
PRINTFORMW 「%CNAME("二人称")%のこと、ずっと見てられるから……」	PRINTFORMW 「因为能一直看着、%CNAME("二人称")%的动作……」
PRINTFORMW 「%CNAME("二人称")%が見えないと結構どきどきして……刺激的です」	PRINTFORMW 「看不见%CNAME("二人称")%就颇为忐忑……很刺激」
PRINTFORMW 「あ……%CNAME("二人称")%、この体勢好きですよね。%CNAME("一人称")%も好きです」	PRINTFORMW 「啊……%CNAME("二人称")%、很喜欢这个姿势呢。%CNAME("一人称")%也喜欢哦」
PRINTFORMW 「……まぁ、される方は結構、恥ずかしいんですけどね」	PRINTFORMW 「……嘛啊，虽然被弄成这样，颇为羞耻的呢」
PRINTFORMW 「奥まで届きそうな感じがして……気持ちよくて」	PRINTFORMW 「快要到达最深处的感觉……太舒服了」
PRINTFORMW 「……ふふ、%CNAME("二人称")%とぴったりくっついていられますから」	PRINTFORMW 「……呼呼、因为能和%CNAME("二人称")%紧紧地贴在一起」
PRINTFORMW 「あんまり見ないでくださいね……その、あまり%CNAME("二人称")%に見せられない顔しちゃうと思うので」	PRINTFORMW 「请不要盯着看啦……因为、想要露出绝对不能给%CNAME("二人称")%看见的表情」
PRINTFORMW 「うー、入れる瞬間はいつも緊張しちゃいます……。い、いきますよ？　ん……っ」	PRINTFORMW 「唔ー、进入的瞬间总是很紧张……。继、继续喲？　嗯……」
PRINTFORMW 「あの%CNAME("二人称")%……手を、ですね、握っていてください……。まだその、ちょっと怖くて」	PRINTFORMW 「那个呢、%CNAME("二人称")%……手、可以的话、请握着好吗……。还是、有点害怕」
PRINTFORMW 「やぁ、やぁぁっ、%CNAME("二人称")%なんで止めちゃうの……っ、イかせてっ、イかせてよぉっ」	PRINTFORMW 「讨、讨厌啊、%CNAME("二人称")%干嘛停下来嘛……让我去、让我去啊」
PRINTFORMW （イきたいっ、イきたいよぉっ、%CNAME("二人称")%のおちんちんでいっぱいイきたいよぉ……っ）	PRINTFORMW （想去、好想去啊、好想被%CNAME("二人称")%的鸡鸡干到高潮喲……）
PRINTFORMW 「このままなんて……っ、つらいよぉっ、せつない、よぉ……っ、ん……うぅっ……」	PRINTFORMW 「这样放置什么的……好过分啊、我好难受、喲……嗯……唔唔……」
PRINTFORMW 「やぁっ、止めないでぇっ、もっとっ、もっと激しくして、くださ……っ、やぁぁぁっ」	PRINTFORMW 「呀啊、别停啊、更加、更加激烈地、求你……呀啊啊啊」
PRINTFORMW 「だめ……っ、やぁっ、あと、あとちょっとなのに……っ」	PRINTFORMW 「不行……呀啊、就、就差一点而已……」
PRINTFORMW 「いじわる、しないで……イかせて、くださ……っ、んぅっ……ぁぁっ」	PRINTFORMW 「不要、欺负我呀……请、让我去嘛……嗯唔……阿阿」
PRINTFORMW 「あ……っ、んぅぅっ、はぁ、っ……%CNAME("一人称", "かな", "どもり")%っ、こんなに痛いのに……あぅっ」	PRINTFORMW 「啊……嗯呜呜、哈啊……%CNAME("一人称", "かな", "どもり")%、明明这么痛的啊……啊唔」
PRINTFORMW 「くる、くるっ、きちゃう……っ、おしりっ、おしり壊されてイっちゃいます……っ！」	PRINTFORMW 「来、来了、要来了……屁股、屁股被弄坏着去了……咿！」
PRINTFORMW 「んんーっ！　んぅっ、んっ、ん……っ、はっ、はっ、はぁっ、ぅ、うぁ……」	PRINTFORMW 「嗯嗯ー！　嗯唔、嗯、嗯……哈、哈、哈啊、呜、呜啊……」
PRINTFORMW 「すご、すぎる……よぉ……っ、はぁーっ、はぁっ、はっ、は……ふぅうっ」	PRINTFORMW 「太、厉害了……喲……哈啊ー、哈啊、哈、哈……哼呜」
PRINTFORMW 「おしり……っ、おかしく、なっちゃい、そう……っ、は、うぅっ、くぅ……」	PRINTFORMW 「屁股……要变奇怪、起来了、那样……哈、呜呜、库呜……」
PRINTFORMW （でもっ、%CNAME("二人称")%に壊してもらえるなら……っ、あ、あはっ……いい、かも……んぐぅっ！？）	PRINTFORMW （不过、被%CNAME("二人称")%弄坏的话……啊、啊哈……也不错、呢……嗯咕唔！？）
PRINTFORMW 「きつ、い……っ、けどっ、%CNAME("二人称")%の、おちんちん、だもん……ぁ、はぁっ……んう゛っ！」	PRINTFORMW 「好、紧啊……但是、因为是%CNAME("二人称")%的、大鸡鸡嘛……啊、哈啊……嗯嗚！」
PRINTFORMW 「おしりも、おなかも……っ、ごりごりして、すごい、ひろがってる……」	PRINTFORMW 「屁股也是、肠道也是……强行被、好厉害地、扩张着……」
PRINTFORMW （すご、ぉい……ぁぐっ、はぁっ、%CNAME("二人称", "かな")%っ、だいすき、です……っ）	PRINTFORMW （好厉、喔害……啊咕、哈啊、最喜欢、%CNAME("二人称", "かな")%、了……）
PRINTFORMW 「あぁ……っ、すご、い……すごい、よぉ……っ、%CNAME("二人称")%、の……」	PRINTFORMW 「啊啊……好、厉害……好厉害、喲……%CNAME("二人称")%、的……」
PRINTFORMW 「あそこの方に、こんなおちんちん入れたら、%CNAME("一人称", "かな")%っ、壊されちゃう、かも……っ」	PRINTFORMW 「那种地方、这样的大鸡鸡进入的话、%CNAME("一人称", "かな")%、可能、要坏掉了……」
PRINTFORMW （う、うぅ……や、やっぱりちょっと、入れてみたいよぉ……）	PRINTFORMW （呜、呜唔……果、果然还是想、进入试试看喲……）
PRINTFORMW 「わ、わたしのことは、気にしないで……んう゛っ、%CNAME("二人称")%の好きなように、うごいて、ください……っ」	PRINTFORMW 「我、我的话、不用在意……嗯譕、请、随%CNAME("二人称")%喜欢的那样、动起来吧……」
PRINTFORMW 「は……っ、はぁ、ふぅ……っ、ちから、抜かなきゃ……っ、んっ、ふ、ぅぅ……」	PRINTFORMW 「哈……哈啊、唿唔……力气、瘫软的话……嗯、唿、唔唔……」
PRINTFORMW （%CNAME("二人称")%を……気持ちよく、してあげたい……っ、もっと、もっと上手く、ならなきゃ……）	PRINTFORMW （想让、%CNAME("二人称")%也……舒服起来……必须、更加、更加擅长才行……）
PRINTFORMW 「んぅぁっ、あぅっ、はっ、はぁっ、はげし……っ、お尻っ、おしりめくれちゃうぅっ」	PRINTFORMW 「嗯呜啊、啊呜、哈、哈啊、太激烈了……屁眼、屁眼翻出来了呜嗚~」
PRINTFORMW 「%CNAME("二人称")%のおちんちんすごいよぉ……おしりビリビリするぅ……っ」	PRINTFORMW 「%CNAME("二人称")%的大鸡鸡好厉害……屁眼麻麻地呜……」
CALL PRINT_STR, @"（だ、だめぇ……こんなの耐えられないよぉっ、おしりでするの大好きになっちゃうっ_H_）_W"	CALL PRINT_STR, @"（不、不行啊……这样的受不了啦、要变得最喜欢用屁股了嗚_H_）_W"
PRINTFORMW 「おふっ……んっ、んう゛っ……ぁ、あぅ……っ、だめぇ……%CNAME("一人称", "かな")%ばかになっちゃう……」	PRINTFORMW 「噢唿……嗯、嗯譕……阿、啊唔……不行……%CNAME("一人称", "かな")%要变成笨蛋了……」
PRINTFORMW 「ぁうっ！？　ぁっ、ぁっあっあ……っ、イく……っ！　ぁっ、あぁっ、イくっ、イっ、イくぅぅぅっ！」	PRINTFORMW 「啊呜！？　啊、啊~啊~啊……去了……！　啊、啊啊、去了、去、去了唔唔唔！」
CALL PRINT_STR, @"「%CNAME("二人称", "かな")%っ、%CNAME("二人称", "かな")%……っ_H_　しゅきぃっ_H_　ぁ、んぅ……%CNAME("二人称", "かな")%のおちんちん、だいしゅきぃ……_H_」_W"	CALL PRINT_STR, @"「%CNAME("二人称", "かな")%、%CNAME("二人称", "かな")%……_H_　稀饭（喜欢）_H_　啊、嗯呜……%CNAME("二人称", "かな")%的大鸡鸡、最稀饭了……_H_」_W"
PRINTFORMW 「ん……あはっ、%CNAME("二人称")%のおちんちん……ふくらんで、きたぁ……っ」	PRINTFORMW 「嗯……啊哈、%CNAME("二人称")%的鸡鸡……膨胀、起来了……」
PRINTFORMW 「我慢しなくて……んっ、いいんです、よ……？　%CNAME("一人称", "かな")%のお尻にっ、いーっぱいだしちゃってくださいね……っ」	PRINTFORMW 「不用忍耐……嗯、也可以、喲……？　%CNAME("一人称", "かな")%的屁股、请好好地使用吧……」
CALL PRINT_STR, @"（ほらぁ……っ、もっと、きもちよくなっちゃえっ_H_　おしりの穴にせーえきびゅーってだしちゃえっ_H_）_W"	CALL PRINT_STR, @"（来吧……更加、舒服起来吧_H_　在屁股的小穴里、精——液、哔——地、射出来了_H_）_W"
PRINTFORMW 「はぁ……っ、んっ、んぅ……ぁ、ふぅ……んくっ、ん……っ」	PRINTFORMW 「哈啊……嗯、嗯唔……阿、唿……嗯库、嗯……」
PRINTFORMW 「%CNAME("二人称")%、上手です……っ、あぅっ、どこでこんなこと、覚えて……ぁくぅっ」	PRINTFORMW 「%CNAME("二人称")%、好擅长……啊呜、在哪里学会、这种事情的……啊库唔」
PRINTFORMW （%CNAME("一人称", "かな")%も……もっとっ、上手くならなきゃ……%CNAME("二人称")%を気持ちよくして、あげるんだから……ぁっ）	PRINTFORMW （%CNAME("一人称", "かな")%也能……更加、擅长的话……也能让%CNAME("二人称")%、变得舒服的吧……啊）
PRINTFORMW 「あ……んぁぁっ、はぁっ……おしり、戻らなくなっちゃいそ……んぅっ」	PRINTFORMW 「啊……嗯啊啊、哈啊……屁眼、恢复不了了……嗯唔」
PRINTFORMW （戻らなくなってもいいからっ、もっとっ、%CNAME("二人称")%もっとしてください……）	PRINTFORMW （还原不了也无所谓、我还要、%CNAME("二人称")%请再多多操我……）
CALL PRINT_STR, @"（はぁぁぁ……%CNAME("二人称")%好きっ、好きぃっ、%CNAME("二人称")%のおちんちんもいっぱいいっぱい好きですっ_H_）_W"	CALL PRINT_STR, @"（哈啊啊……%CNAME("二人称")%喜欢、喜欢、%CNAME("二人称")%的大鸡鸡也非常非常喜欢_H_）_W"
PRINTFORMW 「も、もっと……ぁぅ、ぅ……んぅっ、ぅぅ……」	PRINTFORMW 「还、还要……啊呜、呜……嗯呜、呜呜……」
PRINTFORMW 「……はぁ、ん……や、やっぱりそんなこと、恥ずかしくて言えません……うぅっ」	PRINTFORMW 「……哈啊、嗯……果、果然这种事情、太羞耻了说不出口……呜呜」
PRINTFORMW 「んぅっ、あぅぅっ……はぁっ、はっ」	PRINTFORMW 「嗯唔、啊唔唔……哈啊、哈」
PRINTFORMW 「やだぁ……%CNAME("二人称")%もっ、いっしょに、きてよぉ……っ」	PRINTFORMW 「不要~……%CNAME("二人称")%也、一起、去嘛……」
PRINTFORMW 「じ、じらさないでぇ……っ、ぁひっ、ん、ぅ……あぁ……」	PRINTFORMW 「不、不要着急嘛……啊嗬、嗯、唔……啊~……」
PRINTFORMW 「ひくっ、んぅ……やぁっ、もう無理……っ、もうイかせて……っ」	PRINTFORMW 「嗬库、嗯~……呀~、已经不行了……已经要去了……」
PRINTFORMW 「んぐ……っ、ぁ、あぅっ、%CNAME("一人称", "かな")%のお尻……どうなっちゃってるんだろ……っ」	PRINTFORMW 「嗯咕……啊、啊呜、%CNAME("一人称", "かな")%的屁股……会变成什么样呢……」
PRINTFORMW 「やぁっ！　%CNAME("二人称", "どもり")%は見ようとしないでくださいっ！　おこりますよっ」	PRINTFORMW 「呀啊！　%CNAME("二人称", "どもり")%请别想看！　我会生气的喲」
PRINTFORMW 「く……ぅっ、はっ、はぁ……おしりがっ、裂けちゃいそう、です……」	PRINTFORMW 「库……唔、哈、哈啊……屁股、好像要裂开、那样……」
PRINTFORMW 「だ、大丈夫ですよね……これくらいでおかしくなんて、ならないですよね……？」	PRINTFORMW 「没、没事的吧……这点程度就变得奇怪什么的、那样不行的吧……？」
PRINTFORMW 「はぁっ……ん、はっ、ふぅ……っ」	PRINTFORMW 「哈啊……嗯、哈、唿~……」
PRINTFORMW 「大丈夫です……。これくらいの痛み、なんてことないですよ……？」	PRINTFORMW 「没事……。这点痛、没什么大不了的喲……？」
PRINTFORMW 「自慢じゃないですけど……んっ、慣れてます、から……」	PRINTFORMW 「并不是我自满的说……嗯、因为、习惯了嘛……」
PRINTFORMW 「やぁ……おしりが、おしりがぐちゅぐちゅえっちな音してますっ」	PRINTFORMW 「呀啊……屁股、屁眼咕啾咕啾地发出色色的声音了」
PRINTFORMW 「んぅっ！　こ、これ、誰にも聞こえてませんよねっ？　恥ずかしいです……」	PRINTFORMW 「嗯唔！　这、这个、任谁也不可以听到的吧？　太羞耻了……」
PRINTFORMW 「こんなにされたら……おしり、戻らなくなっちゃいそうです……」	PRINTFORMW 「如果这样的话……屁股、就再也无法恢复了……」
PRINTFORMW 「そ、そんなの……うぅ、だめです……恥ずかしすぎます……」	PRINTFORMW 「那、那样的……呜~、不可以……羞死人了……」
PRINTFORMW 「%CNAME("二人称")%のおちんちんが……んんっ、お尻の中でびくびくしてるの、わかります……」	PRINTFORMW 「%CNAME("二人称")%的大鸡鸡……嗯嗯、在屁股里颤抖着、我知道的喲……」
PRINTFORMW 「……えいっ」	PRINTFORMW 「……诶」
PRINTFORMW 「ふふっ、今の気持ちよかったですか？　それならもっとしてあげますね……」	PRINTFORMW 「呼呼、刚才的太舒服了吗？　那样啊、我来让你更加舒服吧……」
PRINTFORMW 「%CNAME("二人称")%が動いてくれないなら……んっ、%CNAME("一人称")%のほうが……動きます、から……」	PRINTFORMW 「%CNAME("二人称")%不给我动的话……嗯、%CNAME("一人称")%这边……就要、自己动咯……」
PRINTFORMW 「やぁっ、止めないでくださいっ、イかせてっ、イかせてください……っ」	PRINTFORMW 「呀啊、请不要停嘛、让我去、请让我去……」
PRINTFORMW 「あぁ……ん、やっ、止めないでぇ……っ、%CNAME("一人称", "かな")%まだ、イってな……ぁ……っ」	PRINTFORMW 「啊啊……嗯、呀、不要停……%CNAME("一人称", "かな")%还没、去……啊……」
PRINTFORMW 「腰放してくださいっ、んんっ、んーっ！　もっと、もっと激しくさせてくださいよぉ……っ」	PRINTFORMW 「请别放下腰嘛、嗯嗯、嗯——！　更加、更加激烈地顶起来喲哦……」
PRINTFORMW 「%CNAME("二人称")%……っ、いじわるです、いじめっこです……んぅっ」	PRINTFORMW 「%CNAME("二人称")%……太坏了、欺负人……嗯呜」
PRINTFORMW 「あっ、あぅっ、はぁ……っ、もうちょっとなのにっ、こんなゆっくりじゃ、イけないです……やぁぁっ」	PRINTFORMW 「啊、啊呜、哈啊……就差一点的说、这么慢的话、高潮不了……呀啊啊」
PRINTFORMW 「おしり……っ、おしりがっ、ばかになっちゃう……あ、あぁっ、すごい、拡がってるよぉ……っ」	PRINTFORMW 「屁股……屁眼、变成笨蛋了……啊、啊啊、扩张得、好厉害喲……」
PRINTFORMW 「はぁ、ぁぁ……んぐっ、ぃったぁ……っ、ぁっ、あぅっ……」	PRINTFORMW 「哈啊、啊啊……嗯咕、疼啊……啊、啊呜……」
CALL PRINT_STR, @"（おしりがっ、%CNAME("二人称")%の形になってく……っ、あぁ……むりやり%CNAME("二人称")%専用に、されちゃうん、だぁ……っ_H_）_W"	CALL PRINT_STR, @"（屁股、变成%CNAME("二人称")%的形状了……啊~……要强行、变成%CNAME("二人称")%专用、的啦……_H_）_W"
PRINTFORMW 「ひっ、ふ……っ、んぅぅっ！　は、ぁ……ぁく……っ、んぅぅぅぅっ！」	PRINTFORMW 「嗬、唿……嗯呜呜！　哈、啊……啊库……嗯唔唔唔唔！」
PRINTFORMW （なに、これぇ……っ、おっきな杭が、お腹に刺さってる、みたい……っ）	PRINTFORMW （什么啊、这个……好像被大桩子、刺进肚子里、一样……）
PRINTFORMW 「んっ！　んぅっ！　んんぅっ！　あっ、はぁっ、はっ……はふぅっ！　ひっ、ひぅ……っ」	PRINTFORMW 「嗯呢！　嗯呜！　嗯嗯呜！　啊、哈啊、哈……哈唿~！　嗬、嗬唔……」
PRINTFORMW 「んはぁっ、はぁっ、ひぅ……っ、んぐぅっ、あぅっ、ごりゅごりゅして、ぇ……っ！」	PRINTFORMW 「嗯哼啊、哈啊、嗬~……嗯咕~、啊呜、噗嗤噗嗤地、呃……！」
PRINTFORMW 「お……ぉう゛っ、おしりがっ、けずれ、りゅぅ……っ！　んう゛っ……あっ、ぁふぅっ」	PRINTFORMW 「啊……啊譕、屁眼、歪掉、了……！　嗯譕……啊、啊唿~」
PRINTFORMW （%CNAME("二人称")%の、おちんちんっ、すごすぎるよぉ……一番奥まで、いっぱいになってるっ）	PRINTFORMW （%CNAME("二人称")%的、大鸡鸡、太厉害了喲……最深处、都填满了）
PRINTFORMW 「あぅっ、んっ、んくっ！　これ……っ、体重かかって、奥までずしんって、すごい、です……」	PRINTFORMW 「啊唔、嗯、嗯库！　这姿势……借用身体的重力、啪啪地顶到深处、好厉害、啊……」
PRINTFORMW 「はぁ、うぅっ……んん゛っ、おしり、めくれちゃいそう、です……っ」	PRINTFORMW 「哈啊、呜呜……嗯呃、屁眼、要被操翻出来、那样……」
PRINTFORMW （%CNAME("二人称")%……っ、あぁっ、おしりが熱くて、おかしくなっちゃいそう、です……はぁ、あぁ……）	PRINTFORMW （%CNAME("二人称")%……啊啊、屁眼好热、好像要变奇怪起来、了……哈啊、啊啊……）
PRINTFORMW 「やっ、あっ……%CNAME("二人称")%っ、すごい、はげしいですっ……あぅっ、んっ、はぁっ」	PRINTFORMW 「呀、啊……%CNAME("二人称")%、好厉害、太激烈了……啊呜、嗯、哈啊」
PRINTFORMW 「%CNAME("一人称", "かな")%もっ、%CNAME("一人称", "かな")%も%CNAME("二人称")%に、してあげるんですからぁ……あぁっ」	PRINTFORMW 「%CNAME("一人称", "かな")%也、%CNAME("一人称", "かな")%也会为%CNAME("二人称")%、动起来���啦……啊啊」
PRINTFORMW （あぁっ、おちんちん膨らんできたぁ……っ、だしてっ、%CNAME("二人称", "かな")%のせーえきいっぱいちょうだい……っ）	PRINTFORMW （啊啊、大鸡鸡膨胀起来了……射出来、%CNAME("二人称", "かな")%的精液满满地射给我吧……）
PRINTFORMW 「%CNAME("二人称")%は……んっ、動かなくても、いいですよ……？」	PRINTFORMW 「%CNAME("二人称")%……嗯、不用动也、可以喲……？」
PRINTFORMW 「%CNAME("一人称", "かな")%がお尻で……%CNAME("二人称")%のおちんちん、いっぱい気持ちよくしてあげますからね……んっ」	PRINTFORMW 「%CNAME("一人称", "かな")%会用屁股……让%CNAME("二人称")%的大鸡鸡、好好舒服起来的呢……嗯」
PRINTFORMW （はぁ……%CNAME("二人称")%のぴくぴくしてる……かわいい……もっともっとしてあげますっ）	PRINTFORMW （哈啊……%CNAME("二人称")%的鸡鸡颤动着……好可爱……更加更加舒服起来吧）
PRINTFORMW 「んん……はぁっ、ぁぅ……っ、%CNAME("二人称", "かな")%っ、みないで……っ」	PRINTFORMW 「嗯嗯……哈啊、啊呜……%CNAME("二人称", "かな")%、不要看……」
PRINTFORMW 「やぁぁっ、物欲しそうな顔なんて……っ、して、ませんからぁ……」	PRINTFORMW 「呀啊啊、想要的表情什么的……我才、没有呢……」
PRINTFORMW 「%CNAME("二人称")%っ、あぁっ、%CNAME("二人称", "かな")%……っ、やぁっ、これだめ……っ」	PRINTFORMW 「%CNAME("二人称")%、啊啊、%CNAME("二人称", "かな")%……呀啊、这样不行……」
PRINTFORMW 「イけないのに、きもちいいのがどんどん溜まって……これ怖いですぅ……っ」	PRINTFORMW 「明明是不可以的、想要舒服的欲望越来越高涨了……这样好可怕呜……」
PRINTFORMW 「%CNAME("二人称")%のばかぁ……っ、いじわるぅ……っ、あぅっ……んっ、んくぅっ」	PRINTFORMW 「%CNAME("二人称")%笨蛋啊……坏心眼唔……啊唔……嗯、嗯库唔」
PRINTFORMW 「もう……しょうがない%CNAME("二人称")%なんですからぁ……」	PRINTFORMW 「真是的……都怪我总是拿%CNAME("二人称")%没办法啊……」
PRINTFORMW 「んくぅっ！　あっ、ああっ、すごい……っ、%CNAME("二人称")%の形になったまま、戻らなくなっちゃいそう……」	PRINTFORMW 「嗯库呜！　啊、啊啊、好厉害……一直保持着%CNAME("二人称")%的形状、好像回不去了呜……」
PRINTFORMW 「はっ、はぁっ、お腹がっ、おなかが、ひろがる、よぉ……っ」	PRINTFORMW 「哈、哈啊、肚子里、肠道、被扩大了、喲~……」
PRINTFORMW 「一番奥まで、がつんってくるたび……はぁっ、おなかの中がごりごりって、こすれて……っ」	PRINTFORMW 「直到最深处、噗嗤地顶到时……哈啊、屁股里面就咕噜咕噜地、蠕动着……」
PRINTFORMW 「あぁっ、%CNAME("二人称")%のおちんちん、すごく熱くて……やけどしちゃいそう、です……」	PRINTFORMW 「啊啊、%CNAME("二人称")%的大鸡鸡、烫得厉害……要被烫伤了、似的……」
PRINTFORMW 「%CNAME("一人称")%のことは、気にしなくていいんですよ……はぁ、ぁ……ん、ぐぅっ」	PRINTFORMW 「%CNAME("一人称")%的话、不要在意我也可以喲……哈啊、啊……嗯、咕呜」
PRINTFORMW 「%CNAME("二人称")%の好きなように動いてください……もっと奥まで、入れて、いいんですよ……」	PRINTFORMW 「请随%CNAME("二人称")%喜欢的那样动吧……进入到、更深处、也可以喲……」
PRINTFORMW 「はぁ……っ、%CNAME("二人称")%と%CNAME("一人称", "かな")%が……んっ、ぶつかってる音が、してます、ね……」	PRINTFORMW 「哈啊……%CNAME("二人称")%和%CNAME("一人称", "かな")%……嗯、撞击的声音、响起来了、呢……」
PRINTFORMW 「んんっ、これ……なんだかすごく、えっちです……んっ、はぁっ」	PRINTFORMW 「嗯嗯、这个……总感觉非常、色情啊……嗯、哈啊」
PRINTFORMW 「入れるたびに、おしり……っ、奥まで、ずん、ってなって……はぅっ」	PRINTFORMW 「每次进来时、直到……屁股深处、都摩、擦着……哈唔」
PRINTFORMW 「ひろがってるのが、よく、わかっちゃいます……っ、あっ、んんっ、は……ぁっ」	PRINTFORMW 「扩张着的感觉、很、清楚地感受到了……啊、嗯嗯、哈……啊」
PRINTFORMW 「んっ……んっ……ど、どうですか？　ちゃんと%CNAME("二人称")%のこと、気持ちよくできてますか……？」	PRINTFORMW 「嗯……嗯……怎、怎么样？　好好照顾%CNAME("二人称")%的话、有感觉到舒服吗……？」
PRINTFORMW 「もっとぎゅってしてあげたほうが……いいんでしょうか……んっ、んんっ」	PRINTFORMW 「再抱紧一点来做……可以吗……嗯、嗯嗯」
PRINTFORMW 「見てください、私のおっぱい……ふふ、こんなこともできるようになったんですよ」	PRINTFORMW 「请看、我的奶子……呼呼、这种事情也能做到喲」
PRINTFORMW 「これも%CNAME("二人称")%から魂をもらったおかげなんでしょうか……？」	PRINTFORMW 「这也多亏了从%CNAME("二人称")%那得到魂的缘故吧……？」
PRINTFORMW 「さてと、それじゃ……%CNAME("二人称")%のおちんちん、おっぱいでもぐもぐしますね……」	PRINTFORMW 「那么、接下来……%CNAME("二人称")%的肉棒、用奶子先缓慢地套弄吧……」
PRINTFORMW 「えっ、えっ？　今なにがどうなって……%CNAME("二人称")%の指が乳首の中に……？」	PRINTFORMW 「诶、诶？　现在到底是在做什么……%CNAME("二人称")%的手指在乳头里面……？」
PRINTFORMW 「ど、どういうことなんですかこれっ！？　また私の身体に何かしたんですか！？」	PRINTFORMW 「怎、怎么回事啊这个！？　又要用我的身体做什么啊！？」
PRINTFORMW 目を白黒させる%CALLNAME:TARGET%を尻目に、%CALLNAME:MASTER%は満足げに指を引き抜く。	PRINTFORMW 在翻白眼的%CALLNAME:TARGET%鄙视下、%CALLNAME:MASTER%满足地拔出手指。
PRINTFORMW 「……え、あの、なんで%CNAME("二人称")%、こっちにおちんちんを……」	PRINTFORMW 「……呃、那个、%CNAME("二人称")%这边的、鸡鸡为什么……」
PRINTFORMW 「まさか……やだっ、だめですっ、そんなところに入れたらだめですってばっ！　……んっ！　んくぅっ！？」	PRINTFORMW 「不会是……讨厌，不可以，那种地方插入的话，都说了不行的啊！　……嗯！　嗯库~！？」
PRINTFORM 「あぁっ、%CNAME("二人称")%の\@ SIZE("ペニス", PLAYER) >= 2 ? おっきな #\@おちんちんが、%CNAME("一人称")%の	PRINTFORM 「啊啊、%CNAME("二人称")%的\@ SIZE("ペニス", PLAYER) >= 2 ? 大 #\@鸡鸡、用%CNAME("一人称")%的
//段落
//PRINTFORM オナホ	PRINTFORM 飞机杯
//PRINTFORM ソーセージ	PRINTFORM 香肠
//PRINTFORM ぶっとい	PRINTFORM 肥大
PRINTFORMW 乳首でじゅぽじゅぽしてますっ」	PRINTFORMW 乳头啾噗啾噗地做着」
PRINTFORMW 「こんな奥までごりごりされたらっ、おっぱいに%CNAME("二人称")%の%TEXTS("匂い")%が染みついて取れなくなっちゃいますっ！」	PRINTFORMW 「强行插到这么深的话、奶子里染上%CNAME("二人称")%的气味的话、就去不掉了！」
PRINTFORMW 「そんなことになったら……%CNAME("一人称")%おかしくなっちゃいますよぉ……」	PRINTFORMW 「要是变成那样的话……%CNAME("一人称")%会变得很奇怪的喲~……」
PRINTFORMW 「はぁ……%CNAME("一人称")%のおっぱい、%CNAME("二人称")%のせいですごいことになっちゃいましたよね……」	PRINTFORMW 「哈啊……%CNAME("一人称")%的胸部、都是因为%CNAME("二人称")%做这样那样的事情才变成这样出色的喲~……」
PRINTFORMW 「えっ、元からすごかったですか？　うー、それはまぁ、そうかもしれませんけど……」	PRINTFORMW 「诶、本来就很出色吗？　呜——、这个嘛~、虽说也许是那样……」
PRINTFORMW 「まるでおっぱいで妊娠しちゃったみたいになっちゃってますよ」	PRINTFORMW 「就好像用奶子怀孕了一样喲」
PRINTFORMW 「……ここってそんなに気持ちいいですか？　もしそうなら……いいんですけど」	PRINTFORMW 「……这里面就那么舒服吗？　如果那样的话……也不是不可以」
PRINTFORMW 「やっぱり、おっぱいが大きい方が入れていて気持ちよかったりするんでしょうか……」	PRINTFORMW 「果然、胸部比较大的人、插入会更舒服是吗……」
PRINTFORMW 「だったらその、%CNAME("一人称")%は……大きくされてもいいですよ」	PRINTFORMW 「那么的话、被%CNAME("一人称")%……弄大也可以喲」
PRINTFORMW 「奥でいっぱい中出ししてもらえば、もっとおっきくなりますか……？」	PRINTFORMW 「在深处被满满地中出的话、会变得更大吗……？」
PRINTFORMW 「んん……っ、くぅっ、はぁっ」	PRINTFORMW 「嗯嗯……库~、哈~」
PRINTFORMW 「ほらっ、%CNAME("二人称")%に大きくしてもらったおかげですっぽり飲み込めるようになりましたよ」	PRINTFORMW 「看啊、多亏了%CNAME("二人称")%的豊乳、才变得能完全吞没大鸡鸡的喲」
PRINTFORMW 「でもさすがにまだ、キツいですね……もっと大きくしたら楽になるかもですけど……」	PRINTFORMW 「但是果然还是、挺勉强的呢……再大点或许会比较轻松的吧……」
PRINTFORMW 「わたし……赤ちゃんにおっぱいをあげるための大事なとこで、こんなことしちゃってる……」	PRINTFORMW 「我……为了给宝宝喂奶的重要地方、做着这种事情……」
PRINTFORMW 「くっ、んぅっ……んっ、はぁっ」	PRINTFORMW 「库、嗯呜……嗯、哈啊」
PRINTFORMW 「いけないのにっ、こんなことしたらだめなのに……っ」	PRINTFORMW 「不可以的说、明明做这种事情的话、是不行的……」
PRINTFORMW 「%CNAME("一人称")%のおっぱい……おちんちんにめちゃくちゃにされちゃってる……」	PRINTFORMW 「%CNAME("一人称")%的奶子……被鸡鸡弄得乱七八糟的……」
PRINTFORMW 「……っ、ふっ、はぁっ」	PRINTFORMW 「……唿、哈啊~」
PRINTFORMW 「怖いはずなのに……%CNAME("二人称")%にされてるって思うだけで、頭がくらくらして……」	PRINTFORMW 「明明应该害怕的……只是想到被%CNAME("二人称")%这样、脑袋就晕忽忽的……」
PRINTFORMW 「中に入った%CNAME("二人称")%のおちんちん、熱くって……どくどくしてて、すごいです……」	PRINTFORMW 「进到里面的%CNAME("二人称")%的鸡鸡、热乎乎的……咕嘟咕嘟地跳动着、好厉害……」
PRINTFORMW 「なんだか心臓がもう一つ増えたみたいで……んんっ」	PRINTFORMW 「总觉得另外增加了一个心脏似的……嗯嗯」
PRINTFORMW 「あ、%CNAME("二人称")%……。いえ、なんかこう、その……」	PRINTFORMW 「啊、%CNAME("二人称")%……。不是、怎么说呢、那个……」
PRINTFORMW 「%CNAME("二人称")%の執着心が、行き着くところまで行ってしまったんだなぁって思ってたんですよ」	PRINTFORMW 「还以为%CNAME("二人称")%的執着心、已经走到尽头了呢」
PRINTFORMW 「まさか、おしっこの穴がおちんちんを入れられるまで大きくなるだなんて……」	PRINTFORMW 「难道说、为了尿尿的小穴扩大到鸡鸡能进入为止什么的……」
PRINTFORMW 「思いませんよね。というか思ってもやろうとはしませんよね、普通」	PRINTFORMW 「不会这么想的吧。或者说就算这么想也不会做的吧、一般」
PRINTFORMW 「……さ、%CNAME("二人称")%の念願が叶うときです」	PRINTFORMW 「……来吧、是时候实现%CNAME("二人称")%的愿望了」
PRINTFORMW 「ここまできたら乗りかかった船です。最後までおつきあいしますよ」	PRINTFORMW 「事到如今也已经上了贼船。索性奉陪到底喲」
PRINTFORMW 「ん……ぐぅっ、あ、ふっ、ぅくっ、はぁっ」	PRINTFORMW 「嗯……咕唔、啊、唿、呜库、哈啊」
PRINTFORMW 「さすがに……っ、キツいです、ね……。%CNAME("二人称")%は、どう……ですかっ」	PRINTFORMW 「到底还是……太紧了、呢……。%CNAME("二人称")%、怎么……样啊？」
PRINTFORMW 「はぁっ、%CNAME("二人称")%が動くと、奥が、ぞりぞりって……」	PRINTFORMW 「哈啊、%CNAME("二人称")%一动、尿道里头就、哧溜哧溜地……」
PRINTFORMW 「はぁっ、んっ、くぅっ……あぁっ」	PRINTFORMW 「哈啊、嗯、库唔……啊~」
PRINTFORMW 「変えられちゃうっ、%CNAME("一人称", "かな")%のおしっこの穴、%CNAME("二人称")%の形に変えられちゃいますっ」	PRINTFORMW 「被改变了、%CNAME("一人称", "かな")%尿尿的小穴、变成%CNAME("二人称")%的形状了」
PRINTFORMW 「おしっこの穴がこんなに広がるようになったことよりも、ここで感じちゃうことの方が恥ずかしいです」	PRINTFORMW 「比起尿尿的小穴扩张得这么大这种事、这里有感觉什么的更让人羞耻」
PRINTFORMW 「%CNAME("一人称", "かな")%も%CNAME("二人称")%とおんなじ変態さんになっちゃったんでしょうか……」	PRINTFORMW 「%CNAME("一人称", "かな")%也变成和%CNAME("二人称")%一样的变态了吗……」
PRINTFORMW 「やぁ、もぅ……」	PRINTFORMW 「呀啊、真是的……」
PRINTFORMW 「どうですか、%CNAME("二人称")%っ、ちゃんとおしっこの穴、締められてますか？」	PRINTFORMW 「怎样啊？%CNAME("二人称")%、真的要把尿尿的小穴、弄得合不上吗？」
PRINTFORMW 「んんっ、もっとキツく締めますからね……。うぅ、この歳でおむつなんて、イヤなんですから……」	PRINTFORMW 「嗯嗯、还会更松的吧……。呜~、这么年轻就要用尿布什么的、我不要啦……」
PRINTFORMW 「ここまでやろうと思った%CNAME("二人称")%も%CNAME("二人称")%ですけど、ついてきてしまった%CNAME("一人称")%も%CNAME("一人称")%というか」	PRINTFORMW 「本来想做到这种地步的%CNAME("二人称")%也是%CNAME("二人称")%、但是就这么跟上来的%CNAME("一人称")%也是%CNAME("一人称")%、该怎么说呢」
PRINTFORMW 「この%CNAME("二人称")%にしてこの妹あり……ということでしょうか」	PRINTFORMW 「有其兄必有其妹……是这么说的吗？」
PRINTFORMW 「ほんとにしょうがないですね、%CNAME("一人称")%たち」	PRINTFORMW 「真的是无可救药呢、我们」
PRINTFORMW 「%CNAME("二人称")%……おっきくて、熱くて、びくんびくんしてます……」	PRINTFORMW 「%CNAME("二人称")%……好大、好热、一跳一跳地……」
PRINTFORMW 「えっちな気分になってる……ってことですよね、%CNAME("一人称")%で」	PRINTFORMW 「有种好色的感觉……是这样撸吗、%CNAME("一人称")%」
PRINTFORMW 「わっ、またちょっと大きくなりましたよ」	PRINTFORMW 「哇、又变大了一点喲」
PRINTFORMW 「えっと、確か……ここをこすると気持ちいいんですよね？」	PRINTFORMW 「那个、确实啊……摩擦这里会很舒服的吧？」
PRINTFORMW 「%CNAME("二人称")%のおちんちんをこうやってごしごししてると……」	PRINTFORMW 「%CNAME("二人称")%的鸡鸡被这样咯哧咯哧地摩擦的话……」
PRINTFORMW 「なんだかちょっと変な気分になってきます」	PRINTFORMW 「总觉得心情变得有点怪怪的」
PRINTFORMW 「……うぅ、もしかして顔赤いですか、%CNAME("一人称")%」	PRINTFORMW 「……呜~、难道说脸红了吗、%CNAME("一人称")%？」
PRINTFORMW 「うわ……すごく固くなってますね」	PRINTFORMW 「呜哇……硬得好厉害了呢」
PRINTFORMW 「それだけ興奮してるってことなんですか？」	PRINTFORMW 「只是做这种事就兴奋起来了吗？」
PRINTFORMW 「んっ、元気すぎて手から飛び出しちゃう……」	PRINTFORMW 「嗯、太过精神要从手里飞出去了……」
PRINTFORMW 「……ふふ、妹の手でこんなにしちゃって」	PRINTFORMW 「……呼呼、用妹妹的手这样做的话」
PRINTFORMW 「また透明な汁がびゅるびゅる溢れてますよ」	PRINTFORMW 「又有透明的汁液噗噜噗噜地溢出来了哦」
PRINTFORMW 「堪え性がない%CNAME("二人称")%ですね……。いつでも出していいんですよ？」	PRINTFORMW 「真是个没耐力的%CNAME("二人称")%呢……。随时都可以射出来喲？」
PRINTFORMW 「はぁ……っ、もう、だめなんです……」	PRINTFORMW 「哈啊……真是的、不行了啊……」
PRINTFORMW 「お腹がすいて我慢できないんですっ」	PRINTFORMW 「肚子饿得忍不住啦」
PRINTFORMW 「はやく、出して……っ、んく、ちゅる、じゅ、じゅるるるっ」	PRINTFORMW 「快点、射出来……嗯库、唏噜、咀、咀噜噜噜~」
PRINTFORMW 「ごめんなさい%CNAME("二人称")%、ごめんなさい……」	PRINTFORMW 「对不起%CNAME("二人称")%、对不起……」
PRINTFORMW 「んくっ……ん、ちゅっ……んぐ、んむぅっ」	PRINTFORMW 「嗯库……嗯、啾……嗯咕、嗯姆~」
PRINTFORMW 「んぐっ、んっ……んぶぅっ、ぷはっ」	PRINTFORMW 「嗯咕、嗯……嗯哺~、噗哈」
PRINTFORMW 「ひどいです、%CNAME("二人称")%……」	PRINTFORMW 「好过分、%CNAME("二人称")%……」
PRINTFORMW 「先にキスしてくれるって、約束したのに……」	PRINTFORMW 「明明约好了、要先跟我亲亲的说……」
PRINTFORMW 「んむぅっ！？　んっ、んぶっ、ん……ちゅ、ぷはっ」	PRINTFORMW 「嗯姆~！？　嗯、嗯哺、嗯……啾、噗哈」
PRINTFORMW 「ん……っ、ちゃんとやりますから、むりやり入れないで……」	PRINTFORMW 「嗯……我会好好含的啦、不要强行顶进来……」
PRINTFORMW 「お腹がすいて、もう耐えられなくて……」	PRINTFORMW 「肚子好饿、已经无法忍耐了……」
PRINTFORMW 「%CNAME("二人称")%が欲しいんですっ」	PRINTFORMW 「好想要%CNAME("二人称")%的精液」
PRINTFORMW 「んくっ……ん、ちゅっ……ぷはっ」	PRINTFORMW 「嗯库……嗯、啾……噗哈」
PRINTFORMW 「どうですか%CNAME("二人称")%？」	PRINTFORMW 「怎么样呀%CNAME("二人称")%？」
PRINTFORMW 「実は%CNAME("一人称", "かな")%、お見舞いのバナナで練習したこともあるんですよ……」	PRINTFORMW 「其实%CNAME("一人称", "かな")%、也有用慰问的香蕉做练习的喲……」
PRINTFORMW 「こうやって普通にするのって、初めてかもしれません」	PRINTFORMW 「像这样普通的口交、可能还是第一次」
PRINTFORMW 「%CNAME("二人称")%にはなんだか普通じゃないことばかりさせられているような……」	PRINTFORMW 「总觉得、%CNAME("二人称")%总是逼着我做各种奇怪的事情那样……」
PRINTFORMW 「……そもそもおちんちんを舐めるのって普通なんでしょうか？」	PRINTFORMW 「……说起来、舔鸡鸡这种事算是普通的吗？」
PRINTFORMW 「先っちょ、つるつるしてて不思議な感じですよね」	PRINTFORMW 「龟头、光溜溜的、感觉挺不可思议的呢」
PRINTFORMW 「舐めててちょっと楽しくなってくるような……」	PRINTFORMW 「好像被舔得挺开心的样子……」
PRINTFORMW 「……あ、そこ敏感だから丁寧に、ですか？」	PRINTFORMW 「……啊、那里很敏感的所以小心点、是吗？」
PRINTFORMW 「それはその……ごめんなさい。優しくやりますね」	PRINTFORMW 「这可真是……对不起。得温柔点呢」
PRINTFORMW 「そういえば%CNAME("二人称")%、先にキスしてくれるって約束したのに破りましたよね」	PRINTFORMW 「那么说%CNAME("二人称")%、明明约定好要先接吻的，却还是违背了呢」
PRINTFORMW 「しかもむりやり……」	PRINTFORMW 「并且还要硬来……」
PRINTFORMW 「そういうことばかりしてると歯を立てちゃうんですから」	PRINTFORMW 「总是做这种事情的话、我会咬下去喲」
PRINTFORMW 「……嘘です。さすがにそこまではしませんよ」	PRINTFORMW 「……骗你的。倒不至于做到那样」
PRINTFORMW 「それじゃあ約束通りに……%CNAME("二人称")%のおちんちん、舐めてあげますね」	PRINTFORMW 「那么接下来按照约定……给%CNAME("二人称")%舔、鸡鸡吧」
PRINTFORMW 「これで%CNAME("二人称")%のおちんちんにもキスしちゃいましたね」	PRINTFORMW 「这样一来、也和%CNAME("二人称")%的鸡鸡亲嘴了呢」
PRINTFORMW 「でも残念でした。君は初めてじゃないんですよー。ふふっ」	PRINTFORMW 「但是很遗憾。鸡鸡君你不是第一次喲——。呼呼」
PRINTFORMW 「代わりに気持ちよくしてあげますから……すねないでくださいね？」	PRINTFORMW 「作为补偿我会让你舒服起来的啦……请我不要再闹了？」
PRINTFORMW 「今度は前みたいにむりやりしないでくださいね」	PRINTFORMW 「这回请不要像以前那样强来哦」
PRINTFORMW 「もうファーストキスじゃありませんし……普通にやりますから」	PRINTFORMW 「已经没有初吻了……让我普通地做吧」
PRINTFORMW 「ついに%CNAME("一人称")%も、%CNAME("二人称")%のおちんちんを口にしてしまうんですね」	PRINTFORMW 「终于%CNAME("一人称")%也、把%CNAME("二人称")%的鸡鸡含到嘴里了呢」
PRINTFORMW 「実はちょこっとだけ、興味があったり……」	PRINTFORMW 「其实只是有过一点点、兴趣啦……」
PRINTFORMW 「……女の子だってえっちなことが気になるんですよ」	PRINTFORMW 「……女孩子也会在意色色的事情喲」
PRINTFORMW 「はぁ……ぁぅ……っ、ん、ちゅ……んぅ……」	PRINTFORMW 「哈啊……啊呜……嗯、啾……嗯呜……」
PRINTFORMW （%CNAME("二人称")%の匂いがすごすぎて……んっ、あたまがくらくらするよぉ……）	PRINTFORMW （%CNAME("二人称")%的气味实在是太厉害了……嗯、头好晕喲~……）
PRINTFORMW 「%CNAME("二人称")%ってば……んっ、%CNAME("一人称", "かな")%におちんちん舐めさせるの……じゅるるっ、好きですよね……」	PRINTFORMW 「%CNAME("二人称")%真是的……嗯、很喜欢被%CNAME("一人称", "かな")%……咀噜噜~、舔鸡鸡的吧……」
CALL PRINT_STR, @"（んんっ_H_　はぁ……っ、口の中が%CNAME("二人称")%のおちんぽの%TEXTS("匂い")%でいっぱいだよぉ……）_W"	CALL PRINT_STR, @"（嗯嗯_H_　哈啊……嘴里被%CNAME("二人称")%的鸡巴气味充满了喲……）_W"
CALL PRINT_STR, @"（頭の中まで精液の%TEXTS("匂い")%染みついちゃいそう……はやくっ、はやくせーえきだしてっ_H_）_W"	CALL PRINT_STR, @"（精液的气味要渗透到脑子里去那样……快点、快点射进来吧_H_）_W"
PRINTFORMW 「はぁ……っ、%CNAME("二人称")%のおちんちんっ、すっごく、かたくなってるぅ……っ」	PRINTFORMW 「哈啊……%CNAME("二人称")%的鸡鸡、すっごく、かたくなってるぅ……っ」
PRINTFORMW 「んむぅっ、ん……っ、もご、むぐ……んちゅ、ちゅるる……」	PRINTFORMW 「嗯姆~、嗯……嚤㗻、姆咕……嗯唏、唏噜噜……」
PRINTFORMW （%CNAME("二人称")%のおちんちんをぺろぺろしてると……んっ、なんでこんなにきもちよくなっちゃうんだろ……）	PRINTFORMW （呸喽呸喽地舔着%CNAME("二人称")%的鸡鸡……嗯、为什么就会变得这么愉快的啊……）
PRINTFORMW 「はむっ、んっ、ちゅ……じゅるぅっ！　ちゅぽっ、ちゅっ、れるぅ……」	PRINTFORMW 「哈姆、嗯、啾……咀噜~！　啾巴、射、吧~……」
PRINTFORMW （%CNAME("二人称")%の精液っ、せーえきほしいよぉ……っ、はやくっ、はやく飲ませて……っ）	PRINTFORMW （%CNAME("二人称")%的精液、精——液好想吃喲……快点、快点让我喝……）
PRINTFORMW 「んぅ……むぐ、ん……じゅるるっ、じゅぽっ、じゅぽっ、じゅぽっ！」	PRINTFORMW 「嗯唔……姆咕、嗯……咀噜噜、咀巴、咀巴、咀巴！」
PRINTFORMW （%CNAME("二人称")%っ、%CNAME("二人称")%大好きぃっ、おちんちんもせーえきもみんな、みんな好きっ）	PRINTFORMW （%CNAME("二人称")%、最喜欢%CNAME("二人称")%了、鸡鸡也是精液也是全部、全部都喜欢）
CALL PRINT_STR, @"（のどまんこが妊娠しちゃうくらい出してっ_H_　せーえきびゅるびゅるいっぱい出して……っ_H_）_W"	CALL PRINT_STR, @"（让小喉穴怀孕那样射出来吧_H_　精——液噗噜噗噜地全都射出来……_H_）_W"
CALL PRINT_STR, @"「んむぅっ、ん、んくっ……ぷはっ。はやくっ、はやくイっちゃえ……っ_H_　じゅる、じゅるるるるっ_H_」_W"	CALL PRINT_STR, @"「恩姆~、嗯、嗯库……噗哈。快点、快点泄吧……_H_　咀噜、咀噜噜噜噜_H_」_W"
PRINTFORMW 「ん……むぅ、ぷぁっ、はむ……ちゅる、ちゅ……んっ、れろ……」	PRINTFORMW 「嗯……姆唔、噗啊、哈啊……啾噜、啾……嗯、咧啰……」
PRINTFORMW 「あごが疲れてきたので、そろそろ……んっ、出してくださいね……はむっ」	PRINTFORMW 「下巴越来越累了、请差不多……嗯、射出来吧……哈姆」
PRINTFORMW 「……%CNAME("二人称")%もおちんちん丸出しで恥ずかしいかもしれませんけど」	PRINTFORMW 「……也许%CNAME("二人称")%也因为鸡鸡完全露出而感到害羞也说不定」
PRINTFORMW 「舐めてる方はもっと恥ずかしいんですからね……」	PRINTFORMW 「但是舔鸡鸡的那方更害羞的哦……」
PRINTFORMW 「ん……っ、むぐ、む、んん……」	PRINTFORMW 「嗯……姆咕、姆、嗯嗯……」
PRINTFORMW 「良薬口に苦しとは言いますけどね」	PRINTFORMW 「虽说是良药苦口」
PRINTFORMW 「うーん、精液って実は少しだけクセになりそうな感じが……」	PRINTFORMW 「呜——嗯、精液什么的、说实话稍微有那么一点成瘾的感觉……」
PRINTFORMW 「……いやでもさすがにそういうのはちょっと」	PRINTFORMW 「……那样的感觉就算讨厌也的确是有那么一点」
PRINTFORMW 「素直な反応を返してくれるから、ちょっと楽しいかもしれません」	PRINTFORMW 「因为得到了坦率地反应、说不定我也挺开心的」
PRINTFORMW 「この辺のくびれたところを舐めると……んっ」	PRINTFORMW 「舔冠状沟这一带部位的话……嗯」
PRINTFORMW 「んぐっ、ちゅる……じゅる、ぷはっ」	PRINTFORMW 「嗯咕、啾噜……咀噜、噗哈」
PRINTFORMW 「ふふ、びくびくしちゃって可愛いです」	PRINTFORMW 「呼呼、一跳一跳地好可爱」
PRINTFORMW 「%CNAME("二人称")%のおちんちんを胸で挟む……？」	PRINTFORMW 「用胸部夹住%CNAME("二人称")%的鸡鸡……？」
PRINTFORMW 「挟めるほどないってわかってて言ってますよね」	PRINTFORMW 「你明知道夹不住才这么说的吧」
PRINTFORMW 「こすりつけてるだけですよね、これ……」	PRINTFORMW 「只是摩擦着而已吧、这个……」
PRINTFORMW 「えーっと、こうでしょうか」	PRINTFORMW 「那——个、是这样做吗？」
PRINTFORMW 「気持ちいいんですか？　これ……」	PRINTFORMW 「舒服吗？　这样……」
PRINTFORMW 「ぷにぷにするだけであんまり圧迫とかできませんけど」	PRINTFORMW 「虽然软绵绵地没有什么压迫力」
PRINTFORMW 「……%CNAME("二人称")%が満足そうなので、いいかな」	PRINTFORMW 「……不过%CNAME("二人称")%看起来挺满足的样子、感觉还可以吗？」
PRINTFORMW 「えへへ……どうですか。%CNAME("二人称")%のもちゃんと収まりますよ\@ SIZE("ペニス", PLAYER) >= 4 ? 。全部はちょっと厳しいですけど……#\@」	PRINTFORMW 「诶嘿嘿……怎么样啊。就算是%CNAME("二人称")%的也能好好地收入奶中喲\@ SIZE("ペニス", PLAYER) >= 4 ? 。虽然要全根没入的话、就稍微有点苛刻了……#\@」
PRINTFORMW 「さすがにこれ以上大きくなると大変ですけどね……日常生活とか……」	PRINTFORMW 「要是再变大的话可就有够受的呢……日常生活时……」
PRINTFORMW 「ふふふ、こうしてたらもっと大きくなっちゃうかもしれませんね」	PRINTFORMW 「呼呼呼、这样做的话、也许会变得更大也说不定呢」
PRINTFORMW 「よいしょ……っと」	PRINTFORMW 「嘿……咻」
PRINTFORMW 「ふぅ、%CNAME("二人称")%のおっきなおちんちんにだって負けないんですからね」	PRINTFORMW 「呼~、因为就算是%CNAME("二人称")%的大鸡鸡、我也不会认输的哦」
PRINTFORMW 「ふふ……%CNAME("二人称")%のおちんちん、隠れちゃいましたね」	PRINTFORMW 「呼呼……把%CNAME("二人称")%的鸡鸡、藏起来了呢」
PRINTFORMW 「それでその、重たくって大変なので……%CNAME("二人称")%の方も動いてもらえますか……？」	PRINTFORMW 「然而、因为太重了很辛苦哒……%CNAME("二人称")%也能动一下吗……？」
PRINTFORMW 「%CNAME("二人称")%とえっちなこと始めてから、どんどん大きくなっていきましたよね……」	PRINTFORMW 「自从和%CNAME("二人称")%一起做色色的事以来、变得越来越大了呢……」
PRINTFORMW 「どうですか？　やっぱり大きい方が%CNAME("二人称")%も気持ちいいのかな……？　えいっ♪」	PRINTFORMW 「如何呀？　果然比较大的话%CNAME("二人称")%也会更舒服的吧……？　嘿~♪」
PRINTFORMW 「……どくんどくんってなってるの、伝わりますか？」	PRINTFORMW 「……扑通扑通地心跳、鸡鸡感觉到了吗？」
PRINTFORMW 「%CNAME("二人称")%がこんな恥ずかしいことさせるからですよ。もう……」	PRINTFORMW 「都怪%CNAME("二人称")%让我做这么羞耻的事情喲。真是的……」
PRINTFORMW 「ん……%CNAME("二人称")%のおちんちん、熱いです」	PRINTFORMW 「嗯……%CNAME("二人称")%的鸡鸡、好烫」
PRINTFORMW 「なんだか、やけどしちゃいそうなくらい……」	PRINTFORMW 「总觉得、好像要被烧伤了那样……」
PRINTFORMW 「おっぱい好きですよね、%CNAME("二人称")%」	PRINTFORMW 「很喜欢奶子是吧、%CNAME("二人称")%」
PRINTFORMW 「……ふふ、ぎゅーってしてあげます」	PRINTFORMW 「……呼呼、再夹紧——些吧」
PRINTFORMW 「や……入れたらだめですってばっ」	PRINTFORMW 「呀……都说了不能插入的嘛」
PRINTFORMW 「――え、違う？」	PRINTFORMW 「――诶、不是？」
PRINTFORMW 「ふとももで挟んでこするんですか」	PRINTFORMW 「是要用大腿夹起来摩擦吗？」
PRINTFORMW 「んぅ……。これならまぁ、いいですけど……」	PRINTFORMW 「嗯唔……。这个嘛、也不是不可以……」
PRINTFORMW 「……どさくさに紛れて入れようとしたらダメですよ？」	PRINTFORMW 「……想趁着混乱进去可不行哦？」
PRINTFORMW 「%CNAME("二人称")%の出っ張ったところが、こすれて……んんっ」	PRINTFORMW 「%CNAME("二人称")%的鸡鸡在出没的地方、摩擦着……嗯嗯」
PRINTFORMW 「やぁっ、これ思ってたより気持ちいい……」	PRINTFORMW 「呀啊、这个比想象中要舒服……」
PRINTFORMW 「こんなことばかりしてたら、そのうち本当にしたくなりそうで心配です」	PRINTFORMW 「总是做这种事情的话、不久就会真的想做爱那样、好担心啊」
PRINTFORMW 「え、あ……その、%CNAME("二人称")%がですよ？　%CNAME("一人称", "かな", "どもり")%じゃないですよ」	PRINTFORMW 「诶、啊……那个、我是说%CNAME("二人称")%喲？　%CNAME("一人称", "かな", "どもり")%才没有想呢」
PRINTFORMW 「もっと足をぎゅっとしたら気持ちいいですか……？」	PRINTFORMW 「腿再夹紧一点的话、舒服吗……？」
PRINTFORMW 「ほら、がんばってこすってくださいね」	PRINTFORMW 「那么、请加油套弄吧」
PRINTFORMW 「%CNAME("二人称")%だって、いけないんですよ」	PRINTFORMW 「都是%CNAME("二人称")%、不对喲」
PRINTFORMW 「%CNAME("一人称")%は最初からずっとキスしてほしかったのに、いつまでもしてくれないから……」	PRINTFORMW 「%CNAME("一人称")%明明从一开始就希望你能吻我的说、都怪你总是不给我……」
PRINTFORMW 「だから%CNAME("二人称")%のおちんちんにあげちゃうんですっ」	PRINTFORMW 「所以就交给%CNAME("二人称")%的鸡鸡了」
PRINTFORMW 「いじわるな%CNAME("二人称")%の口なんて、%CNAME("一人称")%のあそこを舐めてればいいんですっ」	PRINTFORMW 「坏心眼%CNAME("二人称")%的嘴巴什么的、如果想舔%CNAME("一人称")%那里的话也可以」
PRINTFORMW 「ん……っ、%CNAME("二人称")%の舌、気持ちいいです」	PRINTFORMW 「嗯……%CNAME("二人称")%的舌头、好舒服」
PRINTFORMW 「%CNAME("一人称", "かな")%もお返しに、してあげますから……」	PRINTFORMW 「那么、作为回礼%CNAME("一人称", "かな")%也、舔回给你……」
PRINTFORMW 「いっぱい出してくださいっ。んっ、んむ……ちゅ、じゅるるっ」	PRINTFORMW 「请满满地射出来。嗯、嗯姆……啾、咀噜噜」
PRINTFORMW 「%CNAME("二人称")%のいじわる」	PRINTFORMW 「%CNAME("二人称")%坏心眼」
PRINTFORMW 「先にキスしてくれるって、約束したじゃないですか……」	PRINTFORMW 「不是约好了、先给我亲亲吗……」
PRINTFORMW 「んっ、んむっ、ん……んぅっ、んんーっ」	PRINTFORMW 「嗯、嗯姆、嗯……嗯唔、嗯嗯——」
PRINTFORMW 「%CNAME("二人称")%の舌がはげしくてっ、うまくできな……ひぅっ」	PRINTFORMW 「%CNAME("二人称")%的舌头太激烈了、好会舔……嗬唔」
PRINTFORMW 「ふふっ、%CNAME("二人称")%、舐め合いっこしましょう……？」	PRINTFORMW 「呼呼、%CNAME("二人称")%、让我们互相舔吧……？」
PRINTFORMW 「%CNAME("一人称", "かな")%今、お腹がすいてるんです……」	PRINTFORMW 「%CNAME("一人称", "かな")%现在、肚子饿了……」
PRINTFORMW 「れろ……っ、んー、んんっ、ちゅっ」	PRINTFORMW 「咧啰（张嘴）……嗯——、嗯嗯、啾」
PRINTFORMW 「んぅっ、%CNAME("二人称")%の舌が入ってきます……」	PRINTFORMW 「嗯呜、%CNAME("二人称")%的舌头进来了……」
PRINTFORMW 「%CNAME("一人称")%も負けませんからね、先に参ったって、んっ、言わせてあげますからっ」	PRINTFORMW 「%CNAME("一人称")%也不会认输的哦、就算你先走一步、嗯、我会让你叫出来的」
PRINTFORMW 「前みたいにむりやりはしないでくださいね……」	PRINTFORMW 「请不要像以前那样强来哦……」
PRINTFORMW 「んっ、んむっ、むぐ……」	PRINTFORMW 「嗯、嗯姆、姆咕……」
PRINTFORMW 「舐められながらだと、集中するのが大変です……」	PRINTFORMW 「被舔着的话、很难集中注意力……」
PRINTFORMW 「やっ、あ……んっ、んぅっ」	PRINTFORMW 「呀、啊……嗯、嗯唔」
PRINTFORMW 「あんまりはげしくされると、集中が……」	PRINTFORMW 「这么激烈的话、注意力就……」
PRINTFORMW 「……んむっ、んっ、ちゅ……ちゅる、じゅるるっ」	PRINTFORMW 「……嗯姆、嗯、啾……啾噜、咀噜噜」
PRINTFORMW 「ん……ちゅ、んむ、ん……んぅっ！？」	PRINTFORMW 「嗯……啾、嗯姆、嗯……嗯唔！？」
PRINTFORMW 「やぁっ、クリトリスを甘噛みするのやめてくださいっ」	PRINTFORMW 「呀啊、请不要咬陰蒂啊」
PRINTFORMW 「……%CNAME("一人称")%も同じことやりかえしちゃいますよ？」	PRINTFORMW 「……%CNAME("一人称")%也要做同样的事情咯？」
PRINTFORMW 「ちゃんと先にキスしてくれた%CNAME("二人称")%には、何かお返しをしないとですね」	PRINTFORMW 「对于有好好地先亲吻我的%CNAME("二人称")%、不回敬点什么不行呢」
PRINTFORMW 「けれどキスのおかえしにおちんちんを舐めるというのもなんだかこう……」	PRINTFORMW 「可是作为亲吻的回礼而去舔鸡鸡、总觉得这样做有点……」
PRINTFORMW 「退廃の気配がします……」	PRINTFORMW 「堕落的样子……」
PRINTFORMW 「ひゃんっ、やぁ、もうっ、不意打ちで舐めないでくださいよっ」	PRINTFORMW 「吓嗯、呀啊、真是的、请不要冷不防地舔啦」
PRINTFORMW 「……%CNAME("二人称")%のおちんちんが、%CNAME("一人称", "かな")%のファーストキスの相手なんですよね」	PRINTFORMW 「……%CNAME("二人称")%的鸡鸡、是%CNAME("一人称", "かな")%的初吻对象什么的吧」
PRINTFORMW 「複雑です……」	PRINTFORMW 「关系好乱……」
PRINTFORMW 「やっ、もうっ、口に押しつけなくてもやってあげますからっ」	PRINTFORMW 「呀、真是的、就算不顶着嘴巴也会帮你舔的啦」
PRINTFORMW 「なんだかこの体勢、すごくえっちじゃありませんか……？」	PRINTFORMW 「总觉得这个体位、难道不是很色吗……？」
PRINTFORMW 「……%CNAME("二人称")%もちょっと恥ずかしかったりします？」	PRINTFORMW 「……%CNAME("二人称")%也感觉挺羞耻的吗？」
PRINTFORMW 「だったらその、おそろいですね……」	PRINTFORMW 「那么说、彼此彼此呢……」
PRINTFORMW 「うぅ、恥ずかしいですこの格好……」	PRINTFORMW 「呜~、太羞耻了这个姿势……」
PRINTFORMW 「むぐ……んっ、んむっ……ちゅる、じゅるるっ」	PRINTFORMW 「姆咕……嗯、恩姆……啾噜、咀噜噜」
PRINTFORMW 「その、あんまり激しくしすぎないでくださいね」	PRINTFORMW 「那个、请不要做得太激烈哦」
PRINTFORMW 「びっくりした拍子に歯を立てちゃったりしないか、心配なので……」	PRINTFORMW 「因为担心、被吓着的瞬间会不会咬牙呢……」
PRINTFORMW 「んむっ、ちゅっ、れろ……っ」	PRINTFORMW 「恩姆、啾、咧啰（张嘴吞入）……」
PRINTFORMW 「んん……っ、気持ちいいです、%CNAME("二人称")%……」	PRINTFORMW 「嗯嗯……好舒服、%CNAME("二人称")%……」
PRINTFORMW 「れろ、ちゅ……むぐ、んっ、ちゅるっ」	PRINTFORMW 「咧啰、啾……姆咕、嗯、唏噜」
PRINTFORMW 「お返し、どうですか？　気持ちよくしてあげられてますか……？」	PRINTFORMW 「这回礼、怎么样？　有让你舒服吗……？」
PRINTFORMW 「……ふふ」	PRINTFORMW 「……呼呼」
PRINTFORMW 「いえ、%CNAME("一人称")%にも赤ちゃんができたらこんな感じなのかな……って思って」	PRINTFORMW 「哎呀、要是%CNAME("一人称")%有了宝宝、大概就是这种感觉吧……我想」
PRINTFORMW 「考えますよ、%CNAME("一人称")%だって女の子ですから」	PRINTFORMW 「也会考虑这种事情的喲、怎么说%CNAME("一人称")%可是女孩子嘛」
PRINTFORMW 「それが本当になるかもしれないとは、思っていませんでしたけどね……」	PRINTFORMW 「可是要真的如此的话、倒是没想过呢……」
PRINTFORMW 「……そんなに気持ちいいんですか？」	PRINTFORMW 「……有那么舒服吗？」
PRINTFORMW 「いえ、だってその……%CNAME("一人称")%自身は自分の胸ではできませんし……」	PRINTFORMW 「不、因为那个……%CNAME("一人称")%自己又不能用自己的胸部……」
PRINTFORMW 「む、なに笑ってるんですかもうっ」	PRINTFORMW 「姆、笑什么啊真是的」
PRINTFORMW 「どうですか、%CNAME("二人称")%。%CNAME("一人称")%の音……聞こえてますか？」	PRINTFORMW 「怎么样啊、%CNAME("二人称")%。%CNAME("一人称")%的声音……能听到吗？」
PRINTFORMW 「%CNAME("二人称")%のおかげで今日もちゃんと動いてますよ」	PRINTFORMW 「多亏了%CNAME("二人称")%、今天也能好好地生活着喲」
PRINTFORMW 「しょうがないですね、%CNAME("二人称")%は……赤ちゃんみたいですよ？」	PRINTFORMW 「真拿你没办法呢、%CNAME("二人称")%啊……好像小宝宝喲？」
PRINTFORMW 「……いえ、赤ちゃんはこんなえっちなことしませんよね」	PRINTFORMW 「……不对、宝宝不会做这种色色的事情呢」
PRINTFORMW 「もうっ、だらしない顔しちゃって……」	PRINTFORMW 「真是的、一脸不检点的表情……」
PRINTFORMW 「――ひゃんっ！？」	PRINTFORMW 「――吓嗯！？」
PRINTFORMW 「うぅ、なんですか今の、ぱちんって……%CNAME("二人称")%？」	PRINTFORMW 「呜~、干嘛啊刚刚、啪地一声……%CNAME("二人称")%？」
PRINTFORMW 「ひぅっ！？　もうっ、叩くのやめてくださいって……んんっ」	PRINTFORMW 「嗬唔！？　真是的、请不要打我啊……嗯嗯~」
PRINTFORMW 「もうっ、なんなんですかー！」	PRINTFORMW 「真是的、什、什么啊ー！」
PRINTFORMW 「なんだかお尻がじんじんしてきたんですけど……」	PRINTFORMW 「总觉得屁股都麻木了的说……」
PRINTFORMW 「もうっ、いい加減やめてくださいってば」	PRINTFORMW 「真是的、请适可而止呀」
PRINTFORMW 「やっ、もうっ、やめてくださ――んぅっ」	PRINTFORMW 「呀、真是的、请停——嗯唔」
PRINTFORMW 「そんなに叩いたら痕が残っちゃうじゃないですか」	PRINTFORMW 「这么拍的话、会留下印痕的不是吗」
PRINTFORMW 「はぅっ、んっ……やぁっ」	PRINTFORMW 「哈唔、嗯……呀啊」
PRINTFORMW 「お尻が赤くなっちゃうから、やめてください%CNAME("二人称")%……」	PRINTFORMW 「屁股会变红的啦、求你不要啊%CNAME("二人称")%……」
PRINTFORMW 「楽しそうにぺちぺちしてますけど、%CNAME("一人称")%のお尻は太鼓じゃないんですよ……」	PRINTFORMW 「虽然拍得很开心的样子、但是%CNAME("一人称")%的屁股可不是大鼓喲……」
PRINTFORMW 「うぅー。子供じゃないんですから……もうっ」	PRINTFORMW 「呜呜——。我又不是小孩子……真是的」
PRINTFORMW 「あれ、%CNAME("二人称")%。縄なんて持ち出してきてどうしたんですか？」	PRINTFORMW 「啊咧、%CNAME("二人称")%。绳子什么的、拿出来是要做什么啊？」
PRINTFORMW 「え、あの、何するんですか%CNAME("二人称")%、何されるんですか%CNAME("一人称", "かな")%！？」	PRINTFORMW 「诶、那个、在干什么啊%CNAME("二人称")%、你要对%CNAME("一人称", "かな")%做什么！？」
PRINTFORMW 「やっ、あっ、んんっ、それキツ……っ」	PRINTFORMW 「呀、啊、嗯嗯、好紧……」
PRINTFORMW 「こんなことしなくても、逃げたりしないですよ……？」	PRINTFORMW 「即使不做这种事、我也不会逃跑的喲……？」
PRINTFORMW 「んぅっ……くっ、ふぅっ、やぁっ」	PRINTFORMW 「嗯唔……库、唿唔、呀啊」
PRINTFORMW 「このままでお休みなんて……はぁっ、無理ですよぉっ」	PRINTFORMW 「这样就休息什么的……哈啊、太为难了喲~」
PRINTFORMW 「昔を思い出します……」	PRINTFORMW 「想起从前……」
PRINTFORMW 「小さかった頃の%CNAME("一人称")%をお風呂にいれるのは%CNAME("二人称")%の役目でしたよね。懐かしいです」	PRINTFORMW 「帮小时候的%CNAME("一人称")%洗澡曾是%CNAME("二人称")%的职责吧。好怀念啊」
PRINTFORMW 「え？　今も小さい……？　う、うぅー。それは確かにそうですけど……」	PRINTFORMW 「诶？　现在也还小……？　呜、呜呜——。那个嘛、虽然是那样没错……」
PRINTFORMW 「あの頃にはもう、%CNAME("二人称")%のことが大好きになってましたね」	PRINTFORMW 「那时就已经、喜欢上%CNAME("二人称")%了吧」
PRINTFORMW 「ふぅ……っ、はぁ……」	PRINTFORMW 「呼唔……哈啊……」
PRINTFORMW 「ありがとうございます。%CNAME("二人称")%はやっぱり優しいですね……」	PRINTFORMW 「谢谢你。%CNAME("二人称")%果然很温柔呢……」
PRINTFORMW 「%CNAME("二人称")%のっ、いじわる……っ」	PRINTFORMW 「%CNAME("二人称")%你、好坏……」
PRINTFORMW 「%CNAME("一人称")%をこんなにしたまま、自分ひとりだけ休んで……んぅっ」	PRINTFORMW 「把我%CNAME("一人称")%弄成这样、自己却独自休息……嗯唔」
PRINTFORMW 「やだぁっ、こっち見ないでください……」	PRINTFORMW 「讨厌~、请不要看我这边……」
PRINTFORMW 「こうしていると%CNAME("二人称")%とお風呂につかっていると昔を思い出しますけど」	PRINTFORMW 「这样的话、让我想起了曾和%CNAME("二人称")%一起洗澡的过去呢」
PRINTFORMW 「あの頃とはすっかり変わっちゃいましたね、%CNAME("一人称")%たち……」	PRINTFORMW 「和那时候完全不一样了呢、%CNAME("一人称")%们……」
PRINTFORMW 「けど%CNAME("二人称")%のことが好きなのは、ずーっと変わりませんよ」	PRINTFORMW 「但是对%CNAME("二人称")%的喜欢、永远不会变喲」
PRINTFORMW 湯船から出るまで、%CALLNAME:TARGET%はずっとはにかんだ笑みを%CALLNAME:MASTER%に向け続けていた……。	PRINTFORMW 从浴缸出来为止、%CALLNAME:TARGET%一直面带羞涩的朝%CALLNAME:MASTER%微笑着……。
PRINTFORMW 「ふぅ……おかげで少し、落ち着きました」	PRINTFORMW 「呼~……多亏了、稍微平静下来了」
PRINTFORMW 「身体のこと、気にかけてくれているんですよね……」	PRINTFORMW 「身体的问题、在为我担心是吧……」
PRINTFORMW 「えへへ、ありがとう%CNAME("二人称")%」	PRINTFORMW 「诶嘿嘿、谢谢%CNAME("二人称")%」
PRINTFORMW 「……？　あーんって口を開けるんですか？　喉の奥が見えるくらい？」	PRINTFORMW 「……？　啊——地张开嘴是吗？　喉咙深处也能看见那样？」
PRINTFORMW 「ちょっと恥ずかしいですけど……。まぁ、%CNAME("二人称")%になら……」	PRINTFORMW 「虽然挺羞耻的……。也罢、是%CNAME("二人称")%的话……」
PRINTFORMW 「ふぁい、みえまふか？」	PRINTFORMW 「哈啊~、嫰看间吗？」%CALLNAME:TARGET%因小嘴大张而说话含糊不清
PRINTFORMW 「――んっ！？　むぐぅっ！？」	PRINTFORMW 「――嗯！？　姆咕~！？」
//段落
//PRINTFORM 大きく口を開かせた%CALLNAME:MASTER%は、%CALLNAME:TARGET%の喉奥に向けて	PRINTFORM 在大开地嘴前、%CALLNAME:MASTER%挺着
//PRINTFORM 怒張した	PRINTFORM 怒張地
//PRINTFORM 巨大な	PRINTFORM 巨大的
//PRINTFORM 極太の	PRINTFORM 極粗的
//PRINTFORM 大きすぎる	PRINTFORM 超級大
//PRINTFORMW ペニスを不意打ち気味に突き込んだ。	PRINTFORMW 陰莖、突然袭击那样、突入了%CALLNAME:TARGET%的喉咙深处。
PRINTFORMW 「んぶっ、んぐ……ぉ、おぶっ、おぶぅっ、んぐ……」	PRINTFORMW 「嗯噗、嗯咕……噢、噢噗、噢噗~、嗯咕……」
PRINTFORMW 異物に対し粘膜が反射的に波打ち、排出しようとする動きが亀頭をぞりぞりと刺激する。	PRINTFORMW 异物感使粘膜反射性地蠕动着、想要排出的动作反而一股股地刺激着龟头。
PRINTFORMW 締め付けの強い%CALLNAME:TARGET%の喉を、%CALLNAME:MASTER%は少しずつ確実に、ごりごりと掘削していく……。	PRINTFORMW 在%CALLNAME:TARGET%狭窄的喉咙里、%CALLNAME:MASTER%一点点探索着、深入地开拓下去……。
PRINTFORMW 「むぐ……っ、んくっ、んぶ……」	PRINTFORMW 「姆咕……嗯库、嗯噗……」
//段落
//PRINTFORM 腰がじわじわと前へ進むごとに、	PRINTFORM 每次腰徐缓地向前挺进时、向著
//PRINTFORM 陰毛の茂った	PRINTFORM 陰毛茂盛的
//PRINTFORMW ペニスの根本に向けて、%CALLNAME:TARGET%の薄桃色の唇が少しずつ近づいてくる。	PRINTFORMW 陰莖根部、%CALLNAME:TARGET%的薄桃色的嘴唇也一点点地靠近著。
PRINTFORMW やがて%CALLNAME:MASTER%の股間と%CALLNAME:TARGET%の唇がディープキスを交わすころになると、	PRINTFORMW 最终、当%CALLNAME:MASTER%的股間与%CALLNAME:TARGET%的嘴唇互相深吻在一起的时候、
PRINTFORM 細かった%CALLNAME:TARGET%の喉は食道にまで届くペニスによって完全に占領され、	PRINTFORM %CALLNAME:TARGET%纤细的喉咙被深入食道的陰莖完全占领了、
CALL PRINT_STR, @"%CALLNAME:MASTER%のペニスの形が\@ SIZE("ペニス", PLAYER) >= 2 ? くっきり # うっすら \@と表面に浮き上がってしまっていた……。_W_"	CALL PRINT_STR, @"脖子表面也\@ SIZE("ペニス", PLAYER) >= 2 ? 明显地 # 隐约 \@凸显着%CALLNAME:MASTER%的陰莖的形状……。_W_"
PRINTFORMW %CALLNAME:MASTER%の非常識なペニスの形に合わせて見る影もなく変形してしまっていた……。	PRINTFORMW 同时整个脖子面目全非地变成了%CALLNAME:MASTER%那超出常识的大陰莖的形状……。
PRINTFORMW 「%CNAME("二人称")%のおちんちん、本当にすごいですよね……全部入れたら胃まで届いちゃうんじゃないですか？」	PRINTFORMW 「%CNAME("二人称")%的大鸡鸡、真的好厉害呢……全根没入的话不都要到胃里去了吗？」
PRINTFORMW 「普通の人がこんなものを入れたらそれこそ喉が壊れちゃうんでしょうけど……ふふ、いっぱい練習しましたからね、私たち」	PRINTFORMW 「虽说一般人含入这种的东西话、喉咙真的会坏掉的吧……呼呼、不过已经充分练习过了呢、我们」
PRINTFORMW 「さ、私の喉でいっぱいごしごししましょうね、%CNAME("二人称")%」	PRINTFORMW 「请、尽情用我的喉咙套弄起来吧、%CNAME("二人称")%」
PRINTFORMW 「んむぅ……んっ、ぐむっ、んん……」	PRINTFORMW 「嗯姆~……嗯、咕姆、嗯嗯……」
PRINTFORMW （喉の奥までみっしり詰まって……こんなの、苦しいだけのはずなのに……）	PRINTFORMW （直到喉咙深处都塞得满满的……这样的、明明应该只有痛苦才对……）
PRINTFORMW （%CNAME("二人称")%にごりごり拡げられてるって思うだけで、変な気分になってきちゃう……）	PRINTFORMW （只是想到被%CNAME("二人称")%强行扩张着、感觉变得好奇怪……）
PRINTFORMW 「あぁ……また%CNAME("二人称")%のおちんちんを奥の奥まで入れちゃうんですね……」	PRINTFORMW 「啊~……又要把%CNAME("二人称")%的大鸡鸡含入喉咙里面的深处了呢……」
PRINTFORMW 「ちょっと怖いですけど……その、%CNAME("二人称")%がしたいなら、私は……」	PRINTFORMW 「虽然挺害怕的……那个、如果%CNAME("二人称")%想要的话、我……」
PRINTFORMW 「どうぞ……私のお口、%CNAME("二人称")%の好きなように、好きなだけ使ってください……」	PRINTFORMW 「请用……我的小嘴、请如%CNAME("二人称")%喜欢那样的、随意使用吧……」
PRINTFORMW 「んぶっ！　んぐ、むぐっ……じゅるっ、じゅぽっ！　じゅぽっ！」	PRINTFORMW 「嗯噗！　嗯咕、姆咕……咀噜、咀啵！　咀啵！」
PRINTFORMW （%CNAME("二人称")%のガチガチおちんちんにっ、私の喉がめちゃくちゃにされてます……っ）	PRINTFORMW （%CNAME("二人称")%那硬邦邦地大鸡鸡、把我的喉咙弄得乱七八糟的了……）
PRINTFORMW （乱暴に奥まで入れてもいいですからっ、もっと、気持ちよくなってくださいっ！）	PRINTFORMW （粗暴地插到深处去也可以啦、请更加、舒服起来吧！）
PRINTFORMW 「ゴムがこんなにぱんぱんになるまで出しちゃって……気持ちよかったですか？」	PRINTFORMW 「套套都被射得这么圆鼓鼓的了……太舒服了吗？」
PRINTFORMW 「ん……ちょっとゴムの%TEXTS("匂い")%がしますけど、でも%CNAME("二人称")%の%TEXTS("匂い")%の方がずっと強くて……はぁっ」	PRINTFORMW 「嗯……虽然有一点套套的气味、但是%CNAME("二人称")%的气味更浓呢……哈啊」
PRINTFORMW 「くらくらしてきちゃいます……この中で%CNAME("二人称")%のおたまじゃくしが元気に泳ぎ回っているんですね……」	PRINTFORMW 「渐渐晕乎乎起来了……这里面有%CNAME("二人称")%的精子在健康地游来游去呢……」
PRINTFORMW 「受精させてあげるわけにはいかないですけど……%CNAME("二人称")%がせっかく出してくれた精液ですもの、無駄になんてしませんよ」	PRINTFORMW 「虽然不能让它受精……但这是%CNAME("二人称")%特意为我射满精液的东西、可不能浪费呢」
CALL PRINT_STR, "「ふふ……それじゃあ、いただきまーす……_H_」_W"	CALL PRINT_STR, "「呼呼……那么、我开动——了……_H_」_W"
PRINTFORMW 「……はい、わかってます%CNAME("二人称")%。飲んだほうがいいんですよね」	PRINTFORMW 「……是、我知道了%CNAME("二人称")%。只要喝下这个就可以了吧」
PRINTFORMW 「んっ……！　んくっ、こくっ、こくっ……ぷはっ」	PRINTFORMW 「嗯……！　嗯咕、咕噜、咕噜……噗哈」
PRINTFORMW 「なんだか思ってたよりずっと飲みやすくて……なんだかもっと欲しくなっちゃうような……」	PRINTFORMW 「总觉得比想象中的要好喝多了……不由得变得想要更多那样……」
PRINTFORMW 「……もしかして私の味覚が変なんでしょうか？　でも%CNAME("二人称")%が出してくれたんだって思うと嬉しくて……」	PRINTFORMW 「……难道说我的味觉很奇怪吗？　但是一想到这是%CNAME("二人称")%为我射出来的就很开心……」
PRINTFORMW 「%CNAME("二人称")%の精液、ぷりぷりしててとっても濃厚で……んんっ」	PRINTFORMW 「%CNAME("二人称")%的精液、在套套里滴溜溜地非常濃厚……嗯嗯」
CALL PRINT_STR, "「あぁ……どうしてこんなに美味しく感じられるんでしょう……_H_」_W"	CALL PRINT_STR, "「啊啊……为什么会感觉这么美味可口的呢……_H_」_W"
PRINTFORMW 「あむ……ん、ちゅる、ちゅるちゅる……」	PRINTFORMW 「啊姆……嗯、唏噜、唏噜唏噜……」
PRINTFORMW 「ふぅっ、ゴムに溜まったのを飲むのもいいですけど、やっぱり%CNAME("二人称")%から直接飲ませてもらった方が……ふふ」	PRINTFORMW 「呼~、虽然喝套套里的残留液也不错、但是、果然还是直接从%CNAME("二人称")%那射出来的比较好喝啊……呼呼」
PRINTFORMW 「はぁ……どうしてこんなに美味しいんでしょう……」	PRINTFORMW 「哈啊……为什么这么美味的说……」
PRINTFORMW 「もしかして、私の身体の変化と何か関係があったりするんでしょうか……」	PRINTFORMW 「难道说、和治疗我身体的变化有什么关系么……」
PRINTFORMW 「そうだとしても……おかげで%CNAME("二人称")%の精液を美味しく感じられるわけですから、嬉しい方が大きいですけどね」	PRINTFORMW 「就算是那样……也多亏了%CNAME("二人称")%才让我品尝到精液的美味、所以说愉快的成分更大就是了」
PRINTFORMW 「あら、何持ってきたんですか%CNAME("二人称")%」	PRINTFORMW 「唉呀、%CNAME("二人称")%你拿着什么啊」
PRINTFORMW 「えーっと……ピアス？」	PRINTFORMW 「嗯——……耳环？」%CALLNAME:TARGET%歪着脑袋猜测着
PRINTFORMW 「もしかしてこれって、プレゼントとかそういうの……ですか？」	PRINTFORMW 「难道说这个是、送给我的礼物之类……的吗？」%CALLNAME:TARGET%脸上隐约带着幸福的喜悦、期待着什么
PRINTFORMW 「けど%CNAME("一人称")%、ピアスって付けたことがないので穴があいていなくて……」	PRINTFORMW 「可是%CNAME("一人称")%、因为没有戴过耳环所以耳朵上没有开洞……」
PRINTFORMW 「……違う？　耳じゃない？」	PRINTFORMW 「……不对？　不是给耳朵戴的？」
PRINTFORMW 「えっ、あのちょっと、今どこに付けるって言いました？」	PRINTFORMW 「诶、等一下、你刚才说要戴在哪里？」
PRINTFORMW 「麻酔するから痛くない？　いえあの、そういう問題ではなくてですね……」	PRINTFORMW 「因为有麻醉所以不会痛的？　不是啊、不是那样的问题啊……」
PRINTFORMW 「しかも麻酔なしってどういうことですかー！　やっ、離してください……っ」	PRINTFORMW 「而且没有麻醉是怎么回事啊——！　呀、请放开我……」
PRINTFORMW 「また付けるんですか？」	PRINTFORMW 「又要穿环吗？」
PRINTFORMW 「これを付けていると皮の中に収まらなくなるので、パンツにこすれて大変なんですよね……」	PRINTFORMW 「戴上这个的话小豆豆就不能收进包皮里了的说、会被胖次摩擦得很辛苦的吧……」
PRINTFORMW 「……え、顔がにやけてるって？」	PRINTFORMW 「……诶、我脸都红了？」
PRINTFORMW 「ないです、そんなことありませんからっ。大変なだけなんですからねっ」	PRINTFORMW 「没有、才没有那样啦。只是在担心而已哦」
PRINTFORMW 「ん……麻酔のおかげで痛くはないですけど」	PRINTFORMW 「嗯……虽然多亏了麻醉并不觉得痛」
PRINTFORMW 「まさかこんなところにピアスをつけちゃうだなんて……」	PRINTFORMW 「但是、竟然在这种地方戴耳环什么的……」
PRINTFORMW 「%CNAME("二人称")%ってば本当に変態さんですよね」	PRINTFORMW 「%CNAME("二人称")%啊、真的是有够变态的呢」
PRINTFORMW 「あぅ……っ、ん、うぅっ、いた……ぁ……」	PRINTFORMW 「啊呜……嗯、呜唔、痛……啊……」
PRINTFORMW 「ひぐっ！？　急に入れないでくださいっ、ピアスが冷たくて……」	PRINTFORMW 「哼咕！？　请不要急着刺进去啦、金属环冷冰冰的……」
PRINTFORMW 「ん……っ、外しちゃうんですね」	PRINTFORMW 「嗯~……摘下來是吧」
PRINTFORMW 「え？　寂しそうな顔してる……ですか？　それはまぁ」	PRINTFORMW 「诶？　我一脸寂寞的表情……有吗？　那个嘛~」
PRINTFORMW 「えっちなものではありましたけど、%CNAME("二人称")%からのプレゼントでしたし……」	PRINTFORMW 「对这个色色的东西多少有过一点感情啦、毕竟是%CNAME("二人称")%送的礼物嘛……」
PRINTFORMW 「うぅ……また付けるんですね」	PRINTFORMW 「唔~……又穿环了呢」
PRINTFORMW 「これをぶら下げてると、その……伸びちゃうような気がしてるんですけど」	PRINTFORMW 「挂着这个的话、那个（陰唇）……感觉好像要伸长了」
PRINTFORMW 「もしかして%CNAME("二人称")%はそれが逆に良かったりするの……かな……？」	PRINTFORMW 「难道说%CNAME("二人称")%反而喜欢那样……的吗……？」
PRINTFORMW 「だったらその、我慢してもいいですけど」	PRINTFORMW 「那样的话、让我忍耐下也不是不行啦」
PRINTFORMW 「麻酔があるからって、こんなところにピアスを付けるだなんて……」	PRINTFORMW 「就算有麻醉、在这种部位穿上陰环什么的……」
PRINTFORMW 「誰かに見られたらどう言い訳すればいいんですか、もうっ」	PRINTFORMW 「要是被誰看見了要怎麼解釋才好啊、真是的」
PRINTFORMW 「ひぎっ！？　あぅ、ぐっ、やぁっ！？」	PRINTFORMW 「嗬咿！？　啊呜、咕、呀啊！？」
PRINTFORMW 「いた、ぁ……っ、んっ、ピアスが通ってる……っ」	PRINTFORMW 「疼、啊……嗯、陰环穿透咯……」
PRINTFORMW 「お、終わりましたか……？」	PRINTFORMW 「結、結束了嗎……？」
PRINTFORMW 「え？　反対側にも付ける……？　んぐぅっ！？」	PRINTFORMW 「诶？　另一瓣也要穿上……？　嗯咕~！？」
PRINTFORMW 「あ、はい、外すんですね」	PRINTFORMW 「啊、是、得取下来呢」
PRINTFORMW 「普段からその、はみ出るようになっちゃったんですけど……外したら元に戻るんでしょうか……」	PRINTFORMW 「因为平时都戴着、那个（陰唇）已经翻出来了的说……但是取下之后会恢复原状的是吧……」
PRINTFORMW 「ん……どうですか%CNAME("二人称")%、興奮します？」	PRINTFORMW 「嗯……怎么样啊%CNAME("二人称")%、興奮了？」
PRINTFORMW 「赤ちゃんにおっぱいをあげる大事なところなのに……%CNAME("二人称")%のえっち」	PRINTFORMW 「明明是给宝宝喂奶的重要地方的說……%CNAME("二人称")%好色」
PRINTFORMW 「うーん、水泳の時とかどうやって隠しましょうか」	PRINTFORMW 「唔——嗯、游泳之类的时候该怎么隐藏呢」
PRINTFORMW 「せっかく%CNAME("二人称")%にもらったものですし、外しちゃうのはちょっと」	PRINTFORMW 「难得从%CNAME("二人称")%那收到的东西的说、取下来的话有点……」
PRINTFORMW 「え？　見せつけたいんじゃないかって？」	PRINTFORMW 「诶？　不想显示给别人看吗？」
PRINTFORMW 「ち、違いますっ、そんなわけないじゃないですかっ」	PRINTFORMW 「不、不是的、那不是理所当然的吗」
PRINTFORMW 「ん……ぐっ、はっ、ふっ、ひぅ……っ」	PRINTFORMW 「嗯……咕、哈、唿、嗬唔……」
PRINTFORMW 「くぅっ、はっ、反対側も付けるんですか……？」	PRINTFORMW 「库唔、哈、另一瓣也要穿吗……？」
PRINTFORMW 「わかりました……ひと思いに、やっちゃってください……んんっ」	PRINTFORMW 「我知道了……请一口气、做完吧……嗯嗯~」
PRINTFORMW 「外すんですね、わかりました」	PRINTFORMW 「取下是吧、我知道了」
PRINTFORMW 「そういえば……このままおっぱいが出\@ TALENT:母乳体質 == 0 ? るようになっ # \@たら、ピアスの穴から漏れするんでしょうか」	PRINTFORMW 「话说……接下来如果乳汁出来\@ TALENT:母乳体質 == 0 ? 那样的话 # 的话 \@、会是从乳环的穿孔里漏出来吗」
PRINTFORMW 「ん……どうですか？」	PRINTFORMW 「嗯……怎么样？」
PRINTFORMW 「%CNAME("一人称")%みたいな子にはあんまり、似合わないかもしれないですけど……」	PRINTFORMW 「虽然对%CNAME("一人称")%这样的女孩来说、也许不太合适就是了……」
PRINTFORMW 「耳にしてる人はわりといますけど、おへそはそれに比べると少ないですね」	PRINTFORMW 「虽说耳朵穿环的人也有、但是肚脐这样做的很少呢」
PRINTFORMW 「あんまり綺麗とは言えないところですから、化膿しないかどうかが気になります……」	PRINTFORMW 「因为说不上是多么干净的地方、有些担心伤口会不会化脓……」
PRINTFORMW 「でもいつ%CNAME("二人称")%がさわるかわからないから、するようになってからはいつも綺麗にしてるんですよ？」	PRINTFORMW 「但是因为不知道%CNAME("二人称")%什么时候会触摸、自从这样以来、这里总是保持干净的喲？」
PRINTFORMW 「ん……っ、おへそって普段触ったりしないところですし、なんだか変な感じです」	PRINTFORMW 「嗯……肚脐是平时不怎么碰的地方的说、总感觉怪怪的」
PRINTFORMW 「焼けてるみたいに熱くて、じんじんします……」	PRINTFORMW 「热得像火烧一样、刺刺的……」
PRINTFORMW 「えっと、外すんですよね」	PRINTFORMW 「嗯——、取下来是吧」
PRINTFORMW 「%CNAME("一人称", "かな")%、あんまりお洒落ってしたことなかったので……少し楽しかったです」	PRINTFORMW 「%CNAME("一人称", "かな")%、因为没怎么打扮过……那时有点开心呢」
PRINTFORMW 「でもその、ちょっとですよ、ちょっと」	PRINTFORMW 「但是那个、只是有点喲、有点」
PRINTFORMW 「あ、これは知ってますよ」	PRINTFORMW 「啊、这个我知道喲」
PRINTFORMW 「麻酔で身体が動かせなかったり、トイレに行けないようなときに使うものですね」	PRINTFORMW 「身体因为麻醉无法动弹之类的、不能独自上厕所那样的情况时使用的东西呢」
PRINTFORMW 「――ってあら、それがどうしてここに？」	PRINTFORMW 「——话说回来、那个怎么会在这里？」
PRINTFORMW 「え、あの、これを奥まで入れるとおしっこ出ちゃうんですけど……えっ」	PRINTFORMW 「诶、要是、这个插进深处里面的话、小便会流出来的啦……呃！」
PRINTFORMW 「うぅぅ……また%CNAME("一人称")%にお漏らしさせたいんですか」	PRINTFORMW 「呜呜呜……又想让%CNAME("一人称")%小便失禁吗？」
PRINTFORMW 「%CNAME("二人称")%ってそういうところほんとに変態さんですよね……」	PRINTFORMW 「%CNAME("二人称")%你在这种地方真的是有够变态的呢……」
PRINTFORMW 「女の子にむりやりおしっこをさせたいだなんて」	PRINTFORMW 「竟然想强行让女孩子尿尿什么的」
PRINTFORMW 「%CNAME("二人称")%ってほんとに、ほんとに……もうっ」	PRINTFORMW 「%CNAME("二人称")%你真的是、真的是……唉~」
PRINTFORMW 「だんだん慣れてきている自分が怖いです」	PRINTFORMW 「渐渐习惯了的自己、好可怕」
PRINTFORMW 「これからどうなっちゃうんでしょうか……」	PRINTFORMW 「今后我会怎么样呢……」
PRINTFORMW 「ゼリーは付けましたよね？」	PRINTFORMW 「涂好抗菌凝胶了是吧？」
PRINTFORMW 「それじゃあ、どうぞ……。ゆっくり入れてくださいね」	PRINTFORMW 「那么就、请吧……。请慢慢地插进来哦」
PRINTFORMW 「このつるつるした棒……なんですか？」	PRINTFORMW 「这个光溜溜的棒子……是什么啊？」
PRINTFORMW 「……？　殺菌しなおさないといけないからさわっちゃダメ？　何に使うんですかこれ？」	PRINTFORMW 「……？　因为那样不得不重新杀菌、所以禁止触碰？　做什么的呀这个？」
PRINTFORMW 「えっ」	PRINTFORMW 「诶」
PRINTFORMW 「えっ、えっ、ええぇぇっ！？」	PRINTFORMW 「诶、诶、诶诶诶诶！？」
PRINTFORMW 「%CNAME("一人称", "かな")%のおしっこの穴をっ！？　広げるっ！？　これでっ！？」	PRINTFORMW 「%CNAME("一人称", "かな")%尿尿的小穴！？　扩张！？　用这个！？」
PRINTFORMW 「――――はぅっ」	PRINTFORMW 「————哈唔」
PRINTFORMW 貧血で倒れた%CALLNAME:TARGET%を介抱しつつ、%CALLNAME:MASTER%は尿道を拡張させてくれるように拝み倒すのだった……。	PRINTFORMW %CALLNAME:MASTER%照顾着因贫血而倒下的%CALLNAME:TARGET%、同时为了能扩张尿道而苦苦哀求着……。
PRINTFORMW 「はぐ……っ、いﾞっ、ぎぃ……っ、うﾞっ、あぐぅっ」	PRINTFORMW 「哈咕……唻、了~……呜、啊咕~」
PRINTFORMW 「ひろがってるっ、%CNAME("一人称", "かな")%の、おしっこの穴っ、ひろがっちゃってる……っ」	PRINTFORMW 「扩张着、%CNAME("一人称", "かな")%、尿尿的小穴、扩张开了……」
PRINTFORMW 「んっ……。はふっ、はっ、はっ、ふぅ……っ」	PRINTFORMW 「嗯……。哈唿、哈、哈、唿~……」
PRINTFORMW 「この感触には、なかなか、慣れません、ね……」	PRINTFORMW 「这种触感、很难、习惯、呢……」
PRINTFORMW 「ま、またやるんですか……」	PRINTFORMW 「又、又要做么……」
PRINTFORMW 「これすごく痛いんですよ、わかってますか、わかってませんよね？」	PRINTFORMW 「这个很痛的喲、你明白吗、不明白是吧？」
PRINTFORMW 「やりすぎたらおしっこの穴、閉じなくなっちゃうかもしれないのに……」	PRINTFORMW 「要是太过火的话、尿尿的小穴、也许就再也合不上了呀……」
PRINTFORMW 「……うぅ、でも%CNAME("二人称")%はそれが見てみたいんですよね」	PRINTFORMW 「……呜~、但是%CNAME("二人称")%好像很乐意看到那样是吧」
PRINTFORMW 「うぅ……そんなに痛くはなくなりましたけど、痛くないのがむしろ怖いです……」	PRINTFORMW 「呜~……虽然已经不那么痛了、倒不如说我更害怕……」
PRINTFORMW 「%CNAME("一人称", "かな", "どもり")%の尿道まだ大丈夫ですよね？　と、閉じなくなってたりなんてしませんよね？」	PRINTFORMW 「%CNAME("一人称", "かな", "どもり")%的尿道还没问题的是吧？　不、不会合不上什么的是吧？」
PRINTFORMW 「ただでさえ普段は無菌で、病気になりやすい場所なのに……うぅぅ」	PRINTFORMW 「平常本来是无菌的才对、明明是容易生病的场所……呜唔唔」
PRINTFORMW 「こ、これは……っ、まさか、あの……」	PRINTFORMW 「这、这个……难道说、是……」
PRINTFORMW 「エプロンっ、それも、料理向きでないのがあからさまなほどにフリル過多で可愛らしい……」	PRINTFORMW 「围裙、而且、显然不是料理向、而是荷叶边过多的可爱系……」
PRINTFORMW 「つまりこれが『ご飯にする？　お風呂にする？　それともわ・た・し？』って聞くためのエプロンですね！」	PRINTFORMW 「总之这就是『先吃饭？　还是先洗澡？　还是说先・吃・我？』的传说中的围裙是吧！」
PRINTFORMW エプロンを一目見た%CALLNAME:TARGET%は、黄色い声をあげながら妙なテンションのままはしゃいでいる……。	PRINTFORMW 看了一眼围裙的%CALLNAME:TARGET%、略带轻蔑的说着、同时有一种奇怪的兴奋情绪……。
PRINTFORMW 「あれ、もういいんですか？」	PRINTFORMW 「怎么、已经可以了吗？」
PRINTFORMW 「……もうちょっと着ていたかった気もするんですけど」	PRINTFORMW 「……虽然我还想再穿一会的说」
PRINTFORMW 「冷静になってみると……着るのが若干、恥ずかしいデザインですよね」	PRINTFORMW 「冷静下来一看……穿着的设计、多少有点羞耻的呢」
PRINTFORMW 「%CNAME("二人称")%はこういうのが趣味だったりしますか？　それなら%CNAME("一人称")%は気にしないことにしますけど」	PRINTFORMW 「%CNAME("二人称")%喜好这种风格的吗？　那样的话、%CNAME("一人称")%也不介意穿成这样啦」
PRINTFORMW 「ふふ、だんなさまにご奉仕……してあげますよ」	PRINTFORMW 「呼呼、我来侍奉……老公喲」
PRINTFORMW 「ふふ、脱がせたのが惜しくなりましたか？」	PRINTFORMW 「呼呼、舍不得我脱下来吗？」
PRINTFORMW 「もちろんいいですよ、%CNAME("二人称")%のお願いなら何度でも着てあげますからね」	PRINTFORMW 「当然可以喲、因为只要%CNAME("二人称")%请求的话、无论多少次都会为你穿上哦」
CALL PRINT_STR, @"%CALLNAME:MASTER%がバイブの用意をしていると、横から顔を出した%CALLNAME:TARGET%が",\@ TEQUIP:口枷 == 1 ? ボール # リング \@,"ギャグを外すように合図を送ってきた_W_"	CALL PRINT_STR, @"当%CALLNAME:MASTER%准备着振动棒的时候、从侧面探头过来的%CALLNAME:TARGET%、打着「把",\@ TEQUIP:口枷 == 1 ? 口球 # 口环 \@,"取下来」那样的眼色_W_"
PRINTFORMW 「ごそごそと何を用意しているのかと思ったら……」	PRINTFORMW 「还想说你慌慌张张地在准备什么呢……」
PRINTFORMW 「あのですね%CNAME("二人称")%、%CNAME("一人称")%はそういうものを使った経験がなくてですね」	PRINTFORMW 「是那个啊、%CNAME("二人称")%、%CNAME("一人称")%可是从来没有用过那种东西的哦」
PRINTFORMW 「そして男性とおつきあいをしたことも当然ありません」	PRINTFORMW 「而且、和男性交往后的那种事情、当然也没有做过」
PRINTFORMW 「なので、あの……察してほしいんですけど」	PRINTFORMW 「因此、那个……希望能体谅一下」
PRINTFORMW 「う、うぅ……だからあの、%CNAME("一人称", "かな")%、その……処女なんです、けど」	PRINTFORMW 「呜、呜唔……所以那个、%CNAME("一人称", "かな")%、可还是……処女、的说」
PRINTFORMW 「だからですね、初めてがそういうおもちゃになってしまうというのはその、イヤなんです」	PRINTFORMW 「所以说呢、第一次被那种玩具夺走的话那、绝对不要」
PRINTFORMW 「それに、その……そんな大きいものは入りそうにないですし」	PRINTFORMW 「而且、那个……东西那么大、放不进去的啦」
PRINTFORMW 「……考え直してくれませんか？」	PRINTFORMW 「……能重新考虑一下吗？」
CALL PRINT_SELECT, "やだ/考え直す"	CALL PRINT_SELECT, "不能/重新考虑"
PRINTFORMW 「う、うぅぅ、%CNAME("二人称")%のばか、ばかっ、いじめっこっ」	PRINTFORMW 「呜、呜呜呜、笨蛋%CNAME("二人称")%、笨蛋、欺负人」
PRINTFORMW 「好きな人にあげたいんだって、気づいてくださいよ……もうっ」	PRINTFORMW 「因为想交给喜欢的人啦、请察觉到啊……真是的」
PRINTFORMW 「……ほっとしました」	PRINTFORMW 「……真是松了口气」
PRINTFORMW 「できれば初めては……その、好きな人にあげたいなって思ってたので……」	PRINTFORMW 「可以的话、第一次……那个、想交给喜欢的人哦……」
PRINTFORMW 「お腹がすいて……もう、我慢が……」	PRINTFORMW 「肚子饿了……已经、忍……」
PRINTFORMW 「%CNAME("二人称")%のおちんちん、いっぱい精液が出そうでおいしそうです……」	PRINTFORMW 「%CNAME("二人称")%的鸡鸡、满满的射出精液那样、很好吃的样子……」
PRINTFORMW 「ああ、でも%CNAME("一人称")%、キスもまだしたことないのにそんなこと……っ」	PRINTFORMW 「啊啊、但是%CNAME("一人称")%、明明还没接过吻的说、那种事情……」
PRINTFORMW 「でもぉっ、苦しいんですっ、せつないんですっ」	PRINTFORMW 「但是~、好难受、憋得慌」
PRINTFORMW %CALLNAME:MASTER%は%CALLNAME:TARGET%を――	PRINTFORMW %CALLNAME:MASTER%让%CALLNAME:TARGET%——
CALL PRINT_SELECT, "止める/止めない"	CALL PRINT_SELECT, "停下/继续"
PRINTFORMW ステイ。と、%CALLNAME:MASTER%は%CALLNAME:TARGET%に我慢するように命じた	PRINTFORMW 「停下。」%CALLNAME:MASTER%为了让%CALLNAME:TARGET%忍耐而命令道
PRINTFORMW 「だったらせめて、キスしてくださいっ。%CNAME("二人称")%を吸わせてくださいっ」	PRINTFORMW 「这样的话那就、请先吻我吧。请让我可以吃%CNAME("二人称")%的鸡鸡」
PRINTFORMW 「約束してください%CNAME("二人称")%っ」	PRINTFORMW 「请答应我、%CNAME("二人称")%」
PRINTFORMW %CALLNAME:MASTER%がフェラチオをさせようとペニスを突きつけると、%CALLNAME:TARGET%が口枷を外すように合図を送ってきた	PRINTFORMW %CALLNAME:MASTER%为了口交而挺着陰莖准备突击的时候、注意到%CALLNAME:TARGET%请求取下口枷那样的意图
PRINTFORMW 「……あの、%CNAME("二人称")%。少しいいですか」	PRINTFORMW 「……那个、%CNAME("二人称")%。等一下可以吗」
PRINTFORMW 「%CNAME("二人称")%はその、%CNAME("一人称")%に……おちんちんを舐めさせようとしているんだと思いますけど」	PRINTFORMW 「%CNAME("二人称")%的那个、%CNAME("一人称")%虽然……也挺想给鸡鸡舔的」
PRINTFORMW 「%CNAME("一人称", "かな")%、えっと……誰かとキスをしたことがまだなくって」	PRINTFORMW 「%CNAME("一人称", "かな")%、那个……还没有和谁接吻过」
PRINTFORMW 「初めてのキスは%CNAME("二人称")%と、その、口同士でしたいんです」	PRINTFORMW 「第一次的接吻想和%CNAME("二人称")%、那个、嘴对嘴的做」
PRINTFORMW 「おちんちんよりも先に、%CNAME("一人称", "かな")%とキスしてくれませんか……？」	PRINTFORMW 「在亲鸡鸡之前、能请你先和%CNAME("一人称", "かな")%接吻吗……？」
CALL PRINT_SELECT, "してあげる/あげない"	CALL PRINT_SELECT, "答应/不能"
PRINTFORMW 「……ありがとう」	PRINTFORMW 「……谢谢」
PRINTFORMW 「約束ですからね、%CNAME("二人称")%……」	PRINTFORMW 「约好了哦、%CNAME("二人称")%……」
PRINTFORMW 「……%CNAME("二人称", "かな")%は、いじわるです」	PRINTFORMW 「……%CNAME("二人称", "かな")%、坏心眼」
PRINTFORMW 「へんたいですっ、いじめっこですっ、サディストですっ」	PRINTFORMW 「你这个变态、性虐狂、欺负人」
PRINTFORMW 「ふんだ、あとから欲しくなったって遅いんですからね」	PRINTFORMW 「哼哒、之后要是后悔就太迟了哦」
PRINTFORMW 「わかりました、出してください」	PRINTFORMW 「知道了、请掏出来吧」
PRINTFORMW 「……%CNAME("二人称")%のおちんちんに、%CNAME("一人称")%のファーストキス、あげますから」	PRINTFORMW 「……%CNAME("二人称")%的鸡鸡、%CNAME("一人称")%会献上、初吻的啦」
PRINTFORMW %CALLNAME:MASTER%は%CALLNAME:TARGET%に口枷を付けなおすと、その鼻先にあらためてペニスを突きつけた……	PRINTFORMW 在%CALLNAME:MASTER%给%CALLNAME:TARGET%重新戴好口枷的时候、陰莖再一次顶在她鼻尖上……
PRINTFORMW 「んっ、うぅ……っ！　はっ、はぁっ、んく、はぁ……っ」	PRINTFORMW 「嗯、呜呜……！　哈、哈啊、嗯库、哈啊……」
PRINTFORMW 「す、すごすぎです、こんなにいっぱいっ、自分でするのと全然違います……」	PRINTFORMW 「太、太厉害了、如此射爆、跟自己撸的时候完全不一样……」
PRINTFORMW 「ふぅっ……あぁ……腰が抜けちゃって立てません……」	PRINTFORMW 「唿~……啊啊……腰软得站不起来了……」
PRINTFORMW 「く、ふぅっ、んっ……やっ、なんですかこれっ」	PRINTFORMW 「库、唿唔、嗯……呀、什么啊这个」
PRINTFORMW 「はっ、だめっ、なんかすごいのっ、すごいのきちゃいますっ！」	PRINTFORMW 「哈、不行、感觉好厉害啊、厉害的要来了！」
PRINTFORMW 「ふぐぅっ！？　やっ、だめっ、だめだめだめっ、あっあっ、あぁ……っ！」	PRINTFORMW 「唿咕~！？　呀、不行、不行不行不行、啊、啊、啊啊……！」
PRINTFORMW 「わたしっ、女の子なのにっ、やぁ……いっぱいっ、いっぱい出ちゃう……んんっ！」	PRINTFORMW 「我明明是、女孩子、呀啊……统统、统统出来了……嗯嗯！」
PRINTFORMW 「……っ、はぁっ、はぁ、ぁ……」	PRINTFORMW 「……哈啊、哈啊、啊……」
PRINTFORMW 「はぁ……はぁっ、ふっ……んんっ」	PRINTFORMW 「哈啊……哈啊、唿……嗯嗯」
PRINTFORMW 「あ……わたし、こんなにたくさん、出して……」	PRINTFORMW 「啊……我、射出来、这么多……」
PRINTFORMW 「あっ……やっ、んぅっ！」	PRINTFORMW 「啊……呀、嗯唔！」
PRINTFORMW 「出てるっ、もうイってますからっ、とめ……んひぅっ！？」	PRINTFORMW 「出来啦、已经去了啦、停……嗬唔~！？」
PRINTFORMW ゴムを使うと一言%CALLNAME:TARGET%に伝えると、%CALLNAME:MASTER%はくるりと背を向けてペニスにゴムを装着し始めた。	PRINTFORMW 使用套套一言传达给%CALLNAME:TARGET%后、%CALLNAME:MASTER%转过身去背对着开始套避孕套。
PRINTFORMW 「はぁ……ゴムつけてたら前でしてもいいことにしちゃおうかなぁ」	PRINTFORMW 「哈啊……戴上套套的话、在前穴做也可以了吧」
PRINTFORMW 「いやいや何考えてるの私っ、ルールは例外から崩れていくんだから、そのうちきっとゴムなしですることになっちゃう」	PRINTFORMW 「讨厌讨厌、想什么呢我、因为规则是从例外开始崩溃的啦、总有一天变成不戴套时就完了」
PRINTFORMW 「だって私、%CNAME("二人称")%にゴムなしでしようって言われたら拒める自信ないし……」	PRINTFORMW 「因为、要是%CNAME("二人称")%说不戴套的话、我没有拒绝的自信啦……」
PRINTFORMW 「それに……先にわたしの方が我慢できなくなって、ゴム外そうって言っちゃうかもしれないし……」	PRINTFORMW 「而且……倒是我先忍不住的时候、说不定会说出把避孕套脱掉呢……」
PRINTFORMW 「や、やっぱりダメっ、ぜったいダメっ、赤ちゃんできるようなことは禁止っ」	PRINTFORMW 「果、果然还是不行、绝对不行、禁止做会生小宝宝之类的事情」
PRINTFORMW 後ろで%CALLNAME:TARGET%が小声でぼそぼそと呟いているが、何を言っているのかまでは聞き取れない……。	PRINTFORMW 背后的%CALLNAME:TARGET%捂着脸、叽叽咕咕地小声嘟囔着、到底在说些什么听不清楚……。
PRINTFORMW %CALLNAME:MASTER%がゴムを取り出すと、横合いから%CALLNAME:TARGET%にひょいと取り上げられてしまった。	PRINTFORMW 当%CALLNAME:MASTER%取出套套时、被%CALLNAME:TARGET%从侧面突然抢走了。
PRINTFORMW 「えへへ……%CNAME("二人称")%、私がつけてあげます」	PRINTFORMW 「诶嘿嘿……%CNAME("二人称")%、我来帮你套上」
PRINTFORMW そう言って封を切ると、%CALLNAME:TARGET%はおもむろに中身を口に含んだ。	PRINTFORMW 那样说着撕开了包装、%CALLNAME:TARGET%徐缓地把内容物含入口中。
PRINTFORMW 「んっ……れろ、んくっ、んっ、んむっ……ぷはっ。はいっ、できましたよ」	PRINTFORMW 「嗯……咧啰、嗯库、嗯、嗯姆……噗哈。得、套好了喲」
PRINTFORMW 「あれ、何か変でしたか……？　こうやって口でつけてあげると喜ぶって本に書いてあったんですけど……」	PRINTFORMW 「怎么、有什么不对劲吗……？　这样用嘴帮套上会很高兴那样、虽说书上是这么写的……」
PRINTFORMW 「……わかっているとは思いますけど」	PRINTFORMW 「……我想你应该知道的」
PRINTFORMW 「ゴムがあるからって言っても前でするのはダメですからね」	PRINTFORMW 「虽说有避孕套、但是用前面做的话、还是不行的哦」
PRINTFORMW 「お尻だったら、その……%CNAME("二人称")%の好きなようにしていいですから、ね？」	PRINTFORMW 「屁股的话、那个……%CNAME("二人称")%喜欢怎么做都可以、好吗？」
PRINTFORMW 「ゴム使うんですか？　お尻はあんまり綺麗なところじゃないですし、それがいいと思います」	PRINTFORMW 「要用套套吗？　屁股又不是什么多么干净的场所呢、我想那样也好」
PRINTFORMW 「……ない方が%CNAME("二人称")%を直接感じられて、気持ちいいのは確かですけど」	PRINTFORMW 「……虽说不戴套能直接感受到%CNAME("二人称")%、确实更舒服就是了」
PRINTFORMW 「で、でもっ、%CNAME("二人称")%の健康が第一ですからっ！」	PRINTFORMW 「但、但是、因为%CNAME("二人称")%的健康第一啦！」
PRINTFORMW 「あれ、ゴムないんですか？」	PRINTFORMW 「哎呀、没有避孕套吗？」
PRINTFORMW 「それじゃあ……そのままするしかないですよね……」	PRINTFORMW 「那么……只能那样做了吧……」
PRINTFORMW 「……し、仕方ないことですよね。つけない方が気持ちいいからとか、そういう不純な動機じゃないですしっ」	PRINTFORMW 「……真、真是没办法的事呢。因为不戴的话更舒服啦、不是那种不纯的动机啦」
PRINTFORMW 「……もう、ダメですよ%CNAME("二人称")%。そんなことじゃ」	PRINTFORMW 「……真是的、不可以喲%CNAME("二人称")%。那样做的话」
PRINTFORMW 「わ、私はそんな%CNAME("二人称")%でも嫌いになったりなんてしませんけど……」	PRINTFORMW 「虽、虽然我不会讨厌这样的%CNAME("二人称")%……」
PRINTFORMW 「もう……しょうがない%CNAME("二人称")%ですね」	PRINTFORMW 「真是的……真是无药可救的%CNAME("二人称")%啊」
PRINTFORMW 「これは妹として、責任をもって面倒を見てあげないといけないですよね……？」	PRINTFORMW 「对妹妹这样、不表现出负责任的一面不行的不是吗……？」
PRINTFORMW 「あ……今回はつけないんですか？　実を言うと私、ゴムつけない方が好きで……」	PRINTFORMW 「啊……这次不戴套吗？　老实说我、更喜欢不戴套派……」
PRINTFORMW 「直接感じられるほうが気持ちいいのもあるんですけど」	PRINTFORMW 「虽说有直接感受到会更舒服的成分在内」
PRINTFORMW 「%CNAME("二人称")%がいっぱい出してくれたって思うと、すごく幸せな気持ちになるから……」	PRINTFORMW 「因为、一想到%CNAME("二人称")%为了我满满的射出来、就会感觉到特别幸福啦……」
PRINTFORMW 「……え、生の方がいいからゴムつけない？」	PRINTFORMW 「……诶、因为直接插入也无所谓、所以不戴套？」
PRINTFORMW 「もう、病気になったら困るのは%CNAME("二人称")%なのに……しょうがないなぁ……」	PRINTFORMW 「真是的、要是%CNAME("二人称")%生病的话可就麻烦了……真拿你没办法啊……」
PRINTFORMW 「今度%CNAME("二人称")%のおちんちんを抗菌にしてもらうようにお願いしてみようかな……」	PRINTFORMW 「下次、拜托%CNAME("二人称")%给鸡鸡做抗菌处理试试看比较好吧……」
PRINTFORMW 「ゴムがない方が気持ちよくていい……ですか？」	PRINTFORMW 「不戴套会更舒服……是吗？」
PRINTFORMW 「あぅ、そう言ってもらえるのは嬉しいんですけど……」	PRINTFORMW 「啊呜、虽然很高兴听到你这么说……」
PRINTFORMW 「わかりました……それじゃ、抜いたあとちゃんと綺麗にしましょうね」	PRINTFORMW 「我知道了……那行吧、拔出来后要好好弄干净哦」