
//EVENT_K9_DAILY

PRINTFORMW 「おはようございます」	PRINTFORMW 「早上好」
PRINTFORMW 「そういえば、今日は体育の授業がありますね。なんですか嫌そうな顔をして」	PRINTFORMW 「这么说来，今天有体育课啊。你的表情好让人嫌弃啊」
PRINTFORMW 「朝ですね、朝ですよ。…はい、おはようございます！」	PRINTFORMW 「早上了啊……好困……啊！早安！」
PRINTFORMW 「どれほど時間が足りなくとも、朝食はきちんと摂りましょうね、ええ」	PRINTFORMW 「不管时间够不够，早饭是必须要吃哒！」
PRINTFORMW 「…あ、人が見てるテレビのチャンネルを、勝手に変えないでくださいー…」	PRINTFORMW 「…啊，不要在别人看电视看的正开心的时候换台哦」
PRINTFORMW 「誰もいない。ふむ、まあこんな日もありましょう」	PRINTFORMW 「谁也不在。嗯，也有这样的日子吧」
PRINTFORMW 「おお、%CNAMET(ARG, "一人称")%たちが一番乗りです。珍しいこともあるもんですね」	PRINTFORMW 「啊、%CNAMET(ARG, "一人称")%们是第一个到的！真少见呐~」
PRINTFORMW 「…わ、わ…急に扉を開けないでくださいよ、びっくりするじゃないですか」	PRINTFORMW 「…唔哇……别突然就开门啦……吓我一跳……」
PRINTFORMW 「おや、おつかれさまです」	PRINTFORMW 「哦呀，辛苦啦」
PRINTFORMW 「と、と…ただいま戻りました」	PRINTFORMW 「咳、我、我回来了」
PRINTFORMW 「おかえりなさい。あまり遅くまで出歩かないようにしてくださいね」	PRINTFORMW 「欢迎回家~大晚上的不要在外面呆的太晚哦」
PRINTFORMW 「おかえりなさい！」	PRINTFORMW 「欢迎回来！」
PRINTFORMW 「お邪魔します」	PRINTFORMW 「打扰了……」
PRINTFORMW 「今日もよろしくお願いします」	PRINTFORMW 「今天也麻烦您了」
PRINTFORMW 「こんにちは」	PRINTFORMW 「你好」
PRINTFORMW 「上がらせていただいても、よろしいですか？」	PRINTFORMW 「我可以上去吗？」
PRINTFORMW 「…む、む」	PRINTFORMW 「……嗯，嗯」
PRINTFORMW 「あまり遠くまで、行かないようにしてくださいね」	PRINTFORMW 「请不要离开太远哦，别让人担心，毕竟你那吸引恶魔的体质真的……」
PRINTFORMW 「もし悪魔に襲われたら、教えたとおりの手順で救援を要請してください」	PRINTFORMW 「如果被恶魔袭击了的话，就按照之前教你的程序来发出救援哦」
PRINTFORMW 「どうです、食べてみた感想は？　お口に合えばいいんですが」	PRINTFORMW 「如何？吃了之后有什么感想么？希望能合您口味」
PRINTFORMW 「あっ、いえ、やっぱり言わないでください！　恥ずかしくて聞けません！」	PRINTFORMW 「啊、不、还是别说了、太过羞耻了不想听啦！」
PRINTFORMW 「まさか私に、男の人と二人でお弁当を食べる日が来るとは…」	PRINTFORMW 「想不到……我会和其余人一起吃便当………」
PRINTFORMW 「憧れがなかったわけではありませんが、いざこうして実際にやってみると…」	PRINTFORMW 「到并不是没有憧憬过啦……只不过，突然实际上发生的时候就…」
PRINTFORMW 「あ、あ、だめだ、ものすごい頬が緩みますね、これは」	PRINTFORMW 「啊、啊不行啦！脸烧的厉害，稍微，稍微等我一下我恢复一下心境！」
PRINTFORMW %CALLNAME:ARG%は%TEXTR("目を輝かせながら/胸に手を当てながら/自分が食べるのも忘れて/母親のような表情で")%吃便當%CALLNAME:MASTER%を見守っている。	PRINTFORMW %CALLNAME:ARG%%TEXTR("目光炯炯/手轻抚着胸口/忘记自己吃/露出母亲的表情")%守护着%CALLNAME:MASTER%吃便當。
PRINTFORML 「うあー、汗みずくですねえ…。飲み物飲み物っと…」	PRINTFORML 「呜哇……流了好多汗……可乐~可乐~」
PRINTFORML 「%CNAME("二人称")%も、なにか飲んだ方が良いですよ」	PRINTFORML 「%CNAME("二人称")%也要喝点什么么？我请客也可以哦」
PRINTFORML 「あづいー…この国はどうしてこうも暑いのか…」	PRINTFORML 「啊呜……这个国家怎么这么热啊…」
PRINTFORML 「む、む、こりゃ駄目だ。ちょっと…頭を…すっきりさせてきます」	PRINTFORML 「啊……姆……不、不行、脑袋昏昏沉沉的……」
PRINTFORML %CALLNAME:TARGET%はふらふらと屋外に出ていった	PRINTFORML %CALLNAME:TARGET%打了个哈欠，摇摇晃晃地走出门外
PRINTFORML 「恋人、恋人かあ…なんだな…実感わかないなあ…」	PRINTFORML 「情侣……情侣……什么嘛……这么突然……一点实感都没有//v//…」
PRINTFORML %CALLNAME:TARGET%はふと、%CALLNAME:MASTER%を見つめた	PRINTFORML %CALLNAME:TARGET%忽然凝视着%CALLNAME:MASTER%，傻傻地笑了起来
PRINTFORML 「…ふふ、格好いいな、私の恋人は」	PRINTFORML 「…嘿嘿……真不错呐~我的恋人~」
PRINTFORML 「善い行いをなされました。神も喜ばれましょう」	PRINTFORML 「神爱众人，更爱善人、行善之人会更受神明大人的喜爱哦」
PRINTFORML 「%CNAME("二人称")%の魂はわたしたちが責任をもって預かります」	PRINTFORML 「%CNAME("二人称")%的灵魂由我们负责保管」
PRINTFORML 「この魂に、永遠の安息がありますように」	PRINTFORML 「愿此魂灵、得以永恒……」
PRINTFORML 「え、悪魔は魂を代価に背を伸ばしてくれるんですか」	PRINTFORML 「哎？恶魔能够以灵魂为代价施展法术么？！」
PRINTFORML 「む、どこかに行かれるのであれば、私も同行します」	PRINTFORML 「啊、如果要去哪里的话，我也陪你一起吧」
PRINTFORML 「払うのは他人の魂でも構わなかったりします？」	PRINTFORML “付出别人的灵魂也没关系吗?”
PRINTFORML 「……で、ココで何するんですか？」	PRINTFORML 「……那么，在这里做什么呢？」
PRINTFORML 「…うひゃあ！？」	PRINTFORML 「…咿呀！？」
PRINTFORML 「%CNAME("二人称")%、見てませんでしたよね」	PRINTFORML 「%CNAME("二人称")%、没看见吧……？！」
PRINTFORML 「なにが、じゃありません！なんでもです！」	PRINTFORML 「“怎么了？”个头啦！」
PRINTFORML 「きゃあ！？」	PRINTFORML 「啊！？」
PRINTFORML 「もう、子供ですか、あなたは！」	PRINTFORML 「真是的……你还是小孩子么！」
PRINTFORML 「どちりな…きりしたん…」	PRINTFORML 「zzz…豆沙…zzz」
PRINTFORML 「われにかごー…あんばさ…まはんまおん…」	PRINTFORML 「zz豆沙先生…zz…让我咬一口」
PRINTFORML 「あわーめんあーらんにんぐふろむざばとーふぃる…あっせいむふるじすぷれい…」	PRINTFORML 「「…呜…呜呼……不要咬我」
PRINTFORMW 「今日も良い一日を過ごしましょうね」	PRINTFORMW 「今天也度过美好的一天吧」
PRINTFORMW 「う、あ、その」	PRINTFORMW 「嗯，啊，那个」
PRINTFORMW 明らかに褒められ慣れていないのであろう、%CALLNAME:TARGET%は顔を赤らめている	PRINTFORMW 看起来之前没被这样表扬过，%CALLNAME:TARGET%红着脸，嘴角不由得放松了下来，开心地偷偷挠着脸颊
PRINTFORMW 「ほ、褒められるようなことしましたかね、わたし」	PRINTFORMW 「咿、我做了值得表扬的事吗？」
PRINTFORMW 「そ、そうですか」	PRINTFORMW 「诶、是这样吗？」
PRINTFORMW %CALLNAME:TARGET%はあまり気に留めていないふりをしたが、顔のほころびまでは隠せていない	PRINTFORMW %CALLNAME:TARGET%装作不太在意的样子，但还是掩饰不住脸上的笑容
PRINTFORMW 「そ、そういう不意打ちは、卑怯だと思いますよ！」	PRINTFORMW 「突、突然在说些什么啦、登徒子！色狼！坏人！卑鄙！呃、倒也不、不是讨厌啦…呜…」
PRINTFORMW 「む、む、本気なんだか本気じゃないんだか…」	PRINTFORMW 「呜……人家都不知道你到底是不是真心的了………」
PRINTFORMW 「悪魔祓いは銀の弾丸で悪魔を撃つ…」	PRINTFORMW 「驱魔人用银子弹击退恶魔…」
PRINTFORMW 「というのは銃火器がなんか凄いものだと思われていた時代のフカシであってですね」	PRINTFORMW 「那是一个人们认为枪炮很厉害的时代」
PRINTFORMW 「現代の悪魔祓いは中性子パルスエミッタか位相ディスラプター・ライフルを使って戦うわけです」	PRINTFORMW 「再这样下去、现代的驱魔人就应该用中子脉冲发射器或者带着相位指示器的步枪来战斗」
PRINTFORMW 「高プロトン伝導性ビームがダークマターと対消滅し、あっ、ぶたなくたっていいじゃないですかぁ」	PRINTFORMW 「通过高质子传导性光束与暗物质撞击产生湮灭来消灭恶魔……」
PRINTFORMW 「多くの文化圏において、悪魔は鉄と火に弱いとされています」	PRINTFORMW 「在很多文化圈里，恶魔容易受到铁和火的伤害」
PRINTFORMW 「鉄も火も古来から権威の象徴であったわけですが、これは偶然の一致ですからね」	PRINTFORMW 「嘛、不过钢铁和火焰自古以来都是权威的象征、这也算是偶然的一致吧」
PRINTFORMW 「数学のお勉強ですか、いいですよ、わたしが例題を出しましょう」	PRINTFORMW 「嗯？你要学数学么？呼呼，那我来出个题目考考你……」
PRINTFORMW 「あるプロテスタントの企業が不正に得た利益をxとして、この詐欺師共の株価をyとするとき…」	PRINTFORMW 「某个新教徒的企业以不正当所得的利益为x，以欺诈师们的股价为y时…」
PRINTFORMW 「この国では、たとえ悪魔を見つけてもおいそれとは手を出せないんですよね」	PRINTFORMW 「在这个国家，即使发现了恶魔也不能轻易出手」
PRINTFORMW 「色々あるんです、色々…」	PRINTFORMW 「有各种各样的，各种各样的…」
PRINTFORMW 「最近、この近辺がなんとかいうアニメの聖地になり、巡礼が絶えないとか」	PRINTFORMW 「最近，这附近竟然成了动漫圣地，朝圣不断」
PRINTFORMW 「この島国は無宗教の地と聞いていましたが、信心深い人もいる…世の中捨てたものではありません」	PRINTFORMW 「虽说这个岛国并没有什么正统的宗教，但也是有一些怀揣着信仰的人嘛、所以说世上还是有些东西是不能舍弃的呀。」
PRINTFORMW 「エクソシストが精神科医とソーシャルワーカーを兼ねていた時代がありました」	PRINTFORMW 「曾经有过驱魔师也兼职精神病医生和社会工作者的时代、」
PRINTFORMW 「古き良き時代です。現代人はなんでもかんでも心の病気扱いでかわいそうです」	PRINTFORMW 「真是古老而美好的时代啊……而现代人很多都怀有心理疾病，真是可怜……」
PRINTFORMW 「あー。これが下心から出たものでなければ…」	PRINTFORMW 「啊……如果是出于真心被人家迷住的话………」
PRINTFORMW 「勘ぐりはやめましょう、うん、うん」	PRINTFORMW 「嘛、还是不要太过猜测比较好……唔姆唔姆。」
PRINTFORMW 「どうかしましたか？　ふふ」	PRINTFORMW 「怎么了么？呼呼~」

//EVENT_K9_SHOP

PRINTFORML 「はい、ご用向きを伺いましょう」	PRINTFORML 「我来问一下您的去向」
PRINTFORML 「といっても、%CNAME("一人称")%のできる限りにおいてですが…」	PRINTFORML 「话虽这么说，但我会尽我所能……」
PRINTFORML 「ご入用は聖遺物ですか？　こちらの十字架はいかがです？　安心の国産です！」	PRINTFORML 「您需要圣遗物吗？要这十字架吗？放心的国产货！」
PRINTFORML 「ちりんとひとたび金貨が鳴れば、魂はたちまち天国へ…」	PRINTFORML 「一旦金币响起，灵魂就会立刻飞到天堂……」
PRINTFORML 「%CNAME("一人称")%たちはいついかなるときも、正しい人の味方です」	PRINTFORML 「%CNAME("一人称")%是正义的人伙伴」
PRINTFORML 「ちなみに誰が正しい人かは%CNAME("一人称")%たちが決めます」	PRINTFORML 「顺便说一下，%CNAME("一人称")%们决定谁是正义的人」
PRINTFORML 「ちぎったら増えるのは果たして魂と言えるんでしょうかね？　実はヒトデの腕では？」	PRINTFORML 「撕下的话就会增加，真的可以说是灵魂吗？其实是海星的手臂吗？」
PRINTFORML 「あんまり無茶なお願いは聞けませんよ？」	PRINTFORML 「不能提太过分的请求哟？」
PRINTFORMW 「……お気持ちは嬉しいのですが、%CNAME("一人称")%にも立場が…戒律に背くわけには……」	PRINTFORMW 「……虽然很开心，但是%CNAME("一人称")%也是有自己的立场……不能违背戒律……」
PRINTFORMW %CALLNAME:TARGET%はもごもごと言葉を濁す。	PRINTFORMW %CALLNAME:TARGET%吞吞吐吐地说。
PRINTFORMW 「……えっ？それでも…… %CNAME("一人称")%と付き合いたいのですか？」	PRINTFORMW 「……诶？是这样么……你想和%CNAME("一人称")%交往吗？」
PRINTFORMW どうしても、と頼み込まれるとここまでの事を思い返し、%CALLNAME:TARGET%も退くに退けなくなる。	PRINTFORMW 无论如何，都要拜托的话，回忆起至今为止的事情，%CALLNAME:TARGET%无法退缩。
PRINTFORMW 「……そういうことでしたら……喜んで」	PRINTFORMW 「……如果是这样的话……我愿意」
PRINTFORMW 「……私は悪魔祓いではありますが、誠心誠意あなたに仕えさせて頂きます」	PRINTFORMW 「……我虽然是驱魔人，但我会全心全意地侍奉你的」
PRINTFORMW 「…お気持ちは嬉しいのですが、%CNAME("一人称")%にも立場が…戒律に背くわけには…」	PRINTFORMW 「……我很开心，但是%CNAME("一人称")%也有立场……违背戒律的话……。」
PRINTFORMW %CALLNAME:TARGET%はもごもごと言葉を濁した	PRINTFORMW %CALLNAME:TARGET%吞吞吐吐地推辞掉了。
PRINTFORMW 「あ、魂を納めてくださるんですね！　大変結構なことです」	PRINTFORMW 「啊，您要把灵魂纳过来啊！真是太好了」
PRINTFORMW 「では対価となるお金を…はっ？　お金はいらないから、今履いているパンツが欲しい…？」	PRINTFORMW 「那么作为代价的钱是多少…啊？我不想要钱，所以想要你现在穿的胖次…？」
PRINTFORMW %CALLNAME:TARGET%は呆れてものも言えない様子だったが、%CALLNAME:MASTER%が席を立とうとすると慌ててすがりついた	PRINTFORMW %CALLNAME:TARGET%吃惊得说不出话呆呆的站在那，但当%CALLNAME:MASTER%想要离开时，她慌忙紧紧的抱住了你。
PRINTFORMW 「わ、わ、わかりました！　お渡しします、お渡ししますから！」	PRINTFORMW 「我、我、我明白了！我给你，我给你！」
PRINTFORMW %CALLNAME:MASTER%がここで脱ぐようにと命令すると、彼女は目に涙を浮かべながらスカートをたくしあげた	PRINTFORMW %CALLNAME:MASTER%命令她在这里脱掉，她一边流着泪一边举起了裙子
PRINTFORMW 「うう、これも%CNAME("二人称")%の魂の救済のため、魂の救済のため…」	PRINTFORMW 「呜呜，这也是为了拯救%CNAME("二人称")%的灵魂，为了灵魂的救赎…」
PRINTFORMW 「ええー…またですか」	PRINTFORMW 「啊啊啊…又来了吗？」
PRINTFORMW どん引きしながらも同意した%CALLNAME:TARGET%だったが、その手の動きはたどたどしい	PRINTFORMW 虽然同意了%CALLNAME:TARGET%的请求，但是那只手的动作很笨拙。
PRINTFORMW 「もう…もう！　何がいいんですか、こんなの！」	PRINTFORMW 「够了……够了！这样好吗？」
PRINTFORMW 「…や、あのメイドさんに頼めばいーじゃないですか」	PRINTFORMW 「……呀，拜托那个女仆桑不就行了吗？」
PRINTFORMW 「きっと喜んで作ってくれると思うんですけど」	PRINTFORMW 「我想她一定会很高兴为你做的」
PRINTFORMW 「またお弁当を作って欲しい…ですか。ふむ、悪い気はしませんね！」	PRINTFORMW 「还想让你帮我做便当……嗯，我也没觉得不好啊！」
PRINTFORMW 「あれから%CNAME("一人称")%も頑張って腕を上げましたし！　おっと、こっちの話ですよ、ふ、ふ、ふ」	PRINTFORMW 「从那以后%CNAME("一人称")%也努力提高了手艺！哦，这是我说的，呵呵，呵呵。」
PRINTFORMW 「朝夜だけでなく昼も、%CNAME("一人称")%の作った料理が食べたいと」	PRINTFORMW 「不只是早上晚上，中午也想吃%CNAME("一人称")%做的料理。」
PRINTFORMW 「それ、遠回しな愛の告白ですかね？　…こほん」	PRINTFORMW 「那是委婉的爱的告白吧？这本书」
PRINTFORMW 「いいですよ。食べてくれる人がいるほうが、張り合いがあるというものです」	PRINTFORMW 「没关系。有吃的话，人会更有干劲」
PRINTFORMW 「わ、わかりました、わかりましたって！　でも味の期待はしないでくださいよ！」	PRINTFORMW 「我明白了！但是请不要期待味道哦！」
PRINTFORMW 「……まさか、忘れていません？」	PRINTFORMW 「……难道忘记了吗？」
PRINTFORMW 「仮にも%CNAME("一人称")%、聖職者ですよ？」	PRINTFORMW 「就算是%CNAME("一人称")%，也是圣职者哦？」
PRINTFORMW 「どうしてそんなふしだらなモノを%CNAME("一人称")%の身体に貼り付けなきゃならないんですか」	PRINTFORMW 「为什么一定要把这种不检点的东西贴在%CNAME("一人称")%的身上呢？」
PRINTFORMW 「え、だめです」	PRINTFORMW 「嗯，不行哦」
PRINTFORMW 「これ以上魂を削ったら本当に死んじゃいますよ」	PRINTFORMW 「如果再削减灵魂的话，真的会死的」
PRINTFORMW 「あ、はい。%CNAME("一人称")%の活動費からいくらか、出しときますね」	PRINTFORMW 「啊，是。从%CNAME("一人称")%的活动经费中拿出多少呢」
PRINTFORML キャバァーン！	PRINTFORML 喀嘣！
PRINTFORMW 某国の隠し口座から%CALLNAME:MASTER%の口座にお金が振り込まれた	PRINTFORMW 从某国的隐藏户头把钱汇到了%CALLNAME:MASTER%的户头上
PRINTFORMW 「時勢の流れでうちの教区も稟議書が電子決裁になったんですけど」	PRINTFORMW 「随着时代的进步，我们教区的请示书也变成了电子审批。」
PRINTFORMW 「スマホからグループウェアにログインできないので、どうも使い勝手が…」	PRINTFORMW 「但我无法用手机登录群服，实在是太麻烦了…」
PRINTFORMW %CALLNAME:TARGET%は領収書を書きながらぼやいている	PRINTFORMW %CALLNAME:TARGET%一边写着收据一边发牢骚。
PRINTFORMW 「悪魔に負けない力が欲しいと」	PRINTFORMW 「想要不输给恶魔的力量？」
PRINTFORMW 「ならばわたしたちの出番ですね！」	PRINTFORMW 「那么轮到我们出场了！」
PRINTFORMW 「教皇庁驚異の人体改造術をお目にかけましょう…ふ、ふ、ふ」	PRINTFORMW 「让我们来见识教皇厅神奇的人体改造术吧…呼、呼、呼」
PRINTFORMW 「期待してますからね、いっぱい子供つくりましょうね、%CNAME("二人称")%」	PRINTFORMW 「我很期待，让我生很多孩子吧，%CNAME("二人称")%」
PRINTFORMW 「シスターが身籠るというのはそういうことですからね…ふふ、逃しませんよ、%CNAME("二人称")%？」	PRINTFORMW 「因为修女的身体是这样的…呵呵，我不会放过你的，%CNAME("二人称")%？」
PRINTFORMW 「それは…つまり…そういうことなんですよね…」	PRINTFORMW 「那是……。也就是说…就是这么回事吧…」
PRINTFORMW 「%CNAME("一人称")%に子供を産んで欲しい…んですよね…」	PRINTFORMW 「希望%CNAME("一人称")%生孩子…是吧…」
PRINTFORMW 「子作りしてしまったら、もう取引じゃなくてただのセックスになるわけですが…」	PRINTFORMW 「如果生了孩子的话，就不是交易了，只是单纯的性交了……」
PRINTFORMW 「いいですよ…%CNAME("一人称")%も%CNAME("二人称")%の赤ちゃん…欲しいです…」	PRINTFORMW 「可以啊…%CNAME("一人称")%想要%CNAME("二人称")%的小宝宝…我想要…」
PRINTFORMW 「…いくらあなたのお願いでも、それは聞けません」	PRINTFORMW 「……不管你怎么恳求，我也不能答应」
PRINTFORMW 「いいですか、子作りというのは神聖なものであり…愛し合う男女に対する神の恩寵の…」	PRINTFORMW 「知道吗，生孩子是神圣的…是神对相爱男女的恩宠……」
PRINTFORMW 「あっ、逃げようとするんじゃありません！」	PRINTFORMW 「啊，不要试图逃跑!！」
PRINTFORMW 「さすがに、それは…」	PRINTFORMW 「果然，那是…」

//EVENT_K9_パラチネ

某世界三大宗教の修道女、所謂シスターであり悪魔祓い	某个世界中三大宗教之一的修道女，也就是所谓[修女]的驱魔人
ただし様々な事情により、この地では悪魔と悪魔祓いが表立って争うことはない	但是由于种种原因，那块土地上的恶魔与驱魔人并没有什么明面上的争斗
PRINTFORMW 「悪魔を引き寄せる体質でお困りとか」	PRINTFORMW 「一直因为吸引恶魔的体质而困扰……么」
PRINTFORMW 「教皇庁があなたに保護を提供しましょう。これでもわたし、悪魔祓いなんです！」	PRINTFORMW 「就由教皇庁的我来保護你吧。别看这样、我好歹也是一位正牌的驱魔人的！」
PRINTFORMW ひとり部室で昼寝をしていたあなたは、こつこつと扉を控えめに叩く音で起こされた。	PRINTFORMW 就当自己在部室午睡的时候，咔哒咔哒地响起了敲门的声音。
PRINTFORMW 扉を開けたとき、あなたの眼の前には……シスター服に身を包んだ西洋人の少女がいた	PRINTFORMW 打开门后，出现在你面前的，是一位身着修女服的西洋少女。
PRINTFORMW 「こんにちは、突然ですがわたしはあなたの魂の救いのため……」	PRINTFORMW 「午安，虽然很突然，但是，我想要救助您的灵魂……」
PRINTFORMW 間に合ってます	PRINTFORMW 「不好意思，谢绝宗教劝诱」说着，门就被关上了……
PRINTFORMW 「あ、あ、誤解です、閉めないで！　わたしはそういう、あれ的なあれではなくてですね！」	PRINTFORMW 「啊、等等！您误解了！我、我不是那个意思！请相信我！」
PRINTFORMW あれ的なあれではないらしい	PRINTFORMW ……就算是劝诱，做的未免太敬业了一点，至少先听听她说的是什么，加上她也的确很可爱。
PRINTFORMW 「……そう、そうです。わたしがお話したいのはあなたの"再生する魂"について」	PRINTFORMW 「咳……是、是这样的，我想和您说的，是关于您的"再生之魂"的事情」
PRINTFORMW 「また、その能力のゆえに、あなたの魂が悪魔に狙われる可能性があることについてです」	PRINTFORMW 「虽然不知道您是否了解您的这一体质，但是，您的灵魂很有可能会被恶魔所盯上！」
PRINTFORMW 「えっと、申し遅れましたが、わたしはエティエンヌ・%NAME:ARG%といいます」	PRINTFORMW 「啊、非常抱歉现在才自我介绍、我叫埃蒂安娜 %NAME:ARG%」
PRINTFORMW 「あなたとあなたの魂を悪魔からお守りするよう、猊下から遣わされた教皇庁の悪魔祓いです」	PRINTFORMW 「为了保护您和您的灵魂不受恶魔所蛊惑，而从教皇厅派遣来的驱魔人」
PRINTFORMW 「今後はわたしがあなたの身辺を護衛します。あ、いや、あなたが望む限りにおいてですが」	PRINTFORMW 「从今往后，就由我来承担您的贴身护卫一职。啊、呃……是、根据您希望范围内的……恩。」
PRINTFORMW 自分が望む限りにおいて……か。	PRINTFORMW 如我所愿范围内的……么。
PRINTFORMW なんだか所々甘い、というか、隙だらけのように見えるが、	PRINTFORMW 脸上写满了天真……不如说，明明是驱魔人却满是破绽未免有些微妙
PRINTFORMW 他の部員が軒並み姿を消している点、彼女は本物の悪魔祓いなのだろう	PRINTFORMW 不过……其余部员现在都没有出现，说不定的确是因为她这驱魔人的身份才躲起来的？
PRINTFORMW それに、聖職者の衣装を着ているせいで堅い雰囲気があるが、	PRINTFORMW 而且，虽然满是破绽，但是因为那一身圣职者的服装，的确很有一种圣洁的气氛。
PRINTFORMW よくみると柔和な顔立ちとくるくると動く表情が印象的な、中々の美少女だ	PRINTFORMW 再仔细看下去，亲和而温柔的容貌，以及那活泼灵动的表情的确很能给人留下美好的印象，加上的确是一名美少女
PRINTFORMW 「ふ、ふ、その顔は同意と見てよろしいですね？　それでは……」	PRINTFORMW 「啊、恩……那副表情，我可以当做是同意了么？那么……」
PRINTFORMW %CALLNAME:ARG%が勢いよくシスター服を脱いだ。彼女は折り目もあざやかな、新品のセーラー服を着ていた	PRINTFORMW %CALLNAME:ARG%气势满满地脱下了修女装。修女服下的，是一件新颖而整洁的水手服
PRINTFORMW 「敵を騙すにはまず味方から……ってやつです！　同級生ということで、よろしくお願いしますね！」	PRINTFORMW 「呼呼，要欺骗敌人，首先要欺骗友军……如此，我们今天就是同学啦，请多多关照！」
PRINTFORMW %CALLNAME:ARG%があなたのクラブ活動に加わった	PRINTFORMW %CALLNAME:ARG%加入了你的社团活动
PRINTFORMW 「というわけで、来るべき人類と悪魔との戦いにおいて」	PRINTFORMW 「因此，在即将到来的人类与恶魔的战斗中」
PRINTFORMW 「あなたが……というか、無尽蔵に放出されるあなたの魂が……」	PRINTFORMW 「您……或者说，可以被无穷无尽释放的您的灵魂……」
PRINTFORMW 「悪魔の手に抑えられてしまえば、戦局は極めて人類に不利なものとなるわけです」	PRINTFORMW 「若是被恶魔之手所控制，那么战局就会极度不利于人类」
PRINTFORMW 「むろんこれは人と神に対する反逆であり、死後に極めて重い罰が下ることは疑いありません」	PRINTFORMW 「当然，这是人对神明的背叛行为，死后一定会受到极重的惩罚吧」
PRINTFORMW 「そこであなたの魂が適切なときに、適切な方向へ行くように」	PRINTFORMW 「所以，我需要指引您的灵魂在恰当的时候，向着恰当的方向前进……」
PRINTFORMW 「このわたし、エティエンヌ・%NAME:TARGET%が猊下から遣わされた次第です」	PRINTFORMW 「这就是我，埃蒂安娜 %NAME:TARGET%被派遣而来的使命」
PRINTFORMW 「む、さてはわたしの実力を疑っていますね？　これでもそれなりに腕っぷしは……え、違う？」	PRINTFORMW 「唔姆、您的表情，这是在质疑我的实力对么？　那就给您看看……诶？不对？」
PRINTFORMW 「えええええっ！？　もう渡しちゃったんですか、魂！？」	PRINTFORMW 「哎哎哎哎哎哎哎哎哎哎！？　居，居然已经把魂交易出去过了么！？」
PRINTFORMW 「なんで？！　性欲に負けて！？　魂ってそんな簡単に売っちゃっていいんですか！？」	PRINTFORMW 「为什么？！　是因为输给了性欲么！？　灵魂是可以那么简单卖掉的东西吗！？」
PRINTFORMW 「……むう……契約を結んでしまった以上、こちらから手出しはできませんし……」	PRINTFORMW 「……啧……既然已经和那边缔结了契约，那我们这边就不能多加插手……」
PRINTFORMW 「……いっそ……」	PRINTFORMW 「……索性……」
PRINTFORMW %CALLNAME:TARGET%はしばし額を抑えていたが、やがて居住まいを正してあなたに向き直った	PRINTFORMW %CALLNAME:TARGET%苦恼地揉了揉太阳穴，但是还是真诚地凝视着你
PRINTFORMW 「ひとつ提案があります。あなたの魂の幾分かを、わたしたち教皇庁に提供していただきたい」	PRINTFORMW 「我有一个不情之请，请您将您的一部分灵魂，提供给吾等教皇厅！」
PRINTFORMW 「それが人類のためであり……あなた自身の、魂の救済にいたる道です」	PRINTFORMW 「这，也是为了人类，也是您，救赎您自身的灵魂之道」
PRINTFORMW 「もちろん、対価はお支払いします。必要とあらば……」	PRINTFORMW 「当，当然了！我也会支、支付代价的……如果您需要的话……」
PRINTFORMW 「わたしの身体を使っても、構いません」	PRINTFORMW 「需要发泄性欲的话……请不要以灵魂为代价喂养那些恶魔，使、使用人家的身体也、也没关系……哦……」
PRINTFORMW 魂を代価に、%CALLNAME:TARGET%と取引が可能です	PRINTFORMW 以提供灵魂给教皇厅为代价，可以调教%CALLNAME:TARGET%了
PRINTFORMW 「こういうことをして戒律に違反しないのか……ですって？」	PRINTFORMW 「你说这样做不违反戒律吗?……是吗？」
PRINTFORMW 「ははぁん。さては%CALLNAME:TARGET%の教義を知りたいのですね？」	PRINTFORMW 「哈哈。那么你想知道%CALLNAME:TARGET%的教义吗？」
PRINTFORMW 「いいですか？むやみやたらに快楽を追求したり、子供を作ることが目的ではなければ、性行為ではありません」	PRINTFORMW 「可以吗？如果不是为了追求快乐，或是为了生孩子的话，就不算是性行为」
PRINTFORMW 「だから問題ないのです」	PRINTFORMW 「所以没问题」
PRINTFORMW 「……なんです、そんなじーっと見ないで下さい」	PRINTFORMW 「……什么嘛，请不要一直盯着我看」
PRINTFORMW 「……何度も言いますけどこれは教義に基づいて認められてるから大丈夫なんですよ」	PRINTFORMW 「……我已经说过很多次了，这是根据教义被认可的，所以没关系的」
PRINTFORMW 「何度かこうして、%CNAME("二人称")%の裸体を見てきましたが……」	PRINTFORMW 「几次像这样，看到了%CNAME("二人称")%的裸体……」
PRINTFORMW 「見る度に新たな発見がありますね」	PRINTFORMW 「每次看都有新的发现呢」
PRINTFORMW 「……へ？戒律はどうした……って？」	PRINTFORMW 「……啊?戒律怎么了……是吗？」
PRINTFORMW 「……何度も言いますけどこれは教義に基づいて認められてるから大丈夫なんです」	PRINTFORMW 「……我说过很多次，这是根据教义被认可的，所以没关系」
PRINTFORMW 「……大丈夫なんですってば」	PRINTFORMW 「……虽然是没有问题的话」
PRINTFORMW 「%CNAME("二人称")%から見て、%CNAME("一人称")%はどういう女に見えますか？」	PRINTFORMW 「在%CNAME("二人称")%看来，%CNAME("一人称")%是个什么样的女人？」
PRINTFORMW 「あんまり、取引相手をよこしまな目で見ちゃいけませんよ」	PRINTFORMW 「不要用邪恶的眼光看交易对象哦」
PRINTFORMW 「……%CNAME("二人称")%と取引するのは、あのメイドだけじゃないんですから」	PRINTFORMW 「……和%CNAME("二人称")%进行交易的，不仅仅是那个女仆」
PRINTFORMW %CALLNAME:TARGET%は自分の痴態が今更恥ずかしくなったようで、枕に顔をうずめて脚をばたばたしていた。	PRINTFORMW %CALLNAME:TARGET%现在似乎对自己的痴态感到羞耻，把脸埋在枕头里吧嗒吧嗒地跺着脚。。
PRINTFORMW そこへガチャリ、とドアの音がすると共に、%CALLNAME:MASTER%が入ってきた。	PRINTFORMW "咔嚓"的一声，伴随着门的声音，%CALLNAME:MASTER%进来了。
PRINTFORMW %CALLNAME:TARGET%は気まずそうだがなにやらモノ言いたげに%CALLNAME:MASTER%の方を見ている。	PRINTFORMW %CALLNAME:TARGET%看起来很尴尬，但好像在说什么似的看着%CALLNAME:MASTER%。
PRINTFORMW 「戒律とか、教義とか……そういうルールばっかり今までいっぱい言ってきましたけど……」	PRINTFORMW 「戒律啊、教义啊……一直以来都是这么说着规则……」
PRINTFORMW 「この気持ちを今まで感じた事がなくて……」	PRINTFORMW 「从来没有感受过这种心情……」
PRINTFORMW 「自分の中で感覚としてわかっていても、どう言葉にしたら良いのかわからないんです」	PRINTFORMW 「即使我知道这是我的一种感觉，也不知道该怎么说才好」
PRINTFORMW 「だから、この気持ちを言葉にするための答えを」	PRINTFORMW 「所以，为了搞清楚心中的这份疑惑」
PRINTFORMW 「あなたと交わる事で教えて下さい」	PRINTFORMW 「请与我交合吧」
PRINTFORMW 「……始めましょうか」	PRINTFORMW 「开始了……么。」
PRINTFORMW 「%CNAME("二人称")%の魂が悪魔に奪われるのを、黙って見ているわけにはいきません」	PRINTFORMW 「我可不能就这样看着……%CNAME("二人称")%的灵魂就这样被那些恶魔所玩弄。」
PRINTFORMW 「こういうことをして戒律に違反しないのか、ですか」	PRINTFORMW 「可能，这种行为是违反了戒律……但是！」
PRINTFORMW 「快楽を追求したり、子供を作ることが目的ではなければ、性行為ではありません」	PRINTFORMW 「只追求快乐，但并非为了生育孩子的行为，并不足以称为性行为……」
PRINTFORMW 「そう、だから教義的には問題ありません、ふふ」	PRINTFORMW 「所以，于情于理都没有问题，呼呼~❤」
PRINTFORMW 「何度かこうして、%CNAME("二人称")%の裸体を見てきましたが」	PRINTFORMW 「%CNAME("二人称")%的身体……就这样见了好多次呢……」
PRINTFORMW 「見る度に新たな発見がありますね。ほら、こことか、こことか」	PRINTFORMW 「不过，每次看都会有些新的发现~你看，比如这里，还有这里~」%CALLNAME:TARGET%的可爱脸颊就这样蹭着你的胸膛，用指尖在你的身体上轻轻绕圈着。
PRINTFORMW 「%CNAME("二人称")%から見て、%CNAME("一人称")%はどういう女ですかね？」	PRINTFORMW 「在%CNAME("二人称")%的眼中……%CNAME("一人称")%是一个怎么样的女孩呢？」
PRINTFORMW 「可愛いですか？　魅力的ですか？　抱きたくなりますか？」	PRINTFORMW 「可爱么？对%CNAME("二人称")%而言有魅力么？会在没有交易的情况下想、想要抱人家么……？」
PRINTFORMW 「ふふ……取引相手をよこしまな目で見ちゃいけませんよ」	PRINTFORMW 「呼呼……不能用不纯洁的眼光看交易对象哦……」刚刚一瞬间的小女孩神色如同幻觉一般，只不过最后一句话，到底是说给谁听的呢……
PRINTFORMW 「こ、こんなの無理です、人の身ではとうてい、堪えきれ、っ……」	PRINTFORMW 「这、这么蛮横……人类真的能承受的住的么……」
PRINTFORMW 「……もうよろしいのですか？」	PRINTFORMW 「……已经，满足了么？」
PRINTFORMW 「では、着替えますので……あの……あちらを向いていただけると」	PRINTFORMW 「那么，我要换衣服了……那个……请面向那边」
PRINTFORMW 「あう……うー……うー……！」	PRINTFORMW 「啊呜……姆姆姆……呜！」
PRINTFORMW %CALLNAME:TARGET%は先程までの自分の痴態が今更恥ずかしくなったようで、	PRINTFORMW %CALLNAME:TARGET%想到了自己之前的痴态，把自己羞红的脸埋在了枕头上，粉嫩的小脚发泄一般把周围蹬的乱七八糟
PRINTFORMW 枕に顔をうずめて脚をばたばたしていた。	PRINTFORMW 但是还是用一只手牵着你，十指相扣。
PRINTFORMW 「よくないと思うんですけどね、こういうの」	PRINTFORMW 「这种的……我……觉得不太好哦」
PRINTFORMW %CALLNAME:TARGET%は泣くとも笑うともつかない、伏し目がちな表情で自らの身体を撫でていた。	PRINTFORMW %CALLNAME:TARGET%鼓着脸轻抚着自己绯红的身子，脱力地枕在你的身边，似是撒娇一般小口轻咬了一下你。
PRINTFORMW 「よくないと思うんですけど」	PRINTFORMW 随后又怜爱地伸出粉舌轻轻舔舐着你身上小巧的咬痕
PRINTFORMW 「うっ……触るんですね……」	PRINTFORMW 「呜……爱抚么……」
PRINTFORMW 「もっと力を抜けって……気軽に言わないでくださいよ、もう……」	PRINTFORMW 「再放松一点吧……别，别说人家随便啦！真是的……」
PRINTFORMW 「うぁ……なんでそんな……這い回るみたいに触るんですか……」	PRINTFORMW 「哎……%CNAME("二人称")%的手，好……不，没，没什么！」
PRINTFORMW 「ん……こういうのって、みんな声が出るものなん、ですか、ね？」	PRINTFORMW 「呜……这样的话，声音……」%CALLNAME:TARGET%把手按在嘴边忍耐着呻吟，面色潮红地享受着你的爱抚。
PRINTFORMW 「み、見られたことも触られたこともなかったのに……」	PRINTFORMW 「明、明明都没有被人看过……更不用提摸过的……」
PRINTFORMW 「まして舌で舐められるなんて想像も、ひあっ！」	PRINTFORMW 「用舌头舔舐那边什么的……想象也，唔嗯~❤」
PRINTFORMW 「馬鹿じゃないですか、ばかじゃないですか」	PRINTFORMW 「你是笨蛋么……大笨蛋……」
PRINTFORMW 「こ、こんなことしてなにがいいんですか、まったく……」	PRINTFORMW 「这、这样做到底哪里好了……真是的……」
PRINTFORMW 「よ、よくないと思います、こういうのは！」	PRINTFORMW 「这、这种行为，我觉得不，不太好，恩！」
PRINTFORMW 舌を陰部に押し付けられながら、%CALLNAME:TARGET%は%CALLNAME:PLAYER%の頭部を弱々しく叩いた	PRINTFORMW 舌头在舔舐私处的同时、%CALLNAME:TARGET%轻轻用大腿夹了一下%CALLNAME:PLAYER%的脸颊。
PRINTFORMW 「ちょ、ちょっと……そこは魂の授受とは関係がな……」	PRINTFORMW 「等、等一下，哪里和灵魂的出入没有关系……」
PRINTFORMW 「か、関係があるとしたら、なおさら問題じゃないですかぁー！」	PRINTFORMW 「要是有关系的话，那问题不是更严重了me啊啊！」
PRINTFORMW 「やぁ……こんなの、変態じゃないですか……」	PRINTFORMW 「呜……这样……不完全就是变态了么……」
PRINTFORMW 「は……？してみせろ、って、ここで、ですか？」	PRINTFORMW 「哈……？！让你看自，自……在这里？！现在？！」
PRINTFORMW 「やり方が分からないなら教えても良い、って……結構です！……ぐすっ」	PRINTFORMW 「如果不知道怎么做可以教wo……不，不用了……我做！我现在就做啦！」
PRINTFORMW 「うう、%CNAME("二人称")%の馬鹿、けだもの、野蛮人……」	PRINTFORMW 「呜呜、%CNAME("二人称")%你这大笨蛋、性欲野兽、最喜欢了、野蛮人……」
PRINTFORMW 「ううん……%CNAME("一人称")%の胸とかいじって楽しいんですかね……？」	PRINTFORMW 「呜嗯……玩弄%CNAME("一人称")%的胸就这么开心么……？」
PRINTFORMW 「や、楽しけりゃいいって問題でも……ひゃあああ！？」	PRINTFORMW 「啊不……如果不开心的话那问题就……呀啊！？」
PRINTFORMW 「よ、欲求不満なんですか、%CNAME("二人称")%……」	PRINTFORMW 「哼、是、是欲求不满吗？%CNAME("二人称")%……」
PRINTFORMW 「な、なんだかあれですね、凄いえっちなことしてる気分になります、ね？」	PRINTFORMW 「呐、总感觉那个……变成了非常色色的事情了……吧？」
PRINTFORMW %CALLNAME:TARGET%は身を震わせながら呟いた	PRINTFORMW %CALLNAME:TARGET%被情欲侵染的身体微微颤抖着小声咕哝。
PRINTFORMW 「キス……するんですか？」	PRINTFORMW 「是要……KISS么？」
PRINTFORMW 「いえ、構いません、それが魂の授受に必要なら」	PRINTFORMW 「啊、不、没关系、这也是灵魂交易的必要条件……」
PRINTFORMW 「ん……」	PRINTFORMW 「嗯……」
PRINTFORMW 「案外、あっさりした感じなんですね……」	PRINTFORMW 「意外的……感觉挺舒……呃不、清爽的呢、恩。」
PRINTFORMW 「うん……ん……はぁ……」	PRINTFORMW 「唔嗯~❤哈~~啾~」
PRINTFORMW 「あ、う」	PRINTFORMW 「啊、呃……」
PRINTFORMW 「だ、大丈夫です、きっと。でもちょっと怖い、ですね」	PRINTFORMW 「没、没关系的、恩！虽、虽然的确有点害怕……」
PRINTFORMW 「え、ちょっと、まさか……まさかとは思いますが……」	PRINTFORMW 「……哎？！等、等一下、难道、你想要」
PRINTFORMW 「わー！　どこ舐めてるんですか馬鹿、ばか、ば……うー……」	PRINTFORMW 「唔哎~！你，你到底在舔哪里啊！笨蛋笨蛋大笨蛋……呜……」
PRINTFORMW 「そ、そうやって、舌を抜き差しするのやめてもらえませんかね！？」	PRINTFORMW 「那、那就这样把舌头拔出来吧……？」
PRINTFORMW 「い、挿入れるのですね？」	PRINTFORMW 「要……插入了……对吧？」
PRINTFORMW 「……思う所がないわけでは、ありませんが……」	PRINTFORMW 「……倒也不是没有想说的……」
PRINTFORMW 「これが運命であれば、%CNAME("二人称")%の魂の救いになるのであれば構いません」	PRINTFORMW 「如果这也是我的命运的话、那么能够拯救%CNAME("二人称")%的灵魂的话、乐意之极……」
PRINTFORMW %CALLNAME:TARGET%は意外なほどあっさりと、%CALLNAME:PLAYER%を受け入れた	PRINTFORMW %CALLNAME:TARGET%意外的十分坦率地接受%CALLNAME:PLAYER%的进入
PRINTFORMW 「思ったより、苦しくないものなのですね……」	PRINTFORMW 「倒是……没有想象中的那么疼……」
PRINTFORMW 「それとも、気を使ってくれたのですか？　なんて、ふ、ふ」	PRINTFORMW 「还是说、是您费心了、什么的、呼……呼……」
PRINTFORMW 「……この体勢って、なんか恥ずかしいですね？」	PRINTFORMW 「……这个体位……总感觉有点羞耻呢……」
PRINTFORMW 「あ、あなたがよくても、%CNAME("一人称")%が恥ずかしいんです、あっ……！」	PRINTFORMW 「不是、就算你没问题、%CNAME("一人称")%我也是会害羞的啦！」%CALLNAME:TARGET%闭上眼睛，小心地撑开一条缝偷偷看着你
PRINTFORMW 「……っ、あ……ふっ……」	PRINTFORMW 「……嘶……嗯~」
PRINTFORMW 「だ、大丈夫で……続けて、っ！」	PRINTFORMW 「没、没关系的，继续吧~？」
PRINTFORMW 「こ、こういうやり方は、良く、ないとっ！　思いますうっ！」	PRINTFORMW 「这、这个姿势、我觉得……不太好…！」
PRINTFORMW %CALLNAME:TARGET%は犯され方が気に食わないようだ	PRINTFORMW %CALLNAME:TARGET%似乎有些不喜欢这种被侵犯的感觉
PRINTFORMW 「な、ちょ、このような格好は……いけません、いけませんって！」	PRINTFORMW 「什、等、这、这种样子……不可以！不可以的……明明……」
PRINTFORMW 「手で、握ってほしいと……」	PRINTFORMW 「想要……用手握住么……」
PRINTFORMW 「そうですね、それが一番穏当なやり方でしょうし……」	PRINTFORMW 「是啊，那是最稳妥的做法吧……」
PRINTFORMW 「……な、なんですかその表情は！」	PRINTFORMW 「……干、干什么啦你那表情！！」
PRINTFORMW 「触る前に心の準備をする時間くらいくれたってよろしくないですか！」	PRINTFORMW 「在帮你……那个之前至少给人家一点时间做心里准备好么！」
PRINTFORMW %CALLNAME:TARGET%は頬を膨らませて怒るが、別に恐ろしいものでもなかった	PRINTFORMW %CALLNAME:TARGET%的小脸气鼓鼓地盯着你，但是反而感觉非常的可爱
PRINTFORMW 「こ、こんな感じですかね……」	PRINTFORMW 「是、是这样的感觉……对么？」
PRINTFORMW 「これは駄目？　これならいいと？　な、なんか注文が多くありません……？」	PRINTFORMW 「这里不行？那这里可以么……？呜……」
PRINTFORMW 「魂の授受には粘膜同士の接触が最も効率的、と……」	PRINTFORMW 「对于灵魂的交接……通过粘膜之间的接触是最有效率的……」
PRINTFORMW 「そうですね、性交よりはこちらの方が、%CNAME("一人称")%も気が楽で……んむっ！」	PRINTFORMW 「是、是了！通过性、性交的话，%CNAME("一人称")%这边也比较轻松……嗯嗯」
PRINTFORMW 「ぜ、前言撤回します、げほっ、げほっ」	PRINTFORMW 「咳……呃，现在撤回前言还来得及么？」
PRINTFORMW 「んん……相変わらず、見境のないおちんちんですね……」	PRINTFORMW 「唔嗯……还是往常一样……不听人话的鸡鸡~」
PRINTFORMW 「これを野放しにしてたら、誰彼見境なく種付けしてしまうに違いありません」	PRINTFORMW 「如果就这样放任不管的话，肯定会看见女孩子就会强行让她授种……」
PRINTFORMW 「……これ以上不幸な女の子が生まれないために、ここで処理しなければ……ちゅっ」	PRINTFORMW 「为了不能让那些不幸的女孩子增加，必须要在这里处理才行……啊~呜~❤……」
PRINTFORMW 「い、いいですか、じゅる、出すときは言うんですよ、ちゅく」	PRINTFORMW 「听、听好了哦、下次射出来的时候提前跟人家说一下哦……唔。」
PRINTFORMW 「そうすれば、いくらでも、ん……受け止めてあげます……」	PRINTFORMW 「这样的话、不管多少，人家都会……唔……都会接受的……」
PRINTFORMW 「ちゅ……ちゅ……まだ、出ませんか」	PRINTFORMW 「唔~啾~啊呜…………还，还没出来么？」
PRINTFORMW 「勘違いしないでくださいね……これは取引であり、%CNAME("二人称")%の魂の救済に必要なことなんです……」	PRINTFORMW 「请不要误会……这只是交易、是为了救赎%CNAME("二人称")%的灵魂的必要措施而已……」
PRINTFORMW 「じ、実際どうですか、気持ちいいもんなんですか、これ？」	PRINTFORMW 「感、感觉如何？虽然没有直接插入、但是、嗯~❤、意外的很有感觉」%CALLNAME:TARGET%肉肉的大腿根轻轻地摩擦着你的肉棒，小声地嗫嚅着
PRINTFORMW 「よっと」	PRINTFORMW 「嗳~咻……」
PRINTFORMW %CALLNAME:TARGET%が身を起こすと、軽々と%CALLNAME:PLAYER%の身体がベッドに叩きつけられた	PRINTFORMW %CALLNAME:TARGET%轻柔地抱住你的身体、娇小肉体紧贴着把%CALLNAME:PLAYER%给压倒到床上
PRINTFORMW 「ふ、ふ……%CNAME("一人称")%ばかり触られるってのはフェアじゃないですよね……」	PRINTFORMW 「呼呼~一直都只让%CNAME("一人称")%被欺负一点都不公平呐~」
PRINTFORMW 「んん？　ずいぶん簡単に転がってしまうんですね？」	PRINTFORMW 「呼嗯~与平时不同、倒是很容易推倒嘛……」
PRINTFORMW 「生身の人間の女の子ですよ、%CNAME("一人称")%は」	PRINTFORMW 「%CNAME("一人称")%可是活生生的正常的人类女生哦」
PRINTFORMW 「まさかとは思いますが、こうなるのを……期待してたとか？」	PRINTFORMW 「呐~难道说您……在期待着被%CNAME("一人称")%玩弄么？」她的眼角微眯、愉快地用素指在你的胸口画圈
PRINTFORMW （……なんで？）	PRINTFORMW （……为什么？）
PRINTFORMW 「わ、わ……脚にかかってしまいましたね……」	PRINTFORMW 「啊呜……脚上黏糊糊的……」她白嫩的小脚上沾满了你的精液
PRINTFORMW 「……ん、出たんですね」	PRINTFORMW 「……嗯~出来了呐……」
PRINTFORMW 「良いものなんでしょうかね？　んん、よくわかりません」	PRINTFORMW 「为什么会喜欢这种……呜……不明白……」
PRINTFORMW 「！　……ぐ、んぐっ……うううー！」	PRINTFORMW 「！咕……唔……唔嗯！~~」
PRINTFORMW %CALLNAME:TARGET%は涙目になりながらも、%CALLNAME:PLAYER%の精液を口で受け止めた。	PRINTFORMW %CALLNAME:TARGET%虽然眼泪汪汪的、但是还是把%CALLNAME:PLAYER%射出的精液乖乖地吞进小嘴里。
PRINTFORMW 「……なんですか。魂は大事なものであり、床にこぼしていいものではありません」	PRINTFORMW 「干、干什么嘛……灵魂可是非常重要的东西，如果洒在床上不是浪费了么……」
PRINTFORMW 「だから、飲みました。文句ありますか」	PRINTFORMW 「所以才勉为其难地喝了的哦、别搞错了、你有什么意见么？！」
PRINTFORMW 「ちゅる……出し方にも色々ありますが……わたしはこれが一番好き、ですね」	PRINTFORMW 「咕……阿~姆~❤……虽然……各个地方都被您使用过了……但是果然还是喜欢这样~」
PRINTFORMW 「だって、楽しいじゃないですか、ふ、ふ、ふ」	PRINTFORMW 她漂亮的眼睛眯成一条线，如同小猫一般轻轻蹭着你
PRINTFORMW 「！　……ぐ、ふっ……だから、出すなら出すって言って下さい」	PRINTFORMW 「！ 咕……都说了、要射出来的时候请先说一下啦！」
PRINTFORMW 「っ……！」	PRINTFORMW 「嘶……！」
PRINTFORMW 「はぁ、はぁ、出たんですね……魂が……」	PRINTFORMW 「哈……哈……就这样把您的灵魂……在我的身体内释放吧~…」
PRINTFORMW 「……避妊具をつけなくてよかったのか、ですか？　今更それを言うあなたはひどい人ですね……」	PRINTFORMW 「[……不用避孕物品真的没问题么？]　事到如今才说这话……您真是鬼畜的坏人呐……」
PRINTFORMW 「さ、続けましょう……できますよね、もう一度くらいは」	PRINTFORMW 「那么，继续……可以吧~？再来一次~」
PRINTFORMW 「ふぁっ……いいです、よ……膣内に出して、くだ、あっ、～～っ」	PRINTFORMW 「呼嗯~……可以，哦……就这样在人家的里面射出来、啊～～」
PRINTFORMW %CALLNAME:TARGET%の小柄な身体がひとりでに跳ね、射精を促すのに応えて、	PRINTFORMW %CALLNAME:TARGET%幼小的身体微微颤抖着，蜜穴紧紧地包裹着肉棒，榨取着情欲
PRINTFORMW %CALLNAME:PLAYER%は彼女の最奥に精液を叩きつけた	PRINTFORMW %CALLNAME:PLAYER%在她的最深处射出了浓浓的精液。
PRINTFORMW 「……う、これはまた、いっぱい出しましたね……」	PRINTFORMW 「……唔……这样……射了好多啊……」
PRINTFORMW 熱にうなされたような顔で、%CALLNAME:TARGET%は%CALLNAME:PLAYER%の汗ばんだ耳元に口を近づけた。	PRINTFORMW 她恬淡的俏脸染上了一层绯红、%CALLNAME:TARGET%娇小的身体就这样温柔地挽住%CALLNAME:PLAYER%的脖子，伸出舌头温柔地咬着耳朵，媚音嗫嚅。
PRINTFORMW 「いいんです……あなたが満足するまで、出していいですよ……」	PRINTFORMW 「没关系哦……直到您满意为止……人家的身体任君采撷……」
PRINTFORMW 「……これはセックスじゃなくて……取引なんですから……」	PRINTFORMW 「……因为这可不是性交……只是交易而已……哦~❤」
PRINTFORMW 「く、苦しいです……そんなに抑えつけなくたって、逃げたりはしませんよ……」	PRINTFORMW 「嘶……呼……没、没事哦，不用这么紧紧抱着我、我也不会逃跑的……我还有救赎您的灵魂的使命呐……」
PRINTFORMW 「んん……あっ、でもっ……締め付けすぎて膣内で固まってしまうかもしれませんね、ふ、ふ、ふ……」	PRINTFORMW 「唔恩……不过……好、好大……小穴都被……玩坏了……、呼、呼、呼……」
PRINTFORMW 「……っ」	PRINTFORMW 「❤❤❤……嗯❤❤❤」
PRINTFORMW %CALLNAME:TARGET%は膣内に叩きつけられる精液の衝撃に、目を白黒させながら堪えている	PRINTFORMW %CALLNAME:TARGET%的小穴被浓厚的精液冲击着，一边翻着白眼高潮一边忍耐着
PRINTFORMW 「……素朴な疑問なんです、が……」	PRINTFORMW 「……那个、单纯的想问您一个问题啦……」
PRINTFORMW 「割と解剖学的法則を超越してませんかね、あなたの射精、は……」	PRINTFORMW 「您的射精的量……是不是超过解剖学的法则了……」
PRINTFORMW 「おつかれさまです……ふふ」	PRINTFORMW 「辛苦啦~呼呼」
PRINTFORMW 「あ、いや、可愛らしいなと思ったら、つい……」	PRINTFORMW 「啊、不、不是，只是感觉很可爱，情不自禁…」
PRINTFORMW 不良在庫の山を前に、%CALLNAME:PLAYER%と%CALLNAME:TARGET%は頭を抱えた…	PRINTFORMW 在堆积如山的不良库存面前，%CALLNAME:PLAYER%和%CALLNAME:TARGET%抱着头…

