//PRINTFORML - システムメッセージ -	PRINTFORML - 系统消息 -
PRINTFORML  既に%CALLNAME:ARG%を勧誘済みのセーブデータであるため、	PRINTFORML  因为%CALLNAME:ARG%是已被劝诱的存档数据，
PRINTFORMW  モードセレクトを呼び出します。	PRINTFORMW  调用模式选择。
PRINTFORMW 「忘れ物はない？じゃあまた後で、学校でね」	PRINTFORMW 「有没有忘记带的东西？再见哦，在学校等你」
PRINTFORMW 「今日は家でゆっくりしましょうか」	PRINTFORMW 「今天在家好好休息吧」
PRINTFORMW 「私たちが一番早かったみたい」	PRINTFORMW 「看样子我们是最早的呢」
PRINTFORMW 「せっかくだし…他の子たちが来るまで、何かする？」	PRINTFORMW 「真不容易啊，在其他孩子来之前做点什么吧？」
PRINTFORMW 「私たち以外は誰も居ないようね」	PRINTFORMW 「好像除了我们以外，其他人都不在呢」
PRINTFORMW 「午前中はお疲れ様、と言いたいところだけど」	PRINTFORMW 「虽然很想对你说：上午辛苦了」
PRINTFORMW 「……さっき授業中に居眠りしてたでしょう」	PRINTFORMW 「……但是刚才上课的时候打瞌睡了吧」
PRINTFORMW 「言っておくけど、全部バレてるからね？」	PRINTFORMW 「还是得说一句，都暴露了吧？」
PRINTFORMW 「午前中はお疲れ様」	PRINTFORMW 「上午辛苦了」
CALL PRINT_STR, "「もう、いつまでも甘えん坊さんなんだから_H_」 _W_"	CALL PRINT_STR, "「哎呀，永远都是个爱撒娇的小孩子呢_H_」 _W_"
PRINTFORMW 「はぁ…しょうがない子ねぇ」	PRINTFORMW 「哈……这孩子，真是没办法」
PRINTFORMW 「もう、馬鹿なこと言わないの」	PRINTFORMW 「喂，别再说这种傻话了」
PRINTFORMW 「……ほら、おいで？」	PRINTFORMW 「……喂，要来吗？」
PRINTFORM %TEXTR("重量感たっぷりの乳肉/はち切れんばかりの豊乳")%	PRINTFORM %TEXTR("重量感十足的乳肉/快要断奶的丰乳")%
PRINTFORM 硬く尖りはじめた乳首	PRINTFORM 刚开始变硬的乳头
PRINTFORM %TEXTR("形のよい乳房/撞きたての餅のような柔らかい乳房")%	PRINTFORM %TEXTR("形状姣好的乳房/仿佛年糕般柔软的乳房")%
PRINTFORMW の片方をまろびださせた…	PRINTFORMW 露了出来…
PRINTFORMW （やらしいとこ、ほんと親子でそっくりよね…）	PRINTFORMW （关于下流这点，父子俩还是真是一模一样…）
PRINTFORML 授乳経験＋１	PRINTFORML 哺乳经验＋１
PRINTFORMW 「お昼御飯はしっかり食べなきゃ駄目よ？」	PRINTFORMW 「不好好吃午饭是不行哦？」
PRINTFORMW 「他の先生が褒めてたわよ、その調子で頑張りなさい」	PRINTFORMW 「其他老师表扬你了，加油！」
PRINTFORMW 「…もうお昼なのね。時間が経つのが早いわ」	PRINTFORMW 「……已经是中午了啊。时间过得真快啊」
PRINTFORMW 「…他の子とは一緒じゃないのかしら？」	PRINTFORMW 「……是不是和其他的孩子一起呢？」
PRINTFORMW 「ただいまー」	PRINTFORMW 「我回来了」
PRINTFORMW 「今日は%CNAMET(ARG, "一人称")%がお夕飯作るけど…すぐ食べたい？後にする？」	PRINTFORMW 「今天%CNAMET(ARG, "一人称")%做做晚饭，想马上吃吗？还是等一等？」
PRINTFORMW 「はーぁ、今日も疲れたわー……」	PRINTFORMW 「啊，今天也很疲惫呢……」
PRINTFORM 「今日は早かったのね。	PRINTFORM 「今天真早啊。
PRINTFORM 「先に帰ってたのね。	PRINTFORM 「早点回去。
PRINTFORM 「先に帰ってたの？	PRINTFORM 「早点回去吧？
PRINTFORMW 買い物してきたんだけど、片付けてくれない？」	PRINTFORMW 买东西来了，可以帮我收拾一下吗？」
PRINTFORMW 晩御飯はもう食べちゃった？」	PRINTFORMW 晚饭已经吃过了吗？
PRINTFORMW 晩御飯まだでしょ？すぐ作るからね」	PRINTFORMW 还没吃晚饭吧？马上就做哦」
PRINTFORMW 「ほら、買い物してきたわよー。冷蔵庫にしまうの手伝ってー」	PRINTFORMW 「看，我买东西了，麻烦放到冰箱里哦」
PRINTFORMW 「またこんなに散らかして…ゲームする暇があったら片付けなさい」	PRINTFORMW 「又弄得这么乱……有空玩游戏的话，也适当收拾一下」
PRINTFORMW 「そんな嫌そうな顔しないの。…ハイは一回！」	PRINTFORMW 「别那么一脸嫌弃嘛，就一次！」
PRINTFORMW 「こらこら、だらしない恰好しない」	PRINTFORMW 「看你这邋邋遢遢，吊儿郎当的样子」
PRINTFORMW 「そんな姿を見られたら女の子に嫌われるわよー？」	PRINTFORMW 「这样子被女孩子看到，会被讨厌吧？」
PRINTFORMW 「あ、いま晩御飯できたところよ」	PRINTFORMW 「啊，刚吃完晚饭」
PRINTFORMW 「用意しておくから、着替えてらっしゃい」	PRINTFORMW 「我会准备好的，请换衣服吧」
PRINTFORMW 「今日は遅かったわね」	PRINTFORMW 「今天好晚啊」
PRINTFORMW 「あ、こら…買い食いは禁止でしょ！」	PRINTFORMW 「啊，这个……禁止买零食！」
PRINTFORMW 「しょうがないわね…見逃してあげるから、次は気を付けなさい」	PRINTFORMW 「真没办法啊……这次放过你好了，下不为例哦」
PRINTFORMW 「駄目ですぅ、これは没収♪」	PRINTFORMW 「不行啊，这个没收♪」
PRINTFORMW %CALLNAME:ARG%にお菓子を食べられてしまった……	PRINTFORMW 点心被%CALLNAME:ARG%吃掉了……
PRINTFORMW 「お夕飯できてるわよ。温め直しておくから、着替えてらっしゃい」	PRINTFORMW 「晚饭做好了哦。重新热一下，先换衣服吧。」
PRINTFORMW 「あら、%CNAMET(ARG, "対象")%と一緒だったの」	PRINTFORMW 「哎呀、和%CNAMET(ARG, "対象")%在一起」
PRINTFORMW 「せっかくだからお邪魔してるわ」	PRINTFORMW 「难得来一次，所以要打扰了哦」
PRINTFORMW 「…まあ、私も一応ここの顧問だし、ちゃんと顔を出さないとね」	PRINTFORMW 「……算了，我也算是这里的顾问，不好出面吧。」
PRINTFORMW 「こんにちは。仲良くやってるかしら？」	PRINTFORMW 「你好。有好好地相处吗？」
CALL PRINT_STR, @"「%TEXTR("あらあら……/まあまあ……")%%TEXTR("＿/うふふ/ふふっ")%」_W"	CALL PRINT_STR, @"「%TEXTR("哎呀……/好了好了……")%%TEXTR("＿/诶嘿嘿/呼呼")%」_W"
PRINTFORML 「学校ではお母さんじゃなくて、先生って呼ぶように気をつけるのよ？」	PRINTFORML 「学校里不可以叫妈妈，应该叫老师吧？」
PRINTFORML 「これからは部活の顧問も引きうけてあげるから、何でも困ったら相談しなさいね」	PRINTFORML 「今后我也会接受邀请成为社团活动的顾问，有什么困难的话请和我商量」
PRINTFORML 「学校ではお母さんじゃなくて、先生って呼びなさいね」	PRINTFORML 「在学校不要叫妈妈，叫老师吧」
PRINTFORML 汗だく	PRINTFORML 汗流浃背
PRINTFORML 寝起き	PRINTFORML 刚睡醒
PRINTFORML 「契約の範囲内だからお願いは叶えてあげるけど」	PRINTFORML 「在契约的范围内，我可以实现你的愿望」
PRINTFORML 「そんなに喜んでくれると、何だかこっちまで嬉しくなっちゃうわね」	PRINTFORML 「这么高兴吗，总觉得我也变得开心了呢」
PRINTFORML 「%CNAME("二人称")%ももう高校生なんだから」	PRINTFORML 「%CNAME("二人称")%已经是高中生了」
PRINTFORML 「%CNAME("一人称")%に頼ってばかりじゃダメよ？」	PRINTFORML 「不能总是依赖%CNAME("一人称")%吧？」
PRINTFORML 「…だーめ、魂はきっちり頂きます」	PRINTFORML 「……所以，好好承受灵魂的抽取吧」
PRINTFORML 「親子だからってズルは許さないんだから♪」	PRINTFORML 「这么狡猾，就算是母子关系也不能够原谅哦♪」
PRINTFORML 「ちゅっ……フフッ、ほら早く中に行きましょう」	PRINTFORML 「啾……呵呵，快点进来吧」
PRINTFORML 「いっぱいサービスしてあげるから楽しみにしてなさい♪」	PRINTFORML 「我会尽力为你服务的,请期待吧♪」
PRINTFORML （私、実の%CONDS("間柄", MASTER)%とこれからイケナイ事をするのね）	PRINTFORML （其实呢、要和%CONDS("間柄", MASTER)%做那种事情呢）
PRINTFORML （そう思ったら濡れてきちゃったわ……）	PRINTFORML （光是这么想着就已经湿了……）
PRINTFORML 「今だけは母親じゃなくて、%CNAME("二人称")%の恋人よ」	PRINTFORML 「现在不是母亲，是%CNAME("二人称")%的恋人哦」
PRINTFORML 「他のことは忘れて、いっぱい愛し合いましょうね」	PRINTFORML 「忘掉其他的事情，好好相爱吧」
PRINTFORML 「誰かに見られたら困るから、早く中に入りましょう」	PRINTFORML 「要是被谁看见了就麻烦了，快进来吧」
PRINTFORML 「%CONDS("間柄", MASTER)%に誘われて、こんな所に来ちゃうなんて］	PRINTFORML 「因为被%CONDS("間柄", MASTER)%诱惑，所以来到了这种地方］
PRINTFORML 「途中で知り合いに見られたりしてないかしら……」	PRINTFORML 「会不会在中途被熟人看到呢……」
PRINTFORML 「%CNAME("一人称")%をこんな場所に連れてきて、何をするつもりかしら？」	PRINTFORML 「把%CNAME("一人称")%带到这种地方来，想要做什么呢？」
PRINTFORML 「%CNAME("一人称")%言ったわよね」	PRINTFORML 「%CNAME("一人称")%说过了吧」
PRINTFORML 「部活顧問としては部活が活発なのを喜ぶべきなのかしら」	PRINTFORML 「作为社团活动顾问，是不是应该为社团活动活跃而高兴呢？」
PRINTFORML 「それとも%CONDS("間柄", MASTER)%の手が早いのを悲しむべきなのかしら」	PRINTFORML 「还是应该因为%CONDS("間柄", MASTER)%的毛手毛脚而感到悲伤呢」
PRINTFORML %CALLNAME:TARGET%は連れて来られた部屋に対して複雑な心境のようだ…	PRINTFORML %CALLNAME:TARGET%对于被带来这个房间好像心情很复杂…
CALL PRINT_STR, @"「%TEXTR("我慢出来ない悪い子にはお仕置きが必要かしら/約束が守れないイケナイ子は叱らないとね")%_」_L"	CALL PRINT_STR, @"「%TEXTR("不能忍耐的坏孩子必须要受到惩罚/不能遵守约定的坏孩子不训斥不行呢")%_」_L"
PRINTFORML 「あら、こんな場所に連れてきて何をするつもりかしら？」	PRINTFORML 「哎呀，你带我来这种地方干什么？」
PRINTFORML 「……聞いてみただけよ」	PRINTFORML 「…只是问问而已啦」
PRINTFORML 「どうせ連れ込むなら可愛い彼女にした方が良いんじゃないかしら」	PRINTFORML 「如果被带来是可爱的女朋友比较好吧」
PRINTFORML 「あら、そういう意味じゃないわよ。ふふ、妬いてるの？」	PRINTFORML 「哎呀，不是这个意思。呵呵，嫉妒吗？」
PRINTFORML 「さてと……%CNAME("一人称")%に何をして欲しいのかしら」	PRINTFORML 「那么……想要%CNAME("一人称")%做什么呢」
PRINTFORML 「あら……意外と片付いてるのね」	PRINTFORML 「哎呀……有收拾了呢，真意外」
PRINTFORML 「どうしたの、そわそわしちゃって」	PRINTFORML 「怎么了，坐立不安的」
PRINTFORML 「……いま何考えてるか当ててみよっか？♪」	PRINTFORML 「……猜猜我现在在想什么吧？♪」
PRINTFORML 「これで二人っきりね」	PRINTFORML 「这样就只有两个人了」
PRINTFORML 「あら……こんばんは」	PRINTFORML 「哎呀……晚上好」
PRINTFORML 「何か御用かしら？」	PRINTFORML 「有什么事吗？」
PRINTFORML 「こんな時間にどうしたの？」	PRINTFORML 「都已经这个时间了吧？」
PRINTFORML 「%CNAME("一人称")%で良ければ相談に乗るわよ？」	PRINTFORML 「有什么事可以和%CNAME("一人称")%商量哦」
PRINTFORML 「あら？　どうしたの」	PRINTFORML 「哎呀？怎么了？」
PRINTFORML 「%CNAME("一人称")%に会いに来てくれたのかしら」	PRINTFORML 「来看%CNAME("一人称")%了吗？」
PRINTFORML 「……満足したかしら？」	PRINTFORML 「……满足了吗？」
PRINTFORML 「こらっ」	PRINTFORML 「哎！」
PRINTFORML 「母親をからかうもんじゃありません」	PRINTFORML 「戏弄妈妈可是不行的哦」
PRINTFORML 「…本気で怒る前に、やめなさい」	PRINTFORML 「……在我真正生气之前停手吧」
PRINTFORML 「いっぱい買ったわね」	PRINTFORML 「买了很多呢」
PRINTFORML 「こんなに荷物があるのに持ってくれてありがとね。頼りになる男の子で良かったわ」	PRINTFORML 「多亏了你才能带这么多的东西。能成为可靠的男孩子真是太好了」
PRINTFORML 「色々楽しめそうね。帰ったら一緒に品定めしましょう♪」	PRINTFORML 「一定会很有趣呢，回去我们一起试试吧♪」
PRINTFORML 「気に入ったものはあったのかしら」	PRINTFORML 「有没有中意的东西呢」
PRINTFORML 「それを一体誰に使うつもりなのかしらね？」	PRINTFORML 「你打算把那个给谁用呢？？」
PRINTFORM %TEXTR("難しい顔をしながら/考え事をしながら/思案しながら")%	PRINTFORM %TEXTR("摆出一副很为难的表情/一边思考着/思考着")%
PRINTFORML %TEXTR("本を読んでいる/ＴＶを見ている/持ち帰った書類仕事をしている")%	PRINTFORML %TEXTR("正在读一本书/在看电视/整理着带回家的文件")%
CALL PRINT_STR, @"「%TEXTR("久々に抱っこしてあげようか？　ほら、こっちに来なさいな/暇ならほら、おいで？　良い子良い子してあげる/…いま、私の可愛い子をぎゅーってしてあげたい気分なのよねぇ")%」_L"	CALL PRINT_STR, @"「%TEXTR("好久没抱你了吧？快，到这边来/有空的话，过来吧，真是个好孩子/……现在，真想紧紧地抱住我可爱的孩子啊")%」_L"
CALL PRINT_STR, @"(%CNAME("二人称")%%TEXTR("の視線を感じたのか、/が見ているのに気がついたのか、")%_"	CALL PRINT_STR, @"(%CNAME("二人称")%%TEXTR("感受到了视线，/似乎注意到了，")%_"
CALL PRINT_STR, @"%TEXTR("こちらに微笑んだ/こちらに手招きしてみせた/こちらを誘っている")%)_L"	CALL PRINT_STR, @"%TEXTR("向这边微笑/向这边招了招手/向这边邀请着")%)_L"
CALL PRINT_STRL, @"「%TEXTR("私で良かったら/お母さんね、")%今日は暇だから%TEXTR("何でも言ってね？/何時でも大丈夫よ")%_HH_」"	CALL PRINT_STRL, @"「%TEXTR("如果我可以的话，/妈妈我呢，")%今天很闲%TEXTR("想要说什么？/随时都可以")%_HH_」"
CALL PRINT_STR, @"「%TEXTR("折角のお休み/休日/週末")%だもの」_L"	CALL PRINT_STR, @"「毕竟是%TEXTR("难得的休息/休息日/周末")%」_L"
PRINTFORML 「家でダラダラしてないで出かけてらっしゃい」	PRINTFORML 「别总待在在家里快出去走走吧」
PRINTFORML 「遊ぶのもいいけど、ちゃんと勉強しなさいね」	PRINTFORML 「玩游戏也不是不行，但要前提是要好好学习哦」
PRINTFORML 「解らない事があったら"先生"に聞くのよ」	PRINTFORML 「如果有不明白的事就问“老师”吧」
PRINTFORML 「ｸー……ｽー……」	PRINTFORML 「咕……嘶……」
PRINTFORML 「すぴー……」	PRINTFORML 「噼……」
PRINTFORML 「…………くぅー……」	PRINTFORML 「…………咕唔……」
PRINTFORML 「…………%CNAME("二人称", "甘え")%……ｽﾔｽﾔ」	PRINTFORML 「…………%CNAME("二人称", "撒娇")%……嘻呀，嘻呀」
PRINTFORML 「愛してるわ…………」	PRINTFORML 「爱你…………」
PRINTFORML 「えっち…………zzz」	PRINTFORML 「啊嚏！…………zzz」
PRINTFORML 「……ここ……期末試験に……出そうかしら………………ｸﾞー」	PRINTFORML 「……哼哼……期末考试……要出来了么………………咕」
PRINTFORML 「まったく……もう……zzz」	PRINTFORML 「真是……已经……zzz」
PRINTFORML 「ん……いい子ね……zzz」	PRINTFORML 「嗯……乖孩子……zzz」
PRINTFORML 「今でも……愛してるわ……（よく聞き取れない）…………zzz」	PRINTFORML 「直到现在……爱你……（听不清楚）…………zzz」
PRINTFORMW 『生徒指導室』	PRINTFORMW 『学生指导室』
PRINTFORMW %CALLNAME:MASTER%と二人きりになった%CALLNAME:TARGET%	PRINTFORMW 只有%CALLNAME:MASTER%和%CALLNAME:TARGET%两个人。
PRINTFORMW 「生徒指導っていう事で貸切にしてきたわ」	PRINTFORMW 「因为是学生指导所以就把这里借过来了」
PRINTFORMW 「特別生徒指導を始めるわ」	PRINTFORMW 「现在开始特别学生指导吧」
PRINTFORMW 「先生を余り困らせないでね？」	PRINTFORMW 「不要让老师太为难喔？」
PRINTFORMW 「授業直前に呼び出すなんて」	PRINTFORMW 「上课前记得告诉我哦」
PRINTFORMW 「あまり時間はかけれないわよ……」	PRINTFORMW 「花不了多少时间啊……」
PRINTFORMW 「こんな所に先生を呼び出して……」	PRINTFORMW 「居然把老师叫到这种地方来……」
PRINTFORMW 「本当なら怒ってる所よ？」	PRINTFORMW 「真以为在这里我不会生气吗？」
PRINTFORM 「出来れば%CNAME("二人称")%を%TEXTR("じっくり/たっぷり")%時間をかけて%TEXTR("してあげたいのだけれどね/可愛がってあげたい所だけど")%……	PRINTFORM 「如果可以的话%CNAME("二人称")%%TEXTR("踏踏实实地/尽情地")%花些时间%TEXTR("想要做些什么/想要疼爱那地方")%……
PRINTFORMW %TEXTR(@"時間はあまりないから、続きは帰ってからにしましょうね/他の先生にバレてしまうと困りますからね？/%CNAME("一人称")%は授業に行かなくちゃいけないから、ね？")%」	PRINTFORMW %TEXTR(@"时间不多了，等回去再说吧/如果被其他老师发现了会很麻烦吧？/%CNAME("一人称")%要回去了，毕竟妈妈还得去上课呢")%」
PRINTFORMW 「%TEXTR("時間はないから手短にね/あんまり時間はないのよ")%？　%TEXTR("続きがしたくなったらお家に帰ってからですからね/先生にこんな事させるなんて悪い子ね")%	PRINTFORMW 「%TEXTR("时间是不是快到了/时间不多了吧")%？　%TEXTR("如果还想要的话，回家再继续吧/叫老师干这种事,真是个坏孩子")%
PRINTFORML 「%TEXTR("お口/口")%で%TEXTR("性処理/処理/抜いて")%%TEXTR("欲しいのね？/あげますね/あげるわ")%」	PRINTFORML 「%TEXTR("用嘴/在嘴里")%%TEXTR("性处理/处理/发泄")%%TEXTR("性欲吧？/出去吧/出来吧")%」
PRINTFORMW 「%TEXTR("もう/まったく")%……%TEXTR("イケナイ子ね、こんなに/実の母親にしてもらってるのに")%%TEXTR("大きくして/硬くして")%」	PRINTFORMW 「真是个乖孩子呢，明明是亲生母亲，可是却变得更大更硬了呢」
CALL PRINT_STR, @"「%TEXTR("ちゅっ……じゅるじゅるるっ/れろっ、れろれろっ")%_H_……%TEXTR("これはお仕置きが必要ね/先生にこんな事して良いと思ってるのかしら？")%」_W"	CALL PRINT_STR, @"「%TEXTR("哦呣，嘟噜，嘟噜/布鲁，咕噜")%_H_……%TEXTR("得好好惩罚一下呢/你觉得这件事老师要怎么办呢？")%」_W"
PRINTFORM 「%TEXTR("ほら……昔みたいに脱がせてあげるから/脱がして欲しいの？　しょうがない子ね")%。	PRINTFORM 「%TEXTR("喏，想要像往常一样脱掉吗？/想要脱掉吗？真是让人没办法的孩子呢")%。
CALL PRINT_STR, @"「%TEXTR(@"先生にこんなえっちな事して、本当ならお説教ですからね？/他の子にしてもらうより気持ちいいの？　もう、そんな風に%CNAME("一人称")%をからかうものじゃありませんからね/そんな嬉しそうな顔しないの……もう")%_H_」_W"	CALL PRINT_STR, @"「%TEXTR(@"和老师也这么顽皮，不怕我教训你吗？/比其他孩子更舒服吗？真是的，不要像那样捉弄%CNAME("一人称")%了/不要露出那么高兴的表情……喂")%_H_」_W"
PRINTFORMW 「悪い子ね、ビチャビチャに濡れちゃったじゃない」	PRINTFORMW 「真是坏孩子，都流出来了，黏糊糊的」
PRINTFORMW 「次からは気をつけるのよ？」	PRINTFORMW 「下次要注意点哦」
CALL PRINT_STR, @"「%TEXTR("あらあら/ふふっ")%_H_　%TEXTR("どうしたの？/寂しかったのかしら？")%」_L"	CALL PRINT_STR, @"「%TEXTR("哎呀/呼呼")%_H_　%TEXTR("怎么了？/寂寞了吗？")%」_L"
CALL PRINT_STR, @"「%TEXTR("大丈夫よ/安心しなさい")%、%CNAME("一人称")%%TEXTR(@"は何処にもいかないわ/は%CNAME("二人称")%とこれからもずっと一緒よ/は%CNAME("二人称")%を愛しているわ")%」_W"	CALL PRINT_STR, @"「%TEXTR("没事的/放心吧")%，%CNAME("一人称")%%TEXTR(@"哪里都不会去/%CNAME("二人称")%从今以后也要一直在一起/爱%CNAME("二人称")%")%哦」_W"
PRINTFORML 「%TEXTR("こら/ダメよ")%……」	PRINTFORML 「%TEXTR("哎呀/不行啦")%……」
CALL PRINT_STR, @"「%TEXTR("ちゅっ、ちゅうっ……チュパッ/ちゅっ、んっ……はぁ……")%_H_」_L"	CALL PRINT_STR, @"「%TEXTR("啾、啾汲……啾叭/啾、嗯哼……哈……")%_H_」_L"
PRINTFORMW 「%GREETING%、%TEXTR("情熱的なのは嫌いではないけど/積極的なのは好きよ")%……でも、%TEXTR(@"私達は親子なのよ。忘れないでね？/私達は血が繋がってるんだから控えめにしなさいね/あんまり%CNAME("一人称")%をドキドキさせないの/%CNAME("一人称")%をこんなにドキドキさせてどうする気なのかしら？")%」	PRINTFORMW 「%GREETING%，%TEXTR("这么热情虽然我也不讨厌的/这么主动我也挺喜欢的")%……但是%TEXTR(@"我们是亲生母子哦，忘记了吗？/我们有血缘关系，所以要节制点哦。/不可以做这种%CNAME("一人称")%心跳不已的事哦/让%CNAME("一人称")%这么害羞，究竟想要做什么呢？")%」
CALL PRINT_STR, @"「%TEXTR("ちゅっ/ちゅうっ")%」_L"	CALL PRINT_STR, @"「%TEXTR("啾/啾汲")%」_L"
CALL PRINT_STR, @"「%TEXTR("ダメよ/やめなさい")%%TEXTR("＿/、こらっ")%……んっ_H_」_L"	CALL PRINT_STR, @"「%TEXTR("不行啊/不要这样")%%TEXTR("＿/、喂！")%……嗯哼_H_」_L"
CALL PRINT_STR, @"「%TEXTR("んっ/んぅ")%_H_……」_L"	CALL PRINT_STR, @"「%TEXTR("嗯哼/嗯唔")%_H_……」_L"
CALL PRINT_STR, @"「先生に%TEXTR("何をするの/変な事するのはやめなさい")%！？　%TEXTR("こらっ、続けないの/やめなさいっ、ダメよ")%……%TEXTR("んっ/んぅ")%_H_」_W"	CALL PRINT_STR, @"「%TEXTR("对老师做什么呢/不要对老师干这种奇怪的事了")%！？　%TEXTR("呀，不要再继续了/不要这样了，真的不行哟")%……%TEXTR("嗯哼/嗯唔")%_H_」_W"
PRINTFORMW 「ん……おはよう、どうかしたの？」	PRINTFORMW 「嗯……早上好，怎么了？」
PRINTFORMW 「改まってなぁに？」	PRINTFORMW 「改正了吗？」
PRINTFORMW 、そんなに褒められたら嬉しくなっちゃうわ」	PRINTFORMW ，被那样夸奖的话我会很高兴的」
PRINTFORMW 「フフッ、ありがとうね」	PRINTFORMW 「呵呵，谢谢啦」
PRINTFORMW 「もっと褒めてくれてもいいのよ？」	PRINTFORMW 「可以再夸奖我几句吗？」
PRINTFORM 「%CNAME("一人称")%も%CNAME("二人称")%の事を	PRINTFORM 「%CNAME("一人称")%也喜欢%CNAME("二人称")%哦
CALL PRINT_STR, @"「%TEXTR("愛してるわ/何時でも想っているわ")%_HH_」_W"	CALL PRINT_STR, @"「%TEXTR("我爱你/我总是在想你")%_HH_」_W"
PRINTFORMW 「もう……	PRINTFORMW 「已经……
CALL PRINT_STR, @"「%TEXTR("私も……好きよ……/恥ずかしいわ")%」_W"	CALL PRINT_STR, @"「%TEXTR("我……好喜欢……/好害羞啊")%」_W"
CALL PRINT_STR, @"「%TEXTR("フフッ/ウフフッ")%_HH_　%CNAME("一人称")%も%CNAME("二人称")%の事、%TEXTR("＿/大")%好きよ_HH_」_W"	CALL PRINT_STR, @"「%TEXTR("呵呵/哦呵呵")%_HH_　%CNAME("一人称")%也喜欢%CNAME("二人称")%哦，%TEXTR("＿/最")%喜欢你了_HH_」_W"
CALL PRINT_STR, @"「もう……学校では%TEXTR("先生を口説かないの/そう言うのはダメよ")%」_W"	CALL PRINT_STR, @"「在学校%TEXTR("对老师说这种话/说这种话可不行哦")%」_W"
CALL PRINT_STR, @"「%CNAME("一人称")%も%CNAME("二人称")%の事、%TEXTR("＿/大")%好きよ_HH_　大事な家族ですもの」_W"	CALL PRINT_STR, @"「%CNAME("一人称")%也喜欢%CNAME("二人称")%，%TEXTR("＿/最")%喜欢了_HH_　毕竟是重要的家人」_W"
CALL PRINT_STR, @"「こらっ、学校で%TEXTR("先生を口説かないの/変な事言わない")%」_W"		CALL PRINT_STR, @"「哎！在学校里%TEXTR("可以和老师说这些吗？/不要说奇怪的话")%」_W"
CALL PRINT_STR, @"「%CNAME("一人称")%のパンツの色が知りたいなんて%TEXTR("悪い/困った")%子ね」_W"	CALL PRINT_STR, @"「想知道%CNAME("一人称")%胖次的颜色？真是个%TEXTR("坏/让人困扰的")%孩子」_W"
PRINTFORMW 「どうしてもいま聞かなければいけないことかしら？　……（はぁ）、分かったわよ」	PRINTFORMW 「为什么非得现在问呢？　……唉，我明白了」
CALL PRINT_STR, @"「%CNAME("二人称")%%TEXTR("と「する」のはダメだから/には「させて」あげられないの/には悪いけれど")%、%TEXTR("諦めなさい/お尻で我慢してちょうだい")%」_W"	CALL PRINT_STR, @"「对%CNAME("二人称")%“”%TEXTR("做「那个」是不行的/任凭摆布什么的是不可能的/虽然有点抱歉")%，%TEXTR("请放弃吧/请用屁股忍耐一下吧")%」_W"
PRINTFORMW 「じゃあ……%CNAME("二人称")%のお父さんと%CNAME("一人称")%の昔話、聞かせてあげるわ」	PRINTFORMW 「那么……就让你听一听%CNAME("二人称")%父亲和%CNAME("一人称")%的故事吧」
PRINTFORMW 「長くなるけどいいわよね？」	PRINTFORMW 「虽然会很长但是没关系吧？」
CALL PRINT_STR, @"「%TEXTR("それは/つまり")%、%CNAME("一人称")%としたいって意味かしら？」_W"	CALL PRINT_STR, @"「%TEXTR("那是因为/也就是说")%、想要%CNAME("一人称")%吗？」_W"
PRINTFORMW 「家事を手伝ってくれるのかしら？」	PRINTFORMW 「能帮我做家务吗？」
PRINTFORMW の邪魔をしないでね？」	PRINTFORMW 能别打扰我吗？」
PRINTFORMW %CALLNAME%は整理整頓をしている……	PRINTFORMW %CALLNAME%正在整理……
PRINTFORMW 「大体片付いたかしらね」	PRINTFORMW 「基本都整理完了吧」
PRINTFORMW 「何でもフェリシアさん任せには出来ないのよ、我が家だものね」	PRINTFORMW 「也不能什么都交给弗理希艾尔啊，毕竟这里是自己家」
PRINTFORMW 「顧問だもの、それに片付いてないと落ち着かないのよ」	PRINTFORMW 「因为是顾问，不收拾好就静不下心来。」
CALL PRINT_STR, @"「%TEXTR("見てないで、手伝いなさい/ほら、ぼさっとしてないの")%」_W"	CALL PRINT_STR, @"「%TEXTR("别光顾着看，帮帮忙啊/哎，不要在那光站着发呆啊")%」_W"
PRINTFORMW 「%CNAME("二人称")%が手伝えば半分の時間で終わるんだから」	PRINTFORMW 「因为有%CNAME("二人称")%帮忙只用了一半的时间就完成了」
CALL PRINT_STR, @"「%TEXTR("んー/うーん")%……今日の化粧、少し%TEXTR("濃すぎ/派手すぎ")%ないかしら？」_W"	CALL PRINT_STR, @"「%TEXTR("嗯嗯/唔")%……今天的妆是不是有点%TEXTR("太浓了/太艳了")%？」_W"
CALL PRINT_STR, @"「%TEXTR("似合ってる？/素敵だなんて")%　%TEXTR(@"%CONDS("間柄", MASTER)%に/誰だって")%褒められ%TEXTR("るのは嬉しいわ/たら照れるわよ")%」_W"	CALL PRINT_STR, @"「%TEXTR("合适吗？/太棒了")%　%TEXTR(@"%CONDS("間柄", MASTER)%无论是谁")%被表扬%TEXTR("都会觉得很开心吧")%」_W"
PRINTFORMW 「この歳になるとね、お肌の調子が安定しないのよねぇ……」	PRINTFORMW 「到了这个年龄，皮肤的状况就不稳定了……」
PRINTFORMW 「若い子達が羨ましいわ」	PRINTFORMW 「真羡慕年轻的孩子们啊」
PRINTFORMW 「女性は何歳になっても綺麗でいたいの」	PRINTFORMW 「女性无论几岁都想保持美丽」
PRINTFORMW 「そう、幾つになっても乙女なのよ」	PRINTFORMW 「是啊，无论多大都是少女啊」
PRINTFORMW 「部活で誰か素敵な子、見つからないの？」	PRINTFORMW 「在社团活动里没找到哪个可爱的孩子吗？」
PRINTFORMW 「可愛い子いっぱいいるんだから、早く付き合っちゃいなさい」	PRINTFORMW 「不是有很多可爱的女孩子嘛，快点去和谁交往吧」
PRINTFORMW 「それとも、もう将来を決めた相手が居たりするのかしら」	PRINTFORMW 「还是说，已经有了想要交往的对象呢？」
CALL PRINT_STR, @"「%TEXTR("うんうん、青春って良いわね/青春って感じね、素敵だわ")%」_W"	CALL PRINT_STR, @"「%TEXTR("嗯，青春真好啊/有种青春的感觉，真棒呢")%」_W"
CALL PRINT_STR, @"「%TEXTR("若いって良いわね……/若いって罪ね……")%」_W"	CALL PRINT_STR, @"「%TEXTR("年轻真好啊……/年轻真是罪孽啊……")%」_W"
CALL PRINT_STR, @"「%TEXTR("青春って感じがするわ/私にもあんな頃があったのねぇ")%」_W"	CALL PRINT_STR, @"「%TEXTR("有种青春的感觉/我也有过那样的时候呢")%」_W"
CALL PRINT_STR, @"に%TEXTR("何か用事？/頼みたい事でもあるの？")%」_W"	CALL PRINT_STR, @"に%TEXTR("有什么事吗？/有想拜托的事情吗？")%」_W"
CALL PRINT_STR, @"「%TEXTR("なぁに/どうしたの")%？_"	CALL PRINT_STR, @"「%TEXTR("什么啊/怎么了")%？_"
CALL PRINT_STR, @"「%TEXTR("ほら/おいで")%_HH_……_"	CALL PRINT_STR, @"「%TEXTR("看/过来")%_HH_……_"
PRINTFORMW 撫で撫でしてあげますからね」	PRINTFORMW 来好好抚摸一下吧」
CALL PRINT_STR, @"「%TEXTR("あぁ～/はぁ～")%_HH_　_"	CALL PRINT_STR, @"「%TEXTR("啊~/哈～")%_HH_　_"
CALL PRINT_STR, @"%TEXTR("ダメェ/そこぉ")%_HH_……」_L"	CALL PRINT_STR, @"%TEXTR("不行啊/那里")%_HH_……」_L"
CALL PRINT_STR, @"「%TEXTR("もっとぉ～/あぁん～")%_HH_　_"	CALL PRINT_STR, @"「%TEXTR("更多的～/啊啊啊～")%_HH_　_"
CALL PRINT_STR, @"%TEXTR("滅茶苦茶にしてぇ/気持ちよすぎるのぉ")%_HH_」_W"	CALL PRINT_STR, @"%TEXTR("舒服得乱七八糟的/太舒服了")%_HH_」_W"
PRINTFORMW 「もっとぉ……こほん、先生に変な事しないでくださいね」	PRINTFORMW 「啊更多……咳咳，不要对老师做奇怪的事啊」
PRINTFORMW 「こらっ……みんなが見てるでしょう、や、やめなさい」	PRINTFORMW 「哎呀……这样会被大家发现的吧，快、快住手」
PRINTFORMW 「こ、こら……先生は途中でやめて良いと言ってませんよ」	PRINTFORMW 「哎、哎……老师可没有叫你停下来哦」
PRINTFORMW %CALLNAME:TARGET%はどうにか声を上げまいと懸命に堪えている	PRINTFORMW %CALLNAME:TARGET%不敢出声，拼命地忍耐着。
PRINTFORMW 「こほん……親子だからって、公共の場では慎みなさいね」	PRINTFORMW 「虽然是母子，但是在公共场合也要谨慎点啊」
PRINTFORMW 「したくなっちゃったの？」	PRINTFORMW 「想做了吗？」
PRINTFORMW 「夜まで我慢出来ないの？」	PRINTFORMW 「夜里没法忍耐了么？」
PRINTFORM %CALLNAME:TARGET%は%CALLNAME:MASTER%	PRINTFORM %CALLNAME:TARGET%和%CALLNAME:MASTER%
PRINTFORML 「んっ…ちゅっ……ピチャピチャ…はふっ……」	PRINTFORML 「嗯哼…啾啾……噼啾噼啾…哈芙……」
PRINTFORML 「ちゅっ……チュパッ……」	PRINTFORML 「啾……啾叭……」
PRINTFORMW 「そんなに%CNAME("一人称")%に甘えたいの？」	PRINTFORMW 「想要对%CNAME("一人称")%撒娇吗？」
PRINTFORML 「チュッ……チュク…チュク……」	PRINTFORML 「啾……啾库…啾库……」
PRINTFORMW 「悪い子ね、そんなに%CNAME("一人称")%にお口でして欲しいの？」	PRINTFORMW 「真是个坏孩子，就那么喜欢%CNAME("一人称")%的嘴吗？」
PRINTFORML 「ちゅっ……」	PRINTFORML 「啾……」
PRINTFORMW （この子ったらすっかりお父さんに似てきて……）	PRINTFORMW （这孩子真像他父亲啊……）
PRINTFORML 「ちゅっ、ちゅっ……」	PRINTFORML 「啾、啾……」
PRINTFORMW 「フフッ……二人っきりだからってイケナイ子ね」	PRINTFORMW 「呵呵……虽然现在是两个人」
PRINTFORMW 「ちゅっ……」	PRINTFORMW 「啾……」
PRINTFORMW 「あらあら……」	PRINTFORMW 「哎呀……」
CALL PRINT_STR, @"「%TEXTR("ほら……見られてるわよ？/髪が乱れちゃうでしょう？")%」_L"	CALL PRINT_STR, @"「%TEXTR("你看……都露在外面了呦？/头发已经乱了吧？")%」_L"
CALL PRINT_STR, @"「%TEXTR("ここでそういうことは止めましょう/気持ちは嬉しいけど、そういうのは人が居ないときにね")%」_W"	CALL PRINT_STR, @"「%TEXTR("还是不要这样了吧/虽然很开心，但还是要在没有其他人的时候才能做")%」_W"
PRINTFORML %CNAME("一人称")%に親孝行してくれるの？」	PRINTFORML 因为%CNAME("一人称")%是长辈，所以要好好孝顺吗？」
PRINTFORML 「気が利くのね」	PRINTFORML 「真是机灵呢」
PRINTFORMW 「折角だからお言葉に甘えましょうか」	PRINTFORMW 「难得来一趟,我就不客气了」
PRINTFORMW 「こっちに来て、一緒にお話でもしましょう？」	PRINTFORMW 「过来这边一起聊聊天吧？」
PRINTFORML 「あら、殊勝な心がけね」	PRINTFORML 「哎呀，真是用心啊」
PRINTFORMW 「ありがとう」	PRINTFORMW 「谢谢」
PRINTFORMW 「気持ちは嬉しいけれどね」	PRINTFORMW 「话虽然这么说，还是觉得很开心」
CALL PRINT_STR, @"「%TEXTR("ちゅ/ちゅう")%_H_」_L"	CALL PRINT_STR, @"「%TEXTR("啾/啾~")%_H_」_L"
PRINTFORMW だから、つい……ね？」	PRINTFORMW 所以，一不留神……是吧？」
PRINTFORMW 愛しくなってしまったのよ。愛しているわ」	PRINTFORMW 喜欢上你了哟。我爱你。」
PRINTFORMW あの人の面影をね……なんて、気にしないで」	PRINTFORMW 只是觉得很像那个人罢了，别会错意」
CALL PRINT_STR, @"「%TEXTR("あらあら/フフフ")%_H_」_L"	CALL PRINT_STR, @"「%TEXTR("啊啦啊啦/呵呵呵")%_H_」_L"
CALL PRINT_STR, @"「思春期だから%TEXTR("えっちな/イヤラシイ事")%ばかり考えているのかと思ったら、意外と%TEXTR("されるのは/襲われるのは")%%TEXTR("恥ずかしいのね/照れちゃうのね")%_H_」_W"		CALL PRINT_STR, @"「因为是青春期的%TEXTR("小鬼/讨厌鬼")%，原以为他考虑过这个问题了，没想到，%TEXTR("被迫接受了/被袭击了")%，%TEXTR("真是害羞啊/好害羞啊")%_H_」_W"
PRINTFORMW 「%TEXTR("たまには/昔みたいに")%……%CONDS("間柄", MASTER)%%TEXTR("にこうしてあげるのも良いわね/を可愛がりたくなる時もあるのよ")%」	PRINTFORMW 「%TEXTR("偶尔/就像过去一样")%……%CONDS("間柄", MASTER)%%TEXTR("这样做也很好啊/也会有想要疼爱你的时候")%」
PRINTFORML 「ほら……%TEXTR("来なさいな/おいで")%」	PRINTFORML 「喂……%TEXTR("过来吧/快过来")%」
PRINTFORMW 「今だけは先生ではなく、%TEXTR(@"%CNAME("一人称")%/母/母親")%として%TEXTR("甘えさせてあげますからね/可愛がってあげるから")%」	PRINTFORMW 「现在不是老师哦、%TEXTR(@"%CNAME("一人称")%/身为母亲/作为妈妈")%%TEXTR("会让你好好撒娇的/会好好疼爱你的")%」
PRINTFORMW 声を出すのを我慢出来%TEXTR(@"るなら%CNAME("一人称")%がもっとシコシコしてあげますからね/ないなら%CNAME("一人称")%、お仕舞いにしちゃうからね")%」	PRINTFORMW 忍住别出声，%TEXTR(@"准备好%CNAME("一人称")%要变得更加严厉了哦/因为是%CNAME("一人称")%的话，会很快让你结束的哦")%」
PRINTFORMW 他の子が来るまで、%CNAME("一人称")%とイケナイ事しましょうか？」	PRINTFORMW 在其他孩子来之前、和%CNAME("一人称")%一起做些有趣的事情吧」
PRINTFORML 「うふふ、隙あり～」	PRINTFORML 「嘿嘿、有破绽～」
CALL PRINT_STR, @"「%TEXTR("…頭を撫でられるのがそんなに恥ずかしかった？/あらら、逃げられちゃうなんて寂しいわ～")%」_W"	CALL PRINT_STR, @"「%TEXTR("……被摸头有那么害羞吗？/哎呀，居然跑掉了，好寂寞啊~")%」_W"
CALL PRINT_STR, @"「%TEXTR("フフフ……/不思議なものね……")%」_L"	CALL PRINT_STR, @"「%TEXTR("呼呼呼……/真是不可思议啊……")%」_L"
PRINTFORML 「ほらほら、照れ隠しに暴れないの」	PRINTFORML 「哎呀哎呀，不用害羞啊」
PRINTFORMW 「幾つになっても我が子は可愛いものね」	PRINTFORMW 「不论长到多大，都是我可爱的孩子呢」
PRINTFORML 「最近はどうなの？」	PRINTFORML 「最近怎么样？」
PRINTFORMW 「良い子が見つかったら%CNAME("一人称")%に紹介しなさいね」	PRINTFORMW 「遇见哪个好孩子的话，一定要介绍给%CNAME("一人称")%哦」
PRINTFORML 「あんまり女の子を泣かせるような事しちゃ駄目よ」	PRINTFORML 「让女孩子哭的事情可不要做哦」
PRINTFORMW 「%CNAME("二人称")%のお父さんにも困らされたものよ……」	PRINTFORMW 「%CNAME("二人称")%的父亲也会感到为难呢……」
PRINTFORMW 「良かったら、お話しながら戻りましょうか」	PRINTFORMW 「如果可以的话，我们边聊边回去吧」
PRINTFORMW 「変わりはないかしら？」	PRINTFORMW 「没有变化吗？」
PRINTFORMW 「それともコレは%CNAME("二人称")%の性癖なのかしら？」	PRINTFORMW 「还是说，这就是%CNAME("二人称")%的性癖吗？」
PRINTFORMW 「もう、悪戯ばっかりして」	PRINTFORMW 「真是的，这已经算是恶作剧了」
PRINTFORML 「解りました」	PRINTFORML 「我明白了」
PRINTFORMW 「好きなだけ嗅ぎなさい。先生は%CNAME("二人称")%を無視しますからね」	PRINTFORMW 「喜欢的话闻多久都没问题哦。老师会当做%CNAME("二人称")%不存在的」
PRINTFORML 「もう……」	PRINTFORML 「真是的……」
PRINTFORML 「こらっ！」	PRINTFORML 「喂！」
PRINTFORMW 「怒られないとやめれないの？」	PRINTFORMW 「非得对你生气才能停下来吗？」
PRINTFORML 「%TEXTR("見たいなら言ってくれればいいのよ？/正直に言えば幾らでも見せてあげるからね")%」	PRINTFORML 「%TEXTR("想看的话和我说就行了/说实话无论是多少次都会给你看的哟")%」
PRINTFORMW 「ほら、何も穿いてないわよ。%CNAME("二人称")%、そういうの好きでしょう…？」	PRINTFORMW 「你看，什么都没穿哦。%CNAME("二人称")%喜欢这样子吗…？」
PRINTFORML 「%TEXTR("こらっ/もうっ/めっ")%%TEXTR("＿/……")%」	PRINTFORML 「%TEXTR("喂！/真是的！/哎呀")%%TEXTR("＿/……")%」
PRINTFORMW 「先生は怒っています。理由は解りますね？」	PRINTFORMW 「老师生气了，知道理由吧？」
PRINTFORM 「お茶でもどうかしら？	PRINTFORM 「喝杯茶怎么样？
PRINTFORMW 「んー、ここは過ごしやすくて良いわね♪」	PRINTFORMW 「嗯，在这里呆着真好啊♪」
CALL PRINT_STR, @"「%TEXTR("あら……/あらあら……")%_"	CALL PRINT_STR, @"「%TEXTR("啊啦……/啊啦啊啦……")%_"
CALL PRINT_STR, @"「%TEXTR("なぁに？　/あらあら……")%」_"	CALL PRINT_STR, @"「%TEXTR("怎么了？　/啊啦啊啦……")%」_"
CALL PRINT_STR, @"「%TEXTR("仕方ない子/しょうがない子")%ね_H_」_L"	CALL PRINT_STR, @"「真是%TEXTR("让人头疼的孩子/让人没办法的孩子")%呢_H_」_L"
CALL PRINT_STR, @"「%TEXTR("んんっ/んっ")%_HH_……」_L"	CALL PRINT_STR, @"「%TEXTR("嗯哼/嗯哼")%_HH_……」_L"
豊満なプロポーションとは裏腹に落ち着いた雰囲気を纏った女教師	与性感的身材相反，是一位散发着冷静知性气质的女教师。
大恋愛の末に人間の夫と結ばれたが10年ほど前に死別、なお溺愛する%CONDS("間柄", MASTER)%と娘がいる	虽然身为恶魔，但还是不顾一切地和人类坠入了爱河，并诞生了爱情的结晶，但是这场跨越种族的恋情也随着十年前丈夫去世而告终。现在和%CONDS("間柄", MASTER)%还有女儿住在一起，十分溺爱孩子。
なお、%CONDS("間柄", MASTER)%がメイドの恰好をした意地悪な悪魔と同棲を始めたため心中穏やかでないらしい	因为女仆打扮的恶魔和%CONDS("間柄", MASTER)%同居在一起，一想到这件事心里就久久无法平静。
（勧誘すると%CALLNAME:MASTER%の実母として扱われます）	（如果劝诱的话，将会被视为%CALLNAME:MASTER%的亲生母亲）
PRINTFORMW 「困ったわね、まさか正体を見抜かれるなんて」	PRINTFORMW 「真糟糕，没想到会被看穿本来的面目」
PRINTFORMW 「…それで、要求は何かしら。知識…恋愛成就…それとも成績の融通？」	PRINTFORMW 「……那么，是想要什么呢？知识……恋爱成功……还是通融一下提高成绩？」
PRINTFORMW 「…性欲処理してほしい、ですって？」	PRINTFORMW 「……什么？希望可以处理性欲？」
PRINTFORMW 「そ、そういうのはちゃんと彼女を作ってその子に頼みなさい！」	PRINTFORMW 「那、那种事去找个女朋友再拜托她不是更好吗！」
PRINTFORML （現在口上が未完成です。イベントの大部分が未実装なので注意）	PRINTFORML （请注意现在口上还没完成，大部分事件尚未实现）
PRINTFORMW （勧誘すると%CALLNAME:MASTER%の実母として扱われます）	PRINTFORMW （如果劝诱的话，将会被视为%CALLNAME:MASTER%的亲生母亲）
PRINTFORMW %CALLNAME%は何を隠そう、あなたの実の母親である。	PRINTFORMW 主人公的亲生母亲%CALLNAME%一直都隐藏着什么。
PRINTFORMW 小さい頃に父親が亡くなってから、女手ひとつであなたを育ててくれた大事なひとだ。	PRINTFORMW 小时候父亲就去世了，这个女人独自养育了主人公，是最重要的人。
PRINTFORMW これまで彼女を性的な目で見たことが無かったと言えば嘘になる。	PRINTFORMW 如果说迄今为止，没有用看待女性的眼光来观察过她，那是在说谎。
PRINTFORMW 見た目が若いとも思っていたし、友人から色目を使われて嫉妬したこともある。	PRINTFORMW 因为外貌十分年轻，也被朋友用色色的眼神嫉妒过。
PRINTFORMW 一方でそのことが自慢でもあった。地味で飾らないけど、綺麗で優しい母さん。	PRINTFORMW 另一方面也很自豪。朴素又不妖艳，是一位漂亮温柔的母亲。
PRINTFORMW ただ、つい先日までは想像したこともなかった。	PRINTFORMW 只是，直到前几天为止都没有想象过。
PRINTFORMW まさか、彼女<<自分の母親>>が悪魔だったとは…。	PRINTFORMW 自己的母亲，竟然是恶魔。
PRINTFORMW 「勢いで%CONDS("間柄", MASTER)%と契約してしまった……」	PRINTFORMW 「脑子一热就和%CONDS("間柄", MASTER)%签订了契约……」
PRINTFORMW 「一生の不覚だわ……」	PRINTFORMW 「这真是一生中的最大的失败……」
PRINTFORMW %CALLNAME%はこめかみを押さえながら何やら葛藤している……	PRINTFORMW %CALLNAME%一边按着太阳穴一边纠结着……
PRINTFORMW その彼女の頭には二本の大きい角が生え、髪や目の色もやや変化している。	PRINTFORMW 她头上长出了两根大角，头发和眼睛的颜色也有些变化。
PRINTFORMW 悪魔の角と尻尾。金色がかった目。もう隠す必要が無くなったということだろうか。	PRINTFORMW 恶魔的角和尾巴。金色的眼睛。是觉得已经没有隐藏的必要了吗。
PRINTFORMW ちなみに、背中に翼もあるらしいが邪魔なので仕舞っているそうだ。	PRINTFORMW 顺带一提，背上好像也有翅膀，因为太碍事所以就藏起来了。
PRINTFORMW 「それにしても、私の正体が悪魔だということを見破れたのは何故かしら」	PRINTFORMW 「话虽如此，不知道为什么，我的真正身份到底还是被你看穿了」
PRINTFORMW 「……皆まで言わなくてもいいわ。誰の入れ知恵かは分かっています」	PRINTFORMW 「……这件事你可不要和其他人说，我知道这是谁出的主意。」
PRINTFORMW 「魂の取引は本来危険なものなのよ？　それを欲望に任せてホイホイと……まったくもう」	PRINTFORMW 「你知道灵魂的交易本来就是危险的东西吗？　将它托付给欲望……真是的」
PRINTFORMW 「こっそり陰で見守っているつもりだったのに、こうなってしまっては仕方ないわね」	PRINTFORMW 「本来打算悄悄地在背后守护着你，事到如今也没有办法了」
PRINTFORMW 子供の悪戯を叱るように溜息をつき、腰に手をやりながら前屈みにこちらを覗きこむ%CALLNAME%	PRINTFORMW %CALLNAME%像责备淘气孩子似地叹气，把手搭在腰间，弯腰向前看着这边。
PRINTFORMW お説教のときに相手と視線の高さを合わせるその仕草は見慣れたものだったが、	PRINTFORMW 说教时，习惯性地和对方视线高度保持一致。
PRINTFORMW 今は突き出されたその胸元、スーツから\@TALENT:巨乳?こぼれ出そうな豊満な#覗く形のいい\@乳房から目が離せない。	PRINTFORMW 胸部被服装突出着，视线根本无法离开\@TALENT:巨乳?丰盈得快要溢出来的#外形良好的\@乳房。
PRINTFORMW 目の前の"最も身近な女性"と、最も縁遠いはずの"契約"を交わした実感……	PRINTFORMW 眼前这位"最亲近的女性"和最遥远的"契约"彼此交织着，冲击着所谓的真实感……
PRINTFORMW その背徳的な胸の高鳴りと共に、あなたは意図せず血流が早くなるのを感じた。	PRINTFORMW 伴随着心中这违背道德的冲动，你不由得感觉到血流变快了。
PRINTFORMW 「そ、そういう年頃なのは分かるけど、いくら何でも節操が無さ過ぎるんじゃないかしら」	PRINTFORMW 「那个，虽然知道你正是那样的年纪，但是不管怎么说，是不是太没有节操了呢」
PRINTFORMW こちらの視線の意味に気付いた%CALLNAME%は、少しバツが悪そうに姿勢を正しながら言う。	PRINTFORMW 注意到投过来的视线，%CALLNAME%端正了姿态说道。
PRINTFORMW 「悪魔であっても私があなたの母親であることには変わりないのよ？」	PRINTFORMW 「就算是恶魔，我也是你的母亲哟？」
PRINTFORMW 「け、契約は契約だから、せ…性欲処理くらいはしてあげるけど」	PRINTFORMW 「唉，但契约就是契约，按照约定我也会进行性欲处理的」
PRINTFORMW 「絶～ったいに、本番だけは駄目よ。約束できる？」	PRINTFORMW 「但做爱是绝对、绝对不可以的。能答应我吗？」
PRINTFORMW つまり本番以外はやらせてくれるということだろうか。	PRINTFORMW 也就是说，除了做爱之外的都可以做吗？
PRINTFORMW 「周りの人に言いふらすのも駄目。最悪引っ越ししなきゃいけなくなるもの」	PRINTFORMW 「对周围的人提起也是绝对不行的。否则最坏的结果就是要搬家」
PRINTFORMW そういう問題なのだろうか？	PRINTFORMW 这也会变成问题的吧？
PRINTFORMW 「魂もきっちり頂きますからね、そうしないとすぐ調子に乗るんだから」	PRINTFORMW 「因为是灵魂所以一定要慎重，得意忘形什么的绝对不允许」
PRINTFORMW そこはちゃんと悪魔らしく振る舞うのか……	PRINTFORMW 这个时候才表现得有点像一个恶魔……
PRINTFORMW 「そうそう、それと」	PRINTFORMW 「对了对了，还有」
PRINTFORMW 急に思い出したように普段通りの"母親の声"に戻ったかと思うと、	PRINTFORMW 突然回想起，往日里母亲的声音。
PRINTFORMW 「くれぐれも"%CALLNAME%"と真名で呼び捨てにしたりしないように。良いわね？」	PRINTFORMW 「千万不要直呼"%CALLNAME%"的真名。记住了吗？」
PRINTFORMW と有無を言わさぬ口調で釘を刺されたのだった……	PRINTFORMW 以不容分说的口吻制定了规则……
PRINTFORMW 「あのね、最近の性欲処理のことなんだけど」	PRINTFORMW 「那个，是最近的性欲处理的事情」
PRINTFORMW 「もしかして%CNAME("二人称")%、%CNAME("一人称")%のお尻に興味があるのかしら」	PRINTFORMW 「那么%CNAME("二人称")%对%CNAME("一人称")%的屁股很感兴趣吧」
PRINTFORMW 「やっぱりね。そうなんじゃないかって思っていたわ」	PRINTFORMW 「果然和我想的一样呢」
PRINTFORMW 「あら、違ったかしら」	PRINTFORMW 「哎呀，不对吗？」
PRINTFORMW 「まあ確かに、お尻でなら妊娠はしないけれど……」	PRINTFORMW 「嘛，确实，屁股是不会怀孕的……」
PRINTFORMW 「うーん、それじゃあこうしましょうか」	PRINTFORMW 「嗯，那么就这样吧」
PRINTFORMW 「どうしても我慢できないときだけ、%CNAME("一人称")%のお尻に挿れさせてあげても…いいわ」	PRINTFORMW 「无论如何都无法忍耐的时候，即使插入%CNAME("一人称")%的屁股…也可以哦」
PRINTFORMW 「すっきりすれば、少しは冷静になれるでしょうし」	PRINTFORMW 「如果发泄出去，就会变得冷静下来吧」
PRINTFORML  %CALLNAME:TARGET%が本番の合意を得た。	PRINTFORML  获得了能和%CALLNAME:TARGET%做爱的协议。
PRINTFORML  %CALLNAME:ARG%の%CALLNAME:MASTER%に対する二人称を設定できます。	PRINTFORML  设定%CALLNAME:ARG%对%CALLNAME:MASTER%的第二人称。
PRINTFORML （後から取引でお願いすることで変更することもできます）	PRINTFORML （之后请求交易时可以变更）
PRINTFORML   [0]変更する	PRINTFORML   [0]变更
PRINTFORML   [1]変更しない	PRINTFORML   [1]不变更
PRINTFORMW  二人称を変更しません。	PRINTFORMW  不变更二人称。

PRINTFORMW 調教開始時イベント『フェリシエルの場合』	PRINTFORMW 调教开始事件『弗理希艾尔的场合』
PRINTFORMW 「……ずっと聞こうと思っていたことを聞くわね」	PRINTFORMW 「……一直想问你一些事」

PRINTFORMW 「そちらのメイドさんは%CNAMET(TARGET, "二人称")%の……恋人、じゃないのかしら？」	PRINTFORMW 「那边的女仆是%CNAMET(TARGET, "二人称")%的…恋人吗？」
PRINTFORMW 「私なんかよりその子との時間を大事にするべきだと思うのだけれど」	PRINTFORMW 「比起我，更应该珍惜和她在一起的时间吧。」
PRINTFORMW %CALLNAME%の視線に、%CALLNAME:ASSI%が答える。	PRINTFORMW 迎着%CALLNAME%的视线、%CALLNAME:ASSI%回答道。
PRINTFORMW 「恐縮でございます、"奥様"……」	PRINTFORMW 「真是对不起呢，"太太"……」
PRINTFORMW 「%CNAME("一人称")%は%CNAME("主人")%のメイドです」	PRINTFORMW 「%CNAME("一人称")%只是%CNAME("主人")%的女仆」
PRINTFORMW 「%CNAME("主人")%のご意志を尊重致します」	PRINTFORMW 「绝对遵从%CNAME("主人")%的意志」
PRINTFORMW 心なしかこちらに向けて来る視線が鋭い気がする……	PRINTFORMW 有意无意地把视线投向这边，撩拨着敏感的气氛……
PRINTFORMW 手招きされたので近づいてみると、	PRINTFORMW %CALLNAME%招手示意%CALLNAME:MASTER%过来。
PRINTFORMW 睨むような目で一言だけ「マザコン…」と耳打ちされた。	PRINTFORMW 眼神中透露着不满，在耳边说了一句「恋母控…」。

PRINTFORMW 「とんでもございません、"奥様"……」	PRINTFORMW 「非常抱歉，"太太"……」
PRINTFORMW 「%CNAME("一人称")%は%CNAME("主人")%のメイドに過ぎません」	PRINTFORMW 「%CNAME("一人称")%只不过是%CNAME("主人")%的女仆而已」
PRINTFORMW 「%CNAME("主人")%の助けとなることが%CNAME("一人称")%の望みでございます」	PRINTFORMW 「%CNAME("一人称")%只不过是帮助%CNAME("主人")%把欲望降临在你身上」
PRINTFORMW 言葉こそ丁寧だが、面白がっているのが丸分かりだ。	PRINTFORMW 虽然言辞十分礼貌，但是其中隐约有些莫名的意味。

PRINTFORMW 意地悪そうな声で「マザコン♪」と耳打ちしてきた。	PRINTFORMW 一副坏心眼的模样，在耳边说了一句「恋母控…」。
PRINTFORMW 「何だかよく分からない関係よね、あなたたち……」	PRINTFORMW 「似乎没有搞清什么关系呢，你啊……」
CALL SET_CEVENT, "アドバイザー：フェリシエル"	CALL SET_CEVENT, "助手：弗理希艾尔"

PRINTFORMW 「まあ、私がとやかく口を挟むことでは無いかもしれないわね」	PRINTFORMW 「看来，现在这个情况似乎不适合我插嘴呢」
PRINTFORMW 調教開始時イベント『さくらの場合』	PRINTFORMW 调教开始事件『樱の場合』
PRINTFORMW 「先に聞いておきたいのだけれど…何でこの場に%CNAME("助手")%が居るのかしら」	PRINTFORMW 「我想先问一下，为什么%CNAME("助手")%会在这里当助手啊」
PRINTFORMW %CALLNAME%からの目線が痛い……	PRINTFORMW %CALLNAME%的视线有些刺人……
PRINTFORMW さすがにこの場に%CALLNAME:ASSI%を連れてきたのは失敗だったろうか？	PRINTFORMW 真不愧是主人公呢，想到把%CALLNAME:ASSI%带到这里来，看样子失败了吧？
PRINTFORMW 「ごめんなさい、お母さん。%CNAME("主人")%は悪くないんです」	PRINTFORMW 「对不起，妈妈。%CNAME("主人")%不是个坏人哦」
PRINTFORMW 「%CNAME("一人称")%がお願いしたことなんです。色々あって……魂が必要だったんです」	PRINTFORMW 「是%CNAME("一人称")%主动拜托做色色的事情的……因为必须要有灵魂」
PRINTFORMW 「それに、もっと%CNAME("主人")%と一緒に居たくて…だから、%CALLNAME:FINDCHARA(NO, 1)%さんにお願いしたの」	PRINTFORMW 「而且呢，也非常想要和%CNAME("主人")%住在一起，特地拜托了%CALLNAME:FINDCHARA(NO, 1)%」
PRINTFORMW %CALLNAME:MASTER%を庇う%CALLNAME:ASSI%の言葉に、%CALLNAME%は深いため息をついた。	PRINTFORMW 听着%CALLNAME:ASSI%为%CALLNAME:MASTER%辩解的话，%CALLNAME%深深叹了一口气。
PRINTFORMW 「そう、そういうことなのね…%CNAME("助手")%が退院したときは、私の術が効いたのかと思っていたけれど」	PRINTFORMW 「原来是这样啊……%CNAME("助手")%出院的时候，我还以为是我的法术很有效呢」
PRINTFORMW 「二人には普通の人生を送って欲しかったのに、ままならないものね」	PRINTFORMW 「希望你们二人能够过上普通人的生活、随心所欲地活着」
PRINTFORMW 「%CNAME("一人称")%、こうなったことを後悔してません。むしろ嬉しいんです」	PRINTFORMW 「%CNAME("一人称")%，我不后悔变成这样。反而很高兴哦」
PRINTFORMW 「だから…お母さんと%CNAME("主人")%にも、仲良くして欲しいんです。駄目、ですか？」	PRINTFORMW 「所以……希望妈妈也能和%CNAME("主人")%好好相处，可以吗？」
PRINTFORMW 「仲良くの意味が違います！」	PRINTFORMW 「这里说的关系好，可不是平时那种！」
PRINTFORMW 「もう本当にこの子たちは……いったい誰に似たんだか」	PRINTFORMW 「这孩子已经……到底像谁呢」
PRINTFORMW その声には諦めの色が濃く滲み出ている……	PRINTFORMW 声音中透露着浓浓的无奈……
PRINTFORML  既に%CALLNAME:TARGET%を勧誘済みのセーブデータであるため、	PRINTFORML  因为%CALLNAME:TARGET%是已经被劝诱的存档数据。
PRINTFORMW  口上の初期設定画面を呼び出します。	PRINTFORMW  呼出口上的初期设定画面。
PRINTFORMW 「……それじゃあ、始めましょうか」	PRINTFORMW 「……那么，开始吧」
PRINTFORMW 神妙な声になって%CALLNAME%が言う。	PRINTFORMW %CALLNAME%用微妙的语气说道。
PRINTFORMW 「あくまでこれは性欲処理よ」	PRINTFORMW 「这只是处理性欲罢了」
PRINTFORMW 「できれば%CNAME("一人称")%に全てを任せて、じっとしていて欲しいけれど」	PRINTFORMW 「可以的话，请全部交给%CNAME("一人称")%做，你一直就这样别动就可以了」
PRINTFORMW 「触りたければ、%CNAME("二人称")%の自由にしても……いいわ」	PRINTFORMW 「如果想摸的话，也不是不可以……这是%CNAME("二人称")%的自由」
PRINTFORMW 顔を背けながら%CALLNAME%は組んでいた腕を解き、あなたに身を差し出した……	PRINTFORMW %CALLNAME%把脸转过去，张开双臂，向主人公献上了身体……
PRINTFORMW 「私達は親子だから本番は絶対ダメだけど、お尻になら挿れてもいいわ」	PRINTFORMW 「我们是亲生母子，所以做爱是绝对不行的，但是用屁股来做什么的还是可以啦」
PRINTFORMW 「大丈夫よ。　昔……お父さんも使った事あるから、浮気にはならないでしょう？」	PRINTFORMW 「没关系的，以前你的父亲也这么做过，这可不是什么出轨哦」
PRINTFORMW 「性処理してあげるとは言ったけれど、本番が出来ないと逆効果かもしれないわね」	PRINTFORMW 「虽然说了会帮你处理性欲，但是如果不能做爱的话，说不定会有反效果呢」
PRINTFORMW 「%CNAME("一人称")%が出来る最大限の譲歩として、お口や胸……後はそうね、素股ならしてあげてもいいわ」	PRINTFORMW 「%CNAME("一人称")%作为最大限度的让步，嘴巴和胸部……然后呢，还可以让你股交哦」
PRINTFORMW 「%CNAME("二人称")%が満足するまで付き合ってあげるから、それで我慢なさいな」	PRINTFORMW 「会让%CNAME("二人称")%感到满意为止的，就先忍耐一下吧」
CALL PRINT_STR, @"「%TEXTR("好きよ/愛してるわ")%_BHH_」_L"	CALL PRINT_STR, @"「%TEXTR("好喜欢啊/我爱你")%_BHH_」_L"
CALL PRINT_STR, @"「%TEXTR("家族としてよ、もちろん/家族だものね、当然でしょ？/照れないの、家族じゃない？")%_HH_」_L"	CALL PRINT_STR, @"「%TEXTR("作为家人，当然了/因为是家人嘛，那是当然的吧？/不会害羞的，不是家人嘛？")%_HH_」_L"
CALL PRINT_STR, @"「%TEXTR(@"今日は…%CNAME("一人称")%の中に出して欲しいの……/今日は出来ちゃう日だから……ね？")%_HH_」_W"	CALL PRINT_STR, @"「%TEXTR(@"今天…在%CNAME("一人称")%的身体中释放欲望吧……/今天也要好好射出来，是吧？")%_HH_」_W"
CALL PRINT_STR, @"「%TEXTR(@"普段は%CNAME("二人称")%の%CNAME("一人称")%だけど/学校では先生と生徒だから")%……%TEXTR("今だけは甘えさせてね/今だけは恋人同士よ")%」_W"	CALL PRINT_STR, @"「%TEXTR(@"平时%CNAME("二人称")%和%CNAME("一人称")%是家人/在学校里是老师和学生")%……%TEXTR("现在让我撒娇吧/现在就是恋人了")%」_W"
CALL PRINT_STR, @"「%CNAME("主人")%_HH_　…%TEXTR("ふふっ、新鮮な響きね/普段と違う呼び方も新鮮ね")%」_L"	CALL PRINT_STR, @"「%CNAME("主人")%_HH_　…%TEXTR("呵呵，听起来很新鲜/和平常不一样的称呼也很新鲜呢")%」_L"
CALL PRINT_STR, @"「%CNAME("一人称")%と%TEXTR("したいのね？/エッチな事する？")%_HH_」_W"	CALL PRINT_STR, @"「和%CNAME("一人称")%%TEXTR("在一起，想要吗？/做色色的事情吗？")%_HH_」_W"
CALL PRINT_STR, @"「%CNAME("一人称")%%TEXTR("は準備万端だから/の準備はＯＫだから")%、何時でも襲っていいのよ_HH_」_W"	CALL PRINT_STR, @"「%CNAME("一人称")%%TEXTR("一切准备就绪/已经准备OK了")%，随时都可以袭击哟_HH_」_W"
CALL PRINT_STR, @"「……%TEXTR("学校/授業")%はどうしたのかしら？」_L"	CALL PRINT_STR, @"「……%TEXTR("在学校/上课")%觉得怎么样？」_L"
CALL PRINT_STR, @"「そんな%TEXTR("イケナイ子/悪い子")%に先生は育てた覚えはありませんよ？」_W"	CALL PRINT_STR, @"「老师可不记得有培养过这样的%TEXTR("坏男孩/坏孩子")%哟」_W"
CALL PRINT_STR, @"「罰として、先生%TEXTR("と課外授業に付き合ってもらいますからね/と保健体育を勉強してもらいますからね")%♪」_W"	CALL PRINT_STR, @"「作为惩罚，和老师一起%TEXTR("进行课外教学吧/补习保健体育吧")%♪」_W"
PRINTFORMW 「ほーら、まずは先生と唾液の交換をしましょうねー♪」	PRINTFORMW 「呐，先和老师交换一下唾液吧♪」
CALL PRINT_STR, @"「%TEXTR("ちゅっ……/はむっ……んちゅっ")%_BHH_」_W"	CALL PRINT_STR, @"「%TEXTR("啾……/哈嗯……呣啾")%_BHH_」_W"
PRINTFORML 「成り行きでこんなことになってしまったけれど……」	PRINTFORML 「虽然最后还是变成了这样……」
PRINTFORMW 「%CNAME("一人称")%はあくまで%CNAME("二人称")%の性欲処理に付き合ってあげるだけですからね」	PRINTFORMW 「%CNAME("一人称")%只是陪%CNAME("二人称")%处理性欲而已，才不是在交往什么的」
PRINTFORMW 「こ、こら、がっつかないの！」	PRINTFORMW 「喂、喂、不要咬啊！」
PRINTFORMW 「すっきりしたらちゃんと勉強もするのよ？」	PRINTFORMW 「如果觉得舒服了，要好好地学习哟？」
PRINTFORMW 「ほら、さっさと済ませちゃいましょう」	PRINTFORMW 「好啦，赶快结束吧」
PRINTFORMW 「あんまりジロジロ見ないで…　なんだか恥ずかしいわ」	PRINTFORMW 「不要老是盯着我看……总觉得有点害羞」
PRINTFORMW %CALLNAME:TARGET%は目を逸らしてモジモジしている……	PRINTFORMW %CALLNAME:TARGET%移开视线畏缩不前……
CALL PRINT_STR, @"「%CNAME("二人称")%は本当に%TEXTR("エッチな/いやらしい")%事が好きなのね」_L"	CALL PRINT_STR, @"「%CNAME("二人称")%真的很喜欢这种%TEXTR("色色/坏坏")%的事情呢」_L"
CALL PRINT_STR, @"「%TEXTR("まったく誰に似たのかしらね/お父さんに似ちゃったのかしらね/私を見習って少しは自制なさいな")%……」_W"	CALL PRINT_STR, @"「%TEXTR("真像那个谁呢/看起来很像爸爸呢/我应该学着克制一下了")%……」_W"
PRINTFORMW %CALLNAME:TARGET%は眼鏡を直すと、不敵に微笑んだ	PRINTFORMW %CALLNAME:TARGET%扶正了眼睛，露出无敌的微笑
CALL PRINT_STR, @"「%CNAME("一人称")%もね、本当は%TEXTR("身体で触れ合うことは嫌いじゃないのよ/性行為を禁止したいわけじゃないのよ")%」_L"	CALL PRINT_STR, @"「其实，%CNAME("一人称")%也%TEXTR("不讨厌身体接触/不想禁止性行为")%」_L"
PRINTFORML 「%CNAME("二人称")%の将来のためを思って言ってるの」	PRINTFORML 「这是为了%CNAME("二人称")%的将来着想」
PRINTFORMW 「たとえ契約であろうと、踏み越えてはならない一線というものがあることは分かってちょうだい」	PRINTFORMW 「要明白即使是契约，也有不能跨越的底线」
PRINTFORMW 「このままずっと%CNAME("一人称")%にベットリというわけには行かないでしょう？」	PRINTFORMW 「不能就一直和%CNAME("一人称")%这样睡觉吧？」
PRINTFORMW 「それとも、%CNAME("一人称")%みたいな年上の女性が好みなのかしら？」	PRINTFORMW 「还是说，喜欢%CNAME("一人称")%这种年纪大的女性吗？」
CALL PRINT_STR, @"「先生と%TEXTR("イケナイ/危ない/素敵な")%%TEXTR("個別レッスン/個人指導/課外講習")%したいのかしら？」_L"	CALL PRINT_STR, @"「老师的%TEXTR("坏坏/危险/无敌")%%TEXTR("单人课程/私人指导/课外补习")%，想参加吗？」_L"
CALL PRINT_STR, @"「%TEXTR("最近調子に乗ってるみたいだけど/何でも先生が言う事を聞くと思って")%%TEXTR("侮らないでもらいたいわね/舐めないで欲しいわね")%」_W"	CALL PRINT_STR, @"「%TEXTR("最近好像得意忘形了/不管是什么老师都会听的")%，%TEXTR("但是不管怎么样请不要犹豫/希望不要这样舔了啊")%」_W"
CALL PRINT_STR, @"「%CNAME("二人称")%は%CNAME("一人称")%じゃないとダメなのね　%TEXTR("もう……しょうがない子ね/まったく……ワガママなんだから")%」_L"	CALL PRINT_STR, @"「因为是%CNAME("二人称")%才会答应做这种事，不然%CNAME("一人称")%是不会允许的呢。%TEXTR("唉……真是让人没办法的孩子/真是……太任性了")%」_L"
CALL PRINT_STR, @"「%TEXTR("するからには満足するまで付き合ってもらうわよ/やるからには覚悟しなさい、たっぷり絞ってあげるんだから")%_HH_」_W"	CALL PRINT_STR, @"「%TEXTR("既然你打算干，就请你陪我到满意为止。/既然要做，就要做好心理准备，我会竭尽全力的。")%_HH_」_W"
PRINTFORML 「私ね、思うんだけど……」	PRINTFORML 「我啊，也是这么想的……」
CALL PRINT_STR, @"「%TEXTR("先生として/教師として")%厳しく接してる%TEXTR("ことに対して、何だかむしろ興奮してないかしら？/のをプレイの一種だと思ってない？")%」_L"	CALL PRINT_STR, @"「%TEXTR("作为老师/作为教师")%对于严厉的接触%TEXTR("不觉得兴奋吗？/不觉得是性玩法的一种吗？")%」_L"
CALL PRINT_STR, @"「%TEXTR(@"ほんとうにもう、下半身が正直なんですから/何だか%CNAME("二人称")%には何を言ってもしょうがないって気になってくるわね……")%」_W"	CALL PRINT_STR, @"「%TEXTR(@"真是的，下半身已经很老实地立正了呢/总觉得对%CNAME("二人称")%说什么都不会在意起来……")%」_W"
PRINTFORML 「学校では%TEXTR("教師と生徒/駄目")%だってあれほど言い聞かせてるのに」	PRINTFORML 「已经告诉过你在学校里是%TEXTR("老师和学生……/不行的")%」
CALL PRINT_STR, @"「言葉だけでは懲りないというのなら、もっと%TEXTR("厳しい/激しい/ハード")%な%TEXTR("個別調教/性的教育/調教指導")%が必要のようね」_L"	CALL PRINT_STR, @"「如果光靠说还不能让你吸取教训的话，那么更加%TEXTR("严厉/激烈/艰难")%的%TEXTR("个人调教/性教育/调教指导")%就十分有必要了呢」_L"
CALL PRINT_STR, @"「先生を%TEXTR("呼び出した/連れて来た")%事を%TEXTR("後悔させてあげますから/反省させてあげますから")%、覚悟しなさい」_W"	CALL PRINT_STR, @"「对于把老师%TEXTR("叫出来/带过来")%这件事，%TEXTR("会让你后悔的/会让你反省的")%，做好觉悟吧」_W"
PRINTFORML #!#お叱りイベントＶ中出し	PRINTFORML #!#斥责活动V中出
PRINTFORMW 「次からは気を付けるように！」	PRINTFORMW 「下不为例了！」
PRINTFORMW 「……さっきのあれは、事故よ。だから、忘れましょう」	PRINTFORMW 「………刚才那个是意外哦。所以快点忘了吧」
PRINTFORMW 「無かったことにしてあげるから、次は自制して頂戴。本番はしないって、約束したでしょう？」	PRINTFORMW 「我会当作没发生过，下次请自制点。不能直接插入做爱，不是已经约好了吗？」
PRINTFORMW 「もう二度目は無いからね。約束を守らないなら、%CNAME("一人称")%にも考えがあるんだから」	PRINTFORMW 「不能再有第二次了。如果不遵守约定的话、%CNAME("一人称")%也是有自己的考虑的」
PRINTFORMW どうやら%CALLNAME%は挿入してしまった件については許してくれたようだ。	PRINTFORMW 看起来%CALLNAME%终于原谅了插入的事情。
PRINTFORMW しかし、%CALLNAME%に[素股]を警戒されてしまった！	PRINTFORMW 注意%CALLNAME%开始对[素股]有所警戒了！
PRINTFORML  ただし、再度事故を発生させても好感度が低下する以外のペナルティはありません。	PRINTFORML 但是，即使再次发生“意外”，除了好感度下降以外也不会有其他处罚。
PRINTFORML  本番を解禁したい場合は、まずは好感度を上昇させてみましょう。	PRINTFORML  想解除限制的话，首先想办法提升好感度吧。
PRINTFORMW 「%CNAME("一人称")%の身体じゃ、今一物足りないかもしれないけど」	PRINTFORMW 「%CNAME("一人称")%的身体，或许现在有点不足，不过」
PRINTFORMW 「%CNAME("二人称")%が好きな人にしてあげるのを想像して……触ってみなさい」	PRINTFORMW 「不过我还是想成为%CNAME("二人称")%成为喜欢的人呢……摸摸看吧」
PRINTFORMW 「フフ……%CNAME("一人称")%にご奉仕してもらいましょうか」	PRINTFORMW 「呼呼……请为%CNAME("一人称")%服务吧」
PRINTFORMW 「ダメじゃないけど…恥ずかしいわ……」	PRINTFORMW 「虽然不是不行……可是好害羞啊……」
CALL PRINT_STR, @"「%TEXTR("はぁ/んっ")%_HH_……%TEXTR("んぁっ/あんっ")%_HH_」_W"	CALL PRINT_STR, @"「%TEXTR("哈/嗯")%_HH_……%TEXTR("嗯啊/啊")%_HH_」_W"
PRINTFORMW 「%CNAME("二人称")%が揉むからこんなに大きくなってしまって……」	PRINTFORMW 「因为%CNAME("二人称")%一直这么揉都变大了……」
CALL PRINT_STR, @"「%TEXTR("ああんっ/あぁっ/んっ")%_BHH_　%TEXTR("いいっ/もっとしてぇ/気持ちいいのぉ/")%_BHH_」_W"	CALL PRINT_STR, @"「%TEXTR("啊呣/啊啊/嗯")%_BHH_　%TEXTR("好棒/再更用力点/好舒服啊/")%_BHH_」_W"
CALL PRINT_STR, @"「%TEXTR("ひっ/ひんっ/ひぅ")%_BHH_　%TEXTR("強くされるの好きぃ/もっと強く、ああんっ/いいっ、もっとぉ")%_BHH_」_W"	CALL PRINT_STR, @"「%TEXTR("哦/嗯/呜")%_BHH_　%TEXTR("喜欢被强迫呢/更加强硬点、啊啊/好棒，继续")%_BHH_」_W"
CALL PRINT_STR, @"「%TEXTR("ん/んぁ/んうっ")%_HH_……%TEXTR("あん/あっ/あぁっ/あんっ")%_HH_」_W"	CALL PRINT_STR, @"「%TEXTR("嗯/嗯啊/嗯嗯")%_HH_……%TEXTR("啊啊/啊唔/啊呣/啊")%_HH_」_W"
CALL PRINT_STR, @"「%TEXTR("あんっ/あっ/んぅ")%_HH_　%TEXTR("もっとっ/いいっ/ああっ")%_HH_」_W"	CALL PRINT_STR, @"「%TEXTR("啊呣/啊/呣")%_HH_　%TEXTR("更多/好棒/啊啊")%_HH_」_W"
CALL PRINT_STR, @"「%TEXTR("そうよ/もっとして/感じてるの、解るでしょう")%_HH_……」_W"	CALL PRINT_STR, @"「%TEXTR("是啊/更多，更多/感觉到了，明白了")%_HH_……」_W"
CALL PRINT_STR, @"「%TEXTR("しゃぶって欲しいの……/吸って欲しいの……/つねって欲しいの……")%%TEXTR("ああっ/いいっ/あんっ")%_BHH_」_W"	CALL PRINT_STR, @"「%TEXTR("想要吃吗……/想要吸吗……/想要含住吗……")%%TEXTR("啊啊！/好棒/啊呣")%_BHH_」_W"
PRINTFORMW 「%CNAME("一人称")%がリードしてあげるから、舌を伸ばして……れろ……」	PRINTFORMW 「%CNAME("一人称")%会引导你的，来伸长舌头……哎呀……」
PRINTFORML （私は……母親として、%CONDS("間柄", MASTER)%の持て余してる性欲を受け止めてあげているだけ……）	PRINTFORML （我……作为母亲，只是接受了%CONDS("間柄", MASTER)%无法压抑的性欲而已……）
PRINTFORML （だから……それまでは……）	PRINTFORML （所以……在那之前……）
CALL PRINT_STR, "「仕方のない子……_HH_」_W_"	CALL PRINT_STR, "「真是让人没办法的孩子……_HH_」_W_"
CALL PRINT_STR, "「はむっ…ちゅっ……_HH_」_W_"	CALL PRINT_STR, "「哈唔…啾…_HH_」_W_"
CALL PRINT_STR, "「仕方ない子…ね」_W_"	CALL PRINT_STR, "「真是让人没办法的孩子……呢」_W_"
CALL PRINT_STR, "「はむっ…ちゅっ……」_W_"	CALL PRINT_STR, "「哈唔…啾……」_W_"
PRINTFORMW 「はむ…んんっ」	PRINTFORMW 「嗯……嗯哼」
PRINTFORMW 「こ…こら、しは(舌)をひ(入)れないで……」	PRINTFORMW 「哎……哎呀，不可以伸舌头进来……」
CALL PRINT_STR, "「れろ…ちゅぱ……_HH_」_W_"	CALL PRINT_STR, "「噜…啾吧……_HH_」_W_"
CALL PRINT_STR, "「れろ…ちゅぱ……」_W_"	CALL PRINT_STR, "「噜…啾吧……」_W_"
CALL PRINT_STR, "「ん…ちゅ…ちゅぱ……_HH_」_W_"	CALL PRINT_STR, "「嗯…噜…啾吧……_HH_」_W_"
CALL PRINT_STR, "「ん…ちゅ…ちゅぱ……」_W_"	CALL PRINT_STR, "「嗯…噜…啾吧…………」_W_"
CALL PRINT_STR, "「ちゅぱ…ちゅっ……んむ、ちゅる……_HH_」_W_"	CALL PRINT_STR, "「啾吧…啾芙……嗯、啾噜……_HH_」_W_"
CALL PRINT_STR, "「ちゅぱ…ちゅっ……んむ、ちゅる……」_W_"	CALL PRINT_STR, "「啾吧…啾芙……嗯、啾噜……」_W_"
PRINTFORMW 「%CNAME("一人称")%にこんな恥ずかしい事させて……もう……」	PRINTFORMW 「让%CNAME("一人称")%做这种丢脸的事……已经，已经……」
CALL PRINT_STR, @"「%TEXTR("焦らさずに/いじめないで")%早くココ%TEXTR("にちょうだい/を犯して欲しいの")%_HH_」_W"	CALL PRINT_STR, @"「%TEXTR("不要焦急呀/不要欺负呀")%，快点来这里，%TEXTR("快给我/想要被你侵犯")%_HH_」_W"
CALL PRINT_STR, @"「恥ずかしいのに……%TEXTR("はぁ/はぁん")%_HH_」_W"	CALL PRINT_STR, @"「明明很害羞……%TEXTR("哈/哈嗯")%_HH_」_W"
PRINTFORMW 「変態なんだから……もう」	PRINTFORMW 「因为是变态嘛……已经，已经」
CALL PRINT_STR, @"「%TEXTR("あっ/んっ")%_HH_……抜いちゃうの？」_W_"	CALL PRINT_STR, @"「%TEXTR("唉/啊")%_HH_……拔出来吗」_W_"
PRINTFORMW 「そりゃ本音を言うなら……本物が欲しいけど、絶対にダメよ」	PRINTFORMW 「说实话……虽然想要真货，但是绝对不行啊」
CALL PRINT_STR, @"「%TEXTR("はぁ…はぁ……/んっ…はぁ……")%%TEXTR("んぅっ/んんぅ")%……%TEXTR("はぁっ/はぁん")%_HH_」_W"	CALL PRINT_STR, @"「%TEXTR("哈啊…哈啊…/嗯…啊……")%%TEXTR("唔/嗯啊")%……%TEXTR("哈/哈哦")%_HH_」_W"
CALL PRINT_STR, @"%TEXTR("腸液/体液")%でテラテラと妖しく濡れていた_W"	CALL PRINT_STR, @"%TEXTR("肠液/汗水")%让身体变得濡湿，显得十分妖艳_W"
PRINTFORMW 「こんな大きいのを%CNAME("一人称")%に使わせるなんて……」	PRINTFORMW 「竟然让%CNAME("一人称")%用这么大的东西……」
PRINTFORMW 「%CNAME("一人称")%このぐらいの大きさじゃ物足りないの」	PRINTFORMW 「这么大的还不能满足%CNAME("一人称")%啊」
PRINTFORMW 「もっと太くて大きいのにしてくれると嬉しいけど……」	PRINTFORMW 「如果能给我更大的就好了……」
PRINTFORMW 「もうお仕舞い？」	PRINTFORMW 「已经结束了吗？」
CALL PRINT_STR, @"「%CNAME("一人称")%は準備万端だから、こっちの穴を使ってくれてもいいのよ_HH_」_W"	CALL PRINT_STR, @"「%CNAME("一人称")%一切都准备好了，用这边的洞也行哦_HH_」_W"
PRINTFORMW 「%CNAME("一人称")%ね……もうこのぐらいの大きさじゃ物足りないのよ……」	PRINTFORMW 「啊，这种尺寸的……%CNAME("一人称")%已经没法满足了……」
PRINTFORMW 「もっと太くて大きいのを入れてもいいのよ？」	PRINTFORMW 「可以用更粗更大的吗？」
PRINTFORMW 「もうお仕舞いにするのね……」	PRINTFORMW 「已经结束了吧……」
CALL PRINT_STR, "「こ、こんなの駄目よっ」_W_"	CALL PRINT_STR, "「这、这样可不行啊」_W_"
CALL PRINT_STR, "「す、すぐにっ、抜きなっさ、…いっ_HH_」_W_"	CALL PRINT_STR, "「马上、马上、拔掉……_HH_」_W_"
CALL PRINT_STR, "「んっ、ふっ、ああっ…_HH_」_W_"	CALL PRINT_STR, "「嗯、啊、啊啊啊…_HH_」_W_"
PRINTFORMW 「い、いま止めれば怒らない、からぁっ…！」	PRINTFORMW 「现、现在停手我就不会生气的，所以……！」
CALL PRINT_STR, "「やめ…、なさ、ひんっ…_HH_ _HH_ _HH_」_W_"	CALL PRINT_STR, "「停下……喂，喂…_HH_ _HH_ _HH_」_W_"
CALL PRINT_STR, "(やだ、この子…本気で種付けする目になってるっ_HH_)_W_"	CALL PRINT_STR, "(讨厌，这个孩子…这眼神是真的想要播种呢_HH_)_W_"
CALL PRINT_STR, "(さっきから気持ちいい所ばかり責められてるっ)_W_"	CALL PRINT_STR, "(从一开始就因为被责备而心情舒畅)_W_"
CALL PRINT_STR, "(イケないことなのに…イケないことなのにっ)_W_"	CALL PRINT_STR, "(明明不行的…明明这种事情是不行的)_W_"
CALL PRINT_STR, @"(どんどん%CONDS("間柄", PLAYER)%に弱いところ知られちゃう……_HH_ _HH_ _HH_)_W_"	CALL PRINT_STR, @"(咚咚，%CONDS("間柄", PLAYER)%的弱点被知道了……_HH_ _HH_ _HH_)_W_"
CALL PRINT_STR, "「ふっ、んぐっ…ひぁっ_HH_」_W_"	CALL PRINT_STR, "「哼，呼呼……哈芙_HH_」_W_"
PRINTFORMW 「い、いい加減に止めないと、%CNAME("一人称")%怒るわよっ！？」	PRINTFORMW 「不、不适可而止的话，%CNAME("一人称")%可是要生气咯！？」
PRINTFORMW 「私にこんな獣みたいに恥ずかしい格好をさせるなんて……」	PRINTFORMW 「居然让我像动物一样趴着，好害羞……」
PRINTFORMW 「もう覚悟は出来ていますから……存分に犯してもいいわ」	PRINTFORMW 「我已经做好了心理准备……可以尽情地侵犯我了」
PRINTFORMW 「%CNAME("一人称")%のお尻が良く見えて素敵だなんて……バカ、何を言ってるの……」	PRINTFORMW 「居然说%CNAME("一人称")%的屁股看起来很棒……笨蛋，你在说什么……」
PRINTFORMW 「こらっ、ダメですっ、ダメよっ、ダメっ！！　やめなさいっ！！　あぁあああっ！！」	PRINTFORMW 「喂，不行，不行，不行！别这样！啊啊啊啊啊！！」
PRINTFORMW 「本当は親子でこんな事するなんて、イケナイ事よ」	PRINTFORMW 「母子之间做这种事，真的是太不像话了」
PRINTFORMW 「それでも……%CNAME("二人称")%がしたいならさせてあげるけど」	PRINTFORMW 「尽管如此……%CNAME("二人称")%想要做的话，我也会让你做的」
PRINTFORMW 「ちゃんとした彼女が出来たらやめるって、%CNAME("一人称")%と約束してね」	PRINTFORMW 「和%CNAME("一人称")%做约定，交到女朋友就不再做这种事了」
PRINTFORMW 「待って……ゆっくり入れて……」	PRINTFORMW 「等等……慢慢地进去……」
PRINTFORMW 「そう…少しづつ動いてくれるなら平気よ……」	PRINTFORMW 「没错，如果慢慢动的话，也是可以忍受的……」
CALL PRINT_STR, @"「%TEXTR("巨根/デカチンポ/大きいの")%%TEXTR("好きぃいい/大好きなのぉ")%_BHH_」_W"	CALL PRINT_STR, @"「%TEXTR("巨根/大鸡鸡/粗粗的")%%TEXTR("好喜欢/最喜欢了")%_BHH_」_W"
CALL PRINT_STR, @"「%TEXTR("乱暴に/好きなように")%%TEXTR("動いて/犯して")%……私を%CNAME("二人称")%だけの%TEXTR("雌/メス")%にしてぇ_BHH_」_W"	CALL PRINT_STR, @"「%CNAME("二人称")%%TEXTR("粗暴地/随心所欲地")%%TEXTR("侵犯着")%……我的%TEXTR("雌穴/小穴")%_BHH_」_W"
CALL PRINT_STR, @"「%TEXTR("＿/ひっ、/いっ、/くっ、")%%TEXTR("ま…待ってっ/い、痛い……/さ、裂けちゃう……っ")%」_W"	CALL PRINT_STR, @"「%TEXTR("＿/呼芙、/咿、/库、")%%TEXTR("嗯……等一下/疼，疼……/啊，要裂开了")%」_W"
CALL PRINT_STR, @"「%CNAME("一人称")%ね、%CNAME("二人称")%%TEXTR("とこの体位でするの好きよ/とするこの体位が好き/のしてくれるこの体位が一番好きよ")%_BHH_」_W"	CALL PRINT_STR, @"「%CNAME("一人称")%，啊，%CNAME("二人称")% ，%TEXTR("喜欢以这个体位做哟/喜欢这样的体位/最喜欢这个体位了")%_BHH_」_W"
PRINTFORMW %CALLNAME:TARGET%は%CALLNAME:PLAYER%に両足を絡めて快感に溺れている	PRINTFORMW %CALLNAME:TARGET%两腿缠绕%CALLNAME:PLAYER%，沉溺在快感中。
CALL PRINT_STR, @"「%CNAME("一人称")%ね、%CNAME("二人称")%の%TEXTR("大きいチンポ/デカチン/巨根")%%TEXTR("大好きなのよ/で犯されたいの/見るとご奉仕したくなるのよ")%_BHH_」_W"	CALL PRINT_STR, @"「%CNAME("一人称")%啊、%CNAME("二人称")%的%TEXTR("大鸡巴/大肉棒/巨根")%%TEXTR("最喜欢了/侵犯着/一看见就想侍奉呢")%_BHH_」_W"
CALL PRINT_STR, @"「%TEXTR("あん/はぁん/んっ")%_BHH_　%CNAME("二人称")%ったら%TEXTR("大きい/太い/おっきい")%わ_BHH_」_W"	CALL PRINT_STR, @"「%TEXTR("啊/哈嗯/嗯啊")%_BHH_　%CNAME("二人称")%，糟糕%TEXTR("太粗/太大/太粗壮")%了_BHH_」_W"
CALL PRINT_STR, @"「%TEXTR("はぁ/くぅ/んぅ")%_HH_……　%TEXTR("もっと奥まで/深く入れてね/もっと奥までちょうだいっ")%_HH_」_W"	CALL PRINT_STR, @"「%TEXTR("哈/库/嗯")%_HH_……　%TEXTR("再深点/深深插进去吧/请再往里边一点")%_HH_」_W"
CALL PRINT_STR, @"「%CNAME("一人称")%_BHH_　%TEXTR("この体位/これされるの")%%TEXTR("大好きなの/一番好きぃ")%_BHH_」_W"	CALL PRINT_STR, @"「%CNAME("一人称")%_BHH_　%TEXTR("这个体位/这样子做")%，%TEXTR("真是太喜欢了/最喜欢了")%_BHH_」_W"
CALL PRINT_STR, @"「%TEXTR("だめぇ/ダメェ/らめぇ")%_BHH_　%TEXTR("いいのっ/気持ちいいっ/ああっ")%」_W"	CALL PRINT_STR, @"「%TEXTR("不行啊/不行/不行呀")%_BHH_　%TEXTR("好棒/好舒服啊/啊啊啊！")%」_W"
CALL PRINT_STR, @"「%CNAME("一人称")%、%TEXTR("毎日このチンポの事考えちゃってるの……/このチンポが忘れられないの/このチンポの言いなりになっちゃうの")%_BHH_」_W"	CALL PRINT_STR, @"「%CNAME("一人称")%啊，%TEXTR("每天都在想着肉棒的事情……/这根肉棒怎么都忘不了/要听这根肉棒的话呢")%_BHH_」_W"
CALL PRINT_STR, @"「%TEXTR("あぁん/はぁん/んぅ")%_BHH_　%TEXTR("大きいの/いっぱいになっちゃう/おっきいの大好きなの")%_BHH_」_W"	CALL PRINT_STR, @"「%TEXTR("啊呣/哈嗯/嗯")%_BHH_　%TEXTR("太大了/已经塞满了/最喜欢大的了")%_BHH_」_W"
PRINTFORML 「そうね……本番よりはまだマシよね」	PRINTFORML 「如何，比做爱还要舒服吧」
CALL PRINT_STR, @"「%CNAME("一人称")%が性処理してあげるから、遠慮なくお口にいっぱい出しなさいね_HH_」_W_"	CALL PRINT_STR, @"「%CNAME("一人称")%会帮你进行性欲处理的、不用顾虑尽管射出来吧_HH_」_W_"
PRINTFORMW 「%TEXTR("んっ/んっんっ/んんっ")%……%TEXTR("ぢゅるっ/ぢゅるる/ぢゅる")%……%TEXTR("ん/んっ/んん")%……」	PRINTFORMW 「%TEXTR("嗯/嗯嗯/嗯")%……%TEXTR("啾噜/啾噜噜/啾噜")%……%TEXTR("嗯/嗯/嗯")%……」
CALL PRINT_STR, @"「こんな%TEXTR("悪い/ダメな")%母親%TEXTR("でごめんなさい……/でごめんね……")%」_W"	CALL PRINT_STR, @"「这么%TEXTR("坏/没用")%的母亲，%TEXTR("对不起呢……/真是对不起……")%」_W"
CALL PRINT_STR, @"「%TEXTR("はぁ/んぅ/はぁん")%_HH_……_"	CALL PRINT_STR, @"「%TEXTR("哈/嗯/哈嗯")%_HH_……_"
CALL PRINT_STR, @"「%TEXTR("ずっとこうして居たい位よ/これからもご奉仕させてね/ご奉仕で蕩けちゃいそう")%_HH_」_W"	CALL PRINT_STR, @"「%TEXTR("想要一直都这样下去/今后也请让我效劳吧/侍奉的快要去了呢")%_HH_」_W"
CALL PRINT_STR, @"「%TEXTR("じゅるっ/じゅるじゅるるぅ")%……%TEXTR("ぢゅるっ/ぢゅるる")%_HH_…%TEXTR("はぁ……/んっ、っ……/ちゅ……")%」_W"	CALL PRINT_STR, @"「%TEXTR("咀噜咀噜/咀噜咀噜噜")%……%TEXTR("咀噜/咀噜噜")%_HH_…%TEXTR("哈……/嗯、……/啾……")%」_W"
CALL PRINT_STR, @"「%TEXTR("ちゅっ/ちゅるっ")%……%TEXTR("んっ_HH_/んぅう_HH_/ん_HH_……")%%TEXTR("ちゅるっ/じゅるっ/ぢゅるる")%」_W"	CALL PRINT_STR, @"「%TEXTR("咀芙/咀噜")%……%TEXTR("嗯_HH_/嗯唔_HH_/嗯_HH_……")%%TEXTR("咀噜/咀噜/咀噜噜")%」_W"
PRINTFORMW 「%CNAME("一人称")%に%CNAME("二人称")%の感じてるお顔、もっと見せてね……」	PRINTFORMW 「%CNAME("一人称")%会好好观察%CNAME("二人称")%的表情，看有没有让%CNAME("二人称")%觉得舒服哟……」
CALL PRINT_STR, @"「%CNAME("一人称")%に奉仕されて感じちゃってるのね……イケナイ子_HH_」_W"	CALL PRINT_STR, @"「%CNAME("一人称")%的侍奉有让你觉得舒服吗……坏孩子呢_HH_」_W"
CALL PRINT_STR, @"「そんなに可愛い顔されると……%CNAME("一人称")%もっとご奉仕したくなっちゃうじゃない_HH_」_W"	CALL PRINT_STR, @"「看到那么可爱的表情……%CNAME("一人称")%更加想要为你侍奉了呢_HH_」_W"
CALL PRINT_STR, "「んっ_HH_…ぢゅるっ…ちゅ_HH_……」_W_"	CALL PRINT_STR, "「嗯_HH_…咀噜…啾_HH_……」_W_"
CALL PRINT_STR, @"「たーっぷりお仕置きしてあげるから、覚悟しなさいね_HH_」_W_"	CALL PRINT_STR, @"「我会好好惩罚你的，做好觉悟吧_HH_」_W_"
CALL PRINT_STR, @"「%TEXTR("ちゅる/ちゅ/ちゅっ")%_HH_　%TEXTR("ぢゅる/ぢゅるる/ぢゅるっ")%……」_W"	CALL PRINT_STR, @"「%TEXTR("咀噜/啾/啾呣")%_HH_　%TEXTR("咀噜/咀噜/咀噜")%……」_W"
CALL PRINT_STR, @"「%TEXTR("ちゅっ/ちゅぅ")%_HH_……%CNAME("一人称")%、こんなに感じてくれてとっても嬉しいわ_HH_」_W"	CALL PRINT_STR, @"「%TEXTR("啾呣/啾")%_HH_……能有这样的感觉，%CNAME("一人称")%很开心哦_HH_」_W"
CALL PRINT_STR, @"「%TEXTR("イケナイ/エッチな/変態な")%子ね……%TEXTR("たっぷり可愛がってあげる/出なくなるまで絞ってあげるからね")%_HH_」_W"	CALL PRINT_STR, @"「%TEXTR("坏坏/色色/变态")%的孩子……%TEXTR("会好好地疼爱你呢/会把你榨干到射不出来为止哦")%_HH_」_W"
CALL PRINT_STR, @"「%CNAME("一人称")%と%TEXTR("エッチな事/イケナイ事")%してるのに、こんなに感じちゃってるの？_HH_」_W"	CALL PRINT_STR, @"「明明和%CNAME("一人称")%一起做着%TEXTR("色色的事情/坏坏的事情")%，却这么有感觉吗？？？_HH_」_W"
CALL PRINT_STR, @"「これは%TEXTR("きついお仕置き/正しい性教育/きつめの指導")%が必要ね……%TEXTR("覚悟しなさい/たっぷり可愛がってあげるからね")%_HH_」_W"	CALL PRINT_STR, @"「%TEXTR("严厉的惩罚/正确的性教育/严格的指导")%很有必要……%TEXTR("做好觉悟吧/我会好好疼爱你的")%_HH_」_W"
CALL PRINT_STR, @"「そんな%TEXTR("子に/情けない子に")%%TEXTR("育てた覚えはありませんよ/なってしまったの？")%」_W"	CALL PRINT_STR, @"「那样的%TEXTR("孩子/可怜的孩子")%%TEXTR("我不记得有把你教成这样哦/变成这样了吗？")%」_W"
CALL PRINT_STR, @"「%TEXTR("ほらほら/どうしたの？")%_HH_　%TEXTR("こらえてごらんなさいな/この程度で負けてしまうのかしら？")%_HH_」_W"	CALL PRINT_STR, @"「%TEXTR("看招看招/怎么了？")%_HH_　%TEXTR("要继续忍耐一下哦/这种程度就输了吗？")%_HH_」_W"
CALL PRINT_STR, @"「%TEXTR("あんっ/ああん")%_HH_……%TEXTR("はぁん/あぁん/あんっ、あんっ/いいっ")%_HH_」_W"	CALL PRINT_STR, @"「%TEXTR("啊呣/啊啊")%_HH_……%TEXTR("哈嗯/啊啊呣/啊呣、啊呣/咿")%_HH_」_W"
CALL PRINT_STR, @"「%TEXTR("んっ/んぅ")%_HH_……%TEXTR("ぢゅるっ/ぢゅるぢゅるっ")%_HH_…%TEXTR("＿/ちゅっ……/じゅる……")%」_W"	CALL PRINT_STR, @"「%TEXTR("嗯/嗯啊")%_HH_……%TEXTR("咀噜/咀噜咀噜")%_HH_…%TEXTR("＿/咀芙……/咀噜……")%」_W"
CALL PRINT_STR, @"「%TEXTR("ちゅっ/ちゅぅ")%_HH_……%CNAME("一人称")%、こんなに感じてくれてとっても嬉しい_HH_」_W"	CALL PRINT_STR, @"「%TEXTR("咀芙/啾")%_HH_……%CNAME("一人称")%、能有这样的感觉真的很开心哦HH_」_W"
CALL PRINT_STR, @"「%TEXTR("イケナイ/エッチな/変態な")%子ね……%TEXTR("再教育/特別指導")%が必要かしら？_HH_」_W"	CALL PRINT_STR, @"「真是个%TEXTR("坏坏的/色色的/变态的")%孩子……是否有必要%TEXTR("再教育一次/再进行特别指导")%呢？_HH_」_W"
CALL PRINT_STR, "「ふぅ、んん…ぢゅるっ…ちゅぱっ…_HH_」_W_"	CALL PRINT_STR, "「呼、嗯…嗯呣…啾叭…_HH_」_W_"
CALL PRINT_STR, "「ふぅ、んん…ぢゅるっ…ちゅぱっ…」_W_"	CALL PRINT_STR, "「呼、嗯…嗯呣…啾叭…」_W_"
PRINTFORMW 「ずっと%CNAME("一人称")%と、こういうことしたかったんだ？」	PRINTFORMW 「一直都想和%CNAME("一人称")%做这种事情吧？」
CALL PRINT_STR, "「本当にいけない子……_HH_」_W_"	CALL PRINT_STR, "「真是个坏孩子……_HH_」_W_"
CALL PRINT_STR, "「…どこで育て方を間違えたんだか♪」_W_"	CALL PRINT_STR, "「…是哪方面教育出错了吗♪」_W_"
PRINTFORMW 「%CNAME("一人称")%のふともも…気持ちいい？」	PRINTFORMW 「%CNAME("一人称")%的大腿……感觉舒服吗？」
CALL PRINT_STR, "「はむっ…れろ…ちゅぱ……_HH_」_W_"	CALL PRINT_STR, "「哈…嗯…呣咀……_HH_」_W_"
CALL PRINT_STR, "「はむっ…れろ…んちゅ……」_W_"	CALL PRINT_STR, "「哈…嗯…呣咀……」_W_"
PRINTFORMW 「じゅるじゅる…むちゅ……」	PRINTFORMW 「咀噜咀噜…呣啾……」
CALL PRINT_STR, "「ん、む…はぁ…ちゅっ……_HH_」_W_"	CALL PRINT_STR, "「嗯，嗯…哈……咀芙……_HH_」_W_"
CALL PRINT_STR, "「ん、む…はぁ…ちゅっ……」_W_"	CALL PRINT_STR, "「嗯，嗯…哈……咀芙……」_W_"
CALL PRINT_STR, "「ちゅっ、じゅる…んっ……_HH_」_W_"	CALL PRINT_STR, "「咀芙、咀噜…嗯………_HH_」_W_"
CALL PRINT_STR, "「ちゅっ、じゅる…んっ……」_W_"	CALL PRINT_STR, "「咀芙、咀噜…嗯……」_W_"
CALL PRINT_STR, "（母親相手にこんなにギンギンにさせちゃってぇ……）_W_"	CALL PRINT_STR, "（以母亲为对象做这种事情……）_W_"
CALL PRINT_STR, "（母親相手にこんなにギンギンにさせちゃって……）_W_"	CALL PRINT_STR, "（以母亲为对象做这种事情……）_W_"
CALL PRINT_STR, "（…可愛い_HH_）_W_"	CALL PRINT_STR, "（…可爱_HH_）_W_"
PRINTFORM 「んっ…ええ、%CNAME("一人称")%も、	PRINTFORM 「嗯…%CNAME("一人称")%、
CALL PRINT_STR, "気持ち、いいわよ……_HH_」_W_"	CALL PRINT_STR, "舒服点了吧，也许……_HH_」_W_"
PRINTFORM 「んっ…%CNAME("一人称")%も、	PRINTFORM 「嗯…%CNAME("一人称")%、
CALL PRINT_STR, "ちょっと、気持ちいい、かも……」_W_"	CALL PRINT_STR, "稍微、舒服点了吧，也许……」_W_"
CALL PRINT_STR, "「こんなに喜んでくれるなら……もっと気持ちよくしてあげる_HH_」_W_"	CALL PRINT_STR, "「如果你这么高兴的话……我会让你更舒服的_HH_」_W_"
CALL PRINT_STR, "「こんなに喜んでくれるなら……もっと気持ちよくしてあげる」_W_"	CALL PRINT_STR, "「如果你这么高兴的话……我会让你更舒服的」_W_"
CALL PRINT_STR, @"「%CNAME("一人称")%に……こんな事させて、いけない子ね_HH_」_W_"	CALL PRINT_STR, @"「让%CNAME("一人称")%做这种事，真是个坏孩子_HH_」_W_"
CALL PRINT_STR, @"「%CNAME("一人称")%に……こんな事させて、いけない子ね」_W_"	CALL PRINT_STR, @"「让%CNAME("一人称")%做这种事，真是个坏孩子」_W_"
CALL PRINT_STR, @"「どう？、%CNAME("一人称")%にされるの、ふふっ……_HH_」_W_"	CALL PRINT_STR, @"「怎么样？让%CNAME("一人称")%来做吧，呵呵……_HH_」_W_"
CALL PRINT_STR, @"「どう？、%CNAME("一人称")%にされるの、ふふっ……」_W_"	CALL PRINT_STR, @"「怎么样？让%CNAME("一人称")%来做吧，呵呵……」_W_"
CALL PRINT_STR, "「はっ、んっ、はぁ、はぁ……_HH_」_W_"	CALL PRINT_STR, "「哈、嗯、哈、哈……_HH_」_W_"
CALL PRINT_STR, "「はっ、んっ、はぁ、はぁ……」_W_"	CALL PRINT_STR, "「哈、嗯、哈、哈……」_W_"
CALL PRINT_STR, "「はっ、ふっ、はっ、はぁ……_HH_」_W_"	CALL PRINT_STR, "「哈、呼、哈、哈……_HH_」_W_"
CALL PRINT_STR, "「はっ、ふっ、はっ、はぁ……」_W_"	CALL PRINT_STR, "「哈、呼哈、哈……」_W_"
CALL PRINT_STR, "「はっ、はっ、んっ、はぁ……_HH_」_W_"	CALL PRINT_STR, "「哈、哈、嗯、哈……_HH_」_W_"
CALL PRINT_STR, "「はっ、はっ、んっ、はぁ……」_W_"	CALL PRINT_STR, "「哈、哈、嗯、哈……」_W_"
PRINTFORMW  粘膜を触れ合わせているのに挿入できない切なさが%CALLNAME:MASTER%の欲望を煽り立てる……	PRINTFORMW  粘膜互相接触却又不让插入，让%CALLNAME:MASTER%欲火中烧……
PRINTFORMW  二人は言葉も少なく疑似的な性交に夢中になっている……	PRINTFORMW  两人相对无言，就像在梦中性交似的。
CALL PRINT_STR, @"「%CNAME("一人称")%は……%CONDS("間柄", PLAYER)%に"	CALL PRINT_STR, @"「%CNAME("一人称")%是……被%CONDS("間柄", PLAYER)%侵犯」"
CALL PRINT_STR, @"を犯されて感じちゃう悪い母親です_HH_」_W"	CALL PRINT_STR, @"「还能感受到快感的坏母亲」_W"
CALL PRINT_STR, @"「たっぷりお仕置きしてください_BHH_」_W"	CALL PRINT_STR, @"「请多加惩罚我吧_BHH_」_W"
CALL PRINT_STR, @"を犯されて感じちゃう悪い母親です」_W"	CALL PRINT_STR, @"「被侵犯还能感受到快感的坏母亲」_W"
CALL PRINT_STR, @"私は%CONDS("間柄", PLAYER)%%TEXTR("に犯されて/とエッチして")%、%TEXTR("悦んじゃう/感じちゃう")%悪い母親です」_W"	CALL PRINT_STR, @"被%CONDS("間柄", PLAYER)%%TEXTR("侵犯着/抽插着")%还%TEXTR("觉得很开心/产生了快感")%，我是个坏母亲」_W"
CALL PRINT_STR, @"「%TEXTR("んぅう/んぐぅ/んぶぅ")%%TEXTR("＿/……")%%TEXTR("んっ/んっんっ/んんっ")%　%TEXTR("ぢゅる/ぢゅるる/ぢゅる")%……」_W"	CALL PRINT_STR, @"「%TEXTR("嗯唔/噜唔/唔噜")%%TEXTR("＿/……")%%TEXTR("嗯/嗯嗯/嗯哼")%　%TEXTR("咀噜/咀噜噜/咀噜")%……」_W"
CALL PRINT_STR, @"「%TEXTR("ぢゅぼ/ぢゅぼっ/ぢゅぼっ")%%TEXTR("＿/……")%%TEXTR("はぁ……/はぁはぁ……/ふぅん……")%%TEXTR("んぅ、/ん…/んくっ、")%%TEXTR("んっんっ/んっ……/んんっ")%」_W"	CALL PRINT_STR, @"「%TEXTR("咀啵/咀啵/咀啵")%%TEXTR("＿/……")%%TEXTR("哈……/啊哈……/呼……")%%TEXTR("嗯、/嗯…/嗯呼、")%%TEXTR("啊嗯啊嗯/啊嗯……/嗯啊啊")%」_W"
PRINTFORMW %CALLNAME:ASSI%から借りた学生服一式を%CALLNAME:TARGET%に着てもらった	PRINTFORMW %CALLNAME:TARGET%穿上了一套从%CALLNAME:ASSI%那里借来的学生服。
PRINTFORMW 「うちの学校の制服可愛いから、一度着てみたかったのよね」	PRINTFORMW 「我们学校的制服很可爱，所以想试穿一下」
PRINTFORMW 「流石に、サイズが違うから胸回りが窮屈ね……」	PRINTFORMW 「果然，尺寸不对胸围有点太窄呢……」
PRINTFORMW 「%CNAME("一人称")%、若返った気分よ」	PRINTFORMW 「穿上这个%CNAME("一人称")%的心情也变得朝气蓬勃了」
PRINTFORMW 「%CNAME("二人称")%と一緒に学校に通うのも楽しそうね」	PRINTFORMW 「和%CNAME("二人称")%一起上学非常开心呢」
PRINTFORMW 「充分に濡れてないと女の子に痛い思いをさせちゃうからね。気をつけてあげるのよ」	PRINTFORMW 「如果不充分湿润的话，会让女孩子感到疼痛的。要小心哦」
CALL PRINT_STR, @"「%TEXTR("んっ/んぅっ")%_HH_……」_L"	CALL PRINT_STR, @"「%TEXTR("嗯/嗯呣")%_HH_……」_L"
CALL PRINT_STR, @"「%CNAME("一人称")%の%TEXTR("手/お胸")%で気持ちよくしてあげましょうか？」_L"	CALL PRINT_STR, @"「要用%CNAME("一人称")%的%TEXTR("手/胸部")%让你变得舒服吗？」_L"
CALL SET_CEVENT, "お叱りイベント"	CALL SET_CEVENT, "斥责事件"
PRINTFORMW 「んむ…っ！？」	PRINTFORMW 「嗯…啊！？」
CALL PRINT_STR, "「んっ…ちゅっ……_HH_」_W_"	CALL PRINT_STR, "「嗯…咀芙……_HH_」_W_"
CALL PRINT_STR, "「んっ…ちゅっ……」_W_"	CALL PRINT_STR, "「嗯…咀芙……」_W_"
PRINTFORMW 「こらっ……ダメよ……」	PRINTFORMW 「喂……不行啊……」
PRINTFORMW %CALLNAME:TARGET%は唇を離すと少し困った顔で%CALLNAME:MASTER%の行為を咎めた	PRINTFORMW %CALLNAME:TARGET%一松开嘴唇，就用有些为难的表情责备%CALLNAME:MASTER%的行为。
CALL PRINT_STR, "「口づけ…本気のキスは好きな人以外としちゃ…いけないのよ_H_」_W_"	CALL PRINT_STR, "「接吻……真心的接吻除了喜欢的人以外…不行啊_H_」_W_"
PRINTFORMW 「%CNAME("二人称")%に本当に好きな人が出来たら…後悔、しちゃうもの」	PRINTFORMW 「如果%CNAME("二人称")%有真心喜欢的人……可是会后悔的哦」
PRINTFORMW 「%CNAME("一人称")%が貰っちゃったら…将来のお嫁さんに、申し訳ない…わ」	PRINTFORMW 「%CNAME("一人称")%现在这样做了……也会对不起你未来的新娘」
PRINTFORMW 言葉では否定しているものの、%CALLNAME:TARGET%はうっとりとした表情で口付けの余韻に浸っている	PRINTFORMW 虽然用语言否定了这种行为，%CALLNAME:TARGET%看起来依旧沉浸在亲吻的余韵中。
PRINTFORMW 「本当に好きな人が出来たら後悔しちゃうわよ？」	PRINTFORMW 「如果真的有喜欢的人的话会后悔的哦？」
PRINTFORMW 「%CNAME("一人称")%が貰っちゃったら、将来のお嫁さんに申し訳ないわ」	PRINTFORMW 「%CNAME("一人称")%现在这样做了……也会对不起你未来的新娘」
PRINTFORMW そう言いながらも頬を紅潮させ、まんざらでもなさそうだ……	PRINTFORMW 虽然这么说，但脸上还是泛起了红潮，看上去不怎么坚定的样子……
PRINTFORMW 「…や、やめなさい」	PRINTFORMW 「别、别这样」
PRINTFORMW %CALLNAME%に押しのけられてしまった……	PRINTFORMW %CALLNAME%用力地推开了……
PRINTFORMW %CALLNAME%少し顔を紅潮させながらも真剣な表情だ……	PRINTFORMW %CALLNAME%脸上少见地泛着红晕，露出一副认真的神情……
[0]好きだからこそキスしたい                   (好感度アップ：小)	[0]正因为喜欢才想接吻                  (好感度提高：小)
[1]無言でキスを続ける                         (欲情の珠+50)	[1]默默地继续亲吻                        (欲情の珠+50)
PRINTFORMW 「お、大人をからかわないの！」	PRINTFORMW 「不、不可以戏弄大人啊！」
PRINTFORMW %CALLNAME%の顔全体が一気に赤く染まっていく……	PRINTFORMW %CALLNAME%的整个脸一下子变得通红……
PRINTFORMW 「こ、こらっ…話は最後まで……」	PRINTFORMW 「喂，喂……把话听到最后……」
CALL PRINT_STR, "「んむ…！　はむっ、ちゅぱっ……_H_」_W_"	CALL PRINT_STR, "「嗯…！　哈呣、啾吧……_H_」_W_"
CALL PRINT_STR, "「らめ(駄目)らって…ひ(言)ってるのにぃ……_H_」_W_"	CALL PRINT_STR, "「叭行(不行)……明明书(说)过的……_H_」_W_"
CALL PRINT_STR, "「んむ…！　はむっ、ちゅぱっ……」_W_"	CALL PRINT_STR, "「嗯…！　哈呣、啾吧……」_W_"
CALL PRINT_STR, "「らめ(駄目)らって…ひ(言)ってるれしょう……」_W_"	CALL PRINT_STR, "「叭行(不行)……明明书(说)过的……」_W_"
PRINTFORMW %CALLNAME%のパンストを破きますか？	PRINTFORMW 要撕破%CALLNAME%的连体袜吗？
PRINTFORMW %CALLNAME:MASTER%の突然の行動に%CALLNAME%は身を強張らせた！	PRINTFORMW %CALLNAME:MASTER%突然的行动，让%CALLNAME%身体紧张得僵硬起来。
PRINTFORMW 「エッチはしないって約束したでしょ…？」	PRINTFORMW 「不是说好了不能H吗…？」
PRINTFORMW 挿入せずに擦るだけだと説明すると、%CALLNAME%は一応納得してくれたようだ	PRINTFORMW 向她说明不插入只是摩擦，%CALLNAME%勉强算是理解了。
CALL SET_CEVENT, "パンスト破き"	CALL SET_CEVENT, "胖次撕裂"
CALL PRINT_STR, "「分かってると思うけど…擦るだけ…よ？」_W_"	CALL PRINT_STR, "「我想确认一下，只是摩擦一下而已……吗？」_W_"
CALL PRINT_STR, "「絶対に入れちゃ…駄目…だからね……」_W_"	CALL PRINT_STR, "「绝对是不能插入的……」_W_"
CALL PRINT_STR, "「……ん_HH_」_W_"	CALL PRINT_STR, "「……嗯_HH_」_W_"
CALL PRINT_STR, "「ほら、挟んであげるから…腰、動かしてみなさい……」_W_"	CALL PRINT_STR, "「看，我会好好夹住的，腰要开始动了哦………………」_W_"
CALL PRINT_STR, "「分かってると思うけど、擦るだけよ？」_W_"	CALL PRINT_STR, "「我想知道，只是摩擦一下而已吗？」_W_"
CALL PRINT_STR, "「絶対に入れちゃ駄目だからね……」_W_"	CALL PRINT_STR, "「绝对是不能插入的……」_W_"
CALL PRINT_STR, "「擦るだけでいいの…？」_W_"	CALL PRINT_STR, "「只要这样摩擦就行了？」_W_"
PRINTFORMW ……いま、少し亀頭がワレメに食い込んだような気がする。	PRINTFORMW ……现在，感觉龟头好像稍微被秘裂吞进去了。
//CALL SET_CEVENT, "素股イベント予告"	CALL SET_CEVENT, "素股事件预告"
PRINTFORMW このまま押し込めば挿入できてしまいそうだが……	PRINTFORMW 如果就这样塞进去的话，好像可以插入………
PRINTFORMW %CALLNAME%は%CALLNAME:MASTER%の肩に手をやり、少し止まるように促した……	PRINTFORMW %CALLNAME%用手扶着%CALLNAME:MASTER%的肩膀，催促着稍微停一下……
CALL PRINT_STR, "「ふあっ……_HH_」_W_"	CALL PRINT_STR, "「呼啊……_HH_」_W_"
CALL PRINT_STR, "「いま…少しナカに挿入っちゃった…みたい……」_W_"	CALL PRINT_STR, "「现在，好像稍微插入进去了，好像……」_W_"
CALL PRINT_STR, "「ま、止まって…腰引かないと…このままじゃ…奥に来っちゃう…から……っ」_W_"	CALL PRINT_STR, "「停、停下…不停下的话……这样下去……到里面来了…因为……啊」_W_"
CALL PRINT_STR, "「ひあっ……_HH_」_W_"	CALL PRINT_STR, "「呀！……_HH_」_W_"
CALL PRINT_STR, "「ちょっと…止まってちょうだい……」_W_"	CALL PRINT_STR, "「稍微……先停下来……」_W_"
CALL PRINT_STR, "「いま、少しナカに……っ、挿入っちゃったみたい…だから……っ」_W_"	CALL PRINT_STR, "「现在，稍微有些……啊，好像插进去了…所以……啊」_W_"
PRINTFORMW ごめん…腰…止まんない……	PRINTFORMW 对不起……腰部……停不下来……
CALL PRINT_STR, "「だめ、止めなさいっ……！」_W_"	CALL PRINT_STR, "「不行，快停下来……！」_W_"
CALL PRINT_STR, "「いま止めないと、本当にっ……_HH_」_W_"	CALL PRINT_STR, "「现在不停下的话……真的就……_HH_」_W_"
PRINTFORM 制止する%CALLNAME:TARGET%の声を無視して	PRINTFORM 无视了%CALLNAME:TARGET%制止的声音。
PRINTFORMW ヴァギナに正常位で挿入し、欲望のままにピストンを叩き付けた！	PRINTFORMW 以正常位插入了阴道，受欲望驱使开始了活塞运动！
CALL PRINT_STR, "「はぁっ…はぁっ……_HH_」_W_"	CALL PRINT_STR, "「啊…哈……_HH_」_W_"
CALL PRINT_STR, "「あのまま、挿れちゃっても、良かったのに……_HH_」_W_"	CALL PRINT_STR, "「就这样，插进去，也很舒服_HH_」_W_"
CALL PRINT_STR, "「ちゃんと…我慢、できたね」_W_"	CALL PRINT_STR, "「要…好好地…忍耐」_W_"
CALL PRINT_STR, "「うん、偉いえらい♪」_W_"	CALL PRINT_STR, "「嗯，真了不起呢♪」_W_"
CALL PRINT_STR, "「そんなに残念そうな顔しないの♪」_W_"	CALL PRINT_STR, "「不要露出那么遗憾的表情嘛♪」_W_"
CALL PRINT_STR, "「ごめんね、続きをしましょうか……」_W_"	CALL PRINT_STR, "「对不起，要继续吗……」_W_"
PRINTFORML 「%TEXTR(@"ちゃんと避妊はしなくちゃダメよ？　%CNAME("二人称")%はまだ高校生なのだから子供を持つには早いわ/いくら身体を許したと言っても、私達は親子なのよ。ちゃんと避妊はしましょうね/コンドームがないみたいだから今日は諦めなさい")%」	PRINTFORML 「%TEXTR(@"一定要好好避孕哟？%CNAME("二人称")%还是高中生，有孩子还是太早了呢/不论如何，就算因为身体欲望的驱使，不去考虑我们的母子关系，但是还是要好好避孕哦/似乎没有避孕套啊，今天就别做了吧")%」
PRINTFORM 「%TEXTR("アソコを使えない分/その代わり/本番させて上げられない分")%……_"	PRINTFORM 「%TEXTR("不能插到小穴里来哦/换一种吧/不可以真的做爱哦")%……_"
PRINTFORMW %TEXTR(@"今日はアナルが壊れちゃうまで%CNAME("一人称")%を使わせてあげるから、ね？/私が力尽きるまでお尻でしてあげるから……/%CNAME("一人称")%がアナルでしてあげるから……許して欲しいの")%」	PRINTFORMW %TEXTR(@"今天会一直把%CNAME("一人称")%的肛门搞到坏掉……吗？/我会尽力用屁股满足你的……/%CNAME("一人称")%会献上肛门的……希望你能原谅妈妈")%」
PRINTFORML 「%TEXTR("そんな顔しないの……/そうね、次はラブホテルでしましょうか/よしよし……元気出しなさいな")%」	PRINTFORML 「%TEXTR("别露出那种表情啦……/下次在情人旅馆，也许……/好乖好乖……打起精神来吧")%」
PRINTFORMW 「%TEXTR(@"今日は%CNAME("一人称")%がたっぷりご奉仕してあげるから……それで許してね/物足りないのは%CNAME("一人称")%も一緒だから……我慢しましょ/ほら、本番以外なら何でもしてあげますからね")%？」	PRINTFORMW 「%TEXTR(@"今天%CNAME("一人称")%会尽力为你服务的，原谅妈妈吧/不能做那种事%CNAME("一人称")%也很难受……忍耐一下吧/呐，除了真正的做爱，我什么都可以给你做哦")%？」
CALL PRINT_STR, @"「素股で%CNAME("一人称")%が気持ちよくしてあげましょうか？_HH_」_W"	CALL PRINT_STR, @"「%CNAME("一人称")%的股交有让你感到舒服吗？_HH_」_W"
CALL PRINT_STR, "「で、出そうなのっ！？」_W_"	CALL PRINT_STR, "「要、要出来了吗！？」_W_"
CALL PRINT_STR, "「……せめて膣外(ソト)に出しなさいっ」_W_"	CALL PRINT_STR, "「……至少要射在外边哦」_W_"
CALL PRINT_STR, "「いいわね、絶対に膣内(ナカ)はダメだからねっ！？」_W_"	CALL PRINT_STR, "「要听话呢，射在小穴里是绝对不行的！？」_W_"
CALL PRINT_STR, "「お、お願いっ」_W_"	CALL PRINT_STR, "「拜托了。」_W_"
CALL PRINT_STR, "「そとっ、膣外(ソト)にっ…」_W_"	CALL PRINT_STR, "「一定…要射在外边」_W_"
CALL PRINT_STR, "「ソトに出してっ_HH_」_W_"	CALL PRINT_STR, "「要出来了_HH_」_W_"
PRINTFORMW %CALLNAME:MASTER%は最後まで射精し終わると、しばし%CALLNAME%と抱き合って余韻に浸った……	PRINTFORMW %CALLNAME:MASTER%把最后一滴精液都射在里面，随后与%CALLNAME%相拥，沉浸在高潮的余韵中……
PRINTFORMW 「中に出さないでって、言ったのに」	PRINTFORMW 「明明说过，不可以射在里边的」
PRINTFORMW 「あ…う、そ……」	PRINTFORMW 「啊…唔、哈……」
PRINTFORMW 「膣内(ナカ)に、出ちゃってる……」	PRINTFORMW 「从小穴里流出来了……」
PRINTFORMW 「はぁ…はぁ…はぁ……」	PRINTFORMW 「哈啊……哈啊……哈啊……」
PRINTFORMW 「駄目じゃない、%CNAME("一人称")%の膣内に…射精、するだなんて」	PRINTFORMW 「真是的，在%CNAME("一人称")%的阴道里射精什么的……」
[0]ごめんなさい                               (恭順の珠+300)	[0]对不起                             (恭順の珠+300)
[1]気持ちよくて、つい                         (欲情の珠+100)	[1]太舒服了不由自主就…                (欲情の珠+100)
[2]好きだ、自分の恋人になって欲しい           (二人きりでなければ選択不可)	[2]我喜欢你，希望你能成为我的恋人           (不是两人单独相处的话不能选择)
PRINTFORMW 「そ、そんなこと言っても誤魔化されませんっ！」	PRINTFORMW 「就、就算你说这种话，我也不会被骗的！」
PRINTFORMW 「すぐそうやって調子に乗るんだから……」	PRINTFORMW 「马上就变得得意忘形起来了……」
PRINTFORMW 「こ、こんなときに何言ってるの！もう……」	PRINTFORMW 「这、这种时候你在说什么啊！真是的……」
PRINTFORMW 「自分が言っている意味、分かってる？」	PRINTFORMW 「你明白自己说的话意味着什么吗？」
PRINTFORMW 「……そう、本気なのね」	PRINTFORMW 「……是啊，是认真的吗」
PRINTFORMW 「%CNAMET(TARGET, "二人称")%が%CNAME("一人称")%のことをそういう目で見ていることは、前から知っていたわ」	PRINTFORMW 「%CNAMET(TARGET, "二人称")%用那种眼神看%CNAME("一人称")%的时候，我就已经明白了」
PRINTFORMW %CALLNAME%は繋がったまま%CALLNAME:MASTER%の頭を撫でながら、優しく諭すような声で言う。	PRINTFORMW %CALLNAME%抚摸着%CALLNAME:MASTER%的头，用温和的声音说着。
PRINTFORMW 「でもそれは思春期で女の人に対する興味が強くなっているだけ」	PRINTFORMW 「但这只是青春期对女性的兴趣变强了而已」
PRINTFORMW 「本当の恋心じゃないのよ。だから恋人にはなれないし、なっちゃ駄目なの。分かる？」	PRINTFORMW 「不是真正的恋慕心哟。所以不能成为恋人，不可以的。明白吗？」
PRINTFORMW 親子の一線を大きく踏み越えてなお、その声はどこまでも"母親"の慈愛に満ちていた。	PRINTFORMW 尽管已经大大地跨越了母子的那条界线，可那声音却始终充满着身为“母亲”的慈爱。
PRINTFORMW 「だから、%CNAMET(TARGET, "二人称")%の彼女にはなってあげられないわ」	PRINTFORMW 「所以啊，我不能成为%CNAMET(TARGET, "二人称")%的女朋友」
PRINTFORMW 「ごめんね」	PRINTFORMW 「对不起啊」
PRINTFORMW 「……ふふ、困った甘えん坊さんね」	PRINTFORMW 「……呵呵，真是个让人为难的撒娇鬼啊」
PRINTFORMW 「それに%CNAME("一人称")%のココロは、今でもお父さんのものだから」	PRINTFORMW 「而%CNAME("一人称")%的心，就算现在也是爸爸的东西哦」
PRINTFORMW 「もう、そんなイジケた顔しない」	PRINTFORMW 「真是的，别露出那种失落的表情嘛」
PRINTFORMW ……%CALLNAME%の心には響かなかったようだ。	PRINTFORMW ……%CALLNAME%的心似乎没有回应。
PRINTFORMW %CALLNAME%が心変わりした後ならあるいは……	PRINTFORMW 或许要让%CALLNAME%改变心意……
PRINTFORMW (※[相思相愛]になるには、相手が[恋慕]の必要があります)	PRINTFORMW (※成为[相思相愛]、对方必须要拥有[恋慕])
PRINTFORMW 「ちゃんと反省してる？」	PRINTFORMW 「有好好地反省吗？」
PRINTFORMW 「……今回のこれは、事故よ。だから、忘れましょう」	PRINTFORMW 「……这次就当做是意外忘了吧」
PRINTFORMW 「無かったことにしてあげるから、次は自制して頂戴。その…妊娠、したら…まずいでしょう？」	PRINTFORMW   我会当作没发生过，下次请自制点。那个……如果怀孕了……那可就不妙了哦？」
PRINTFORMW どうやら%CALLNAME%は今回の件については許してくれたようだ。	PRINTFORMW 看来%CALLNAME%似乎原谅了这件事。
PRINTFORML 「%TEXTR("ダメよ、出来ちゃったらどうするの/ダメっ……安全日でも出来ないわけじゃないのよ")%？」	PRINTFORML 「%TEXTR("不行，如果射进去了怎么办/不行……就算是安全日也不能做哟")%？」
PRINTFORMW 「%TEXTR(@"せめて……%CNAME("二人称")%が高校を卒業するまでは我慢しなさい/そんなにも……%CNAME("一人称")%の事が好きなのね……/愛しているわ……でも、それは親子としてよ")%」	PRINTFORMW 「%TEXTR(@"至少……在你%CNAME("二人称")%高中毕业之前要忍耐/那么……喜欢%CNAME("一人称")%吗……/我也爱你……但是，我们是母子关系哟")%」
PRINTFORML 「%TEXTR(@"今日は……%CNAME("一人称")%は安全じゃない日なのよ、生で挿れちゃダメよっ！！/ああっ、ダメっ、ダメよ、今日は危険日よ。入れないでっ……ああっ、ダメっ！！")%」	PRINTFORML 「%TEXTR(@"今天……不是%CNAME("一人称")%的安全日，不可以直接插进来！！/啊，不行，不行，今天是危险日。不可以进来……啊啊、不行！！")%」
CALL PRINT_STR, @"「%TEXTR(@"好きなだけさせてあげるわね/%CNAME("一人称")%とこんな事するなんて……悪い子ね/ほらほら……%CNAME("一人称")%はその程度では参らないわよ")%_H_」_W"	CALL PRINT_STR, @"「%TEXTR(@"一起做喜欢的事情吧/居然和%CNAME("一人称")%做这种事情，真是个坏孩子/看……对%CNAME("一人称")%来说这种程度可还远远不够哦")%_H_」_W"
PRINTFORMW 「……%TEXTR("中はダメよ/中に出しちゃダメよ/中は避けるのよ")%」	PRINTFORMW 「……%TEXTR("里面不行哦/不可以射在里面哦/里面要避开")%」
CALL PRINT_STR, @"「%TEXTR("今夜、空いてたらしない？/帰って来たら続きをしましょうね")%_HH_」_W"	CALL PRINT_STR, @"「%TEXTR("今晚有空吗？/回来的话继续做吧")%_HH_」_W"
CALL PRINT_STR, @"「%TEXTR("おはよう/起こしちゃったかしら")%_HH_　%CNAME("一人称")%にこういうのされるの嫌じゃないかしら」_W"	CALL PRINT_STR, @"「%TEXTR("早上好。/把你叫醒了呢")%_HH_　%CNAME("一人称")%这样做不会被讨厌吧」_W"
CALL PRINT_STR, @"「%CNAME("二人称")%%TEXTR("が欲しくなっちゃったの/がなかなか起きないから悪戯しちゃったの")%　ごめんなさいね」_W"	CALL PRINT_STR, @"「%CNAME("二人称")%%TEXTR("看起来很想要的样子/怎么也起不来所以就恶作剧了")%，对不起啊」_W"
CALL PRINT_STR, @"「%TEXTR("おはよう/起こしちゃったかしら")%_HH_　%CNAME("一人称")%にこういうのされるの嫌じゃないかしら」_L"	CALL PRINT_STR, @"「%TEXTR("早上好/把你叫醒了呢")%_HH_　%CNAME("一人称")%这样做不会被讨厌吧」_L"
PRINTFORMW #!#Ｖ中出し　危険日生挿入ＯＫ（初めて）	PRINTFORMW #!#Ｖ中出　危险日无套插入ＯＫ（第一次）
CALL SET_CEVENT, "告白お断り済み"	CALL SET_CEVENT, "告白被拒绝了"
PRINTFORMW #!#手で射精	PRINTFORMW #!#手射精
PRINTFORMW #!#手で射精（奉仕精神Lv3以上）	PRINTFORMW #!#手射精（奉仕精神Lv3以上）
PRINTFORMW #!#手で射精（奉仕精神Lv5以上）	PRINTFORMW #!#手射精（奉仕精神Lv5以上）
PRINTFORMW #!#手で射精（初めて）	PRINTFORMW #!#手射精（第一次）
PRINTFORMW #!#胸で射精（初めて）	PRINTFORMW #!#胸射精（第一次）
PRINTFORMW #!#胸で射精（奉仕精神Lv5以上）	PRINTFORMW #!#胸部射精（奉仕精神Lv5以上）
PRINTFORMW #!#胸で射精（奉仕精神Lv3以上）	PRINTFORMW #!#胸部射精（奉仕精神Lv3以上）
PRINTFORMW #!#胸で射精	PRINTFORMW #!#胸部射精
PRINTFORMW #!#口で射精（初めて）	PRINTFORMW #!#口射精（第一次）
PRINTFORMW #!#口で射精（精液中毒Lv5以上）	PRINTFORMW #!#口射精（精液中毒Lv5以上）
PRINTFORMW #!#口で射精（精液中毒Lv3以上）	PRINTFORMW #!#で射精（精液中毒Lv3以上）
PRINTFORMW #!#口で射精（奉仕精神Lv3以上）	PRINTFORMW #!#口射精（奉仕精神Lv3以上）
PRINTFORMW #!#口で射精	PRINTFORMW #!#口射精
PRINTFORMW #!#脚で射精（初めて）（恋慕）	PRINTFORMW #!#脚射精（第一次）（恋慕）
PRINTFORMW #!#脚で射精（初めて）	PRINTFORMW #!#脚射精（第一次
PRINTFORMW #!#脚で射精（恋慕）	PRINTFORMW #!#脚射精（恋慕）
PRINTFORMW #!#脚で射精	PRINTFORMW #!#脚射精
PRINTFORMW #!#ぶっかけ　自慰で射精	PRINTFORMW #!#射出　自慰射精
PRINTFORMW #!#ぶっかけ　超大量射精	PRINTFORMW #!#射出　超大量射精
PRINTFORMW #!#ぶっかけ　大量射精	PRINTFORMW #!#射出　大量射精
PRINTFORMW #!#ぶっかけ　通常	PRINTFORMW #!#射出　通常
PRINTFORML 「%CNAME("一人称")%%TEXTR("と魂の取引をしたいのね/を呼び出して何の用事かしら？")%」	PRINTFORML 「找%CNAME("一人称")%是%TEXTR("想要用灵魂做交易吗？/有什么事情呢？")%」
PRINTFORML 「そうそう、もしも女の子とエッチしたいなら、ムードは大事よ」	PRINTFORML 「对了，如果想和女孩子做爱的话，气氛可是很重要的呢。」
PRINTFORML 「まずは女の子に囁く甘い言葉の習得をオススメするわ」	PRINTFORML 「所以呢，我推荐先学习怎么对女孩子甜言蜜语哟」
「%TEXTR("お願い/頼みごと")%は%TEXTR("なぁに/何かしら")%_HH_」	「%TEXTR("想要/需要")%%TEXTR("什么呀/什么东西呢")%_HH_」
「%CNAME("一人称")%ねぇ、何だって叶えてあげたい気分なの」	「呐，和我说吧%CNAME("一人称")%，不管是什么，都想要为你实现呢。」
PRINTFORML 「駄目とは言わないけれど、今すぐいらない物を欲しがっちゃダメよ」	PRINTFORML 「虽然不是不可以，但是有些要求现在还没法实现呢」
PRINTFORML 「何が欲しいか、%CNAME("一人称")%に言ってみなさい」	PRINTFORML 「想要什么呢？请和%CNAME("一人称")%说吧」
PRINTFORML 「魂もお金も無駄遣いは許しませんからね。良く考えて決めなさい」	PRINTFORML 「浪费灵魂和金钱可不行哦。所以请仔细考虑然后再决定」
PRINTFORML 「魂の取引がしたいのね。分かったわ」	PRINTFORML 「想进行灵魂的交易呀。我明白了」
PRINTFORML 「%TEXTR("契約は/正式な")%契約ですもの、%TEXTR("聞くだけ聞いてあげるわ/何でも言ってちょうだい")%」	PRINTFORML 「已经%TEXTR("立下/正式")%契约了什么的，%TEXTR("我也会听从你吩咐的/请尽管说吧")%」
PRINTFORML 「%TEXTR("もちろん、叶えてあげられる願いと叶えてあげられない願いはあるわよ/もっとも、あんまり大きな願いは叶えてあげられないんだけどね")%」	PRINTFORML 「%TEXTR("当然，有些愿望可以实现，而有些就没办法了。/不过，太庞大的愿望是无法实现的。")%」
PRINTFORML 「いまちょっと忙しいんだけど、夜になってからじゃダメなの？」	PRINTFORML 「现在稍微有点忙，晚上再说可以吗」
PRINTFORMW 「……それが%CNAME("二人称")%の真剣な気持ち、なのね」	PRINTFORMW 「……看来%CNAME("二人称")%是认真的呢」
PRINTFORMW 「勇気を振り絞って告白してくれたのだから、私もその覚悟に正面から応えます」	PRINTFORMW 「既然鼓起勇气向我告白，我也会正面回应你的决心的」
PRINTFORMW %CALLNAME:TARGET%はまっすぐ%CALLNAME:MASTER%を見つめ、	PRINTFORMW %CALLNAME:TARGET%目不转睛盯着%CALLNAME:MASTER%。
PRINTFORMW 一瞬の間を置いてから言葉を紡ぐ	PRINTFORMW 在片刻之间组织好了想说的话。
PRINTFORMW 「……最初は、お父さんの面影に溺れていただけでした」	PRINTFORMW 「……最初，只是因为你酷似你父亲的外表才如此沉湎」
PRINTFORMW 「私の愛したあの人にそっくりな%CNAME("二人称")%に求められて、心が苦しくなることもありました」	PRINTFORMW 「被酷似我所爱之人的%CNAME("二人称")%追求着，心里也十分纠结」
PRINTFORMW 「この子は何時か、素敵な相手を見つけて私の元を離れていく、そうでなければいけないんだって」	PRINTFORMW 「心想总有一天，这孩子一定会找到一个很棒的恋人，从我身边远去吧」
PRINTFORMW 「母親としての愛情と、女としての愛情がごちゃまぜになって、わけが分からなくなる時もありました」	PRINTFORMW 「作为母亲还有女人的感情混杂在一起，有时候会变得莫名其妙」
PRINTFORMW 「でもね」	PRINTFORMW 「但是呢」
PRINTFORMW 「%CNAME("二人称")%が私を一人の女として、本気で求めてくれている」	PRINTFORMW 「%CNAME("二人称")%把我看做一个女人，认真地追求着」
PRINTFORMW 「今は、そのことが嬉しい……どうしようもなく、嬉しいの」	PRINTFORMW 「现在，我对这件事感到很开心……有些无可奈何，但是真的很高兴」
PRINTFORMW 「私達が親子である事は変えられないけれど……」	PRINTFORMW 「虽然无法改变我们是亲子的事实……」
PRINTFORMW 「それでも、あなたの気持ちを受け入れたいって、そう思えるから」	PRINTFORMW 「尽管如此，我还是想要接受这份心意，我就是这样想的」
PRINTFORMW 「私の気持ちを表す言葉を、あなたにも贈ります」	PRINTFORMW 「我也想用这些话，向你表达我的心意」
PRINTFORMW 『%CALLNAME:TARGET%は、%CNAME("二人称")%のことを愛しています』	PRINTFORMW 『我，%CALLNAME:TARGET%……也爱着%CNAME("二人称")%』
CALL PRINT_STR, @"「%TEXTR("ちょ、ちょっと落ち着きなさい/な、な、何を言ってるの？")%_HH_」_W"	CALL PRINT_STR, @"「%TEXTR("等等、你冷静一点/你、你、你在说什么呢？")%_HH_」_W"
PRINTFORMW %CALLNAME:TARGET%は%CALLNAME:MASTER%の頭に手を当てると熱を測った	PRINTFORMW %CALLNAME:TARGET%把手放在%CALLNAME:MASTER%的额头。
PRINTFORMW 「熱はないみたいね……」	PRINTFORMW 「好像没发烧呀……」
PRINT 「どこか具合でも悪いの？、それとも	PRINT 「哪里不舒服吗？还是怎么了
PRINTFORMW をからかってるのかしら？」	PRINTFORMW 你在开玩笑吗？」
PRINTFORMW 「ごめんなさい。今、穿いてないのよ……」	PRINTFORMW 「对不起，现在没有穿着呢……」
PRINTFORMW 「残念ね、今は穿いてないの……」	PRINTFORMW 「真是抱歉，现在没有穿哦」
PRINTFORMW %CALLNAME:TARGET%は気まずそうに%TEXTR("視線を逸らした/答えた/頬を赤らめた")%	PRINTFORMW %CALLNAME:TARGET%尴尬%TEXTR("地挪开了视线/地回答道/得脸颊泛红")%
「%TEXTR("信じてない顔ね/疑ってるの？")%　何なら%TEXTR("いまここで/直接")%確認してみる？_HH_」	「%TEXTR("表情看起来不太相信呢，/怀疑我说的话吗？")%　那就%TEXTR("现在在这里/直接")%确认一下？_HH_」
PRINTFORMW 「なんてお願いするのよ……もう」	PRINTFORMW 「真是的，怎么拜托我这种事情呢」
PRINTFORMW 「こら、恥ずかしいからそんなに見ないで……」	PRINTFORMW 「真是的，太丢人了，不要那样看啊……」
PRINTFORMW 「くすん……」	PRINTFORMW 「哼……」
PRINTFORMW 「%CNAME("一人称")%、%CNAME("二人称")%に追い出されて結構傷ついたんですからね……」	PRINTFORMW 「%CNAME("一人称")%因为被%CNAME("二人称")%赶了出去，感觉很受伤哟」
PRINTFORMW 「%CNAME("二人称")%は平気でも、%CNAME("一人称")%は気にするんですからね」	PRINTFORMW 「虽然%CNAME("二人称")%不在乎，但%CNAME("一人称")%还是很在意的」
PRINTFORMW 「反抗期？　まあ、話くらいは聞いてあげるけれど」	PRINTFORMW 「是叛逆期吗？不过，我还是会听你的」
PRINTFORMW 「突然どうしたの？　%CNAME("一人称")%に不満があるなら言ってもいいのよ？」	PRINTFORMW 「突然怎么了？要是对%CNAME("一人称")%有什么不满的话，可以说出来吗？」
PRINTFORMW 「……後で話があります。いいですね？」	PRINTFORMW 「……之后再说可以吗？」
CALL PRINT_STR, @"「私としては弟や、妹が出来てもいいのだけれど_HH_」	CALL PRINT_STR, @"「对我来说再给你生个弟弟或者妹妹，也不是不行_HH_」
PRINTFORMW 「%CNAME("一人称")%が妊娠したら、毎晩抱けなくなっちゃうのがイヤなのかしら？」	PRINTFORMW 「可如果%CNAME("一人称")%怀孕了，就不能每天做爱了，那样也可以吗？」
PRINTFORMW 「そうね、親子で赤ちゃんが出来ちゃったら困るものね」	PRINTFORMW 「是啊，如果父母和孩子生了孩子那就麻烦了」
PRINTFORMW 「ピルを飲んでる間は生でエッチさせてあげてもいいけど、その分いい子にしなさいね？」	PRINTFORMW 「在服用避孕药的时候可以中出，但是要当一个听话的好孩子哦？」
PRINTFORMW 「勘違いしてるかもしれないけれど……妊娠しなければ本番ＯＫって事ではないのよ」	PRINTFORMW 「你是不是搞错了，如果不是直接做爱的话，是不会怀孕的哟」
PRINTFORMW 「好きなだけお尻でしてあげるから、それだけは我慢してね？」	PRINTFORMW 「我会用屁股小穴让你很舒服的，只是，那种事就忍耐一下吧」
PRINTFORMW 「%CNAME("一人称")%は%CNAME("二人称")%以外と契約したりしないから、ピルは必要ないわよ？」	PRINTFORMW 「%CNAME("一人称")%不会跟%CNAME("二人称")%意外的人契约，所以没必要吃避孕药吧？」
PRINTFORMW 「どうしても飲んで欲しいって言うなら、飲むけれど……」	PRINTFORMW 「如果你一定要我吃的话，那我就吃吧……」
PRINTFORMW 「ピルを飲んでようが飲んでまいが、本番はさせてあげませんからね」	PRINTFORMW 「反正不管吃不吃避孕药，都是不可以做爱的呢」
PRINTFORMW 「ピルを使うのをやめるのね、安心したわ」	PRINTFORMW 「停止使用避孕药了，放心吧」
PRINTFORMW 「子供は二人の愛の証だもの。私も出来ればピルは使いたくないわ」	PRINTFORMW 「孩子是两个人爱情的见证，如果可以的话，我也觉得不想吃避孕药的」
PRINTFORMW 「妊娠しないと分かってはいても、やっぱり生でするのは気が引けるもの」	PRINTFORMW 「虽然知道不会怀孕了，但还是感觉有点别扭呢」
PRINTFORMW 「やめても良いのね、助かるわ」	PRINTFORMW 	「可以不用了吧，太好了」
PRINTFORMW 「生理周期が乱れるからあまりピルは好みではないの」	PRINTFORMW 「因为会导致生理周期紊乱，所以不太喜欢吃避孕药」
PRINTFORMW 「もちろん、悪魔の力を用いればどうとでもなるのだけれどね」	PRINTFORMW 「当然如果使用恶魔之力的话，这种小事也是无所谓的」
PRINTFORMW 「あの人と出会って%CNAME("二人称")%が産まれてから決めたのよ」	PRINTFORMW 「只是与那个人相遇以后，才决定生下%CNAME("二人称")%」
PRINTFORMW 「今生は人として人間らしく生きるってね」	PRINTFORMW 「已经决定这辈子要作为人类活下去了」
PRINTFORMW 「そろそろ本番でエッチすることを諦められたかしら？」	PRINTFORMW 「做爱的时候只要不射进去就没问题吧」
PRINTFORMW 「%TEXTR("めっ/こらっ")%、魂をあんまり使い過ぎると死んじゃいますからね」	PRINTFORMW 「%TEXTR("呐/喂")%，过度使用灵魂可是会死掉哦」
PRINT 「あんまり	PRINT 「有些过头了
PRINTFORMW を%TEXTR("心配させないの/困らせないでね")%」	PRINTFORMW %TEXTR("别让我担心啊/别让我为难啊")%」
PRINTFORMW 「あんまりワガママ言わないの」	PRINTFORMW 「不要任性了」
PRINT 「いい加減にしないと	PRINT 「适可而止吧
PRINTFORMW 怒りますよ？」	PRINTFORMW 你生气了吗？」
PRINTFORMW 「お小遣い足りないの？　取引だから用意してあげるけど、子供に多額の現金は教育上良くないわ」	PRINTFORMW 「零花钱不够了吗？既然是交易我也会给你的，但是从教育的角度来讲，给孩子大量的现金可不是好事啊。」
PRINTFORMW 「何に使うつもりなのかは聞かせてもらいますからね」	PRINTFORMW 「能告诉我是打算用在什么地方吗？」
PRINTFORMW 「一体何に使うつもりなの？　無駄遣いしちゃいけませんからね」	PRINTFORMW 「你到底想用来干什么？不能浪费哦」
PRINTFORMW 「もし何か困ってることがあるなら直接言いなさいね」	PRINTFORMW 「如果有什么困难的话，请直接说出来」
PRINTFORMW 「そうね、賢い選択だと思うわ」	PRINTFORMW 「是哦，真是聪明的选择」
PRINTFORMW 「例え、セフレだとしても相手もその気になってくれた方がお互いに楽しめるでしょう？」	PRINTFORMW 「比方说，就算是炮友，但是彼此之间相互喜欢，这样也会很开心吧？」
PRINTFORMW 「%CNAME("一人称")%としては、使う相手をしっかり選んで欲しいけどね」	PRINTFORMW 「来自%CNAME("一人称")%的忠告，希望你好好选择使用的对象」
PRINTFORMW 「なんだか不思議な感じね」	PRINTFORMW 「总觉得很不可思议呢」
PRINTFORMW 「%CNAME("一人称")%が%CNAME("二人称")%のお父さんに口説かれちゃったあの日を思い出すわ」	PRINTFORMW 「让%CNAME("一人称")%想起了%CNAME("二人称")%的父亲说过这句话的那天」
PRINTFORMW 「やっぱり、%CNAME("二人称")%はあの人の子」	PRINTFORMW 「果然呢，%CNAME("二人称")%不愧是那个人的孩子」
PRINTFORMW 「血は争えないのね……」	PRINTFORMW 「血统是不会说谎的呢……」
PRINTFORMW 「ちょっと甘い言葉を囁いてみてくれるかしら？」	PRINTFORMW 「可以稍微试着说些甜言蜜语吗？」
PRINTFORMW 「そうね……そこはこう言った方が素敵ね」	PRINTFORMW 「是的，还有更多的话要说呢」
PRINTFORMW 「まだまだだけど筋は悪くないわ」	PRINTFORMW 「虽然还差得远呢」
PRINTFORMW 「向上心があって」	PRINTFORMW 「很有上进心呢」
PRINTFORMW 「向こう見ずだけどその真っ直ぐな感じが若さって感じよね」	PRINTFORMW 「虽然有些直率，但是这就是年轻的感觉呢」
PRINTFORMW 「%CNAME("一人称")%は好きよ、そう言う口説き方」	PRINTFORMW 「%CNAME("一人称")%喜欢这种奉承的方式哦」
PRINTFORMW 「フフッ」	PRINTFORMW 「哼」
PRINTFORMW 「やっぱり似てきちゃうものなのね、親子って」	PRINTFORMW 「果然很像呢，不愧是亲生的」
PRINTFORMW 「%CNAME("二人称")%からあの人に口説かれた時の言葉を聞くなんてね……」	PRINTFORMW 「%CNAME("二人称")%说这些话的时候，让我想起了那个人……」
PRINTFORMW 「レッスンはもう充分」	PRINTFORMW 「看来已经都学会了」
PRINTFORMW 「後は%CNAME("二人称")%自身が経験を積んでいくのよ」	PRINTFORMW 「以后就需要%CNAME("二人称")%自身的经验积累了」
PRINTFORMW 「私はその手助けをするだけだから」	PRINTFORMW 「我只是帮忙而已」
PRINTFORMW 「『淫紋』を覚えたいの？」	PRINTFORMW 「想要学『淫纹』？」
PRINTFORMW %CALLNAME:TARGET%は小首を傾げて少し眉根を寄せた	PRINTFORMW %CALLNAME:TARGET%略微歪着脑袋皱起了眉头。
PRINTFORMW 「他人の身体に刺青を刻み、身も心も支配する」	PRINTFORMW 「在别人的身体刻上刺青，支配其身体和心灵」
PRINTFORMW 「その意味をちゃんと理解して、絶対に悪い事には使わないって%CNAME("一人称")%と約束しなさい」	PRINTFORMW 「好好理解它意味着什么，请和%CNAME("一人称")%做好约定，不可以用它做坏事哦」
PRINTFORMW 「約束してくれないなら教えてあげれないわ」	PRINTFORMW 「如果不答应我的话我可不会教你」
PRINTFORMW 「そうね……最初はシールから試してみなさい」	PRINTFORMW 「是啊……可以先试试用贴纸的形式来」
PRINTFORMW 「悪魔の力というのはとても恐ろしいものなのよ」	PRINTFORMW 「恶魔的力量可是非常可怕的」
PRINTFORMW 「『具現』を習得したいのね」	PRINTFORMW 「学会了『具现』」
PRINTFORMW 「悪い事に使わないって%CNAME("一人称")%と約束してちょうだいね？」	PRINTFORMW 「答应%CNAME("一人称")%不要用来做坏事可以吗？」
PRINTFORMW 「そうね……女性同士で愛し合う為の術は必要よね」	PRINTFORMW 「是啊，女性之间想一起爱爱的话，这是必要的法术」
PRINTFORMW 「少し難しい儀式になるから、これからみっちり修行しましょうね」	PRINTFORMW 「仪式有点难，以后好好练习吧」
PRINTFORMW 「更なる高みを目指すのは良い事だけれど……」	PRINTFORMW 「虽然追求更高的目标是件好事……」
PRINTFORMW 「使い方を誤れば取り返しのつかない事になる力という事を忘れないでね」	PRINTFORMW 「但不要忘记如果使用不当，就会变成无法挽回的力量哦」
PRINTFORMW 「なんだか勉強熱心じゃない、%CNAME("一人称")%嬉しいわ」	PRINTFORMW 「并没有急于求成，%CNAME("一人称")%感到很开心呢」
PRINTFORMW 「はい、これで一緒に勉強しましょうね」	PRINTFORMW 「来，让我们一起学习吧」
PRINTFORMW %CALLNAME:TARGET%は古びた古書の山を書斎から持ってきた	PRINTFORMW %CALLNAME:TARGET%从书房里拿出一本古书。
PRINTFORMW 「これは%CNAME("二人称")%のお父さんも使っていたのよ」	PRINTFORMW 「这个%CNAME("二人称")%的父亲也使用过哟」
PRINTFORMW 「難しい所もあると思うけれど、解らない所は%CNAME("一人称")%が教えてあげるからね？」	PRINTFORMW 「虽然有些地方很难，但不明白的地方我也会解答的，怎么样？」
CALL PRINT_STR, @"、実は心配してたの　そのサイズじゃ相手の子に失礼じゃないかなって」_L"	CALL PRINT_STR, @"我其实很担心如果是这个尺寸的话，会让和你做爱的孩子觉得很失礼呢」_L"
CALL PRINT_STR, @"も男の子は大きい方がいいと思うわ_HH_」_L"	CALL PRINT_STR, @"我觉得男孩子还是大一点更好呢_HH_」_L"
PRINTFORMW 、流石にこれ以上大きいサイズは相手の子が可愛そうだと思うのだけれど……」	PRINTFORMW 不愧是这个尺寸的呢，和你做爱的孩子只会觉得其他的尺寸很可爱吧……」
PRINTFORMW はあんまり賛成出来ない大きさになっちゃうけど、しょうがないわね」	PRINTFORMW 虽然不是很赞成这种大小，但是没办法呢」
PRINTFORMW 「う～ん、どうしてもするの？」	PRINTFORMW 「嗯，无论如何都要这样做？」
PRINTFORMW 「嫌になったらすぐに戻してあげるから言うのよ」	PRINTFORMW 「等你讨厌了，记得来找我变回去哦」
PRINTFORMW 「契約だから大きくしてあげるけど……本当に困った子ね」	PRINTFORMW 「因为是契约，所以会帮助你的……真是让人为难的孩子啊」
CALL PRINT_STR, @"「フフッ、可愛い_HH_　まるで子供の頃みたいなサイズになっちゃったわね」_L"	CALL PRINT_STR, @"「哎呀，好可爱_HH_　简直成了小孩子那样的尺寸了」_L"
PRINTFORMW 「%CNAME("一人称")%にお風呂で洗ってもらってたの、覚えてるかしら？」	PRINTFORMW 「还记得在浴室的时候，%CNAME("一人称")%我给你洗过澡吗？」
CALL PRINT_STR, @"「今日は特別に、%CNAME("一人称")%がキレイキレイしてあげましょうか？_HH_」_L"	CALL PRINT_STR, @"「今天有特别服务，需要%CNAME("一人称")%帮你弄干净吗？_HH_」_L"
PRINTFORMW は大きい方が好きだけど、人によるものね」	PRINTFORMW 我喜欢大一点的，不过还是因人而异呢」
PRINTFORMW も大きすぎるのは相手の子が可愛そうだと思うわ」	PRINTFORMW 觉得真是太大了，和你做爱的孩子有些可怜呢」
PRINTFORMW 「正直、大きすぎると不便だったでしょう？」	PRINTFORMW 「说实话，太大了有些不方便吧？」
PRINTFORMW 「何事も適度が一番よ、うんうん」	PRINTFORMW 「什么事情都要适度哦」
CALL PRINT_STR, @"「あらあら、%CNAME("一人称")%と買い物に行きたいだなんて_HH_」_W"	CALL PRINT_STR, @"「哎呀! %CNAME("一人称")%想要去买东西呢_HH_」_W"
PRINTFORMW 「なぁに？　何か買って欲しいものでもあるのかしら？」	PRINTFORMW 「怎么了？有什么想要买的吗？」
PRINTFORMW 「誰かに会うかもしれないからお化粧はしっかりしていかなくちゃね」	PRINTFORMW 「我必须要好好化妆，也许会碰见熟人呢」
PRINTFORMW 「%TEXTR("フフッ、一緒に手を繋いで恋人みたいね/じゃあ、手を繋いでデートしましょうか/こうしてデートするの新鮮ね")%」	PRINTFORMW 「%TEXTR("呵呵，一起牵着手就像恋人一样呢/那么，我们牵着手约个会吧/这样的约会，感觉很新鲜呢")%」
PRINTFORMW 「%TEXTR("お買い物ついでに面白そうな場所を探してみましょうか/お買い物だけじゃ寂しいから色々行きましょうね")%	PRINTFORMW 「%TEXTR("买完东西顺便去哪里逛逛吧/光买东西的话很寂寞吧，去其他的地方看看吧")%
CALL PRINT_STR, @"「%TEXTR("可愛い彼女とデートしてきなさいよ/誘う子いないの？/他の子にマザコンだと思われちゃうわよ")%」_W"	CALL PRINT_STR, @"「%TEXTR("没有和可爱的女朋友约好见面吗/没有要邀请的孩子吗？/这样会被其他孩子认为是恋母控哦")%」_W"
PRINTFORMW 「どうしてもって言うなら付き合ってあげるけれど……しょうがないわねぇ」	PRINTFORMW 「如果非得说的话，那就和你约会吧……真是没办法呢」
PRINTFORMW 「気をつけていってらっしゃい」	PRINTFORMW 「路上请小心」
CALL PRINT_STR, @"「フフッ_HH_……これもプレイの一環かしら？」_W"	CALL PRINT_STR, @"「呵呵_HH_……这也是play的一环吧？」_W"
CALL PRINT_STR, @"「残念ね……今は穿いてないの」_W"	CALL PRINT_STR, @"「真遗憾……现在没有穿」_W"
CALL PRINT_STR, @"「次は%CNAME("二人称")%好みのパンツを穿いておくからね_HH_」_W"	CALL PRINT_STR, @"「下次会穿%CNAME("二人称")%喜欢的胖次哦」"
CALL PRINT_STR, @"「%TEXTR("命令ならしょうがないわね/ご主人様の命令だものね/命じられたら逆らえないものね")%」_W"	CALL PRINT_STR, @"「%TEXTR("如果是命令的话就没办法了/毕竟这是主人的命令呢/被命令的话就无法违抗了呢")%」_W"
PRINTFORMW %CALLNAME:TARGET%は穿いていた%CLOCOLOR(CSTR:パンツ)%%PANTIES(TARGET, "種類")%を%CALLNAME:MASTER%に手渡した	PRINTFORMW %CALLNAME:TARGET%把穿着的%CLOCOLOR(CSTR:パンツ)%%PANTIES(TARGET, "種類")%递给了%CALLNAME:MASTER%。
PRINTFORMW 「誰かに見られたら困るかしら……」	PRINTFORMW 「要是被谁看见就麻烦了……」
PRINTFORMW 「まあ……大丈夫よね？」	PRINTFORMW 「嘛，应该不会吧？」
PRINTFORMW 「流石に……%CNAME("二人称")%のお父さんともこんなプレイした事ないのよ？」	PRINTFORMW 「不愧是你呢……%CNAME("二人称")%的父亲大概没想过会发生这种事吧？」
CALL PRINT_STR, "「ウフフ_HH_……ばれたらどうなっちゃうのかしら……」_W"	CALL PRINT_STR, "「呵呵_HH_……要是暴露了会怎么样呢……」_W"
PRINTFORMW %CALLNAME:TARGET%は上着のコートを羽織るとハイヒールを履いて%CALLNAME:MASTER%に従った	PRINTFORMW %CALLNAME:TARGET%穿着和服外套和高跟鞋跟着%CALLNAME:MASTER%。
CALL PRINT_STR, @"「%CNAME("一人称")%ったら……%TEXTR("前回、命令されてドキドキしてきちゃったのが忘れられないの/恥ずかしいのに逆らえないの/イケナイ事なのに興奮してきちゃったわ")%_HH_」_W"	CALL PRINT_STR, @"「%CNAME("一人称")%真是太糟糕了……%TEXTR("上次被命令做这种事，心脏紧张地跳个不停，真是难忘的经历/明明是很羞耻的事却感觉很兴奋")%_HH_」_W"
PRINTFORMW 「なぁに　恥ずかしいの？」	PRINTFORMW 「怎么啦，觉得害羞吗？」
PRINTFORMW 「%CNAME("一人称")%が代わりに行ってきてあげるわ」	PRINTFORMW 「让%CNAME("一人称")%替你去吧」
CALL PRINT_STR, @"「%TEXTR("お財布を忘れたの？/お金が足りないの？/お小遣い足りないのね？")%」_W"	CALL PRINT_STR, @"「%TEXTR("忘了带钱包吗？/钱不够吗？/零花钱不够吗？")%」_W"
PRINTFORMW 「ココは%CNAME("一人称")%が払ってあげるから、後で返しなさいね」	PRINTFORMW 「先让%CNAME("一人称")%来付款吧，之后记得还哦」
PRINTFORMW 「すいません、これとこれをお願いね」	PRINTFORMW 「对不起，请把这个和这个给我。」
CALL PRINT_STR, @"「%TEXTR("この辺もオススメなの？/あら……これもお買い得ねぇ")%」_W"	CALL PRINT_STR, @"「%TEXTR("这个也是推荐的吗？/哎呀……这个也很划算呢")%」_W"
PRINTFORMW 「コンドームくださいな」	PRINTFORMW 「请给我避孕套谢谢」
PRINTFORMW 「その1ダースセットのお買い得品でお願いしますね」	PRINTFORMW 「请给我一份优惠套装」

PRINTFORMW 「フフッ……」	PRINTFORMW 「呵呵……」
PRINTFORMW 「最近のコンドームは色んな種類があるのね、どれがいいかしら？」	PRINTFORMW 「最近的避孕套有各种类型和颜色呢，选哪个好呢？」
PRINTFORMW 「この辺はやっぱり売れ筋なのかしら？」	PRINTFORMW 「果然这个卖得很好呢」
PRINTFORMW 「そう…じゃあ、折角だからソレも貰おうかしら」	PRINTFORMW 「那么，难得来一趟，就买这个吧」
CALL PRINT_STR, @"「%TEXTR("手を離さないでね？/一人にしちゃいやよ……/何だか見られてる気がするんだけど……")%」_W"	CALL PRINT_STR, @"「%TEXTR("不要放开我的手呀/不要让我一个人……/总觉得会被谁看见……")%」_W"
PRINTFORMW %CALLNAME:TARGET%は不安げな視線を%CALLNAME:MASTER%に向けながら、手を繋いだまま買い物に付き合っている	PRINTFORMW %CALLNAME:TARGET%用不安的视线环视着，一边牵着%CALLNAME:MASTER%的手买东西。
PRINTFORML %TEXTR("「お買い得品ね」/「セール品みたいよ」/「こんなのもあるのね」/（……使った事があるわ）/（懐かしいわ……）")%	PRINTFORML %TEXTR("「这个很便宜呢」/「好像是打折品一样」/「还有这样的东西呢」/（……像是二手的）/（好怀念啊……）")%
PRINTFORMW %CALLNAME:TARGET%は店の商品%TEXTR("を一つづつ丁寧に見てまわっている/に興味を引かれ、手に取って見ている/を気に入ったようだ")%	PRINTFORMW %CALLNAME:TARGET%对店里的商品%TEXTR("逐个精心打量着/挺感兴趣，拿在手里看着/好像很中意")%
CALL PRINT_STR, @"「%CNAME("一人称")%、%TEXTR("ばれたらどうしようか……心配してたのよ_HH_/はぁ……もう心臓が止まりそう")%」_W"	CALL PRINT_STR, @"「%CNAME("一人称")%，%TEXTR("要是暴露了怎么办呢……一直好担心啊_HH_/哈……心脏都快停止了")%」_W"
PRINTFORMW パンツを返してもらった%CALLNAME:TARGET%は安堵の吐息を漏らして、その場にへたり込んだ	PRINTFORMW 拿回胖次的%CALLNAME:TARGET%松了口气，然后一起离开了现场。
PRINTFORML 「%TEXTR("生はダメよ　解るでしょう？/ちゃんとつけてね？　いい子だから/つけないなら、挿れさせてあげないわよ？")%」	PRINTFORML 「%TEXTR("不用是不行的，明白吗/乖乖地用可以吗？真是个好孩子/如果不戴的话，就不让你插进来了哦")%」
PRINTFORML 「%TEXTR("ねぇ、何か忘れてるでしょう？/コンドームをするのはエチケットよ/ちゃんとゴムを買っておいてあげたからね")%」	PRINTFORML 「%TEXTR("喂，你忘了什么吧？/用避孕可套是礼仪哟/要记得买避孕套哦")%」
PRINTFORMW ＜母親からコンドームを手渡された＞	PRINTFORMW 母亲把避孕套递了过来。
PRINTFORMW 「今日は何も買わなくていいの？」	PRINTFORMW 「今天什么都不需要买吗？」
PRINTFORMW 「ああ言うお店だから、何も言われなかったのかしら？」	PRINTFORMW 「因为是那样的店、所以什么都不说吗？」
PRINTFORMW 「べ、別に……物足りなかったわけではないのよ」	PRINTFORMW 「没什么……没有觉得不够呢」
PRINTFORMW 「ふふっ……」	PRINTFORMW 「呵呵……」
PRINTFORMW 「こんな取引しなくても、%CNAME("二人称")%は後10年もすればお父さんに似た素敵な魅力のある男になれるわ」	PRINTFORMW 「即使不做这种交易、%CNAME("二人称")%再过10年，也能和你父亲一样有魅力的。」
PRINTFORMW 「%CNAME("二人称")%を産んだ%CNAME("一人称")%が言うのだから、信じなさいな」	PRINTFORMW 「因为是%CNAME("一人称")%生下了%CNAME("二人称")%，所以请相信我吧」
PRINTFORMW 「それでも、契約は契約だものね」	PRINTFORMW 「即便如此，契约就是契约。」
PRINTFORMW 「今回は%CNAME("一人称")%が特別に%CNAME("二人称")%の将来の魅力を引き出してあげましょう」	PRINTFORMW 「这次%CNAME("一人称")%就特意把%CNAME("二人称")%将来的魅力吸引出来吧」
LOCALS = ママ_まま	LOCALS = 妈妈_妈妈
LOCALS = お母さん_おかあさん	LOCALS = 母亲_母亲
LOCALS = 私_わたし	LOCALS = 我_我
LOCALS = 先生_せんせい	LOCALS = 老师_老师
PRINTFORMW 「%CNAME("二人称")%が好き嫌いしなくなったら、考えてあげてもいいわよ♪」	PRINTFORMW 「如果%CNAME("二人称")%变得不挑食，会考虑一下哦♪」
PRINTFORMW 「私をその気にさせるにはまだまだよ？」	PRINTFORMW 「想让我在意还没那么简单喔？」
PRINTFORML 「……あの子は……わたしが絶対、幸せに…………ﾑﾆｬﾑﾆｬ」	PRINTFORML 「……那孩子啊……一定要、幸福啊…………zzzz」
PRINTFORML 「……（よく聞き取れない）…………ﾑﾆｬﾑﾆｬ」	PRINTFORML 「……（听不清楚）…………zzzz」
PRINTFORML 「……セール品……急がなきゃ………ﾑﾆｬﾑﾆｬ」	PRINTFORML 「……在打折啊，如果不快点的话………呣呀，呣呀」
PRINTFORML 「採点……成績提出…………しめ…………きり………………ｽー」	PRINTFORML 「评分……成绩提交…………只有………………唔」
PRINTFORMW 「つまり……　%CNAME("一人称")%と"アナルセックス"したいのよね？」	PRINTFORMW 「也就是说……　想和%CNAME("一人称")%"肛交"吗？」
PRINTFORMW 「ただし、"アナルセックス"ではなくて"性欲処理"の一環として、ね」	PRINTFORMW 「但是，与其说是“肛交”不如说是“性欲处理”的一环，对吧」
PRINTFORMW 「%CNAME("一人称")%のお尻をオナホールか何かだと思って、悪い欲望を全部吐き出しちゃいましょうね」	PRINTFORMW 「把%CNAME("一人称")%的屁股当成飞机杯什么的，把邪恶的欲望全部吐出来吧」
PRINTFORML  %CALLNAME:TARGET%がアナルセックスの合意を得た。	PRINTFORML  获得了能和%CALLNAME:TARGET%肛交的协议。
PRINTFORML  Ａ挿入系コマンドが使用可能になります	PRINTFORML  A插入系统指令可以使用
PRINTFORML  Ｖ挿入系コマンドが使用可能になります	PRINTFORML  V插入系统指令可以使用
PRINTFORMW  (未完成につきイベント無し、発生条件は将来的に変更の可能性あり)	PRINTFORMW  (事件还没有完成，触发条件将来可能会变更)
PRINTFORMW %CALLNAME:ARG%は %CALLNAME:MASTER% と %CALLNAME:(FINDCHARA(NO, 6))% の"実母"であると共に、"同棲中"となります。	PRINTFORMW %CALLNAME:ARG% %CALLNAME:(FINDCHARA(NO, 6))%作为%CALLNAME:MASTER%  "亲生母亲"的同时，状态变为"同居中"。
PRINTFORMW %CALLNAME:ARG%は %CALLNAME:MASTER% の"実母"であると共に、"同棲中"となります。	PRINTFORMW %CALLNAME:ARG%作为%CALLNAME:MASTER% "亲生母亲"的同时，状态变为"同居中"。
PRINTFORML  現在の二人称は『%CNAMET(ARG, "二人称")%』です。変更しますか？	PRINTFORML  現在的第二人称是『%CNAMET(ARG, "二人称")%』。要进行变更吗？
PRINTFORMW 「まさかとは思うけど…あなた自分の妹にまで手を出したりしてないわよね？」	PRINTFORMW 「虽然觉得不可能……但是你该不会连自己的妹妹都下手了吧？」
PRINTFORMW 「ちょっと話し合いが必要なようね、"お兄ちゃん"？」	PRINTFORMW 「需要稍微协商一下吗"哥哥"？」
CALL SET_CEVENT, "アドバイザー：さくら"	CALL SET_CEVENT, "助手：樱"
CALL SET_CEVENT, "調教開始：アナルセックス合意獲得"	CALL SET_CEVENT, "调教开始：肛门性交合意获得"
PRINTFORMW %CALLNAME:TARGET%はわざとらしく\@TALENT:巨乳?豊満な#形のいい\@胸を%CALLNAME:MASTER%に押し付けて%TEXTR("囁いた/微笑んだ")%	PRINTFORMW %CALLNAME:TARGET%故作姿态，用\@TALENT:巨乳?丰满的#外形良好的\@胸部挤压着%CALLNAME:MASTER%一边%TEXTR("低声私语着/微笑着")%
CALL PRINT_STR, @"「先生をこんな場所に%TEXTR("連れ出して/連れ込んで")%%TEXTR("いい度胸ね？/、解ってるんでしょうね？")%」_L"	CALL PRINT_STR, @"「把老师带到%TEXTR("这里/这样的地方")%%TEXTR("胆子不小啊？/你知道有什么后果吗？")%」_L"
CALL PRINT_STR, @"「%TEXTR("特別授業してあげる/個別補習の時間よ")%　%TEXTR("思い知らせてあげるわ、たっぷりとね/身の程を教えてあげるわ")%_」_W"	CALL PRINT_STR, @"「%TEXTR("特殊课程/私人补习时间")%　%TEXTR("让你好好地学习知识/用身体进行解答")%_」_W"
CALL PRINT_STR, @"「%CNAME("二人称")%%TEXTR("が実の子供だから/とは血が繋がっているから")%ダメって言ってるの」_L"	CALL PRINT_STR, @"「但因为%CNAME("二人称")%%TEXTR("是我的亲生儿子/和我血脉相连")%，所以说还是不行」_L"
PRINTFORML  ムードがMAXでなければ素股事故が発生しなくなりました。	PRINTFORML  情绪如果不是MAX就不会有股交事件发生。
CALL PRINT_STR, @"「%TEXTR("フフッ/いいわ/もっと強くしてもいいのよ/優しくしてね")%_HH_」_W"	CALL PRINT_STR, @"「%TEXTR("呵呵/不错呢/再强硬点也没关系/请温柔点吧")%_HH_」_W"
CALL PRINT_STR, @"「%CNAME("一人称")%が相手なんだから%TEXTR("遠慮はいらないからね/どんどん色々試していいのよ")%」_W"	CALL PRINT_STR, @"「%CNAME("一人称")%可是你的对手，%TEXTR("请不要客气/可以不断尝试各种各样的东西哦")%」_W"
PRINTFORMW 「上手に出来たらご褒美をあげますからね、一生懸命ペロペロしてちょうだいね」	PRINTFORMW 「如果做得好的话我会给你奖励的，要加油哦」
PRINTFORMW 「%CNAME("一人称")%のアソコを舐めたいだなんて……」	PRINTFORMW 「竟然想要舔%CNAME("一人称")%的阴部啊……」
CALL PRINT_STR, @"「%TEXTR("上手よ/いいわ")%_HH_……」_W"	CALL PRINT_STR, @"「%TEXTR("很擅长啊/不错嘛")%_HH_……」_W"
CALL PRINT_STR, @"「%CNAME("一人称")%ね、おっぱいは自信があるのよ_HH_」_W"	CALL PRINT_STR, @"「%CNAME("一人称")%对胸部很有自信哦_HH_」_W"
PRINTFORMW 「思う存分、吸ったり舐めたり%CNAME("二人称")%の好きにしてみてね」	PRINTFORMW 「就允许%CNAME("二人称")%尽情地舔吸吧」
CALL PRINT_STR, @"「そんなに%CNAME("一人称")%のおっぱいが好きなの？_HH_」_W"	CALL PRINT_STR, @"「这么喜欢%CNAME("一人称")%的胸部吗？_HH_」_W"
CALL PRINT_STR, @"「%CNAME("一人称")%ね、%TEXTR("おっぱい/胸/乳房")%を%CNAME("二人称")%に%TEXTR("滅茶苦茶にされるの好きなのよ/強くされるのが好きよ/揉まれると感じちゃうの")%_BHH_」_W"	CALL PRINT_STR, @"「%CNAME("一人称")%的%TEXTR("胸部/胸/乳房")%被%CNAME("二人称")%%TEXTR("弄乱七八糟的，好喜欢/强硬地弄着，好喜欢/使劲揉搓着，很有感觉")%_BHH_」_W"
PRINTFORMW 「ほら……相手は%CNAME("一人称")%なんだから失敗してもいいのよ」	PRINTFORMW 「呐……因为对手是%CNAME("一人称")%，所以失败了也没关系」
PRINTFORMW 「ちゅっ、優しく唇を重ねて……はむっ……そう、上手よ……」	PRINTFORMW 「啾，让嘴唇温柔地重叠……哈哈……对，很擅长呢……」
PRINTFORML （この子は人恋しいの……きっと愛する人が出来たら私の元から離れていくのだから……）	PRINTFORML （这孩子很让人爱恋……一旦有了心爱的人，就会从我身边离开吧……）
PRINTFORMW 「%CNAME("一人称")%と…キス、したいの？」	PRINTFORMW 「想和%CNAME("一人称")%…接吻，吗？」
CALL PRINT_STR, @"（%CONDS("間柄", PLAYER)%とこんな…いやらしいキスをしちゃう…なんて……_HH_）_W_"	CALL PRINT_STR, @"（和%CONDS("間柄", PLAYER)%这样接吻，多么……_HH_）_W_"
CALL PRINT_STR, @"（%CONDS("間柄", PLAYER)%とこんな…いやらしいキスをしちゃう…なんて……）_W_"	CALL PRINT_STR, @"（和%CONDS("間柄", PLAYER)%这样接吻，多么…………）_W_"
PRINTFORMW 「実の母親のアナルに中出しして、こんな恥ずかしい事まで命令するなんて……」	PRINTFORMW 「在亲生母亲的肛门里中出、连这么害羞的事情你都要命令……」
PRINTFORMW 「癖になったらどうする気なのよ……」	PRINTFORMW 「如果上瘾变成了癖好要怎么办哟……」
CALL PRINT_STR, @"「ウフッ_HH_　%CNAME("一人称")%の中出しアナル見られちゃってる_HH_」_W"	CALL PRINT_STR, @"「呼呼_HH_　%CNAME("一人称")%的中出肛门被看见了呢_HH_」_W"
CALL PRINT_STR, @"「%TEXTR("私/お母さん")%の%TEXTR("アナル/お尻")%%TEXTR("ひくひくしてる/広がっちゃってる")%でしょう？_HH_」_W"	CALL PRINT_STR, @"「%TEXTR("我/妈妈")%的%TEXTR("肛门/屁股小穴")%大概在%TEXTR("抽搐着/扩张着")%吧？_HH_」_W"
PRINTFORMW 「バイブを使いたいの？　別にいいけれど……」	PRINTFORMW 「想用振动棒吗？没关系哦……」
PRINTFORMW %CALLNAME:TARGET%のアソコは難なくバイブを飲み込んでいく	PRINTFORMW %CALLNAME:TARGET%的阴部毫不费力地吞下了振动棒。
PRINTFORMW 「意外そうな顔をするけど、私こう見えても子供を二人も産んでるのよ」	PRINTFORMW 「看起来很意外呢，就算我这样看起来不像，但毕竟还是生过两个孩子。」
CALL PRINT_STR, "「多少の大きさのバイブぐらいなら全然平気。本番させてあげれない分もたっぷりと楽しんでね_HH_」_W_"	CALL PRINT_STR, "「多大的振动棒都完全不要紧哦。虽然不是在做爱，但是也请好好地享受吧_HH_」_W_"
CALL PRINT_STR, @"「%TEXTR("うふふ/ふふっ")%_HH_　こうして%CONDS("間柄", PLAYER)%にバイブ%TEXTR("で犯される/を咥え込まされる")%って……とっても%TEXTR("ゾクゾクしちゃうわ/背徳的ね")%_HH_」_W"	CALL PRINT_STR, @"「%TEXTR("诶嘿嘿/哦呼呼")%_HH_　就这样被%CONDS("間柄", PLAYER)%的振动棒%TEXTR("侵犯/插入")%，嗯……感觉非常地%TEXTR("激动呢/背德呢")%_HH_」_W"
CALL PRINT_STR, @"%CALLNAME:TARGET%の%TEXTR("尻/アナル")%から%TEXTR("ひり出された/排泄された")%%TEXTR("馬型/巨大")%バイブは、_"	CALL PRINT_STR, @"%CALLNAME:TARGET%的%TEXTR("屁眼/肛门")%被%TEXTR("马型/巨大")%的振动棒抽插得%TEXTR("要出来了/要排泄了")%_"
CALL PRINT_STR, @"「%TEXTR("本当に悪い子ね/イケナイ子ね")%、%TEXTR("ガバガバになったら責任をとってもらいますからね/普通の大きさじゃ物足りなくなった責任はとってもらいますからね")%_HH_」_W"	CALL PRINT_STR, @"「%TEXTR("真是个坏孩子/真是个小坏蛋")%，%TEXTR("那里变得空空荡荡的，记得要负责哦/普通的大小的已经无法满足了，记得要负责哦")%_HH_」_W"
CALL PRINT_STR, "(こんなにっ、こんなに激しく求められたら、私…っ)_W_"	CALL PRINT_STR, "(如此强烈地渴求着我…)_W_"
PRINTFORMW 「いいえ……けして、嫌ではないわ。実の%CONDS("間柄", PLAYER)%に四つん這いにされて、タダの牝として種付けされる日が来るなんて想像もした事がなかっただけだもの」	PRINTFORMW 「讨厌……倒也说不上。实际上和%CONDS("間柄", PLAYER)%用这种四肢着地、像母畜配种一样的做爱方式什么的，完全没有想象过」
PRINTFORML 「ちょっとこの姿でするのは……お尻が目立つんじゃないかと思うと恥ずかしいわ……」	PRINTFORML 「以这种姿势来做……一想到屁股是不是很显眼就觉得有点害羞……」
PRINTFORML 「ダメよっ、ちゃんとゴムをしなさいっ！！」	PRINTFORML 「不行哟，一定要用避孕套才行！！」
PRINTFORMW （%CONDS("間柄", PLAYER)%の生ちんぽを受け入れるなんて本当はダメよ、ダメなのに……私は……私はどうして……）	PRINTFORMW （被%CONDS("間柄", PLAYER)%射在里面真的不可以啊，不行……我……我为什么……）
CALL PRINT_STR, @"「%TEXTR("あぁん/はぁん/んぅっ")%_BHH_　%TEXTR("おっきいの/大きいの/太いの")%が私の%TEXTR("お尻/アナル")%に入ってきちゃってる_BHH_」_W"	CALL PRINT_STR, @"「%TEXTR("啊唔/哈啊/嗯啊")%_BHH_　%TEXTR("大大的/很大的/粗大的")%已经进入我的%TEXTR("屁股小穴/肛门")%了_BHH_」_W"
CALL PRINT_STR, @"「%CNAME("一人称")%の%TEXTR("お尻/アナル")%、%TEXTR("壊れ、ちゃうっ/壊れちゃう/こ、壊れるからっ")%、%TEXTR("やめて……/許してっ/ああっ！！")%」_W"	CALL PRINT_STR, @"「%CNAME("一人称")%的%TEXTR("屁股小穴/肛门")%、%TEXTR("坏、坏掉了/会坏掉的/这里、坏掉了")%、%TEXTR("停…停下…/原谅我/啊啊啊！！")%」_W"
CALL PRINT_STR, @"「%TEXTR("＿/お願いだから")%……%TEXTR("ゆっくり動いてっ/優しくしてっ/もっとゆっくりにしてぇ")%」_W"	CALL PRINT_STR, @"「%TEXTR("＿/所以拜托了")%……%TEXTR("慢慢地动/温柔点/再慢一点吧")%」_W"
CALL PRINT_STR, @"「%TEXTR("はぁん/あぁん/ひゃん")%_BHH_　%TEXTR("お尻/アナル")%%TEXTR("好きぃ/気持ちいいっ/で感じちゃうのぉ")%_BHH_　%TEXTR("いいっ/いくっ/いっちゃいます")%_BHH_」_W"	CALL PRINT_STR, @"「%TEXTR("哈嗯/啊呣/嗯唔")%_BHH_　%TEXTR("屁股小穴/肛门")%……%TEXTR("好喜欢/好舒服/这种感觉")%_BHH_　%TEXTR("咿/要去了/要、要出来了")%_BHH_」_W"
CALL PRINT_STR, @"「%TEXTR("はしたない/エッチな/スケベな")%%TEXTR("母親/お母さん")%でごめんなさい_BHH_」_W"	CALL PRINT_STR, @"「我是个%TEXTR("肮脏/色情/好色")%的%TEXTR("母亲/妈妈")%，对不起_BHH_」_W"
CALL PRINT_STR, @"「私の%TEXTR("お尻/アナル")%_"	CALL PRINT_STR, @"「我的%TEXTR("屁股小穴/肛门")%_"
CALL PRINT_STR, @"%TEXTR("、滅茶苦茶にしてぇ/、壊れるまで犯してぇ/、あなただけのものだからぁ/があなたのカタチになるまで犯して欲しいのぉ/、毎日使って欲しいのぉ")%_BHH_」_W"	CALL PRINT_STR, @"%TEXTR("乱七八糟的/、被侵犯坏的/、只属于主人公的/只被主人公侵犯的/、每天泄欲用的")%_BHH_」_W"
CALL PRINT_STR, @"「は%CNAME("二人称")%%TEXTR("だけの性処理穴だから/のモノだから/用の肉便器だから")%_HH_　%TEXTR("アナル/お尻")%%TEXTR("の中にいっぱい出して/に沢山種付けして")%ぇ_HH_」_W"	CALL PRINT_STR, @"「%CNAME("二人称")%%TEXTR("的性欲处理小穴/的东西/的肉便器")%_HH_　%TEXTR("肛门/屁股小穴")%%TEXTR("里射被得满满的/播下了很多种子")%_HH_」_W"
CALL PRINT_STR, @"「%TEXTR("お母さん/私")%……%TEXTR("お尻/アナル")%に入ってた%TEXTR("おちんぽ/ペニス")%%TEXTR("にご奉仕して/をペロペロ舐めさせられ/をしゃぶらされて")%、%TEXTR("感じちゃってるの/興奮しちゃってるの/喜んじゃってるの")%……」_W"	CALL PRINT_STR, @"「%TEXTR("妈妈/我")%……%TEXTR("服务/舔舐/清洁")%着插入%TEXTR("屁股小穴/肛门")%的%TEXTR("小鸡鸡/肉棒")%，%TEXTR("感觉很舒服/感觉很兴奋/感觉很开心")%哦……」_W"
PRINTFORMW %TEXTR("素敵/立派/逞しい")%な%TEXTR("おチンポ/ペニス/アソコ")%ね……」	PRINTFORMW %TEXTR("无敌的/挺立的/雄伟的")%%TEXTR("大鸡鸡/肉棒/那里")%……」
CALL PRINT_STR, @"「%CNAME("一人称")%ね、%CNAME("二人称")%の%TEXTR("おちんぽ/ペニス")%ならいつでも%TEXTR("ご奉仕してあげる/綺麗にしてあげる/しゃぶってあげる")%_HH_」_W"	CALL PRINT_STR, @"「%CNAME("一人称")%随时都可以把%CNAME("二人称")%的%TEXTR("大鸡鸡/肉棒")%%TEXTR("好好服务/打扫干净/舔干净")%_HH_」_W"
PRINTFORMW 「私も%TEXTR("母親/お母さん")%だもの……%TEXTR("子供/我が子")%が喜んでくれるなら何でもしたくなっちゃうのよ」	PRINTFORMW 「我也是个%TEXTR("母亲/妈妈")%嘛……只要%TEXTR("孩子/我的孩子")%喜欢，做什么都可以哟」
PRINTFORMW 「あんなに小さかった%CNAME("二人称")%が、私にお掃除フェラさせてるなんて不思議ね」	PRINTFORMW 「%CNAME("二人称")%这个可爱的小家伙，我的清洁口交很不可思议吧……」
PRINTFORMW 「%CNAME("一人称")%のアソコに%TEXTR("玩具/おもちゃ/オモチャ/バイブ")%入れてご奉仕させるなんて……%TEXTR("イケナイ子/悪い子")%ね……」	PRINTFORMW 「让%CNAME("一人称")%的阴部插着%TEXTR("玩具/大玩具/玩具/振动棒")%进行侍奉……真是%TEXTR("坏小孩/坏孩子")%……」
CALL PRINT_STR, @"「%CNAME("二人称")%は小さい時から、%CNAME("一人称")%のおっぱい大好きね_HH_」_W_"	CALL PRINT_STR, @"「记得%CNAME("二人称")%小时候，最喜欢%CNAME("一人称")%的胸部了_HH_」_W_"
PRINTFORMW 「可愛い顔してるのに……こんなにアソコを硬くしちゃって」	PRINTFORMW 「明明长着一张可爱的脸……下边却如此坚硬」
CALL PRINT_STR, @"「ほら……%TEXTR("私/お母さん")%の%TEXTR("パイズリ/胸/おっぱい")%%TEXTR("大好きなんでしょう/で感じちゃってるんでしょう")%」_W"	CALL PRINT_STR, @"「看……%TEXTR("我/妈妈")%的%TEXTR("乳交/胸/胸部")%%TEXTR("最喜欢了，对吧/有好好感觉到吧")%」_W"
CALL PRINT_STR, @"「%TEXTR("押し倒されて/犯されて")%_HH_　喜んじゃうなんて情けない」_W"	CALL PRINT_STR, @"「%TEXTR("被逆推/被侵犯")%_HH_　还觉得高兴什么的，太可怜了呢」_W"
PRINTFORMW 「%TEXTR("お母さん/一生懸命")%ご奉仕したいのに……%TEXTR("玩具/おもちゃ/オモチャ/バイブ")%%TEXTR("が動いて、集中出来ないじゃない/で感じちゃって声出ちゃう……")%」	PRINTFORMW 「%TEXTR("妈妈/拼命")%被……%TEXTR("玩具/承认玩具/大玩具/振動棒")%%TEXTR("因为活动，不能集中精力/因为快感发出了声音……")%」
CALL PRINT_STR, @"「%TEXTR("私/お母さん/母親")%の%TEXTR("胸/おっぱい")%でこんなに%TEXTR("カチカチ/ガチガチ")%にさせ%TEXTR("＿/ちゃっ")%て_HH_」_W"	CALL PRINT_STR, @"「因为%TEXTR("我/妈妈/母亲")%的%TEXTR("乳头/胸部")%变得%TEXTR("硬邦邦了/硬硬的")%呢_HH_」_W"
CALL PRINT_STR, @"「%TEXTR("母離れ出来なく/マザコンに")%なるまで……%TEXTR("可愛がってあげるんだからね/いじめちゃおうかしら")%_HH_」_W"	CALL PRINT_STR, @"「真是个%TEXTR("恋母狂/恋母控")%……%TEXTR("我会好好疼爱你的/尽情地欺负我吧")%_HH_」_W"
CALL PRINT_STR, "「うふふ、必死に腰振っちゃってぇ……_HH_」_W_"	CALL PRINT_STR, "「呵呵，看我的绝招腰部振动……_HH_」_W_"
CALL PRINT_STR, "「うふふ、必死に腰振っちゃって……」_W_"	CALL PRINT_STR, "「呵呵，看我的绝招腰部振动……」_W_"
PRINTFORMW  直接触れ合う互いの性器がくちゅくちゅと水音を立てている……	PRINTFORMW  彼此的性器直接接触，淫水声嗤嗤地响着……
PRINTFORMW  下着の薄布一枚を隔ててペニスがワレメに食い込んでは押し戻されていく……	PRINTFORMW  隔着内衣的一层布，阴茎似乎被吞进去，又吐了出来……
CALL PRINT_STR, @"「%TEXTR("たっぷりお仕置きしてください/ご主人様の性奴隷になりますから、許ししてください")%」_W"	CALL PRINT_STR, @"「%TEXTR("请您继续用肉棒惩罚我吧/我会成为主人的性奴隶的，请原谅我")%」_W"
PRINTFORMW 「エッチな事をする前に、ちゃんとローションを使うのは大事ね」	PRINTFORMW 「在做色色的事情之前，好好使用润滑液是很重要的」
PRINTFORMW 「%TEXTR("お尻/アナル")%は%TEXTR("繊細だから/アソコより締まっちゃうから")%、ローションをたっぷり塗ってくれると%CNAME("一人称")%も嬉しいわ」	PRINTFORMW 「%TEXTR("屁股小穴/肛门")%因为%TEXTR("很纤细/比阴部还要紧")%，能涂满润滑油再做的话，%CNAME("一人称")%会觉得很开心的」
CALL PRINT_STR, "「ローションでいっぱいヌルヌルにしてからご奉仕してあげる_HH_」_W"	CALL PRINT_STR, "「涂满润滑液后再为您服务_HH_」_W"
CALL PRINT_STR, "「口づけ…本気のキスは好きな人以外としちゃ駄目…よ_H_」_W_"	CALL PRINT_STR, "「接吻……真心的接吻除了喜欢的人以外……不行呀_H_」_W_"
CALL PRINT_STR, "「口づけ…本気のキスは好きな人以外としちゃいけないのよ」_W_"	CALL PRINT_STR, "「接吻……真心的接吻除了喜欢的人以外……不行呀」_W_"
CALL PRINT_STR, "「口づけ…本気のキスは好きな人以外としちゃ駄目なんだから」_W_"	CALL PRINT_STR, "「接吻……真心的接吻除了喜欢的人以外是不行的」_W_"
PRINTFORMW %CALLNAME:TARGET%は言葉では抵抗を示すものの、払いのけようとはせず消極的にキスを受け入れ始めた	PRINTFORMW %CALLNAME:TARGET%用语言象征性地表达了抵抗，没有主动拒绝而是被动地接受着亲吻。
PRINTFORMW 下着を露わにした…	PRINTFORMW 内衣露了出来…
PRINTFORMW 「ちょ…ちょっと……」	PRINTFORMW 「稍微…等等……」
PRINTFORMW 夢中で腰を使っているとペニスの先端がワレメの中に入り込んでしまった！	PRINTFORMW 感觉只要腰部用力的话，肉棒的前端就能直接插进那秘裂里去了。
PRINTFORMW 構わず強く押し込むと、ペニスの先端に感じていた僅かな抵抗感が消え去り、じゅぶっという感触と共に陰茎の半ばまで完全に肉膣の暖かさに包まれた。	PRINTFORMW 不顾一切地强行推入阴茎，尖端传来的抵触感仅仅一小会就消失了。取而代之的是咕啾咕啾的美妙触感，随后阴茎完全被温暖的肉壁包裹住了。
CALL PRINT_STR, "「今の、危なかった、わね……」_W_"	CALL PRINT_STR, "「今天……是危险期……」_W_"
CALL PRINT_STR, "「うふふっ」_W_"	CALL PRINT_STR, "「哦呼呼」_W_"
CALL PRINT_SELECT, "はい/そのまま"	CALL PRINT_SELECT, "是/保留"
PRINTFORML 「%CNAME("一人称")%%TEXTR("に乱暴にしたいなんて……困った子ね/のパンストを破いて、無理やりしたいの？/をいつもそんな目で見てたのかしら？")%」	PRINTFORML 「%CNAME("一人称")%%TEXTR("居然这么粗暴，真是让人为难的孩子啊/想要撕破以后，强行插入吗？/怎么用那种眼光看着我？")%」
PRINTFORML 「%TEXTR("こらっ/もう")%……%TEXTR("興奮しすぎよ、我が子ながら困った子ね/私にはしても良いけど、他の子には優しくするのよ？")%……」	PRINTFORML 「%TEXTR("哎呀！/真是的")%……%TEXTR("太兴奋了吧，就算是自己的儿子，都让人觉得为难呢/对我这样没关系，但是对其他的孩子要温柔一点哦？")%」
PRINTFORM %CALLNAME:MASTER%は%OUTER(TARGET, "略")%を力任せに破いて%CALLNAME%の	PRINTFORM %CALLNAME:MASTER%%OUTER(TARGET, "略")%用力地撕破%CALLNAME%的
PRINTFORMW \@ PENIS(TARGET) ? 股間 # アソコ \@を剥き出しにした……	PRINTFORMW \@ PENIS(TARGET) ? 股间 # 阴部 \@赤裸地展露出来……
PRINTFORMW 下着を露わにした……	PRINTFORMW 露出了内衣……
PRINTFORMW 「折角ローションを使ってくれたんだものね」	PRINTFORMW 「好不容易用了润滑液啊」
[2]好きだ、自分の恋人になって欲しい           (告白 & 好感度ボーナス：中)	[2]我喜欢你，希望你能成为我的恋人          (告白 & 好感度BOUNS：中)
PRINTFORMW そう言って軽く流そうとする%CALLNAME%だが、あなたは真剣な顔で重ねて想いを告白した。	PRINTFORMW 虽然%CALLNAME%想要轻描淡写地略过，告白的%CALLNAME:MASTER%看起来却一脸认真。
PRINTFORMW どう答えるべきか考えているのだろうか、しばしの間が流れる。	PRINTFORMW 在考虑应该怎么回答呢，时间在这一瞬间仿佛不再流逝。
PRINTFORMW 今この瞬間も、互いの熱を粘膜に感じているというのに。	PRINTFORMW 现在这一瞬间，用炽热的粘膜感受着彼此的存在。
PRINTFORMW 熱が離れようとする気配がする。せめて唇を奪おうと迫るが、そっと躱される。	PRINTFORMW 嘴里发出灼热的气息，至少想夺走嘴唇，却被悄悄地躲开了。
PRINTFORMW と逆に頬にキスをされてしまった。	PRINTFORMW 反而被亲吻了脸颊。
CALL PRINT_STR, @"「%TEXTR(@"ちゃんと避妊してくれて偉いわね/ゴムをつけてくれて%CNAME("一人称")%も嬉しいわ/いい子ね、ゴムをつけてくれるなら安心して親子でえっち出来るものね")%_H_」_L"	CALL PRINT_STR, @"「%TEXTR(@"好好避孕真了不起/有戴上避孕套%CNAME("一人称")%也很高兴/好孩子，如果戴上避孕套，就算是母子也可以安心的做了呢")%_H_」_L"
PRINTFORMW 「あらあら……ゴムを何処に落としてきたのかしらね？」	PRINTFORMW 「哎呀，避孕套不知道掉在什么地方了？」
PRINTFORMW 「%TEXTR("ちゃんとゴムをつけなさいっ……/ゴムはどうしたの！？　ダメっ、ダメよっ……/抜きなさいっ！！　このままじゃ親子で出来ちゃうのよ、解っているのっ！？")%」	PRINTFORMW 「%TEXTR("好好地戴上避孕套吧……/避孕套呢！？　不行、不行哦……/拔出来！！　母子之间不可以这样做，你忘了吗！？")%」
CALL PRINT_STR, @"「%TEXTR("おはよう/良い朝ね")%　%TEXTR("ちゅっ/ちゅぅ")%_HH_」_W"	CALL PRINT_STR, @"「%TEXTR("早上好/早上好哦")%　%TEXTR("啾芙/啾")%_HH_」_W"
CALL PRINT_STR, @"「%CNAME("二人称")%%TEXTR("にもっとおっぱい苛めて欲しいの/の手でもっとおっぱいをイジメてね/になら少しぐらい痛くされてもいいのよ")%_BHH_」_W"	CALL PRINT_STR, @"「%CNAME("二人称")%%TEXTR("更加激烈地欺负胸部吧/用手好好得欺负乳头吧/稍微弄疼些也是没关系的哦")%_BHH_」_W"
CALL PRINT_STR, "「んくっ、んくっ、んくっ…ぷぁ… _H_ごちそうさま_H_」_W_"	CALL PRINT_STR, "「嗯哼、嗯哼、嗯哼…啊噗… _H_多谢款待_H_」_W_"
PRINTFORMW %CALLNAME:ARG%はそそくさと起き上がって咳払いした…	PRINTFORMW %CALLNAME:ARG%一边咳嗽，一边慌慌张张的站了起来…
PRINTFORMW 「こほんっ。さ、早く朝ごはん食べちゃいなさい」	PRINTFORMW 「呵呵，起来吃早饭了哦」
PRINTFORMW 「今日は体育がある日みたいね。体操服とタオルは持った？」	PRINTFORMW 「今天好像有体育课，带体操服和毛巾了吗？」
PRINTFORMW 「今日は体育がある日みたいね。怪我をしないように気を付けて行ってらっしゃい」	PRINTFORMW 「今天好像有体育课，运动的时候一定要小心别受伤哦」
PRINTFORMW 　…うふふ、それともおっぱいの方がよかった？」	PRINTFORMW 　……诶嘿嘿，还是胸部比较好吧？」
PRINTFORMW 　…え、『おっぱいの方がいい』？」	PRINTFORMW 　……嗯、『胸部最棒了』？」
PRINTFORM %CALLNAME:ARG%はあなたにだけ見えるように	PRINTFORM %CALLNAME:ARG%只想让%CALLNAME:MASTER%看见。
PRINTFORMW （エッチの時はあんなに逞しいのに）	PRINTFORMW （H的时候明明那么健壮）
CALL PRINT_STR, "（ちゅうちゅうって一生懸命…かわいい_H_） _W_"	CALL PRINT_STR, "（中途拼命的样子…真是可爱_H_） _W_"
PRINTFORMW （あの人も私のおっぱい、よく飲みたがったっけ）	PRINTFORMW （那个人看见我胸部的时候，也想要喝我的奶水来着）
PRINTFORMW 「お茶でもどう？良かったら淹れてあげるけど」	PRINTFORMW 「喝杯茶怎么样？如果可以的话我给你泡哦」
PRINTFORMW 「遊んでばかり居ないで、ちゃんと宿題終わらせなさいよ？」	PRINTFORMW 「别老是玩，作业有好好做完吗？」
PRINTFORMW 「…今日はやけに素直ね」	PRINTFORMW 「……今天真是坦率啊」
PRINTFORMW 「…素直でよろしい」	PRINTFORMW 「…很老实呢」
PRINTFORMW 「今日は美味しいケーキ買ってきたから、皆で一緒に食べましょうね」	PRINTFORMW 「今天买了好吃的蛋糕，大家一起吃吧」
PRINTFORMW 「今日は美味しいケーキ買ってきたから、{CHARA_NUM("集合予定")}人で一緒に食べましょうね」	PRINTFORMW 	「今天买了好吃的蛋糕，{CHARA_NUM("集合予定")}人一起吃吧」
PRINTFORMW 「今日は美味しいケーキ買ってきたから、後で一緒に食べましょうね」	PRINTFORMW 「今天买了好吃的蛋糕，一会儿一起吃吧」
PRINTFORMW 「寄り道するのは良いけど、遅くなり過ぎないようにね」	PRINTFORMW 「可以绕道，但是不要太晚哦」
PRINTFORMW 「お風呂沸かしてあるから、入ってきちゃいなさい」	PRINTFORMW 「浴室的水烧开了，快进来吧」
PRINTFORMW 「ウフフ…いいえ、何でもないわ♪」	PRINTFORMW 「哦呼呼…不，没什么♪」
PRINTFORML 「今日からここの顧問になったメリィエーナです。先生に何でも相談してね」	PRINTFORML 「我叫麦莉爱娜，从今天开始在这里当顾问。有什么问题都可以和老师商量」
PRINTFORML 「…ちょっと甘やかし過ぎかしら」	PRINTFORML 「…是不是有点太娇惯了呢」
PRINTFORML 「人間が取引で悪魔を出し抜こうとする昔話があるけれど」	PRINTFORML 「虽然有人类通过交易想要赶走恶魔的传说」
PRINTFORML 「なんであんな話が今も語り継がれてるのかしら…子供の教育上良くないわ」	PRINTFORML 「为什么那样的话，现在还在流传呢……这对教育小孩子可不好」
PRINTFORML 「そうね、こういう場所にはあまり慣れてなくて……ちょっと緊張してるかも」	PRINTFORML 「是啊，对这样的地方不太习惯……也许稍微有些紧张了」
PRINTFORML 「お家ではいいけど、学校では教師と生徒なんだから我慢してって」	PRINTFORML 「在家怎么都好，但在学校是师生关系，所以给我忍耐一下」
CALL PRINT_STR, @"「%TEXTR("お仕事中だから長くは付き合えないわよ/終わったら戻るからね/ほら、早く済ませちゃいましょう")%_」_L"	CALL PRINT_STR, @"「%TEXTR("因为在工作，不能花太长时间哦/结束的时候要说出来哦/那，快点结束吧")%_」_L"
PRINTFORML 「男の子の%TEXTS("匂い")%がする部屋って健康的で良いわね……」	PRINTFORML 「这房间%TEXTS("气味")%的味道很大呢，大概这些男孩子都比较健康吧……」
PRINTFORML 「自分で片付けたのかしら、それとも%CALLNAME:FINDCHARA(NO, 1)%さんに片付けてもらったのかしら？」	PRINTFORML 「是自己收拾的，还是%CALLNAME:FINDCHARA(NO, 1)%帮忙收拾的？」
PRINTFORML 「たまには親子二人でゆっくりお話しするのも良いわね」	PRINTFORML 「偶尔母子二人好好聊聊也不错呢」
PRINTFORML 「随分と立派なバイブね。こんな大きいのを挿れられたら、さすがに壊れてしまいそうだわ」	PRINTFORML 「相当漂亮的振动棒呢。要是被这么大的东西插进去，大概会坏掉吧」
CALL PRINT_STR, @"「%TEXTR("メイドさんが来てくれて本当に助かるわ……でも、私も母親ですから/何でもお任せにするのは悪いもの、手伝うわよ")%」_L"	CALL PRINT_STR, @"「%TEXTR("女仆来了，真是帮了大忙了……但是，我也是个母亲呢/什么事都交给别人可不好，还是我来帮你吧")%」_L"
PRINTFORML %TEXTR("掃除を手伝っている/洗濯物を畳んでいる/洗い物をしている/料理を手伝っている")%	PRINTFORML %TEXTR("在帮忙做扫除/在叠晾好的衣服/在洗衣服/在帮忙做饭")%
CALL PRINT_STR, @"「%TEXTR("誰か可愛い子と/好きな子と一緒に")%%TEXTR("デートしてらっしゃいな/お買い物でもしてらっしゃい")%」_L"	CALL PRINT_STR, @"「%TEXTR("和哪个可爱的孩子/和喜欢的孩子一起")%%TEXTR("约好了吗/去买东西吧")%」_L"
CALL PRINT_STR, @"「そうねえ……%TEXTR("相手がいないなら/好きな子がいないなら")%%CNAME("一人称")%%TEXTR("がデートしてあげる/とデートする？")%」_L"	CALL PRINT_STR, @"「是啊……%TEXTR("如果没有对象的话/如果没有喜欢的孩子的话")%，就和%CNAME("一人称")%%TEXTR("一起逛逛吧/一起去约会吧？")%」_L"
PRINTFORML 「魔界カツカレーみそうどん定食…………もう一度…………だけ………………zzz」	PRINTFORML 「魔界咖喱酱乌冬面套餐…………想要………再来一份…………………………zzz」
CALL PRINT_STR, @"「%TEXTR("性処理して欲しいイケナイ子を徹底的に教育しなくちゃね/スッキリしたらちゃんと授業を受けるのよ？")%」_W"	CALL PRINT_STR, @"「%TEXTR("必须要通过性欲处理，彻彻底底地教育这个坏孩子/如果舒服地性欲处理之后冷静下来，应该会认真听课吧？")%」_W"
PRINTFORML 「%TEXTR("手/手コキ")%で%TEXTR("＿/処理")%してあげ%TEXTR("るから……/ますから……/るわ")%」	PRINTFORML 「会用手好好处理的」
PRINTFORML 「%CNAME("二人称")%は本当に%CNAME("一人称")%の%TEXTR("おっぱい/胸")%が好きなのね……」	PRINTFORML 「看来%CNAME("二人称")%真的很喜欢%CNAME("一人称")%的%TEXTR("胸部/胸")%呢……」
PRINTFORMW 「%TEXTR("学校では先生と生徒なんだから、抱きついちゃダメですからね？/もう……甘えん坊ね。なでなでしてあげるから離れなさいな/めっ、学校では自重しなさいね")%」	PRINTFORMW 「%TEXTR("在学校里是老师和学生，不可以搂搂抱抱吧？/已经这样撒娇了。让我来好好抱抱你吧/哎，在学校也要自重啊")%」
PRINTFORML 「%TEXTR("こらっ/ダメよ？")%　%TEXTR("いきなりキスするなんて/挨拶の前に口付けするなんて")%」	PRINTFORML 「%TEXTR("喂！/不行吧？")%　%TEXTR("突然接吻什么的/在打招呼之前就亲嘴")%」
PRINTFORMW 「%TEXTR(@"ちゃんと挨拶してからにしなさいね、解りましたか？/大体、%CNAME("一人称")%とキスしても嬉しくないでしょう？/してはイケナイとは言いません。ＴＰＯを考えなさいね")%」	PRINTFORMW 「%TEXTR(@"好好打招呼之后再做吧，明白了吗？/大概，和%CNAME("一人称")%接吻也不开心吧？/不是说不行。但也要考虑一下ＴＰＯ（时间“time”、地点“place”、场合“Occasion”）啊")%」
PRINTFORMW 「%TEXTR("あんまりふざけてると先生、怒りますからね？/ちゃんと挨拶しなさい。スキンシップはそれからです/部室の外では絶対にダメですからね？")%」	PRINTFORMW 「%TEXTR("太过分的玩笑，老师会生气的哦？/好好打招呼，身体接触以后再说吧/在活动室外绝对不行，明白吧？")%」
CALL PRINT_STR, @"「%CNAME("一人称")%の%TEXTR("アソコ/おまんこ")%……%TEXTR("に挨拶代わりのクンニなんて/に喜んで欲しいなんて")%ダメよ、%TEXTR("あぁっ/あんっ")%_H_」_W"	CALL PRINT_STR, @"「%CNAME("一人称")%的%TEXTR("阴部/おまんこ")%吗……%TEXTR("用舔阴代替打招呼/你开心就好吧")%不行啊、%TEXTR("啊啊/啊嗯")%_H_」_W"
PRINTFORMW （実の%CONDS("間柄", MASTER)%に%TEXTR("奉仕/クンニ")%されて……%TEXTR("感じちゃうなんて、こんなのダメよ……/イケナイと解っているのに……ドンドン濡れてきちゃってる……")%）	PRINTFORMW （事实上因为%CONDS("間柄", MASTER)%的%TEXTR("奉仕/舐陰")%……%TEXTR("竟然有这种感觉，这种事情可不行啊……/明明知道不可以……小穴还是湿了……")%）
PRINTFORMW %CALLNAME:TARGET%はこつんと%CALLNAME:MASTER%を叱りながらも、嬉しそうに微笑んでいる	PRINTFORMW %CALLNAME:TARGET%一边责备着%CALLNAME:MASTER%，一边开心地微笑着。
PRINTFORMW %CALLNAME:TARGET%は気まずそうに注意しながらも、頬は嬉しそうに緩んでいる	PRINTFORMW %CALLNAME:TARGET%虽然看上去有点尴尬，但是脸上的笑意却止不住展露出来。
PRINTFORMW 「%TEXTR("今はね……/特別に教えてあげるわね、今は")%%CLOCOLOR(CSTR:パンツ, "形容詞")%ものを穿いてるわ」	PRINTFORMW 「%TEXTR("今天……/今天，会特别告诉你的")%，穿着%CLOCOLOR(CSTR:胖次, "形容詞")%」
PRINTFORMW %CALLNAME:TARGET%は%CALLNAME:MASTER%にそっと耳打ちしてきた	PRINTFORMW %CALLNAME:TARGET%悄悄地在%CALLNAME:MASTER%耳边说着悄悄话。
CALL PRINT_STR, @"「%TEXTR("……ほら、自分で見てごらんなさい/知りたいなら、自分で確かめなさいな")%_HH_」_W"	CALL PRINT_STR, @"「%TEXTR("喏，那你自己来看吧/想知道的话，自己确认一下嘛")%_HH_」_W"
PRINTFORMW 「ちょっと耳を貸しなさい」	PRINTFORMW 「把耳朵凑过来吧」
PRINTFORMW 「……%CLOCOLOR(CSTR:パンツ, "形容詞")%ものを穿いてるわ」	PRINTFORMW 「……现在穿着%CLOCOLOR(CSTR:胖次, "形容詞")%」
PRINTFORMW %CALLNAME:TARGET%は頬を赤らめながら、%CALLNAME:MASTER%にそっと耳打ちしてきた	PRINTFORMW %CALLNAME:TARGET%脸颊通红地和%CALLNAME:MASTER%说着悄悄话。
PRINTFORMW 「好きなプレイ？」	PRINTFORMW 「喜欢的玩法？」
CALL PRINT_STR, @"「そうね……%CNAME("二人称")%にされる事なら%TEXTR("何でも好きだけど/嫌いなものはないけれど")%」_W"	CALL PRINT_STR, @"「是呀……如果是%CNAME("二人称")%的话，%TEXTR("做什么都很喜欢/没有讨厌的玩法")%」_W"
CALL PRINT_STR, @"「世の大半の女の子と同じで、%TEXTR("本番/種付けセックス/中出しエッチ")%が一番好きよ」_W"	CALL PRINT_STR, @"「和世界上大多数女孩子一样，最喜欢%TEXTR("爱爱/内射做爱/中出内射")%了」_W"
CALL PRINT_STR, @"「言葉では伝えにくいから続きはベッドで教えてあげるわね_HH_」_W"	CALL PRINT_STR, @"「因为很难用语言表达，接下来就在床上进行解答吧_HH_」_W"
CALL PRINT_STR, @"「%TEXTR("まあ/もちろん")%……%TEXTR("お母さん/私")%だって%TEXTR("女/悪魔")%だもの、一番好きなのは、%TEXTR("本番/種付けセックス/中出しエッチ")%だけど」_W"	CALL PRINT_STR, @"「%TEXTR("哎呀!/当然")%……因为%TEXTR("妈妈/我")%是%TEXTR("女人/恶魔")%的关系，%TEXTR("爱爱/内射做爱/中出内射")%什么的最喜欢了」_W"
CALL PRINT_STR, @"「%TEXTR("うふふ、冗談よ♪/分かってるでしょうけど、ダメなものはだーめ！")%」_W"	CALL PRINT_STR, @"「%TEXTR("诶嘿嘿，开玩笑的♪/话虽这么说，但不行就是不行！")%」_W"
PRINTFORMW 「見ての通りよ、書類が溜まってるの」	PRINTFORMW 「正如所见,堆满了文件」
PRINTFORML %CNAME("一人称")%のおっぱいが恋しくなったの？」	PRINTFORML 变得喜欢%CNAME("一人称")%的胸部了吗？」
PRINTFORMW 「%TEXTR("あんまり変な事ばかりしてると先生も怒りますからね/学校では先生と生徒なんだから、我慢しなさい")%」	PRINTFORMW 「%TEXTR("如果老是做些奇怪的事情，老师也会生气的/在学校里是老师和学生，所以要忍耐")%」
PRINTFORMW %CALLNAME:TARGET%はあられもない声をあげて身悶えしている	PRINTFORMW %CALLNAME:TARGET%发出压抑的惊讶声。
CALL PRINT_STR, @"「%TEXTR("を抱きしめると/の顔を覗き込み")%_"	CALL PRINT_STR, @"「%TEXTR("拥抱住/窥视着脸")%_"
CALL PRINT_STR, @"「そっと%TEXTR("頭/頬")%を撫でた」_W"	CALL PRINT_STR, @"「悄悄地抚摸着%TEXTR("头/脸颊")%」_W"
PRINTFORMW そっと頭を撫でた	PRINTFORMW 悄悄地抚摸着头。
PRINTFORMW %CALLNAME:MASTER%と%CALLNAME:TARGET%は互いに舌を絡めあう	PRINTFORMW %CALLNAME:MASTER%和%CALLNAME:TARGET%的舌头相互缠绕着。
PRINTFORMW 「顧問だから大目に見るけど、部室であんまり騒ぎになる様な事はしないようにね？」	PRINTFORMW 「虽然因为是顾问所以可以不介意，但是这种事还是会引起活动室的骚乱吧？」
PRINTFORMW 「キス上手になったのね、まったく誰に似たのかしら」	PRINTFORMW 「变得擅长接吻了呢，是因为谁呢？」
PRINTFORMW 「折角だから、キスの練習しましょうか？」	PRINTFORMW 「好不容易，要练习接吻吗？」
PRINTFORMW 「フフッ……ちょっと嬉しいから、甘えちゃいましょうか」	PRINTFORMW 「呼呼……有点开心呢，那就撒娇咯」
CALL PRINT_STR, @"%TEXTR("親孝行だなんて嬉しいわね/お茶を淹れてくれるなんて、気が利くのね")%」_W"	CALL PRINT_STR, @"%TEXTR("孝顺父母真是高兴啊/很机灵嘛，还知道要倒茶")%」_W"
PRINTFORML 「気遣いはいいから」	PRINTFORML 「因为很关心呢」
PRINTFORML 「私はここの顧問なんだし、おもてなしの必要はないわよ」	PRINTFORML 「我是这里的顾问，没必要这么客气」
PRINTFORM 「%TEXTR("ちょっとはしたなかったかしらね/どうせなら若い子にキスされる方が良かったかしら")%……%CNAME("二人称")%の顔を見ていたら	PRINTFORM 「%TEXTR("是不是有点不值得一提呢/反正和年轻的孩子接吻还是很棒的吧")%……看着%CNAME("二人称")%的脸
PRINT 我が子ながら	PRINT 我的孩子
PRINT イケメン	PRINT 帅哥
CALL PRINT_STR, @"「%TEXTR(@"それとも、%CNAME("一人称")%にされるから恥ずかしいのかしら？/%CNAME("一人称")%とちょっぴり仲良しなだけだもの、他の子の事は気にしなくてもいいのよ/そんな顔されると意地悪したくなっちゃうわね")%_H_」_W"		CALL PRINT_STR, @"「%TEXTR(@"哎呀，因为我%CNAME("一人称")%而感觉到害羞了吗？/只不过是和%CNAME("一人称")%关系有些亲密罢了，其他孩子的事不用介意哟/看你的表情是有了坏心眼吧")%_H_」_W"
CALL PRINT_STR, @"「%TEXTR("まだまだ子供だと思っていたのにね/あんなちびっ子がこんなに大きくなって")%」_W"	CALL PRINT_STR, @"「%TEXTR("还以为是个孩子呢/原来的小不点已经长大了呢")%」_W"
PRINTFORMW 「最初からそうやって素直に甘えればいいのに」	PRINTFORMW 「明明一开始就这样坦率地撒娇就好了呀」
PRINTFORML 「うふふ、いい子いい子～♪」	PRINTFORML 「诶嘿嘿、好孩子～好孩子～～♪」
CALL PRINT_STR, @"「%TEXTR("…はい、どうぞ。熱いから気を付けてね/熱いなら、昔みたいにふーふーしてあげましょうか？")%」_W"	CALL PRINT_STR, @"「%TEXTR(@"哎呀，因为我%CNAME("一人称")%而感觉到害羞了吗？/只不过是和%CNAME("一人称")%关系有些亲密罢了，其他孩子的事不用介意哟/看你的表情是有了坏心眼吧")%_H_」_W"
PRINTFORML 「あら……%CNAME("二人称")%もトイレだったのね」	PRINTFORML 「哎呀……%CNAME("二人称")%也在厕所里」
PRINTFORMW 「ちょっとお花を摘みに行ってくるわね」	PRINTFORMW 「稍微等一下，我先去洗个手」
PRINTFORML 「……もしかして私、子供の育て方を間違えたのかしら」	PRINTFORML 「……难道我教育孩子的方法错了吗？」
PRINTFORML 「甘えたいなら素直にそう言えばいいのに」	PRINTFORML 「想撒娇就坦率地说出来吧！」
PRINTFORMW 「やめなさい、%CNAME("一人称")%の%TEXTS("匂い")%なんて嗅いで嬉しいの？」	PRINTFORMW 「不要这样啊，闻着%CNAME("一人称")%的%TEXTS("气味")%感觉到很高兴吗？」
PRINTFORML 「%TEXTR("命令された通り/言われた通り")%……」	PRINTFORML 「%TEXTR("按照命令/如您所说")%……」
PRINTFORML 「%TEXTR("拡張して/バイブを入れて")%%TEXTR("るわ/るから/ます")%……」	PRINTFORML 「会%TEXTR("扩张/插入振动棒")%%TEXTR("的啊！/的啦所以/的")%……」
PRINTFORML 「%CNAME("一人称")%%TEXTR("は良いけど、彼女が出来たらこういう事はしてはいけませんからね/以外の人にこういう事しちゃダメよ")%……」	PRINTFORML 「虽然%CNAME("一人称")%%TEXTR("可以这样做，如果她来了就不能做这种事了/没有问题，但是就不要让其他人这样做了")%……」
PRINTFORML 「フフ……%CNAME("一人称")%の%TEXTR("下着/パンツ")%が見たいなんてイケナイ子ね」	PRINTFORML 「咯咯……竟然想看%CNAME("一人称")%的%TEXTR("内衣/胖次")%，真是个讨厌的孩子呢。」
PRINTFORMW 「いつからパンツが%CNAME("二人称")%の%CNAME("一人称")%になったのかしら？」	PRINTFORMW 「什么时候%CNAME("一人称")%的胖次变成%CNAME("二人称")%的了？」
PRINTFORMW 「%TEXTR("母親の下着なんて見てもつまらないでしょう？/ビックリしたわ、変な事はしないの/お母さんの下着なんてどうして見たいの")%」	PRINTFORMW 「%TEXTR("看母亲的内衣不会觉得无聊吗？/没有做奇怪的事呢，真是吓了一跳/为什么想看母亲的内衣呢？")%」
PRINTFORML 「%CNAME("一人称")%%TEXTR("には良いけど、彼女が出来たらこういう事はしてはいけませんからね/以外の人にこういう事しちゃダメよ")%……」	PRINTFORML 「%CNAME("一人称")%%TEXTR("感觉还不错，如果她来了就不能做这种事了。/不要让别人做这种事")%……」
PRINTFORML 「%TEXTR("もしかしてお弁当を忘れたの？/さては、ハンカチを忘れたんでしょう？/まさか、お財布を忘れたの？")%それとも……」	PRINTFORML 「%TEXTR("是不是忘记带便当了？/哎呀，你是不是忘记带手帕了？/不会吧，忘记带钱包了？")%还是……」
PRINTFORMW 「%CNAME("一人称")%のパンツが欲しいの？　まったく誰に似たのかしら」"	PRINTFORMW 「想要%CNAME("一人称")%的胖次？　想知道是什么样子的吗？」"
PRINTFORMW 「はい、どうぞ……こら、そんなに見るんじゃありません」	PRINTFORMW 「好吧，但是，呀，别这么看啊」
PRINTFORMW 「ごめんなさいね、%CNAME("一人称")%ちょっと忙しくて……」	PRINTFORMW 「对不起呢，%CNAME("一人称")%现在有点忙……」
PRINTFORMW 「%CNAME("一人称")%、ちょっと身支度するから待ってね」	PRINTFORMW 「让我稍微换身衣服准备一下」
