//文件: EVENT_K100_DAILY.ERB
CALL PRINT_STR, @"「んぅっ…はむっ…どうぞ、お好きな時に…_HH_」_W"
PRINTFORMW 意識が朦朧としている中で、溢れた精液が%CALLNAME:TARGET%の口から流れ出ているのが見える……	PRINTFORMW 含糊不清地说起了话，结果来不及吞咽的白浆流了出来……
PRINTFORMW 「んはぁ……朝のご奉仕です、どうぞお楽しみください。」	PRINTFORMW 「哈……这是清晨份的女仆服务，希望您会喜欢。」
CALL PRINT_STR, @"「おはようございます…んぅぅ…_H_」_W"	CALL PRINT_STR, @"「早上好呢~嗯哼~_H_」_W"
CALL PRINT_STR, @"「朝なのに、とても元気ですね…」_W"	CALL PRINT_STR, @"「从早上開始就很有精神呢」_W"
CALL PRINT_STR, @"「元気に射精できましたね…_H_これで爽やかにお目覚めいただけますね…」_W"	CALL PRINT_STR, @"「很有精神地射出来了_H_这样就会清爽起来了吧~」_W"
PRINTFORMW 「はぁぁ……朝のご奉仕です…%CNAMET(ARG, "二人称")%のお気に召すと良いのですが。」	PRINTFORMW 「哈……这是清晨份的服务，希望%CNAME("二人称")%会喜欢。」
CALL PRINT_STR, @"「はぁ…はぁ…朝からこんなに元気だなんて……」_W"	CALL PRINT_STR, @"「啊哈~啊哈~，大清早就这么有精神……」_W"
CALL PRINT_STR, @"「んぅぅ～…硬いです…こうして朝からしっかりと発散しておけば、いい一日になりますよ_HH_」_W"	CALL PRINT_STR, @"「嗯哼~好硬呢~清早在的身体里发泄一下的话，一天都会过的很舒服吧_HH_」_W"
CALL PRINT_STR, @"「はぁぁ、お腹の中が熱いです……沢山出ましたね_HH_」_W"	CALL PRINT_STR, @"「哈，肚子里热热的……真不少呢_HH_」_W"
PRINTFORML 「%CNAMET(ARG, "二人称")%のお気に召すと良いのですが……この、特別なモーニングコール……」	PRINTFORML 「希望%CNAME("二人称")%会喜欢……这样的叫醒方式……」
CALL PRINT_STR, @"「おはようございます、あなた…_HH_」_W"	CALL PRINT_STR, @"「早上好呢~亲爱的~_HH_」_W"
CALL PRINT_STR, @"「愛するあなたに、お目覚めのご奉仕をさせてください」_W"	CALL PRINT_STR, @"「要服侍亲爱的起床了呢~」_W"
CALL PRINT_STR, @"「どうぞご期待くださいね…」_W"	CALL PRINT_STR, @"「请好好地期待吧~」_W"
PRINTFORMW 「これから%CALLNAME:TARGET%は%CNAMET(ARG, "二人称")%のために新婚の妻を演じます」	PRINTFORMW 「接下来%CALLNAME:TARGET%会扮演服侍%CNAME("二人称")%起床的新婚妻子」
PRINTFORMW 「このご奉仕が%CNAMET(ARG, "二人称")%のお気に召すと良いのですが」	PRINTFORMW 「希望%CNAME("二人称")%会喜欢这样的服务」
PRINTFORMW 「あ……%CNAMET(ARG, "一人称")%と%CNAMET(ARG, "二人称")%の二人だけのようですね…」	PRINTFORMW 「啊……这里只有%CNAME("一人称")%和%CNAME("二人称")%两个人呢」
PRINTFORMW %CALLNAME:TARGET%は、欲望に満ちている潤んだ瞳で、こちらを見つめている	PRINTFORMW %CALLNAME:TARGET%用水汪汪的眼神看了过来，眼神装满了欲望
CALL PRINT_STR, @"「その……_HH_」_W"	CALL PRINT_STR, @"「那个……_HH_」_W"
PRINTFORMW %CALLNAME:TARGET%は無意識に太ももを擦り合わせ始めた……	PRINTFORMW %CALLNAME:TARGET%似乎開始不自觉地摩擦着大腿……
PRINTFORMW %CALLNAME:TARGET%は%CALLNAME:MASTER%の隣に恭しく座る。とても礼儀正しく。	PRINTFORMW %CALLNAME:TARGET%恭恭敬敬的坐在了%CALLNAME:MASTER%的身边。看起来很乖巧的样子
PRINTFORMW 「もし、何かご命令があるのでしたら……」	PRINTFORMW 「如果%CNAME("二人称")%有什么吩咐的话……」
PRINTFORMW 「もし、何かご命令があるのでしたら……」	PRINTFORMW 「如果%CNAME("二人称")%有什么吩咐的话……」
PRINTFORMW 「ようやくお帰りですね、%CNAMET(ARG, "二人称")%。何かお手伝いできることはありますか？」	PRINTFORMW 「%CNAME("二人称")%终于回来了，有什么能为%CNAME("二人称")%做的吗？」
PRINTFORMW 「本日はどのような事がありましたか？何か気がかりなことがあれば%CNAMET(ARG, "一人称")%に仰ってください。」	PRINTFORMW 「今天一天都遇到了什么事情呢？有什么不顺心的事的的话，可以讲给%CNAME("一人称")%听」
PRINTFORMW 「お帰りなさいませ、%CNAMET(ARG, "二人称")%。何かご命令はありますか？」	PRINTFORMW 「%CNAME("二人称")%回来了，有什么吩咐吗？」
PRINTFORMW 「本日はどのような一日でしたか？」	PRINTFORMW 「今天一天过得怎么样呢？」
PRINTFORMW 「おかえりなさいませ、%CNAMET(ARG, "二人称")%。何かご命令はありますか？」	PRINTFORMW 「%CNAME("二人称")%回来了，有什么吩咐吗？」
PRINTFORMW 「本日はどのような一日でしたか？」	PRINTFORMW 「今天一天过得怎么样呢？」
PRINTFORMW 「さ、今日のお弁当ですよ」	PRINTFORMW 「呐、这是今天的便当呢」
PRINTFORMW %CALLNAME:MASTER%がお弁当箱の蓋を開けると、見たこともない食材が並んでいる……	PRINTFORMW %CALLNAME:MASTER%把便当盒打開确认了一下，都是不知名的食材呢……
PRINTFORMW 「どうかご心配なく、%CNAMET(ARG, "二人称")%…これは全部『とても元気が出る』材料ですよ」	PRINTFORMW 「请%CNAME("二人称")%不用担心呢，都是对身体非常“有益”的材料」
PRINTFORMW %CALLNAME:TARGET%は口元を歪め、意味深に微笑んでいる…	PRINTFORMW %CALLNAME:TARGET%的嘴角挂着意味深长的微笑
PRINTFORMW 「%CNAMET(ARG, "二人称")%、本日のお昼ご飯です」	PRINTFORMW 「这是%CNAME("二人称")%今天的午餐」
PRINTFORMW 「こちらが%TEXTR("辣子鶏/麻婆豆腐/玉翔細切り豚肉/牛のホルモン煮")%です、もし辛い物の気分でなければ…」	PRINTFORMW 「做的是%TEXTR("辣子鸡丁/麻婆豆腐/鱼香肉丝/夫妻肺片")%呢，如果%CNAME("二人称")%不想吃辣的话」
PRINTFORMW 「こちらに%TEXTR("海老の卵白炒め/春雨と白菜の炒め物/素三鮮餃子/豚肉と筍の炒め物")%も、ありますよ」	PRINTFORMW 「也有%TEXTR("龙井虾仁/粉丝白菜/素三鲜/竹笋红烧肉")%可以选呢」
PRINTFORMW %CALLNAME:TARGET%は色々と選択肢を用意してくれているようだ……	PRINTFORMW 看来%CALLNAME:TARGET%准备了不止一份的可选项啊……
PRINTFORMW 「今日は特別美味しくできていると思いませんか…」	PRINTFORMW 「觉得今天的料理有别样的美味吗…」
PRINTFORMW 「玉ねぎです…玉ねぎを入れたおかげですよ」	PRINTFORMW 「是洋葱，我加了洋葱」
PRINTFORMW 「冗談です…料理には魂が宿っています、%CNAMET(ARG, "一人称")%はそこに魂を注いでいるだけです……」	PRINTFORMW 「開个玩笑…料理是有自己的灵魂的，%CNAME("一人称")%只是倾注了自己的心意在里面……」
PRINTFORMW 今日のお弁当は、海苔とご飯、そして野菜とお肉が少し入っている……	PRINTFORMW 今天的便当是由紫菜，米饭，以及一些蔬菜和肉类做成的……
PRINTFORMW メイドが一人で一生懸命作っている姿が目に浮かぶ…	PRINTFORMW 看起来图案像是一名正在劳作的女仆呢
PRINTFORMW 「あ……このお弁当ですか？」	PRINTFORMW 「啊……您说这个便当吗？」
PRINTFORMW 「ちょっとした気まぐれです…“%CNAMET(ARG, "一人称")%も少しは魂を持っています”と叫んでみましょうか？」	PRINTFORMW 「只是一时心血来潮摆的，打算叫它“小小妹抖亦有几分魂魄”」
PRINTFORMW 「冗談です、失礼致しました」	PRINTFORMW 「開个玩笑」
PRINTFORMW 「いかがですか？お気に召しましたか？」	PRINTFORMW 「怎么样？喜欢这种味道吗？」
PRINTFORMW 「でしたら、次からもこのレシピを使うことにしますが……」	PRINTFORMW 「那样的话、可以考虑一会多做几次这一种呢……」
PRINTFORMW %CALLNAME:TARGET%は何かを考えているようだ	PRINTFORMW %CALLNAME:TARGET%好像在思量着什么
PRINTFORMW 「%CNAMET(ARG, "二人称")%のお口に合えばよいのですが」	PRINTFORMW 「希望%CNAME("二人称")%会喜欢」
PRINTFORMW 「明日に食べたいものがありましたら、遠慮なくおっしゃってくださいね」	PRINTFORMW 「明天想吃什么的话，也请%CNAME("二人称")%吩咐一下」
PRINTFORML 「今日はとても暑く感じます」	PRINTFORMW 感觉真是炎热的天气呢
PRINTFORML %CALLNAME:TARGET%がぼそりと呟やいた。	PRINTFORMW %CALLNAME:TARGET%在一旁嘟囔着
PRINTFORML %CALLNAME:TARGET%の体中には汗が浮かんでおり、湿った肉体はとても魅力的だ	PRINTFORMW 汗水在%CALLNAME:TARGET%的身体上肆意的留着，湿润的肉体看起来分外诱人
PRINTFORML 「あ…ここは？」	PRINTFORMW 「啊…这里是？」
PRINTFORML 寝起きの%CALLNAME:TARGET%は、ぼーっとした様子で辺りを見渡した。	PRINTFORMW 刚睡醒的看起来有些茫然，四处打量着确认着情况
PRINTFORML 「あ…はい、%CNAME("二人称")%、何か御用ですか」	PRINTFORMW 「哦…是啊，有%CALLNAME:MASTER%什么吩咐吗」
CALL DAILY_MESSAGE, "寝言"	CALL DAILY_MESSAGE, "梦话"
PRINTFORML 「どうして……」	PRINTFORML 「居然……」
PRINTFORML 「なぜ、そんなに優しいのですか……」	PRINTFORML 「为什么会这么的温柔……」
PRINTFORML 「できませんよ……」	PRINTFORML 「不可能的吧……」
PRINTFORML 「恋人になる、なんて……」	PRINTFORML 「做恋人什么的……」
PRINTFORML KOJO_DAILY_K100, %CSTR:PREV_DAILYCOM%後
PRINTFORML 「一緒にデートに行きたい、ですか？」	PRINTFORML 「要一起去约会吗？」
PRINTFORML 「メイドとデート、など…変な感覚ではないですか？」	PRINTFORML 「和女仆去约会，会不会显得有些奇怪？」
PRINTFORML 「いえ、%CNAME("一人称")%は、その、構いませんが……」	PRINTFORML 「不，%CNAME("一人称")%并不是不愿意……」
PRINTFORML 「一緒にデートですか？」	PRINTFORML 「一起去约会吗？」
PRINTFORML 「%CNAME("二人称")%…本当にご自分のメイドとデートをするのですか？」	PRINTFORML 「%CNAME("二人称")%确定要和自己的女仆约会吗？」
PRINTFORML 「%CNAME("二人称")%から言われたことですし、%CNAME("一人称")%の準備ができるまでお待ちくださいね…」	PRINTFORML 「既然%CNAME("二人称")%这么说了，请等%CNAME("一人称")%准备一下…」
PRINTFORML 「何のために魂が必要なのか、ですか？」	PRINTFORML 「想要灵魂用来做什么？」
PRINTFORML 「うーーん……簡単には申し上げられません……」	PRINTFORML 「Emmmm……不太好讲呢……」
PRINTFORML 「何故魂を集めるのか、ですか？」	PRINTFORML 「为什么要收集灵魂？」
PRINTFORML 「…悪魔にとっては、至って普通のことでは？」	PRINTFORML 「这对于恶魔来说，不应该是很正常的事情吗？」
PRINTFORML 「%CALLNAME:TARGET%は他にどうやって生きていけばいいのかわからないのです……」	PRINTFORMW 「%CALLNAME:TARGET%也并不知道有什么其他的生活方式了……」
PRINTFORML 「これが可能な取引の項目です。」	PRINTFORML 「这只是交易的内容。」
PRINTFORML 「ええ、これで全てです……。」	PRINTFORML 「这一切……都是。」
PRINTFORML メイドは絞り出すようにそう言うと無意識に首を振った	PRINTFORML 女仆几乎是用挤的方式从嘴唇里吐出肯定的话语……说完了却又下意识地摇了摇头。
PRINTFORML 「%CNAME("二人称")%、これ以上のことは不可能です……%CALLNAME:TARGET%はただのメイドですから……」	PRINTFORML 「请%CNAME("二人称")%不要再……%CALLNAME:TARGET%只是个女仆而已……」
PRINTFORML 「いらっしゃいませ」	PRINTFORML 「欢迎~」
PRINTFORML 「何か御用はございますか？」	PRINTFORML 「请问有什么需要吗？」
PRINTFORML 「いらっしゃいませ、%CNAME("二人称")%。」	PRINTFORML 「%CNAME("二人称")%来了。」
PRINTFORML 「お呼びの際は、鈴を鳴らしていただければ%CNAME("一人称")%は出ていきますが……」	PRINTFORML 「其实只要%CNAME("二人称")%摇铃召唤%CNAME("一人称")%，%CNAME("一人称")%就会过去的……」
PRINTFORML 「またですか…もう少しこちらの気持ちも尊重していただきたいです、%CNAME("二人称")%……」
PRINTFORML 「駄目という訳ではないですが…他の方に見られたら、%CNAME("二人称")%にとっても不利益が生じますよ」
PRINTFORMW 在裙子下面看到的光景…
PRINTFORMW 而黑色的光滑尾巴则缠在大腿上，像要隐藏起来什么一样有些紧张的蠕动着
PRINTFORMW 不过桃心形的尾巴尖还是没来的及藏在大腿后面，尖尖上面的来历不明的透明粘液反着光，一大滴的液滴正要跌落
CALL PRINT_STR,  "「啧…」_W"
PRINTFORMW %CALLNAME:TARGET%把脸别开躲避着%CALLNAME:MASTER%的眼神，尾巴越缠越紧勒出了大腿肉来…
CALL PRINT_STR,  "「啊…」_W"
PRINTFORMW 在象征性的抵抗之后，女仆服的裙摆被你掀开了，下面是一副淫菲的样子…
PRINTFORMW 内裤被拉在一边，%CALLNAME:TARGET%的尾巴绕着翘起来，用膨大的尾巴尖端塞入了自己的蜜穴
CALL PRINT_STR,  "「因为太多了来不及吃干净，所以想存着慢慢品尝一下…」_W"
PRINTFORMW %CALLNAME:TARGET%面无表情的这么解释了
CALL PRINT_STR,  "「啊…」_W"
PRINTFORMW 没有什么太大的反应，%CALLNAME:TARGET%俯视着你
PRINTFORMW 「怎么了，%CNAME("二人称")%？需要%CNAME("一人称")%帮%CNAME("二人称")%提住裙摆吗？」
PRINTFORMW 不知道是不是%CALLNAME:MASTER%的错觉，%CALLNAME:TARGET%的脸上略过了一丝丝戏谑的笑
CALL PRINT_STR,  "「啊…」_W"
PRINTFORMW 没有什么太大的反应，%CALLNAME:TARGET%俯视着你
CALL PRINT_STR,  "「%CALLNAME:MASTER%看够了吗？看够了请说一声。」_W"
PRINTFORML 「还请%CNAME("二人称")%稍微放尊重些……」
PRINTFORML 「虽然不是不可以，但是……被其他人看到了可能会对%CNAME("二人称")%产生不好的影响」
PRINTFORML 「これは……少し太すぎますね……」	PRINTFORML 「这个……有些太大了吧……」
PRINTFORML 「%CNAME("二人称")%ご使用の際には注意しなければいけませんね……」	PRINTFORML 「%CNAME("二人称")%使用的时候一定要注意啊……」
PRINTFORML 「こういったものを、慣れない女性に無理やり使ったりすると……」	PRINTFORML 「如果对没什么经验的女孩子直接粗暴地使用的话……」
PRINTFORML 「とても……とても痛いです……」	PRINTFORML 「会非常……非常的疼……」
PRINTFORML %CALLNAME:TARGET%は何か思う所があるようだ。	PRINTFORML %CALLNAME:TARGET%一副若有所思的样子。
CALL SET_DEVENT, "巨大バイブ感想"	CALL SET_DEVENT, "巨大振動棒感想"
PRINTFORML 「しかし……沢山買われましたね……」	PRINTFORML 「话说回来……买了很多东西呢……」
PRINTFORML 「%CALLNAME:TARGET%が整理のお手伝いをいたしましょうか？。」	PRINTFORML 「%CALLNAME:TARGET%会帮%CNAME("二人称")%整理好的。」
PRINTFORML 「よし、問題なく買い物は終わりましたね。」	PRINTFORML 「好的，确实买到了。」
PRINTFORML 「坊やのお守りは～」	PRINTFORML 「宝宝的护身符~」
「どこへ行った……」	「哪里去了啊……」
「どこ……どこへ行ったの？」	「哪……哪里？」
PRINTFORMW 熏熏然的%CALLNAME:TARGET%不明所以地哼唱着……
PRINTFORML 優しく微笑む%CALLNAME:TARGET%は無意識なのか歌を口ずさんでいる……	PRINTFORMW 听起来唱给小孩子的歌曲……%CALLNAME:TARGET%又是在哪里听到的呢？
PRINTFORML 童謡のようだが……%CALLNAME:TARGET%はいったいどこで覚えたのだろう？
PRINTFORML 「うぅぅぅ……す……少しめまいがします……」	PRINTFORMW 「咿呀……有……有些头晕……」
PRINTFORML それほど飲んでいないにも関わらず、%CALLNAME:TARGET%の顔は既に真っ赤だ……	PRINTFORMW 并没有喝太多，%CALLNAME:TARGET%的脸已经红扑扑的了……
PRINTFORML %CALLNAME:TARGET%は%CALLNAME:MASTER%の手を引いている。人目のない場所に行きたいようだ…	PRINTFORML %CALLNAME:TARGET%拉了拉的%CALLNAME:MASTER%手，似乎想去没人的地方
PRINTFORML %CALLNAME:TARGET%は%CALLNAME:MASTER%をじっと見つめている。が、こちらがそれに気付くと視線を逸らした。	PRINTFORML %CALLNAME:TARGET%正在凝视着%CALLNAME:MASTER%，被发现之后移開了眼神
PRINTFORML その直後、%CALLNAME:TARGET%は潤んだ瞳で見つめ返してきた…	PRINTFORML 片刻之后，又用湿润的目光看了过来
PRINTFORML %CALLNAME:TARGET%は辺りを隅々まで整理整頓している…	PRINTFORML %CALLNAME:TARGET%打理着各个角落
PRINTFORML %CALLNAME:TARGET%は%CALLNAME:MASTER%の動向をじっと監視している…	PRINTFORML %CALLNAME:TARGET%正观察着%CALLNAME:MASTER%在做什么
PRINTFORML %CALLNAME:TARGET%は畏まった様子で傍に立ち、%CALLNAME:MASTER%の指示を待っている。	PRINTFORML %CALLNAME:TARGET%恭敬地等在一旁等候着吩咐
PRINTFORML %CALLNAME:TARGET%は%CALLNAME:MASTER%をじっと見つめている。が、こちらがそれに気付くと視線を逸らした。	PRINTFORML %CALLNAME:TARGET%正在凝视着%CALLNAME:MASTER%，被发现之后移開了眼神
PRINTFORML その直後、%CALLNAME:TARGET%は潤んだ瞳で見つめ返してきた…	PRINTFORML 片刻之后，又用湿润的目光看了过来
PRINTFORML %CALLNAME:TARGET%は辺りを隅々まで整理整頓している…	PRINTFORML %CALLNAME:TARGET%打理着各个角落
PRINTFORML %CALLNAME:TARGET%は%CALLNAME:MASTER%の動向をじっと監視している…	PRINTFORML %CALLNAME:TARGET%正观察着%CALLNAME:MASTER%在做什么
PRINTFORML %CALLNAME:TARGET%は畏まった様子で傍に立ち、%CALLNAME:MASTER%の指示を待っている。	PRINTFORML %CALLNAME:TARGET%恭敬地等在一旁等候着吩咐
PRINTFORML 「うぅ……」	PRINTFORML 「呜……」
PRINTFORML 眠っている%CALLNAME:TARGET%は体を強張らせている…	PRINTFORMW 沉睡中的%CALLNAME:TARGET%的身体猛然的紧绷了一下
PRINTFORML 「お願い……します……痛いのは……嫌…」	PRINTFORML 「求……不……不要……疼」
PRINTFORML 眠っている%CALLNAME:TARGET%は悪夢にうなされているようだ……	PRINTFORMW 沉睡中的%CALLNAME:TARGET%好像在做噩梦的样子……
PRINTFORML 「って……帰って……」	PRINTFORML 「让……让……回」
PRINTFORML 眠っている%CALLNAME:TARGET%は、普段とは違う、泣くような声で理解不能な言葉を発している……	PRINTFORMW 沉睡中的%CALLNAME:TARGET%用平常从来没听到过的哭泣腔调说着意义不明的语言……
PRINTFORML 「お願い……帰って……」	PRINTFORMW 「求求……让……回」
PRINTFORML 「やめて……痛いぃ、うぅぅ…」	PRINTFORMW 「不要……好疼，唔」
PRINTFORML 「逃げないと……逃げないと……」	PRINTFORMW 「逃……逃……」
PRINTFORML 「坊やのお守りは～」	PRINTFORMW 「宝宝的护身符~」
PRINTFORML 「どこへ行った……」	PRINTFORMW 「哪里去了啊……」
PRINTFORML 「あの山越えて……」	PRINTFORMW 「翻过那座山……」
PRINTFORML 「里へ行った―」	PRINTFORMW 「去村里了啊———」
PRINTFORML 眠っている%CALLNAME:TARGET%は聞いたこともない奇妙な曲を口ずさんでいる……	PRINTFORMW 沉睡中的%CALLNAME:TARGET%哼唱着从来没有听过的奇怪曲调……
PRINTFORML %CALLNAME:TARGET%の目からは大粒の涙が零れ落ちた……	PRINTFORMW 大颗的泪珠从%CALLNAME:TARGET%的眼角滑了出来……
PRINTFORML どういう訳か、眠っている%CALLNAME:TARGET%の体は相変わらず強張っている…	PRINTFORMW 不知道为什么，沉睡中的%CALLNAME:TARGET%的身体仍旧十分紧张
PRINTFORML 何らかの言葉を発しているようだが、声が小さすぎてはっきりとは聞こえない…	PRINTFORMW 好像在说着什么，但是因为声音太轻了，并不能听得清楚
PRINTFORMW 「これで安全に楽しめますね、%CNAME("二人称")%……」	PRINTFORMW 「%CNAME("二人称")%做了安全措施呢……」
PRINTFORMW 「始めても構いませんか？」	PRINTFORMW 「可以開始了吗？」
PRINTFORMW 「ゴムの中、一杯ですね……」	PRINTFORMW 「里面都要装满了呢……」
PRINTFORMW 「%CNAME("二人称")%にご満足いただけていると良いのですが……」	PRINTFORMW 「%CNAME("二人称")%能满意就好了……」
PRINTFORMW 「%CNAME("二人称")%、お楽しみいただけましたか……？」	PRINTFORMW 「%CNAME("二人称")%開心就好了……」
PRINTFORMW KOJO_DAILYCOM_K100, %ARGS%(%CALLNAME:MASTER%に先に打招呼された)
PRINTFORMW 「申し訳ありません、つい眠ってしまって……」	PRINTFORMW 「对不起，不小心睡着了……」
PRINTFORMW 「あ……%CNAME("二人称")%のお言葉、とても嬉しいです……」	PRINTFORMW 「啊……感谢%CNAME("二人称")%的夸奖呢……」
CALL PRINT_STR, @"「そうまで言われますと、少し恥ずかしいです……_H_」_W"	CALL PRINT_STR, @"「这样的话，多少会有些不好意思……_H_」_W"
CALL PRINT_STR, @"「いえ…少し、ではないですね……あ、聞きたくない、という程ではありませんが」_W"	CALL PRINT_STR, @"「实在是太……啊，并不是讨厌听到这样的话」_W"
CALL PRINT_STR, @"「あ、どうぞ、続けてください……_H_」_W"	CALL PRINT_STR, @"「啊、继续说下去也没関系的……_H_」_W"
CALL PRINT_STR, @"「少し恥ずかしいですが……聞きたくない、という程ではありません」_W"	CALL PRINT_STR, @"「虽然多少会有些不好意思……但是并不讨厌听到这样的话」_W"
CALL PRINT_STR, @"「でしたら、%CNAME("二人称")%の事は他の女の子にお任せすることにしましょう」_W"	CALL PRINT_STR, @"「这样的话，%CNAME("二人称")%还是留给其他的女孩子吧」_W"
PRINTFORMW 「%CNAME("二人称")%がお求めとあれば、いつでも……」	PRINTFORMW 「如果%CNAME("二人称")%有什么需求的话……」
PRINTFORMW 「%CNAME("一人称")%はただのメイドにすぎません……」	PRINTFORMW 「%CNAME("一人称")%只是%CNAME("二人称")%的女仆……女仆怎么会介意%CNAME("二人称")%到底和几个女孩子在交往的事情呢。」
PRINTFORMW 「%CNAME("二人称")%が何人の女性と付き合っていようとメイドには関係のないことです。」
CALL PRINT_STR, @"「ただ……メイドの『罰ゲーム』を乗り切る体力は残しておいてくださいね……_HH_」_W"	CALL PRINT_STR, @"「只不过……%CNAME("二人称")%一定要预留足够的体力来撑过女仆的惩罚游戏呢……_HH_」_W"
PRINTFORMW 「%CALLNAME:TARGET%の個人的な事情に関心を向ける必要はありません。」
PRINTFORMW 「%CNAME("二人称")%は、契約に則って%CALLNAME:TARGET%を使って頂くだけでよいのです。」	PRINTFORMW 「%CNAME("二人称")%不需要过多的好奇%CALLNAME:TARGET%的事情呢。」
PRINTFORMW 「%CNAME("二人称")%只需要按照契约随意地使用%CALLNAME:TARGET%就好了。」
PRINTFORMW しかし%CALLNAME:TARGET%は%CALLNAME:MASTER%と目を合わせない	PRINTFORMW 然而%CALLNAME:TARGET%并不敢和%CALLNAME:MASTER%对视，不知道是害怕继续追问还是想到了平时%CALLNAME:MASTER%对女仆的使用……
PRINTFORMW それ以上の質問を恐れているのか、普段の%CALLNAME:MASTER%のメイドの扱いについて考えているのか……
PRINTFORMW 「ありがとうございます…自分でも可能ではありますが」	PRINTFORMW 「非常感谢，其实自己来也可以的」
CALL PRINT_STR, @"「そこが好きなのですね…では、もっと丹念に拭いてくださいますか……_BH_」_W"	CALL PRINT_STR, @"「喜欢那里吗，可以仔细地多擦一擦呦~……_BH_」_W"
PRINTFORMW 「あ…いけません、そのような場所ばかり…」	PRINTFORMW 「啊…请不要总是着重于奇怪的地方…」
PRINTFORMW KOJO_DAILYCOM_K100, %ARGS%
CALL PRINT_STR, @"「%CNAME("一人称")%の胸がお好きなのですね、もっと触っても構いませんよ……_BH_」_W"	CALL PRINT_STR, @"「喜欢%CNAME("一人称")%的胸部吗，可以多来几次呢~……_BH_」_W"
PRINTFORMW 「%CNAME("二人称")%が満足されるまで…」	PRINTFORMW 「直到%CNAME("二人称")%满意为止…」
PRINTFORMW 「%CNAME("二人称")%はここがお気に入りのようですね……」	PRINTFORMW 「看来%CNAME("二人称")%很喜欢这里呢……」
PRINTFORMW 「どうぞ%CNAME("二人称")%のお好きなように……」	PRINTFORMW 「随%CNAME("二人称")%喜欢吧……」
PRINTFORMW 「%CNAME("二人称")%のご厚意に感謝します……」	PRINTFORMW 「谢谢%CNAME("二人称")%的好意……不过真的只是想帮%CALLNAME:TARGET%按摩而已嘛？」
PRINTFORMW 「しかし、本当は%CALLNAME:TARGET%にマッサージをしたいだけなのではないですか？」
PRINTFORMW 「あ……%CNAME("二人称")%が望むのであれば……」	PRINTFORMW 「啊……如果%CNAME("二人称")%喜欢的话……」
PRINTFORMW 「%CNAME("一人称")%ですか？ただのメイドに……断る権利などありません……」	PRINTFORMW 「%CNAME("一人称")%？对于一名女仆的话……并不能拒绝呢……」
CALL PRINT_STR, @"「いえ、断れるはずがありません……こんなに素敵な事……_HH_」_W"	CALL PRINT_STR, @"「不能拒绝……这么喜欢的事……_HH_」_W"
PRINTFORMW 「%CNAME("二人称")%は本当に仕方のない方ですね…」	PRINTFORMW 「真拿%CNAME("二人称")%没办法啊」
PRINTFORMW 「しかし、これもメイドとしての仕事の一つです」	PRINTFORMW 「不过这看来也是女仆的工作之一呢」
PRINTFORMW 「%CNAME("二人称")%可以尽管的放轻松哦……」
CALL PRINT_STR, @"「このように%CNAME("二人称")%に体を預けると、すこし安心します…」_W"	PRINTFORMW %CALLNAME:TARGET%的大腿并不是最适合膝枕的那种软软的呢……多少有久经锻炼的意思……
PRINTFORMW %CALLNAME:TARGET%は%CALLNAME:MASTER%の膝を枕にしながら感嘆している……	PRINTFORMW 「不是很舒服吗？」
PRINTFORMW 「很抱歉……因为劳作的原因……手臂和腿多少会有些肌肉的……」
CALL PRINT_STR, @"「不过也不是全都是不好的……比如说，在骑马的时候，无论马儿怎么颠簸，%CALLNAME:TARGET%的大腿都会紧紧地夹住不会松開的喔~_HH_」_W"
PRINTFORMW 「少し疲れました…失礼します、%CNAME("二人称")%……」	PRINTFORMW 「这就去为%CNAME("二人称")%准备茶水……」
PRINTFORMW %CALLNAME:TARGET%は%CALLNAME:MASTER%の膝を枕にしながら休憩している……
PRINTFORMW 「こういったときは、楽しまなければいけませんよね？」	PRINTFORMW 「这种事情，是一定要尽兴的啊？」
PRINTFORMW 「ということで、もう一杯いかがですか？」	PRINTFORMW 「要再来一杯吗？」
PRINTFORML [1]一緒に飲もう	PRINTFORML [1]一起来喝酒吧
PRINTFORML [2]%CALLNAME:TARGET%の口移しで飲みたい	PRINTFORML [2]来服侍%CNAME("一人称")%喝酒吧
PRINTFORMW 「%CNAME("二人称")%のご厚意に感謝します。」	PRINTFORMW 「谢谢%CNAME("二人称")%的好意了呢。」
PRINTFORMW 「%CALLNAME:TARGET%は、昔とてもお酒が好きだったようです、飲みながら歌っていました……」	PRINTFORMW 「%CALLNAME:TARGET%过去好像也是很喜欢喝酒的，会边喝酒边唱歌……」
PRINTFORMW 「何の曲か、ですか？それについては全く思い出せません……」	PRINTFORMW 「唱的什么歌吗？不太记得清了呢……」
PRINTFORMW 「何かを探している、という歌だったのは覚えているのですが……」	PRINTFORMW 「好像是和寻找什么东西有関的呢……」
PRINTFORMW 「げほげほっ！げほっ……！」	PRINTFORMW 「咳咳！咳！咳！……」
PRINTFORMW お酒を口にした%CALLNAME:TARGET%激しくせき込み始める。	PRINTFORMW 喝下了一口酒的%CALLNAME:TARGET%剧烈地咳嗽了起来。
PRINTFORMW 「ごほ……だ……大丈夫です。本当です……げほげほっ！飲むのは久しぶりなので……けほっ！」	PRINTFORMW 「咳……没……没関系。应该……咳咳！只是太久没喝过……咳！」
PRINTFORMW 「こんなに辛口だとは思いませんでした……」	PRINTFORMW 「这么辣的吗……」
PRINTFORMW 「しかし、今日はこれくらいで遠慮させていただきます……」	PRINTFORMW 「不过今天就先算了吧……」
PRINTFORMW 「畏まりました……」	PRINTFORMW 「遵命……」
PRINTFORMW そう言って、%CALLNAME:TARGET%はお酒を一口だけ飲んだ。	PRINTFORMW %CALLNAME:TARGET%轻轻地抿了一口酒。
PRINTFORMW %CALLNAME:TARGET%はぎゅっと目を閉じると、唇を%CALLNAME:MASTER%に近づけた…	PRINTFORMW %CALLNAME:TARGET%皱了皱眉头，随后闭上了眼睛，把嘴唇向%CALLNAME:MASTER%贴近。
PRINTFORMW わずかに開いた口から、小さな舌先を上に向かって突き出している…	PRINTFORMW 微微地张開了嘴，小巧的舌尖翘起着伸了出来，
PRINTFORMW 「あ……」	PRINTFORMW 「啊……」
PRINTFORMW 「%CNAME("二人称")%、お味はいかがですか？」	PRINTFORMW 「%CNAME("二人称")%喜欢这个味道吗？」
PRINTFORMW 「このような、人間とは違う身体…嫌だとは思わないのですか？」	PRINTFORMW 「这种跟人类不同的样子，%CNAME("二人称")%不会觉得反感吗？」
PRINTFORMW 「あぁ……これ以上はもう、許してください……」	PRINTFORMW 「啊……请不要一直……」
PRINTFORMW 「本当に変わった方です…人ならざる者の身体が怖くないなんて……」	PRINTFORMW 「真是奇怪的人呢，不会害怕这种非人类的样子……」
PRINTFORMW 「本当に変わった方です…仕方ありませんね……」	PRINTFORMW 「真是奇怪的人呢，没办法……」
PRINTFORMW 「変わった趣味ですね……」	PRINTFORMW 「奇怪的爱好呢……」
PRINTFORMW 「まぁ、お気に召すのであれば…」	PRINTFORMW 「嘛，随您喜欢吧…」
PRINTFORMW 「嗯？」
PRINTFORMW 「%CNAME("二人称")%は本当にいやらしいですね…」	PRINTFORMW 「%CNAME("二人称")%真是很有兴致啊…」
PRINTFORMW 「さ、ご奉仕の時間です……」	PRINTFORMW 「现在是服务的时间了」
PRINTFORMW 「我慢をしていては、お体に障りますよ…」	PRINTFORMW 「不要忍耐了，对身体不好哦」
PRINTFORMW 「%CNAME("二人称")%は本当にいやらしいですね…」
PRINTFORMW 「ここでご奉仕をすればいいのですか？」	PRINTFORMW 「要在这里进行服务吗？」
PRINTFORMW 「承りました」	PRINTFORMW 「好的」
PRINTFORMW 「どうぞ、%CNAME("二人称")%は楽にしていてください…」	PRINTFORMW 「请%CNAME("二人称")%随意吧」
PRINTFORMW 「…これが一般的なメイドとしての責務とは思えませんが」	PRINTFORMW 「虽然这些不像是正常的女仆的服务职责呢」
PRINTFORMW 「どうぞ、心行くまでお楽しみください」	PRINTFORMW 「请%CNAME("二人称")%尽情享受吧」
PRINTFORMW 「…これが一般的なメイドとしての責務とは思えませんが」	PRINTFORMW 「虽然这些不像是正常的女仆的服务职责呢」


PRINTFORMW 「%CNAME("二人称")%、どうぞ楽になさってくださいね……」
PRINTFORMW %CALLNAME:TARGET%の太ももは、膝枕としては少し硬すぎる……どれだけの鍛錬を積んでいたのだろう……
PRINTFORMW 「もしかして、快適ではありませんか？」
PRINTFORMW 「申し訳ありません、日々の仕事が原因でしょうか……腕や脚が筋肉質になってしまって……」
CALL PRINT_STR, @"「しかし、悪いことばかりではありませんよ…例えば馬に乗る時です」"
CALL PRINT_STR, @"「馬がどんなに暴れても、%CALLNAME:TARGET%の太ももがしっかりしていれば、決して離すことはありません…_HH_」_W"
PRINTFORMW 「今ですか？」	PRINTFORMW 「现在吗？」
PRINTFORMW 「拒否は致しませんが…%CNAME("二人称")%は本当に物好きですね…」	PRINTFORMW 「不是不行，只是感叹%CNAME("二人称")%真的很有兴致呢」
CALL PRINT_STR, @"「このように%CNAME("二人称")%に体を預けると、すこし安心します…」_W"	CALL PRINT_STR, @"「这样依靠着%CNAME("二人称")%，有一丝丝的安心感呢…」_W"
PRINTFORMW %CALLNAME:TARGET%は%CALLNAME:MASTER%の膝を枕にしながら感嘆している……	PRINTFORMW %CALLNAME:TARGET%枕在%CALLNAME:MASTER%的大腿上感叹道
PRINTFORMW 「少し疲れました…失礼します、%CNAME("二人称")%……」	PRINTFORMW 「有些劳累了呢，可以吗%CNAME("二人称")%……」
PRINTFORMW %CALLNAME:TARGET%は%CALLNAME:MASTER%の膝を枕にしながら休憩している……	PRINTFORMW %CALLNAME:TARGET%枕在%CALLNAME:MASTER%的大腿上歇息着……
PRINTFORMW 「%CNAME("二人称")%、こちらにお茶の準備ができています……」	PRINTFORMW %CALLNAME:TARGET%鞠了个躬就去准备茶水了
PRINTFORMW 「紅花茶とダンギク茶があります…%CNAME("二人称")%はどちらになさいますか？」
PRINTFORMW 「自信はありませんが……%CNAME("二人称")%のご要望であれば。少々お待ちください」
PRINTFORMW %CALLNAME:TARGET%はお辞儀をしてお茶の準備をしに行った。
PRINTFORMW 「はい？何か御用ですか？」	PRINTFORMW 「嗯？有什么需求吗？」
PRINTFORMW 「%CNAME("二人称")%、どうぞご命令を」	PRINTFORMW 「请%CNAME("二人称")%吩咐」
PRINTFORMW 「あ……%CNAME("二人称")%、もう十分ご覧になりましたか……？」	PRINTFORMW 「啊……%CNAME("二人称")%看够了没有啊……」
PRINTFORMW %CALLNAME:TARGET%は少し躊躇いながらも命令に従った。	PRINTFORMW %CALLNAME:TARGET%犹豫了一下依旧服从了命令。
PRINTFORMW スカートの下の光景が目に飛び込んでくる…
PRINTFORMW %CALLNAME:TARGET%はクロッチをずらし、美しく濡れそぼった秘所を露わにした…
PRINTFORMW 黒くツヤのある尻尾は太ももに巻き付き、何かを隠してかいるかのようにもぞもぞと蠢いている
PRINTFORMW しかし、ハート型の尻尾の先端は太ももの後ろに隠れてよく見えない…
PRINTFORMW 先端付近では正体不明の透明な粘液が光を反射しており、大きな雫となって滴り落ちようとしている…
CALL PRINT_STR, "「はぁ…」_W"
PRINTFORMW %CALLNAME:TARGET%は%CALLNAME:MASTER%から目を逸らしながら、尻尾をきつく締め太ももに食い込ませている…
CALL PRINT_STR, "「あ…」_W"
PRINTFORMW 形だけの抵抗の後、メイド服のスカートがめくり上げられ、その下の淫靡な光景があらわになる…
PRINTFORMW 下着は脇にずらされ、%CALLNAME:TARGET%の尻尾の膨らんだ先端は自身の蜜穴に挿入されている
CALL PRINT_STR, "「お腹の中に沢山いただいてしまったので、保存しておいて後で味見をしようかと思いまして…」_W"
PRINTFORMW %CALLNAME:TARGET%は無表情のまま、そう説明した…
CALL PRINT_STR, "「あ…」_W"
PRINTFORMW %CALLNAME:TARGET%は無感情に%CALLNAME:MASTER%を見下ろしている。
CALL PRINT_STR, @"「どうしました、%CNAME("二人称")%？よろしければ%CNAME("一人称")%がスカートを持ち上げましょうか？」_W"
PRINTFORMW 錯覚かもしれないが、%CALLNAME:TARGET%の顔にからかうような笑みが浮かんだ気がする…
CALL PRINT_STR, "「あ…」_W"
PRINTFORMW %CALLNAME:TARGET%は無感情に%CALLNAME:MASTER%を見下ろしている。	PRINTFORMW KOJO_DAILYCOM_K100, %ARGS%
CALL PRINT_STR, @"「%CALLNAME:MASTER%…満足なされましたか？十分ご覧になったら一声おかけくださいね」_W"
PRINTFORMW 写真には「%MAIL_BODY%」というメッセージが添えられている…
//文件: EVENT_K100_SELECT.ERB
STR:選択肢 += "パトラについての考えをまとめる/"	STR:選択肢 += "整理思路/"
PRINTFORMW 問題はどこにあるのだろう…いつもそんなことを考えてしまう…	PRINTFORMW 总觉得……有哪里不太对啊……
PRINTFORMW もしそれが、封じられた過去の記憶の中にあるのだとしたら―	PRINTFORMW 如果是，封存了过去的记忆的话——
PRINTFORMW 酒に酔っている時に口ずさんでいた童謡には、どういう意味があるのか……	PRINTFORMW 在醉酒时候哼唱的儿歌，是怎么一回事呢……
PRINTFORMW そう言えば、眠っているときにも歌を歌っていたような……	PRINTFORMW 睡梦里也听到了相似的旋律……
PRINTFORMW 夢の中での、誰かに許しを乞うような言葉……うーん……	PRINTFORMW 在说梦话的时候在痛苦地求饶……嗯……
PRINTFORMW 彼女はいつも安眠できず、うなされている……	PRINTFORMW 总是不能，好好地安眠呢……
STR:選択肢 += "箱を開ける/"	STR:選択肢 += "打開箱子/"
PRINTFORMW %CALLNAME:MASTER%は、適当な理由をつけて%CALLNAME:TARGET%を遠ざけた…	PRINTFORMW 想了个借口把%CALLNAME:TARGET%支開了
PRINTFORMW 始めこそ性処理をこなすメイド、という振る舞いではあったが、今では笑顔を見せるようになっている	PRINTFORMW 从一開始做爱都像在应付的女仆，到现在时常也会露出笑容了
PRINTFORMW しかし…もし過去の記憶が封印されているとすれば…	PRINTFORMW 不过…如果说是封印了记忆的话
PRINTFORMW なぜ、そんなことになっている？	PRINTFORMW 为什么还会？
PRINTFORMW 酔いつぶれた時の寝言…	PRINTFORMW 醉后的呓语…
PRINTFORMW 何か訳がありそうな悪夢…	PRINTFORMW 深陷的噩梦…
PRINTFORMW 密室の中でのゲームに対する拒否反応…	PRINTFORMW 对密室的谜之排斥…
PRINTFORMW その他にも、一緒に過ごしていて気になることがある…	PRINTFORMW 还有一些共处时令人在意的…
PRINTFORMW 伝説の通りであるならば、	PRINTFORMW 如果是传说的话
PRINTFORMW パンドラの箱が開かれた時、世界へ向かってあらゆる災厄が解き放たれるという	PRINTFORMW 打開了潘多拉的魔盒，放出了世上的种种灾难
PRINTFORMW そして、箱の中には希望だけが残っていたとも…	PRINTFORMW 只有希望，仍被関在魔盒里
PRINTFORMW %CALLNAME:TARGET%には開けるな、と言われているが…やはり気になってしまう……	PRINTFORMW 虽然%CALLNAME:TARGET%曾经说过不要打開，但还是很在意啊…
PRINTFORML [1] 真実を知りたい	PRINTFORML [1] 想要一探究竟
PRINTFORML [2] やっぱりやめておこう…	PRINTFORML [2] 还是算了吧…
PRINTFORMW 意外にも、鍵はかかっていない	PRINTFORMW 出乎意料的，没有任何的锁
PRINTFORMW 蓋は軽く、開けても軋むようなことはなかった	PRINTFORMW 并不沉重，打開时也没有发出来吱吱呀呀的声音
PRINTFORMW 開けた瞬間に埃が撒きあがり、箱の中にゆっくりと光が満ちていく	PRINTFORMW 打開盒子时扬起来尘土，光线慢慢的展開在盒子里
PRINTFORMW 中は空っぽだ……埃の他には何も入っていない	PRINTFORMW 空无一物……除了尘土之外，什么都没有
PRINTFORMW 「%CNAME("二人称")%…全て、飛び出して行ってしまいましたか？」	PRINTFORMW 「%CNAME("二人称")%啊…这下不全都跑出来了吗？」
PRINTFORMW いつの間にか、%CALLNAME:TARGET%が後ろに立っている	PRINTFORMW 不知道什么时候，%CALLNAME:TARGET%已经站在身后了
PRINTFORMW 「困りましたね…%CNAME("二人称")%、下がっていてくださいますか」	PRINTFORMW 「很麻烦的…%CNAME("二人称")%让開一下啊」
PRINTFORMW 「ごほっ、ごほっ、埃まみれですね…%CNAME("二人称")%、開ける前に拭かなかったのですか？」	PRINTFORMW 「咳…咳，好多灰啊…%CNAME("二人称")%開之前不能先擦一下吗？」
PRINTFORMW 「よし、これで大丈夫です…また床を掃除しないと…」	PRINTFORMW 「这下好了，还得扫地啊…」
PRINTFORMW 「%CNAME("二人称")%のせいですからね、%CALLNAME:TARGET%のお手伝いをして頂きますよ」	PRINTFORMW 「怎么想都是%CNAME("二人称")%的错吧，来帮%CALLNAME:TARGET%打扫吧」
PRINTFORMW 「ちゃんと綺麗にしておく必要がありますからね…」	PRINTFORMW 「一定要打扫的干干净净才行啊」
PRINTFORMW 「確実に、しっかりと…」	PRINTFORMW 「一定啊…」
PRINTFORMW もう一度よく考えてみることにした……	PRINTFORMW 还是再思考一下……
STR:選択肢 += "リアル脱出ゲーム/"	STR:選択肢 += "密室逃脱/"
PRINTFORMW 「脱出ゲームですか…やはり…%CNAME("一人称")%は結構です」	PRINTFORMW 「密室逃脱吗…还是…不要了吧」
PRINTFORMW 「以前ですか？いえ、行ったことはないです…泊まる場所にも困る暮らしだったので」	PRINTFORMW 「之前？并没有…」
PRINTFORMW 「ところで、これはどこに行けば遊べるのですか…？」	PRINTFORMW 「之前那朝不保夕的日子…哪里有可能玩这些…」
PRINTFORMW 「うぅん……気が進まなかったのですが、何かを思い出せそうな気が…」	PRINTFORMW 「唉，本来是不想的，会想起一些…」
PRINTFORMW 「…いえ、忘れてください…行きましょう、%CNAME("二人称")%」	PRINTFORMW 「算了，就陪%CNAME("二人称")%去玩吧」
PRINTFORMW 「またですか…%CNAME("二人称")%、そんなにお気に召したのですか？」	PRINTFORMW 「还要去吗，%CNAME("二人称")%这是上瘾了吗？」
PRINTFORMW 「…ところで、この暗闇の密室ステージでは、呪術の類がうまく使えません…」	PRINTFORMW 「从伸手不见五指的密室里逃出去，也不可以用法术什么的…」
PRINTFORMW 「%CALLNAME:TARGET%は暗闇の中でも問題なく見えます…しかしこの場合、見えないほうが好ましいですね」	PRINTFORMW 「黑暗环境下%CALLNAME:TARGET%是看得见啦…不过，宁愿还是看不到的为好」
PRINTFORMW 「はい！見えなくなりました！%CNAME("二人称")%、どうか%CALLNAME:TARGET%の手を取って出口まで導いてください…」	PRINTFORMW 「所以！看不见啦！请%CNAME("二人称")%牵着%CALLNAME:TARGET%的手，带%CALLNAME:TARGET%逃出去…」
PRINTFORMW 「思い返してみると、%CNAME("二人称")%は優しいところもありますが、人をいじめるのが好きなのですね」	PRINTFORMW 「有时候回想，虽然%CNAME("二人称")%人还是蛮温柔的，但总是喜欢欺负人啊」
PRINTFORMW 「密室には行きたくないと初めに申し上げましたのに」	PRINTFORMW 「第一次就说过不想去密室啊」
PRINTFORMW 「それでも、%CNAME("二人称")%の望みですから…」	PRINTFORMW 「不过随%CNAME("二人称")%的便吧」
PRINTFORMW 「%CNAME("二人称")%と共に楽しめるのなら、何も問題ありません…」	PRINTFORMW 「如果是和%CNAME("二人称")%在一块儿玩这个的话，似乎还可以…」
PRINTFORMW 「たとえ、脱出できなかったとしても…」	PRINTFORMW 「即使逃不出去…」
PRINTFORMW 「初めからわかっていました…%CNAME("一人称")%は、脱出などできない、と」	PRINTFORMW 「明明从第一次開始就没有成功逃脱过啊…」
PRINTFORMW 「%CALLNAME:TARGET%は役立たずです…所詮、%CNAME("二人称")%の付き添いでしかありません」	PRINTFORMW 「怪%CALLNAME:TARGET%没有帮忙吗，%CALLNAME:TARGET%只是陪%CNAME("二人称")%去玩的啊，坐在那里看着就好了吧」
PRINTFORMW 「ですので…お邪魔にならないよう、座って見守らせていただきます」	PRINTFORMW 「为什么只是看着…」
PRINTFORMW 「………なぜ、見ているだけしかできないのでしょうか」	PRINTFORMW 「逃出去了，就要回家了吧…」
PRINTFORMW 「脱出してしまったら、帰ることになってしまいますよね…」	PRINTFORMW 「%CNAME("二人称")%只有周末才在家啊…偶尔也想多和%CNAME("二人称")%待一会儿的」
PRINTFORMW 「%CNAME("二人称")%は週末しかご自宅にいません…こういう機会に、存分に楽しめると思っていましたのに」	PRINTFORMW 「出来之后去情人旅馆？好吧好吧，就帮%CNAME("二人称")%想想办法吧」
PRINTFORMW 「『じゃあ、出られた後でラブホテルに』…？わかりました！脱出方法を考えるお手伝いをいたします！」
PRINTFORMW 「とても楽しませていただきました…」	PRINTFORMW 「上一次玩的很開心呢…」
PRINTFORMW 「…未だ密室は苦手ですが…%CNAME("二人称")%のお傍にいれば、全てが楽しみに変わるのです」	PRINTFORMW 「…还是不喜欢密室啊…不过跟在%CNAME("二人称")%一起的话，哪里都好」
PRINTFORMW %SAVESTR:デート%での%CALLNAME:TARGET%の反応	PRINTFORMW %SAVESTR:约会%での%CALLNAME:TARGET%の反応
//文件: EVENT_K100_SHOP.ERB
PRINTFORMW 「このような時まで取引を行うのですか…？」	PRINTFORMW 「想要在这个时候进行交易吗？」
PRINTFORMW 「%CNAME("二人称")%は本当に興味深い方です…」	PRINTFORMW 「真是有兴致啊%CNAME("二人称")%」
PRINTFORMW 「このような時まで取引を行うのですか…？」	PRINTFORMW 「想要在这个时候进行交易吗？」
PRINTFORMW 「契約通りに、魂を払っていただけるのであれば……」	PRINTFORMW 「像契约里一样，支付灵魂就可以了……」
PRINTFORMW 「取引を行うのですか？」	PRINTFORMW 「想要进行交易吗？」
PRINTFORMW 「契約通りに、魂を払っていただけるのであれば」	PRINTFORMW 「像契约里一样，支付灵魂就可以了」
PRINTFORMW 「恋人……ですか？」	PRINTFORMW 「恋人……吗？」
PRINTFORMW 「過去の%CALLNAME:TARGET%であれば、それは最大の不名誉であり罰であると感じたに違いありません……」	PRINTFORMW 「如果是过去的%CALLNAME:TARGET%，一定会觉得这是最大的耻笑和惩罚吧……」
PRINTFORMW 「%CNAME("二人称")%……今のは、%CNAME("二人称")%の本心ですか？」	PRINTFORMW 「%CNAME("二人称")%……%CNAME("二人称")%是真心的吗？」
PRINTFORML [1] 何も言わない	PRINTFORML [1] 沉默不语
PRINTFORML [2] もちろん本気だ！	PRINTFORML [2] 当然是真的！
PRINTFORMW 「%CNAME("二人称")%……やはり……からかっていたのですね？」	PRINTFORMW 「%CNAME("二人称")%……果然是……在開玩笑的吧？」
PRINTFORMW 「そうだと思いました……」	PRINTFORMW 「也是呢……」
PRINTFORMW 「ありがとうございます……%CNAME("二人称")%……」	PRINTFORMW 「谢谢……%CNAME("二人称")%……」
PRINTFORMW 「一緒に過ごしていても……%CNAME("二人称")%はとてもとても優しく接してくださいます……」	PRINTFORMW 「能在一起的日子里……%CNAME("二人称")%确实是真的非常的温柔对待着……」
PRINTFORMW 「しかしやはり……%CNAME("二人称")%は最初のご主人様ではありません。」	PRINTFORMW 「但是说起来……%CNAME("二人称")%并不是第一个服侍的主人。」
PRINTFORMW 「%CALLNAME:TARGET%はかつて人類の奴隷として売られ、長い間服従することを強いられていました……」	PRINTFORMW 「%CALLNAME:TARGET%曾经作为奴隶被卖给了人类，被迫服从于他不短的时间……」
PRINTFORMW 「悪魔にとっては暗黒時代ともいえる期間でした……」	PRINTFORMW 「那是一段对于恶魔来说都暗无天日的时间……」
PRINTFORMW 「ですから、身体の面においても、心の面においても……」	PRINTFORMW 「所以说不管是身体也好，心灵也好……」
PRINTFORMW 「%CALLNAME:TARGET%よりも、%CNAME("二人称")%に相応しい方がいるのではないでしょうか…」	PRINTFORMW 「%CALLNAME:TARGET%想……%CNAME("二人称")%值得更好的女孩子去渡过%CNAME("二人称")%的一生呢……」
PRINTFORMW 「%CNAME("二人称")%には幸せな人生を送って頂きたいのです」	PRINTFORML [1] 沉默不语
PRINTFORML [1] 何も言わない
PRINTFORML [2] 抱きしめる	PRINTFORML [2] 抱住她
PRINTFORMW 「それが良いと思われます……」	PRINTFORMW 「是的呢……」
PRINTFORMW 「あ……ご安心ください、%CALLNAME:TARGET%はここで%CNAME("二人称")%のメイドとして務めさせていただきます。」	PRINTFORMW 「啊……不用担心，%CALLNAME:TARGET%会继续在这里任职%CNAME("二人称")%的女仆呦。」
PRINTFORMW 「%CNAME("二人称")%が飽きてしまわれない限り、ずっと……」	PRINTFORMW 「直到%CNAME("二人称")%厌倦了为止……」
PRINTFORMW 「実は……」	PRINTFORMW 「居然呢……」
PRINTFORMW 「%CALLNAME:TARGET%は話したいことが沢山あります。」	PRINTFORMW 「看来是%CALLNAME:TARGET%多话了啊。」
PRINTFORML [1] 過去の主人について尋ねる	PRINTFORML [1] 询问她过去的主人
PRINTFORML [2] 過去の生活について尋ねる	PRINTFORML [2] 询问她过去的生活
PRINTFORML [3] 持ってきた箱について尋ねる	PRINTFORML [3] 询问她带来的箱子
PRINTFORML [4] キスをする（質問を終わる）	PRINTFORML [4] 一个恋人之间的吻
PRINTFORMW 「前のご主人様ですか……」	PRINTFORMW 「过去的主人吗……」
PRINTFORMW 「残酷な人でした……%CALLNAME:TARGET%が痛がれば痛がるほど興奮していた、と記憶しています……」	PRINTFORMW 「是个残酷的人呢……只记得如果%CALLNAME:TARGET%非常非常的疼……他就会很兴奋……」
PRINTFORMW 「その後、あの方は不摂生と放蕩が原因で体を壊し、亡くなりました……」	PRINTFORMW 「后来他的身体因为过度的放纵而崩坏了……」
PRINTFORMW 「それで問題は全て解決…本当に、それほど単純であればよかったのですが……」	PRINTFORMW 「结束……如果真的那么简单就好了……」
PRINTFORMW 「思い出せない部分も多いのですが……」	PRINTFORMW 「很多都已经不记得了……」
PRINTFORMW 「前のご主人様は不老不死を望み、%CALLNAME:TARGET%はそのために魂を集めさせられていました」	PRINTFORMW 「那个人为了不那么死掉，强迫着%CALLNAME:TARGET%去为他收集灵魂……」
PRINTFORMW 「騙したり、誘惑したり……どんな手を使っても…」	PRINTFORMW 「欺骗也好，诱惑也好……无论用什么办法……只要没有收集到灵魂就会疼的不想活下去……」
PRINTFORMW 「それができなければ、死ぬほど辛い仕打ちを受けました……」	PRINTFORMW 「还好……找到了机会毁掉了束缚的契约逃了出来……」
PRINTFORMW 「運よく……契約を破棄する機会を見つけて逃げ出すことができたのです……」
PRINTFORMW 「あまりにも、辛すぎたのです……」	PRINTFORMW 「因为实在是太痛苦了……」
PRINTFORMW 「あの頃のことを思うと、過去の傷が痛むのです…悪魔には傷跡が残らないものの……」	PRINTFORMW 「一想到那段日子，即使恶魔不会留下伤疤，那些过去的伤口都在疼……」
PRINTFORMW 「%CNAME("一人称")%に魂を騙し取られた哀れな人々……私と共に拷問されていた奴隷たち……」	PRINTFORMW 「还有那些被我骗走了灵魂的可怜人……那些和我一起被折磨的奴隶……」
PRINTFORMW 「その人達のことを考えたとき……当然、復讐を思い立ちました……ですが……」	PRINTFORMW 「想过……当然想过去复仇……可是……可是……」
PRINTFORMW 「復讐のため、前のご主人様のもとに戻った時に知らされたのです」	PRINTFORMW 「等到回去时候，才知道在我逃出去之后……没多少日子他就因为身体支撑不住死掉了……」
PRINTFORMW 「%CNAME("一人称")%が逃げ出してからすぐ…ご主人様は体を壊して死んでしまったということに…」	PRINTFORMW %CALLNAME:TARGET%紧紧地咬住了牙齿，眼圈发红……
PRINTFORMW %CALLNAME:TARGET%は歯噛みをして、目を赤くする……	PRINTFORMW 「好绝望啊……好绝望啊……即使这样都觉得好绝望啊！！！该怎么向一个死人复仇啊！」
PRINTFORMW 「絶望でした……それすらも絶望になり得るんです！！！どうやって死人に復讐しろというんですか！」	PRINTFORMW 「%CALLNAME:TARGET%的精神撑不住了……复仇不了也好……黑暗的往日也好……」
PRINTFORMW 「%CALLNAME:TARGET%の精神は限界でした……復讐も果たせず……闇に囚われたままの日々でした……」	PRINTFORMW 「但是不想那么简单地疯掉……想活下去……明明都已经逃出来了……」
PRINTFORMW 「しかし、気が狂ってしまうのは嫌でした…生きていたかった……折角、自由の身になれたのですから……」	PRINTFORMW 「于是，用法术把自己过去的一切记忆……都封印在了那个箱子里。只给苏醒后的新的自己留下了必要的记事……」
PRINTFORMW 「だから、自分の過去の記憶を全て、あの箱に封印したのです…魔術を使って。」	PRINTFORMW 「但是也因此失去了一切……我给自己取了一个新的名字……」
PRINTFORMW 「そして術は成功し…目が覚めると『新たな自分』のために必要なことが書かれたメモが残されていました…」	PRINTFORMW 「潘多拉（帕图拉）……，永远，永远不要打開潘多拉的盒子。」
PRINTFORMW 「過去のすべては失われたのです…その代わりに、%CNAME("一人称")%は自分に新しい名前を付けました」	PRINTFORMW 「还剩下的……就是恶魔寻求灵魂的本能了，但是%CALLNAME:TARGET%并不想因此去害人……直到听说了有个可以再生的灵魂。」
PRINTFORMW 「パンドラ（パトラ）……絶対に、絶対に開くことのないパンドラの箱。」	PRINTFORMW 「然后就……遇……遇……鱼……嘘、嘘……唏、唏……呜呜……呜呜呜……」
PRINTFORMW 「魂を求める悪魔の本能は残っていましたが、%CALLNAME:TARGET%は誰も傷つけたくなかったのです……」	PRINTFORMW 啜泣声掩盖了接下来的话语……
PRINTFORMW 「『再生できる魂』の噂を聞くまでは。」
PRINTFORMW 「そして…ここで、%CNAME("二人称")%と……うぅ……ぐすっ、ぐすっ……うぅ…うぅぅっ……」
PRINTFORMW 続く言葉は泣き声にかき消されてしまった……
PRINTFORMW %CALLNAME:TARGET%はキスを受け入れようとしない……	PRINTFORMW %CALLNAME:TARGET%并没有接受……
PRINTFORMW ただ%CALLNAME:MASTER%をきつく抱きしめ、%CALLNAME:MASTER%の胸に顔を埋めている。	PRINTFORMW 她只是紧紧地抱住了%CALLNAME:MASTER%，把自己的脸埋进了%CALLNAME:MASTER%的胸膛。
PRINTFORMW 「ううぅ……申し訳ありません……うぅ……申し訳っ、ありません……」	PRINTFORMW 「呜呜呜……对不起……呜呜……对、对不起……」
PRINTFORMW ―――今でもあなたは私の光―――	PRINTFORMW ——————今でも你は我の光——————
PRINTFORMW 「御冗談はおやめください……」	PRINTFORMW 「请不要拿这种事開玩笑……」
CALL DAILY_MESSAGE, "パンツを脱いで手渡し"	CALL DAILY_MESSAGE, "脱下胖次交了出去"
CALL EVENT_DATUI, "ハダカ"	CALL EVENT_DATUI, "裸体"
PRINTFORMW 「お断りします。」	PRINTFORMW 「不行。」
PRINTFORMW 「駄目なものは駄目です……%CNAME("二人称")%、これ以上は言わせないでくださいね。」	PRINTFORMW 「不行就是不行……%CALLNAME:MASTER%请不要再问了。」
PRINTFORMW 「お断りします。」	PRINTFORMW 「不行。」
PRINTFORMW 「駄目なものは駄目と言っています……%CNAME("二人称")%、これ以上は言わせないでくださいね。」	PRINTFORMW 「说过了不行就是不行……%CALLNAME:MASTER%请不要再问了。」
PRINTFORMW 「%CNAME("二人称")%、どういうおつもりですか……」	PRINTFORMW 「%CNAME("二人称")%在想什么呢……」
PRINTFORMW 「所有権の宣言のつもりですか？犬が電柱にマーキングするかのように？本当に呆れました。」	PRINTFORMW 「想像公狗在电线杆上撒尿那样的宣誓主权吗？真是无耻。」
PRINTFORMW 「勘違いされては困りますが、%CALLNAME:TARGET%はメイドとしての契約を結んだだけで、%CNAME("二人称")%の所有物ではないのです。」	PRINTFORMW 「请%CNAME("二人称")%别误会了，%CALLNAME:TARGET%是契约的女仆而不是%CNAME("二人称")%的所有物。」
PRINTFORMW 「断じて、違います……」	PRINTFORMW 「也从来不是……」
PRINTFORMW %CALLNAME:TARGET%は激しく怒り、歯ぎしりをしながら言葉を絞り出す。	PRINTFORMW %CALLNAME:TARGET%的反应非常激烈，说到后来几乎就是咬牙切齿的语气了。
PRINTFORMW 「誰の玩具でも、ありません……！」	PRINTFORMW 「任何人的……玩物……！」
PRINTFORMW 「はぁ……まあ、シールであれば構いませんが……」	PRINTFORMW 「啧……如果只是贴纸的话……」
PRINTFORMW 「いずれ効力はなくなりますし……いいでしょう……」	PRINTFORMW 「反正只能持续一段时间……算了……」
PRINTFORMW %CALLNAME:TARGET%は呆れたような目で%CALLNAME:MASTER%を見ている。	PRINTFORMW %CALLNAME:TARGET%的无奈地看着你。
PRINTFORMW 「また、そのお願いですか……」	PRINTFORMW 「总是这样……」
PRINTFORMW 「まあ、どうせシールですし……」	PRINTFORMW 「反正只是贴纸……」
PRINTFORMW 「%CALLNAME:TARGET%、本当はこの術を使われるのは嫌だったのですが……」	PRINTFORMW 「%CALLNAME:TARGET%本来是非常反感这种术法的……」
PRINTFORMW 「しかし……そうまで望まれるのであれば……」	PRINTFORMW 「不过……如果是……」
PRINTFORMW %CALLNAME:TARGET%は服をたくし上げて、すべすべとした魅力的な下腹部を露わにした……	PRINTFORMW 掀開了自己的衣服，露出了光滑而诱人的小腹……
CALL PRINT_STR, @"「%CNAME("二人称")%、できるだけ、優しくお願いしますね……」_W"	CALL PRINT_STR, @"「请%CNAME("二人称")%尽可能地温柔一点……」_W"
PRINTFORMW 「%CNAME("二人称")%にそのようなお願いをされると%CALLNAME:TARGET%はとても困ります……」	PRINTFORMW 「%CNAME("二人称")%的请求真的让%CALLNAME:TARGET%非常为难……」
PRINTFORMW 「これでは、奴隷に烙印を押すのと変わりがありません……」	PRINTFORMW 「这么做和给奴隶烙上印记有什么区别呢……」
PRINTFORMW 「シールなら問題ありませんが……こういったものは体にも魂にも一生残るのですよ……」	PRINTFORMW 「贴纸还好……这种的可是到死去都会印在身体和灵魂上的啊……」
PRINTFORMW 「それなら、ずっと一緒にいられる……？ご……御冗談を……」	PRINTFORMW 「那就到在一起到……開……開什么玩笑……」
PRINTFORMW 「やはり……一度あれば二度目もあると思いました」	PRINTFORMW 「早就知道……有一就有二」
PRINTFORMW 「しかし……%CNAME("二人称")%の望みとあれば」	PRINTFORMW 「不过……如果是%CNAME("二人称")%的要求话」
PRINTFORMW %CALLNAME:TARGET%は服をたくし上げて、すでに淫紋が刻まれた褐色の下腹部を露わにした……	PRINTFORMW %CNAME("一人称")%掀開了自己的衣服，褐色的性感小腹上已经雕刻上了粉红的纹路……
CALL PRINT_STR, @"「%CNAME("二人称")%、できるだけ、優しくお願いしますね……」_W"	CALL PRINT_STR, @"「请%CNAME("二人称")%尽可能地温柔一点……」_W"
PRINTFORMW 「%CNAME("二人称")%にそのようなお願いをされると%CALLNAME:TARGET%はとても困ります……」	PRINTFORMW 「%CNAME("二人称")%的请求真的让%CALLNAME:TARGET%非常为难……」
PRINTFORMW 「%CNAME("一人称")%は、淫紋を刻まれればどうなるか、はっきりわかっています……」	PRINTFORMW 「%CNAME("一人称")%很清楚接下来的纹路效果……」
PRINTFORMW 「ですから、お断りさせていただきます」	PRINTFORMW 「请容%CNAME("一人称")%拒绝」
PRINTFORMW 「……そんな目で%CNAME("一人称")%をご覧にならないでください！本当にこれが最後の一回ですからね！」	PRINTFORMW 「……不要用那样的眼神看着%CNAME("一人称")%，这绝对是最后一次了！」
PRINTFORMW 「前回淫紋を刻まれてから、%CALLNAME:TARGET%の体はおかしくなっています……」	PRINTFORMW 「从上次之后，%CALLNAME:TARGET%的身体已经变得非常奇怪了……」
PRINTFORMW 「少し触られただけで感じてしまいますし、すぐにビショビショになってしまいます……」	PRINTFORMW 「被摸一摸肚子也有感觉，下面很容易就湿漉漉的……」
PRINTFORMW %CALLNAME:TARGET%は服をたくし上げて、前回に刻まれた、卑猥な光を放つ淫紋を露わにした	PRINTFORMW 掀開了自己的衣服，之前刻下的淫纹散发出淫霏的光芒
CALL PRINT_STR, @"「%CNAME("二人称")%には責任を取って頂かなければいけませんね……」_W"	CALL PRINT_STR, @"「请%CNAME("二人称")%一定要负起责任啊……」_W"
PRINTFORMW 「%CNAME("二人称")%……またですか」	PRINTFORMW 「%CNAME("二人称")%……又来了」
PRINTFORMW 「このようにして%CALLNAME:TARGET%を支配するおつもりなのですね」	PRINTFORMW 「一点要这样的占有%CALLNAME:TARGET%吗」
PRINTFORMW 「心と体に一生消えない快楽を刻み込まれて、欲望の奴隷にされてしまうのですね」	PRINTFORMW 「到死去为止都会印在身体和灵魂上，变成欲望的奴隶」





PRINTFORMW 「尻尾が見たい？」	PRINTFORMW 「想要看尾巴？」
PRINTFORMW 「気味が悪いとは思わないのですか？悪魔の尻尾ですよ……」	PRINTFORMW 「不会觉得不舒服么？恶魔的样子……」
PRINTFORMW 「ご主人様は本当に、変わった方なのですね……」	PRINTFORMW 「您真是奇怪呢……」
PRINTFORMW 「拒否させていただきます。」	PRINTFORMW 「还请容我拒绝啊。」
PRINTFORMW 「服を通して尻尾を外に出すのにはそれなりの労力を要します。ご理解ください。」	PRINTFORMW 「您有没有想过要怎么把尾巴从女仆服里伸出来呢？」
PRINTFORMW 「まあ、予想の範疇の要求ですね……」	PRINTFORMW 「意料之中呢……」
PRINTFORMW 「篭絡のための技術ですか……こういったものの習得には個人差が出ますよ？」	PRINTFORMW 「哄骗的技巧……这种东西还是看个人的吧？」
PRINTFORMW 「まあ、不可能ではなさそうですが……」	PRINTFORMW 「虽说也不是做不到……」
PRINTFORMW 「こういった取引を望まれるのは、一般的には女性の方なのですが……」	PRINTFORMW 「向恶魔提出这种交易的，一般是女孩子多一点……」
PRINTFORMW 「%CALLNAME:TARGET%自身には効果があるのか、ですか？何を仰っているんですか……」	PRINTFORMW 「对我有没有效？您在想什么啊……」
CALL PRINT_STR, @"「あふぅ…んふぅぅ…_H_このようなときにそのような要求を……」_W"	CALL PRINT_STR, @"「啊哈~嗯哈~_H_您在这种时候提这种要求……」_W"
CALL PRINT_STR, @"「%CALLNAME:TARGET%の中がいっぱいになるまで注ぎたいのですか……_HH_」_W"	CALL PRINT_STR, @"「想要把%CALLNAME:TARGET%里面灌的满满的吗_HH_……」_W"
CALL PRINT_STR, @"「断れるはずがありません……_H_」_W"	CALL PRINT_STR, @"「让人怎么拒绝呢_H_……」_W"
PRINTFORMW 「畏まりました、お待ちくださいね……」	PRINTFORMW 「好吧，好吧……」
PRINTFORMW 「しかし、度が過ぎると……負傷の危険もありますよ……」	PRINTFORMW 「太过分的话……会损害身体的……」
PRINTFORMW 「なぜ知っているか……？あー……それについては、秘密です。」	PRINTFORMW 「我怎么知道……嗯……这是秘密呢。」
CALL PRINT_STR, @"「いやらしいお願いですね……_H_」_W"	CALL PRINT_STR, @"「下流的要求呢_H_……」_W"
PRINTFORMW 「あ……%CALLNAME:TARGET%は、どのような大きさでも楽しめますよ…本当です」	PRINTFORMW 「啊……其实，对%CALLNAME:TARGET%来说，怎么样的型号都有其乐趣呢~」
PRINTFORMW %CALLNAME:TARGET%は微笑みながら手の中にある%CALLNAME:MASTER%のペニスを増大させた！	PRINTFORMW %CALLNAME:TARGET%笑吟吟的把%CALLNAME:MASTER%的阴茎变大了！
PRINTFORMW 「ん……もしかして、満足させられないお相手がいたのですか？」	PRINTFORMW 「嗯……您是应付不了哪个女孩子了吗？」
PRINTFORMW 「あ……失礼致しました、メイドの%CNAME("一人称")%が言うことではありませんね」	PRINTFORMW 「啊……不好意思，是女仆多嘴了呢~」
PRINTFORMW 「すっかり暴れん坊になりましたね…」	PRINTFORMW 「变成了坏家伙呢~」
PRINTFORMW 「この暴れん坊を使って、だれを泣かせに行くのでしょう……」	PRINTFORMW 「您是要用这个坏家伙去祸害哪个女孩子呢……先用您的女仆适应一下怎么样？」
PRINTFORMW 「…それともまず、このメイドを使って試し斬りをしてみますか？」	PRINTFORMW %CALLNAME:TARGET%笑吟吟的把的阴茎变大了！
PRINTFORMW %CALLNAME:TARGET%は微笑みながら手の中のペニスを増大させた！
PRINTFORMW 「もしかして、めちゃくちゃにしたいお相手がいるのですか？」	PRINTFORMW 「您是想用这个去玩弄哪个女孩子呢？」
PRINTFORMW 「あ……失礼致しました、メイドの%CNAME("一人称")%が言うことではありませんね」	PRINTFORMW 「啊……不好意思，是女仆多嘴了呢~」
PRINTFORMW 「あぁ……素敵です%CNAME("二人称")%、とても勇ましいです…」	PRINTFORMW 「啊……真不愧是%CALLNAME:MASTER%，这么雄伟~」
PRINTFORMW 「それにとても硬くて…手の中でビクビクしています……」	PRINTFORMW 「还这么硬~在手里一跳一跳的……」
PRINTFORMW %CALLNAME:TARGET%はうっとりしながら%CALLNAME:MASTER%のペニスを増大させた！	PRINTFORMW %CALLNAME:TARGET%双眼迷离着把%CALLNAME:MASTER%的阴茎变大了！
PRINTFORMW 「うーん……これは、大層な大きさになりましたね……」	PRINTFORMW 「嗯……相当夸张的尺寸呢……」
PRINTFORMW 「一緒にローションを買いに行きましょう…必要になったら、ですが。」	PRINTFORMW 「需要的话……可以和您去买润滑液。」
PRINTFORMW %CALLNAME:TARGET%は目の前で跪くと、%CALLNAME:MASTER%のペニスを増大させた！	PRINTFORMW %CALLNAME:TARGET%跪坐在%CALLNAME:MASTER%身前把%CALLNAME:MASTER%的阴茎变大了！
PRINTFORMW 「こ……こんなに太い……」	PRINTFORMW 「这……这也太……」
PRINTFORMW %CALLNAME:TARGET%は目の前でそそり立つ巨大な肉棒を呆然と見つめている。他の何物も目に入らないようだ……	PRINTFORMW %CALLNAME:TARGET%呆呆地看着竖直在自己面前的巨大肉棒，仿佛视野里已经容不下其他的东西……
PRINTFORMW 「ん……この大きさは……」	PRINTFORMW 「嗯……您真的是……」
PRINTFORMW 「事前にしっかり慣らしてからでないと……女性の側は大変かもしれません……」	PRINTFORMW 「这一根如果没有好好的做好之前的工作的话……女孩子是可是不会感到舒服的……」
PRINTFORMW 「こんな大きさ……どうすれば……」	PRINTFORMW 「这样的尺寸……怎么会……」
PRINTFORMW %CALLNAME:TARGET%の声は少し震えているが、それでも%CALLNAME:MASTER%のペニスを増大させた。	PRINTFORMW %CALLNAME:TARGET%虽然声音有些颤抖，但仍旧把%CALLNAME:MASTER%的阴茎变大了。
PRINTFORMW 「はぁ…本当にこんなものを性交に使うつもりなのですか？」	PRINTFORMW 「啧，您真的是要拿这根来做爱吗？」
PRINTFORMW 「それは既に性交ではありませんよね……ただ嗜虐心を満足させるための行為ですよね……」	PRINTFORMW 「这已经不是做爱了吧……这是为了满足您嗜虐心理的折磨吧……」
PRINTFORMW 「何を考えていらっしゃるのですか、本当に……」	PRINTFORMW 「搞什么啊……」
PRINTFORMW %CALLNAME:TARGET%珍しく明らかに怒っているが、契約には応じるようだ……	PRINTFORMW %CALLNAME:TARGET%难得一见地明显地很生气，但仍然履行了契约……
PRINTFORMW 「随分と可愛らしくなってしまいましたね……でもメイドの意見としては、嫌いではないですよ……」	PRINTFORMW 「变成可怜兮兮的样子了……不过就算这样女仆也不会嫌弃的……」
PRINTFORMW %CALLNAME:TARGET%は微笑みながら手の中にある%CALLNAME:MASTER%のペニスを縮小させた！	PRINTFORMW %CALLNAME:TARGET%把%CALLNAME:MASTER%的阴茎变小了！
PRINTFORMW 「うーん……不可解な要求ですね……」	PRINTFORMW 「嗯……奇怪的要求呢……」
PRINTFORMW 「んん……この大きさでは、簡単に女性に飲み込まれてしまいますよ？」	PRINTFORMW 「呐呐……这样的话不会变得容易被驯服了吗？」
PRINTFORMW 「それとも……そうされるのがお望みなのですか？」	PRINTFORMW 「还是说……这就是您的愿望呢~？」
PRINTFORMW %CALLNAME:TARGET%は微笑みながら手の中にある%CALLNAME:MASTER%のペニスを縮小させた！	PRINTFORMW %CALLNAME:TARGET%笑吟吟的把%CALLNAME:MASTER%的阴茎变小了！
PRINTFORMW 「うーん……不可解な要求ですね……」	PRINTFORMW 「嗯……奇怪的要求呢……」
PRINTFORMW 「少し小さくなっても、まだまだ素敵ですね？」	PRINTFORMW 「就算这样，还是好厉害的样子？」
PRINTFORMW 「凶暴な種馬ではなくなったようですが……」	PRINTFORMW 「从凶暴的种马变成了……？」
PRINTFORMW %CALLNAME:TARGET%は微笑みながら手の中にある%CALLNAME:MASTER%のペニスを縮小させた！	PRINTFORMW %CALLNAME:TARGET%笑吟吟的把%CALLNAME:MASTER%的阴茎变小了！
PRINTFORMW 「うーん……不可解な要求ですね……」	PRINTFORMW 「嗯……奇怪的要求呢……」
PRINTFORMW 「受け入れられそうな大きさになってきましたね……」	PRINTFORMW 「交易达成了呢」
PRINTFORMW 「このままだと女の子の大事な所が緩んでしまいますからね……まあ、悪魔の場合は簡単に元に戻りますが」
PRINTFORMW %CALLNAME:TARGET%は微笑みながら手の中にある%CALLNAME:MASTER%のペニスを縮小させた！
PRINTFORMW 「それがよいと思われます、これなら多少激しくても痛くはないですし……」	PRINTFORMW 「交易达成了」
PRINTFORMW 「情事の際に相手をいじめたりする場合もありますが……」
PRINTFORMW 「それは、相手を傷つけるだけとの行為とは違う、と思います……」
PRINTFORMW %CALLNAME:TARGET%は珍しく真剣な表情をしている。
//EVENT_K100_帕图拉.ERB
LOCALS = 私_わたし	LOCALS = 私_私
LOCALS = ご主人様_ごしゅじんさま	LOCALS = 您_您
LOCALS = あなた_あなた	LOCALS = 您_您
LOCALS = ご主人様_ごしゅじんさま	LOCALS = 老爷_老爷
LOCALS = %CALLNAME:ASSI%さん_%CSTR:ASSI:ふりがな%さん	LOCALS = %CALLNAME:ASSI%桑_%CALLNAME:ASSI%桑
PRINTFORML 褐色の肌をした不思議な悪魔のメイド	PRINTFORML 深色皮肤的神秘恶魔女仆
PRINTFORML %CALLNAME:MASTER%の存在について聞いていたらしく、契約を結んで魂を得ることを望んでいた	PRINTFORML 说是听闻了%CALLNAME:MASTER%的存在，希望可以用主仆契约来得到灵魂
PRINTFORML 一般的なメイドとしての待遇と、プライバシーの保たれた個室を要求している	PRINTFORML 以及要求被当作正常的女仆对待，和一些私密的个人空间
PRINTFORML 彼女に関する情報は、他に何もない	PRINTFORML 除了这些之外，并没有更多的东西了
PRINTFORMW 「私が結びたいのは一般的な主従契約です。対価は魂で支払っていただく形でも構いません。」	PRINTFORMW 「只是普普通通的主仆契约，为提供女仆的服务，支付给与灵魂即可。」
PRINTFORMW 「また、私のことは通常のメイドとして扱ってください。居住スペースとして個室も用意していただきます。」	PRINTFORMW 「其他的，只要把%CALLNAME:TARGET%当作正常的女仆对待即可，以及，还需要一间个人的房间」
PRINTFORMW 黒い肌をしたそのメイドの顔からは何の感情も読み取れない。	PRINTFORMW 有些无表情属性的黑皮女仆呢……
PRINTFORMW 見たところかなりの長身で、標準的なメイド服を身にまとっている。	PRINTFORMW 看起来个子很高，穿着标标准准的女仆装
PRINTFORMW 眼光は鋭く、表情は氷のように冷たい…	PRINTFORMW 眼神有些锋利，面孔也冷冰冰的。
PRINTFORMW どんな性格なのか？何を考えているのか？全くわからない。	PRINTFORMW 不知道实际上是怎么样的人呢……
PRINTFORMW その鉄仮面の下にはどのような秘密が隠されているのだろう…？	PRINTFORMW 那副冰冷的面具下面，又隐藏着什么秘密呢？
PRINTFORMW EVENT_PROFILE_K100, %ARGS%
PRINTFORMW 「%CNAMET(ARG, "二人称")%のご命令であれば、どのようなものであろうと、%CNAMET(ARG, "一人称")%は従います」	PRINTFORMW 「不管%CALLNAME:MASTER%有什么吩咐、%CNAMET(ARG, "一人称")%都会照做的」
PRINTFORMW 「はい？何か問題でも？説明は不要だと思いますが？」	PRINTFORMW 「啊？怎么了？不、没什么，没什么其他要说的。」
PRINTFORMW 「%CNAMET(ARG, "二人称")%は自由に命令を下せばいいのです。」	PRINTFORMW 「%CALLNAME:MASTER%只要随意地吩咐就好了，%CNAMET(ARG, "一人称")%应该也不是您的第一名女仆了吧，没什么特别的。」
PRINTFORMW 「メイドを雇うのは%CNAMET(ARG, "一人称")%が初めてではないようですし、それと同じです」	PRINTFORMW 「一些额外的女仆服务吗？和您的其他女仆一样即可」
PRINTFORMW 「……『特別なご奉仕』の話ですか？それも他のメイドと同じです。」	PRINTFORMW 「只要按照约定支付灵魂就好了。」
PRINTFORMW 「あとは契約通りに魂を支払っていただければ。」	PRINTFORMW 「期限吗？到%CNAME("二人称")%或者%CNAME("一人称")%厌倦为止吧」
PRINTFORMW 「…契約の期限ですか？%CNAMET(ARG, "二人称")%か%CNAMET(ARG, "一人称")%が飽きるまで、としましょう」	PRINTFORMW 「没什么其他事的话。%CNAMET(ARG, "一人称")%就先去准备自己的房间了。」
PRINTFORMW 「他に質問がないのであれば、%CNAMET(ARG, "一人称")%は自分の部屋を準備させていただきます」	PRINTFORMW 恭恭敬敬地行了一个女仆的礼，%CALLNAME:TARGET%离開了。
PRINTFORMW %CALLNAME:TARGET%はそう言うと、恭しくお辞儀をして去っていった。	PRINTFORMW 听说了関于%CALLNAME:MASTER%的灵魂之后，就突然出现并提出了作为女仆的契约……除了一间自己的房间和灵魂之外，没什么多的要求。
PRINTFORMW ……%CALLNAME:MASTER%の魂についての噂を聞きつけると、突然現れて契約を提案してきた。	PRINTFORMW 对了，还有什么“当作正常的女仆对待就好”，那又是什么意思呢……
PRINTFORMW しかも要求しているのは個室と魂だけ。	PRINTFORMW 也没什么太多的话，脸上也没有表情，関于签订契约之后的事也没什么提问……
PRINTFORMW そして「普通のメイド扱い」というのはどういう意味なのだろうか…？	PRINTFORMW 甚至随身只有一身女仆服和一个拖箱……就没有多余的行李了。
PRINTFORMW 彼女には表情がない。契約後の事に関する質問もない。彼女には本当に何もない。	PRINTFORMW 话说，那个箱子摇晃起来叮叮当当的，里面是什么啊……
PRINTFORMW 持ち物だって、着ているメイド服と、あの大きなスーツケースだけだ。他に荷物は何もない。
PRINTFORMW しかし、ガタガタと大きく揺れていたあの箱には、いったい何が詰まっているのだろう…
PRINTFORMW 「そんなことですか……%CNAME("二人称")%が望むのであれば」	PRINTFORMW 「这种事，如果%CNAME("二人称")%希望的话」
PRINTFORMW メイドはこちらと向かい合う形で跪いた。	PRINTFORMW 女仆恭敬地跪坐在对面。
PRINTFORMW 「%CNAME("二人称")%が%CNAME("一人称")%の体を使用する…これも契約の範疇と言えるでしょう」	PRINTFORMW 「%CNAME("一人称")%的身体，就随%CNAME("二人称")%使用好了，毕竟这也是符合契约的。」
PRINTFORMW そう言い終えると、メイドはこちらをまっすぐに見つめて来た…	PRINTFORMW 女仆说罢了，眼神直直的盯了过来。
PRINTFORMW 「はい、従います。」	PRINTFORMW 「是的，遵命。」
PRINTFORMW 「%CALLNAME:TARGET%は単なるメイドです。%CNAME("二人称")%の命令を拒否する権利はありません」	PRINTFORMW 「%CALLNAME:TARGET%只是一名女仆，没有权利拒绝%CALLNAME:MASTER%的命令吧」
PRINTFORMW そう言いながらも、相変わらず彼女は無表情のまま淡々としているのだった。	PRINTFORMW 这么说着，脸上是一副没有表情的平淡样子。
PRINTFORMW 「このようなこと……%CNAME("一人称")%にとっては光栄です」	PRINTFORMW 「这种事，是%CNAME("一人称")%的荣幸」
PRINTFORMW 「ああ…%CNAME("二人称")%、よろしくお願い致します」	PRINTFORMW 「啊啦，也请%CALLNAME:MASTER%多多指教了」
PRINTFORMW メイドは恭しく跪くと、軽く頭を下げてお辞儀をした…	PRINTFORMW 女仆恭恭敬敬地跪坐着，微微的低下了头
PRINTFORMW メイドは恭しく跪いている……	PRINTFORMW 女仆恭恭敬敬的低着头跪坐着……
PRINTFORMW ……そして、着ている服の裾を摘まんでいじくり回している…	PRINTFORMW ……手指似乎轻轻地揉捏着自己衣服的下摆
PRINTFORMW 「あの…%CNAME("二人称")%、まだ始めないのですか？」	PRINTFORMW 「啊，%CNAME("二人称")%还不開始吗？」
PRINTFORMW 「%CALLNAME:TARGET%は準備ができています…%CNAME("一人称")%、いつでも開始、できます…」	PRINTFORMW 「%CALLNAME:TARGET%已经准备好了，%CNAME("二人称")%……随时可以開始的」
PRINTFORMW どうやら、面白くなってきたようだ…	PRINTFORMW 看起来事情变得有趣了起来
PRINTFORMW 「調教を始めますか？%CNAME("一人称")%の準備は万全です。」	PRINTFORMW 「又要開始调教了吗，%CNAME("一人称")%已经准备好了。」
PRINTFORMW 「…何度仰るのですか…あり得ませんよ！%CALLNAME:TARGET%はご主人様の調教に飽きてなどいません！」	PRINTFORMW 「为什么要说又……啊，并没有呦，%CALLNAME:TARGET%并不厌倦主人的调教呦」
PRINTFORMW 「むしろ、%CNAME("一人称")%は幸せなのですが、時々…」	PRINTFORMW 「反倒说很開心吧，只是希望偶尔……偶尔可以不以主仆的身份……」
PRINTFORMW 「本当に時々ですが、主従という身分に関係なく、その……」	PRINTFORMW %CALLNAME:TARGET%的声音越来越小，逐渐细如蚊声，再也听不清了
PRINTFORMW %CALLNAME:TARGET%の声は徐々に小さく、蚊の鳴くような声になり、やがて聞こえなくなった…	PRINTFORMW 「啊……没什么的，请随您喜欢吧。」
PRINTFORMW 「あ……何でもありません、よろしくお願いします」
PRINTFORMW 「本日も、よろしくお願い致します。」	PRINTFORMW 「今天也请多指教了呢。」
PRINTFORMW すっかり見慣れたメイドが跪いてこちらを無表情に見つめる。	PRINTFORMW 熟悉的女仆跪坐在熟悉的位置，面无表情的看了过来。
PRINTFORMW 「今回は、何処で気持ちよく射精なさりたいですか？」	PRINTFORMW 「今天您想用哪里舒舒服服的射出来呢？」
PRINTFORMW 話している最中、誰かがこっそり唇を舐めたような気がする……気のせいだろうか？	PRINTFORMW 感觉刚才说话的时候有人偷偷的舔了舔嘴唇呢……是错觉吗。
PRINTFORMW 「本日は安全日です、%CNAME("二人称")%は、安心してお楽しみいただけます……」	PRINTFORMW 「今天是安全日呦、%CNAME("二人称")%可以尽情地……」
PRINTFORMW %CALLNAME:TARGET%は、無表情のままこちらに顔を寄せると、耳元で優しく囁いた。	PRINTFORMW %CALLNAME:TARGET%面无表情地凑了过来，在耳边轻轻地吐息。
PRINTFORMW 「契約は契約です…しかし、今子供ができてしまうのは非常に問題がありますね……」	PRINTFORMW 「尽管是有契约的，但是无论如何有了孩子还是很麻烦的……」
PRINTFORMW 表情だけでなく、声にも冷たさが滲み出ている……	PRINTFORMW 不仅是表情，连声音都有点冷冰冰的呢……
PRINTFORMW 「従います……」	PRINTFORMW 「遵命……」
PRINTFORMW 「本日も、よろしくお願い致します。」	PRINTFORMW 「今天也请多指教了呢。」
PRINTFORMW 見慣れたメイドがいつもの姿勢で跪き、微かな笑みを浮かべた。	PRINTFORMW 熟悉的女仆跪坐在熟悉的位置，脸上带着淡淡的微笑。
PRINTFORMW 「今日は一緒に気持ちよくなりたい、ですか…？それは、とても素敵ですね……」	PRINTFORMW 「今天也要一起变得舒服起来吗？真是太好了呢……」
PRINTFORMW %CALLNAME:TARGET%がこちらに向ける眼差しは、愛されたいという欲望に満ちたものだった…	PRINTFORMW %CALLNAME:TARGET%的眼神里写满了被疼爱的欲望
PRINTFORMW %CALLNAME:TARGET%は%CALLNAME:MASTER%が来たことに気づかないまま、自らの陰核を愛撫している	PRINTFORMW 并没有注意到有人来了，%CALLNAME:TARGET%正自顾自的地爱抚着自己的小豆豆。
PRINTFORMW 秘裂には自らの尻尾を浅く挿入しており、ハートの形をした先端は愛液で濡れている…	PRINTFORMW 尾巴的前端也浅浅地插进了小穴里，桃心状的前端有一半漏在外面。
CALL PRINT_STR, @"「あぁっ…_H_はぁぁ…_BH_治まらないっ、これだけじゃ………あっ」_W"	CALL PRINT_STR, @"「啊哈~_H_啊哈~_BH_，比不上啊，完全……啊！」_W"
PRINTFORMW %CALLNAME:MASTER%に気づいた%CALLNAME:TARGET%は明らかに驚いた表情を浮かべたが、すぐに普段の無表情に戻った…	PRINTFORMW 突然发现了%CALLNAME:MASTER%的到来，%CALLNAME:TARGET%显然是被吓了一跳，但很快恢复了平常的面无表情。
PRINTFORMW %CALLNAME:TARGET%はゆっくりと立ち上がると、こちらに近づいてくる。自慰の手を止め、こちらに手を伸ばしている。	PRINTFORMW %CALLNAME:TARGET%站了起来，慢慢的走了过来。虽然手的动作已经停止了，并把手伸出过来。
PRINTFORMW しかし、尻尾の動きは全く止まらず、さらに激しくなり、ハート形の先端は完全に秘裂に埋め込まれた…	PRINTFORMW 但是尾巴却完全没有停下来，反而动的越来越激烈了，桃心形的前端已经完全地没了进去。
PRINTFORMW %CALLNAME:TARGET%の顔に表情はない。しかし、頬は紅潮しており、その呼吸は荒い。	PRINTFORMW 虽然没有什么表情，但是%CALLNAME:TARGET%的整个脸都已经红了起来，呼吸也变得沉重了。
CALL PRINT_STR, @"「この哀れなメイドを慰めてください…ご主人様でないと駄目なのです…全く、快感を得られないのです…_BH_」_W"	CALL PRINT_STR, @"「来安慰一下%CNAME("二人称")%可怜的女仆吧，不是主人的话……完全，完全舒服不起来啊……_BH_」_W"
PRINTFORMW %CALLNAME:TARGET%がそう言うと、透明な粘液が尻尾を伝ってトロリと滴り落ちた…	PRINTFORMW 透明的粘液沿着尾巴流下来了……
PRINTFORMW 「本日も、よろしくお願い致します。」	PRINTFORMW 「今天也请多指教了呢。」
PRINTFORMW 見慣れたメイドがいつもの姿勢で跪き、微かな笑みを浮かべた。	PRINTFORMW 熟悉的女仆跪坐在熟悉的位置，脸上带着淡淡的微笑。
PRINTFORMW 「今日は一緒に気持ちよくなりたい、ですか…？」	PRINTFORMW 「今天也要一起变得舒服起来吗？」
PRINTFORMW 会話中、%CALLNAME:TARGET%の脚に挟まれたエプロンスカートのひだは明らかに深まった……	PRINTFORMW 说话间，%CALLNAME:TARGET%的女仆服围裙在两腿间的褶皱却明显的变深了……
PRINTFORMW 「頭では理解していましたが、これほど強力なものだったとは……」	PRINTFORMW 「虽然有所了解，但是没想到这么厉害啊……」
PRINTFORMW 「…ご報告いたしますと、この淫紋を刻まれてから、%CALLNAME:TARGET%の体は…大きく変化しています」	PRINTFORMW 「向%CALLNAME:MASTER%报告呢，淫纹刻上去之后，%CALLNAME:TARGET%的身体变得非常奇怪了。」
CALL PRINT_STR, @"「こんなにも爽やかな天気であるのに、体が熱いのです…_H_」_W"	CALL PRINT_STR, @"「明明是清爽的天气却全身燥热_H_，做着家务活胖次却完全湿透了_H_，看到%CALLNAME:MASTER%就会……」_W"
CALL PRINT_STR, @"「家事をしていても、下着を濡らしてしまうのです…_H_ご覧になりますか？%CNAME("二人称")%……」_W"	PRINTFORMW 平日里的冰山美人已经完全崩塌了，眉毛紧蹙着，瞳孔湿润的望过来，面皮烧的像要冒烟了一样，微微张開的小嘴里能看到鲜红的舌尖。
PRINTFORMW 普段の氷のような美しさは完全に崩壊してしまっている…	PRINTFORMW 扑克脸已经完全成了不像话的样子了呢……
PRINTFORMW 眉は垂れ下がり、瞳は潤んでいる。顔は煙が出そうな程に紅潮し、わずかに開かれた口から真っ赤な舌がのぞいている。	PRINTFORMW 「一看到%CALLNAME:MASTER%，子宫和心脏就不听话的一直向脑子说起话了……」
PRINTFORMW ポーカーフェイスを保つことは、もはや不可能のようだ…	PRINTFORMW 「她说……」
PRINTFORMW 「%CNAME("二人称")%を見た瞬間、子宮も心臓も言うことを聞かなくなって…」	PRINTFORMW 「好想要啊，好想要啊……好想要啊~~好想要啊！！！」
PRINTFORMW 「%CNAME("一人称")%の脳に、訴えかけて来ます……こんな風に」	CALL PRINT_STR, @"「%CALLNAME:TARGET%好想要啊_H_~_BH_~_BH_」_W"
PRINTFORMW 「欲しい、欲しい、欲しい……欲しくてたまらない…！！！」	PRINTFORMW %CALLNAME:TARGET%闭上眼睛，渐渐的平复下来，又慢慢地变成素日里冷冷的女仆了。只是脸蛋还红扑扑的……
CALL PRINT_STR, @"「%CALLNAME:TARGET%はっ…_H_%CNAME("二人称")%が欲しいんですっ……_BH_」_W"
PRINTFORMW %CALLNAME:TARGET%は目を閉じると、次第に落ち着き始め、普段の無表情なメイドに戻った…
PRINTFORMW しかし、こちらの頬の紅潮は治まりそうもない…
PRINTFORMW 「本日も、よろしくお願い致します。」	PRINTFORMW 「今天也请多指教了呢。」
PRINTFORMW 見慣れたメイドがいつもの姿勢で跪き、微かな笑みを浮かべた。	PRINTFORMW 熟悉的女仆跪坐在熟悉的位置，脸上带着淡淡的微笑。
PRINTFORMW 「今日は一緒に気持ちよくなりたい、ですか…？」	PRINTFORMW 「今天也要一起变得舒服起来吗？」
PRINTFORMW %CALLNAME:TARGET%は下腹部にそっと手を当てた…その目の奥には何かが流れているような感覚を覚えた。	PRINTFORMW %CALLNAME:TARGET%用手轻轻地捂住自己的小腹，眼神深处好像有什么东西在流动。
PRINTFORMW 「%CNAME("二人称")%が、%CNAME("二人称")%が%CALLNAME:TARGET%をこんな風に作り変えたんです……」	PRINTFORMW 「%CNAME("二人称")%说，%CNAME("二人称")%把%CALLNAME:TARGET%变成了这个样子……」
PRINTFORMW %CALLNAME:TARGET%は悪魔の形態になってベッドに横たわり、腹部に刻まれたピンク色の線を指でなぞっている。	PRINTFORMW 已经变成了恶魔形态的%CALLNAME:TARGET%半躺在床上，用手指轻轻地沿着自己小腹上发亮的粉色纹路滑动着。
CALL PRINT_STR, @"「遠くからでも精液の匂いがわかりますし…_H_子宮はいつも震えたがっています_H_」_W"	CALL PRINT_STR, @"「大老远就能闻到下流的子种汁的味道~_H_子宫想要的在发颤啊_H_」_W"
PRINTFORMW 突然%CALLNAME:TARGET%が視界から消えたかと思うと、%CALLNAME:MASTER%の体は見えない力で縛り付けられて動けなくなった…	PRINTFORMW 忽然间%CALLNAME:TARGET%从%CALLNAME:MASTER%的视野里消失了，下一秒%CALLNAME:MASTER%就被什么看不到的力量束缚住了，一点点也动不了。
PRINTFORMW 普段はクールで無表情なメイドの姿なので忘れていたが、目の前のこの相手は悪魔なのだ…	PRINTFORMW 因为平日里都是潇洒的冰山女仆，有时候会忘了本质上对方是一个恶魔呢……
PRINTFORMW 首の後ろに熱い息がかかるのを感じる。%CALLNAME:MASTER%のパンツにしなやかな手が伸びてきて、大事な場所を優しく握る……	PRINTFORMW 温热的吐息出现在后颈上，一只柔软滑嫩的手伸进了%CALLNAME:MASTER%的裤子，握住了%CALLNAME:MASTER%的要害……
CALL PRINT_STR, @"「もう硬くなっていますね…_H_ああ…_H_この浮き出た血管、このいやらしい形…_H_」_W"	CALL PRINT_STR, @"「这不是已经很硬了吗~，啊哈~_H_这个突出的血管，这个下流的形状_H_，这坏东西已经惹得多少姑娘哭泣了呢？」_W"
PRINTFORMW 「この悪い子でいったい何人の女の子を泣かせてきたんですか？」	PRINTFORMW 握住的玉手上的力量渐渐加大，甚至大到有点隐隐作痛了。同时另一只手从另一边伸了进来，找到了重要的弹药库。
PRINTFORMW 玉の如く美しい手は次第に力強く握られ、徐々に痛みを感じ始める。同時にもう片方の手が伸びてきて、大事な弾薬庫に到達する。	PRINTFORMW 「那这个坏东西又把多少……」
PRINTFORMW 「次ですよ…こっちはどれくらい悪い子なんですか……？」	PRINTFORMW 从背后能听到%CALLNAME:TARGET%轻轻地吞咽声音，之后%CALLNAME:TARGET%突然两字一顿的说起话来，而且每次说完，就狠狠的撸动一下%CALLNAME:MASTER%的鸡巴。
PRINTFORMW 背後から%CALLNAME:TARGET%がゆっくりと息をのむ音が聞こえる。	CALL PRINT_STR, @"「原本……全部……属于……我的……精液……_BH_……射进……其他……小穴！！！」_W"
PRINTFORMW と思うと、%CALLNAME:TARGET%は途切れ途切れに言葉を発しながら%CALLNAME:MASTER%のペニスを揺さぶり始めた…	PRINTFORMW 两只手突然又放開了，之后一只手搭在了%CALLNAME:MASTER%的肩膀上，%CALLNAME:TARGET%缓缓地绕到了%CALLNAME:MASTER%的正面来。
CALL PRINT_STR, @"「もともと…これは…全部…%CNAME("一人称")%の…精液……_BH_でも%CNAME("二人称")%は…他の子の穴に…射精した！！！」_W"	PRINTFORMW 「%CNAME("二人称")%猜一猜我是不是在開玩笑呢~」
PRINTFORMW 突然、両手が離される。片方の手が肩に置かれ、%CALLNAME:TARGET%はゆっくりとあなたの正面に回り込む。	CALL PRINT_STR, @"「恶魔的秘法有很多种，可以让人除了在%CALLNAME:TARGET%的小穴里之外再也射不出来了~_BH_，也可以让人变成只知道噗噜噗噜的笨蛋呦~_BH_」_W"
PRINTFORMW 「%CNAME("二人称")%…%CNAME("一人称")%が冗談を言っている、と…そう思いますか？」	PRINTFORMW 不同于往日的面无表情，%CALLNAME:TARGET%脸上挂着嗜虐的笑容，嘴角甚至都有些过度的咧開了。
PRINTFORMW 「悪魔の使う術といっても様々なものがあるのですよ」	CALL PRINT_STR, @"「除非这次%CNAME("二人称")%把蛋蛋里的东西全部的，全部射·给·我·呦~_BH_」_W"
CALL PRINT_STR, @"「%CALLNAME:TARGET%のココにしか射精できなくなる術…_BH_人間を『ぶひぶひ』としか喋れない馬鹿に変える術…_BH_」_W"
PRINTFORMW %CALLNAME:TARGET%は最早今までのような無表情ではない。ニヤリと口角を上げて、嗜虐的な笑みを浮かべている。
CALL PRINT_STR, @"「今日、%CNAME("二人称")%の睾丸の中にある精液は全部、%CNAME("一人称")%が頂きます…全部、ですからね…_BH_」_W"
PRINTFORMW %CALLNAME:MASTER%は束縛から解放された！	PRINTFORMW %CALLNAME:MASTER%身上的束缚解開了！
PRINTFORMW 「%CNAME("二人称")%が、%CNAME("二人称")%が%CALLNAME:TARGET%をこんな風に作り変えたんです……」	PRINTFORMW 「%CNAME("二人称")%说，%CNAME("二人称")%把%CALLNAME:TARGET%变成了这个样子……」
PRINTFORMW %CALLNAME:TARGET%は悪魔の形態になってベッドに横たわり、腹部に刻まれたピンク色の線を指でなぞっている。	PRINTFORMW 已经变成了恶魔形态的%CALLNAME:TARGET%半躺在床上，用手指轻轻地沿着自己小腹上发亮的粉色纹路滑动着。
PRINTFORMW 「遠くからでも精液の匂いがわかってしまうんです…」	PRINTFORMW 「大老远就能闻到下流的子种汁的味道~」
PRINTFORMW 突然、%CALLNAME:TARGET%の姿が視界から消え、次の瞬間、%CALLNAME:MASTER%はとてつもない力でベッドに押し倒された…	PRINTFORMW 忽然间%CALLNAME:TARGET%从%CALLNAME:MASTER%的视野里消失了，下一秒%CALLNAME:MASTER%就被一股无法抵抗的力量强行推倒在床上
PRINTFORMW 普段はクールで無表情なメイドの姿なので忘れていたが、目の前のこの相手は悪魔なのだ…	PRINTFORMW 因为平日里都是潇洒的冰山女仆，有时候会忘了本质上对方是一个恶魔呢……
CALL PRINT_STR, @"「今日は、私が満足するまで付き合っていただきます…_BH_」_W "	CALL PRINT_STR, @"「今天一定要好好地满足人家啊~_BH_」_W "
PRINTFORMW 「本日も、よろしくお願い致します。」	PRINTFORMW 「今天也请多指教了呢。」
PRINTFORMW 見慣れたメイドがいつもの姿勢で跪き、微かな笑みを浮かべた。	PRINTFORMW 熟悉的女仆跪坐在熟悉的位置，脸上带着淡淡的微笑。
PRINTFORMW 「今日は一緒に気持ちよくなりたい、ですか…？」	PRINTFORMW 「今天也要一起变得舒服起来吗？」
PRINTFORMW %CALLNAME:TARGET%はそう言うと、にっこりと笑いながら首を縦に振った…	PRINTFORMW %CALLNAME:TARGET%说着话，笑容灿烂地歪了歪头。
PRINTFORMW 「仰せのままに。」	PRINTFORMW 「遵命。」
PRINTFORMW 「仰せのままに。」	PRINTFORMW 「遵命。」
PRINTFORMW 「%CALLNAME:TARGET%が%CNAME("二人称")%に逆らうことなどあり得ません。」	PRINTFORMW 「%CALLNAME:TARGET%是不会拒绝%CALLNAME:MASTER%的命令的。」
PRINTFORMW %CALLNAME:TARGET%の浮かべている表情には未だ変化が見られない…	PRINTFORMW %CALLNAME:TARGET%的脸上却还是没有什么表情。
PRINTFORMW 「ご主人様に調教していただけること、%CALLNAME:TARGET%はとても光栄に思います。」	PRINTFORMW 「%CALLNAME:TARGET%很荣幸能被主人调教。」
PRINTFORMW 「ああ…%CNAME("二人称")%、よろしくお願い致します。」	PRINTFORMW 「啊啦，也请%CALLNAME:MASTER%多多指教。」
PRINTFORMW メイドは恭しく跪くと、軽く頭を下げてお辞儀をした…	PRINTFORMW 女仆恭恭敬敬地跪坐着，微微的低下了头。
PRINTFORMW 「始めてください……%CALLNAME:TARGET%はその準備ができています。」	PRINTFORMW 「请開始吧……%CALLNAME:TARGET%已经准备好了。」
PRINTFORMW そう言いながら、メイドは目を閉じた。	PRINTFORMW 说罢，女仆闭上了自己的眼睛。
PRINTFORMW お酒が入っているせいか、苦しそうにしている%CALLNAME:TARGET%は行為が終わるとすぐに眠ってしまった…	PRINTFORMW 或许是因为酒精的缘故吧，被折腾的不轻的%CALLNAME:TARGET%在结束后很快就进入了梦乡
PRINTFORMW 目の前で眠っている%CALLNAME:TARGET%の美しい体を見ていると、どうしても悪戯心が出てきてしまう…	PRINTFORMW 看着沉睡在身边的佳人的肉体，忍不住恶作剧的心理，%CALLNAME:MASTER%在%CALLNAME:TARGET%圆润丰满的臀部上不重不轻地拍了一下
PRINTFORMW %CALLNAME:MASTER%は%CALLNAME:TARGET%の丸くて柔らかいお尻をこっそりと叩いてみた…	PRINTFORMW “啪！”随着手掌的落下，%CALLNAME:TARGET%的身体却非常过激地蜷缩了起来
PRINTFORMW 『パン！』と掌が当たると、%CALLNAME:TARGET%は身を守るように体をギュッと縮こまらせた…	PRINTFORMW 「对……对不起！主人！我还可以的继续的！」
PRINTFORMW 「も、申し訳ありませんご主人様！まだ続けられます……」	PRINTFORMW 「求求主人不要生气，求求主人继续惩罚……」
PRINTFORMW 「どうか、怒らないでください……お仕置きを、続けてください……」	PRINTFORMW 「唔唔……求……不要用铁链！会……唔……」
PRINTFORMW 「そんな……お願いです…いやぁぁっ！鎖はやめてぇっ！うぁ……ぁ……！」	PRINTFORMW 然后是不知道是哀求还是悲鸣的声音……
PRINTFORMW その後には、哀願とも悲鳴ともつかないような声が続いた	PRINTFORMW %CALLNAME:TARGET%不是已经封印了过去的记忆了吗？为什么还会做这样的噩梦呢？
PRINTFORMW %CALLNAME:TARGET%の過去の記憶は封印されていたのではないのか？何故未だにこんな悪夢を見ている？	PRINTFORMW %CALLNAME:MASTER%一边握住睡梦中的%CALLNAME:TARGET%的手来安抚她，一边思考了起来……
PRINTFORMW %CALLNAME:MASTER%は、%CALLNAME:TARGET%を慰めるように彼女の手を握りながら、そのことについて考え続けた……	CFLAG:11003 = 1
PRINTFORMW 「終わったのであれば……後片付けを、しないと…」	PRINTFORMW 「结束了之后要…做一下清洁呢…」
PRINTFORMW 疲れているにも関わらず、%CALLNAME:TARGET%はよろめきながら立ち上がった…	PRINTFORMW 尽管有些疲惫，%CALLNAME:TARGET%仍坚持的摇摇晃晃地站了起来
PRINTFORMW 気づくと、ぽた…ぽた…と床に液体が垂れ落ちる音がする。	PRINTFORMW 滴…滴…，突然有几声液体滴到地板上的声音
PRINTFORMW 音の正体は、たっぷりと精液を注がれた%CALLNAME:TARGET%のようだ…白く濁った液体が足元の床に垂れ落ちている。	PRINTFORMW 原来是被注入了过多精液的%CALLNAME:TARGET%……几滴乳白色的液体滴落在%CALLNAME:TARGET%两腿间的地板上
PRINTFORMW メイドは赤面しながら恥ずかしそうに頭を下げ、未だ震えている両脚を精一杯閉じて内股になった…	PRINTFORMW 有些脸红的女仆害羞地低下了头，努力地夹紧仍有些颤抖的大腿
PRINTFORMW しかし、大量の精液で微かに膨らんだ下腹部と、小麦色の太ももに残る精液の垂れた跡が、一切を明らかにしている……	PRINTFORMW 然而被射的微微鼓起的小腹和小麦色的丰满大腿内测不断多出来的乳白液痕却暴露了一切……
PRINTFORMW %CALLNAME:TARGET%の歩いた後には、乳白色の『足跡』が残っていた…	PRINTFORMW %CALLNAME:TARGET%走过的路径留下了一串乳白色的“脚印”
PRINTFORMW 「全部を%CNAME("一人称")%の中に出しては下さりませんでしたね…」	PRINTFORMW 「没有全部射给%CNAME("一人称")%呢…」
PRINTFORMW パンパンになったコンドームを手に取りながら、%CALLNAME:TARGET%は静かに言った。	PRINTFORMW 拿起了一个装满的避孕套，%CALLNAME:TARGET%幽幽地说道
PRINTFORMW 「精液が、こんなに沢山…もったいない……」	PRINTFORMW 「这么多的种子，好浪费……」
PRINTFORMW %CALLNAME:TARGET%は天を仰いで大口を開けると、突き出した舌の上にコンドームの中身を注ぎ始めた…	PRINTFORMW %CALLNAME:TARGET%仰起头，大大地张開了嘴巴，伸出了舌头——把套中的液体倒在了舌头上
CALL PRINT_STR, @"「ふふ、とても臭いです……_H_しかし、この粘り気は素晴らしいですね……_HH_」_W"	CALL PRINT_STR, @"「好臭~但是非常的粘稠呢~_HH_」_W"
PRINTFORMW 年代物のワインを味わうかのように精液を舌の上で転がしながら、%CALLNAME:TARGET%はうっとりと目を閉じた…	PRINTFORMW 用舌头把液体卷进口中，%CALLNAME:TARGET%闭着眼，好像在品味某种陈年的酒一样……
PRINTFORMW 「はぁっ……はぁっ……はぁっ………」	PRINTFORMW 「啊哈~啊哈~啊哈~…」
PRINTFORMW 行為が終わってからどれくらいたっただろう…ぐったりとした%CALLNAME:TARGET%は未だ快感の余韻に浸っている…	PRINTFORMW 不知道调教已经结束了多久，瘫软着的%CALLNAME:TARGET%依然回味着……
PRINTFORMW 官能的な場面を思い出しているのであろう%CALLNAME:TARGET%の手は、無意識に自らの秘所に伸ばされている…	PRINTFORMW 沉浸在刚才的肉欲的回忆中，%CALLNAME:TARGET%的手指不自觉地伸向了自己的蜜所…
PRINTFORMW ほどなくして、再び甘美な水音が聞こえてきた…	PRINTFORMW 不一会儿，就又响起来了甜蜜的声音……
CALL PRINT_STR, @"「まだ、足りないのです…%CNAME("二人称")%、次はいつ、%CNAME("一人称")%を愛してくださいますか…_H_」_W"	CALL PRINT_STR, @"「自己怎么样都不够啊……%CNAME("二人称")%，什么时候能再来疼爱%CNAME("一人称")%呢~_HH_」_W"
PRINTFORMW 「ご主人様…」	PRINTFORMW 「主人…」
PRINTFORMW %CALLNAME:TARGET%に対する調教を終えた…	PRINTFORMW 对%CALLNAME:TARGET%的调教结束了
CALL PRINT_STR, @"「あらあら……_H_もう終わりですか？」_W"	CALL PRINT_STR, @"「啊啦啊啦_H_～，这就要结束了吗？」_W"
CALL PRINT_STR, @"「駄目ですよ、%CNAME("二人称")%_BH_男性たるもの『できない』などと簡単に口に出すべきではありません」_W"	CALL PRINT_STR, @"「不可以哦%CALLNAME:MASTER%_BH_，男孩子是不可以轻易说不行的啊……」_W"
CALL PRINT_STR, @"「ほらほら_H_しっかりなさってください…早く続きを致しましょう…_H_」_W"	CALL PRINT_STR, @"「来吧来吧_H_，打起精神来，还可以继续的吧」_W"
PRINTFORMW %CALLNAME:TARGET%はにっこりと微笑みながら、半ば萎れている%CALLNAME:MASTER%のペニスを手に取った…	PRINTFORMW %CALLNAME:TARGET%眯着眼笑着抓住了%CALLNAME:MASTER%的半软的肉棒。
CALL PRINT_STR, @"「まだ終わっては駄目ですよ、%CNAME("二人称")%…」_W"	CALL PRINT_STR, @"「这就不行了吗%CALLNAME:MASTER%。」_W"
CALL PRINT_STR, @"「この中、もう空っぽなんですか…？どうなんですか…_BH_」_W"	CALL PRINT_STR, @"「蛋蛋里面已经什么都没有了吗……_BH_」_W"
PRINTFORMW %CALLNAME:TARGET%は、すっかり柔らかくなった%CALLNAME:MASTER%の玉袋を揉みしだいた…	PRINTFORMW %CALLNAME:TARGET%揉捏着%CALLNAME:MASTER%已经松弛变软的玉袋。
CALL PRINT_STR, @"「そんな筈はないですよね……%CNAME("一人称")%はまだ満足していないのですよ…_H_」_W"	CALL PRINT_STR, @"「怎么会……人家可是还没吃饱啦_H_」_W"
PRINTFORMW 「…………本当に、もう空っぽ、のようですね」	PRINTFORMW 「真的已经已经什么都没有了……」
PRINTFORMW 「あああ！もう！%CNAME("二人称")%、また他の女狐にたぶらかされましたね！？」	PRINTFORMW 「啊啊啊啊！%CNAME("二人称")%一定又去找其他狐狸精了！」
PRINTFORMW 「許しません！！この中にある精子は、一滴残らず%CNAME("一人称")%の物なんですからね！」	PRINTFORMW 「不行！这里边的东西，每一滴都是我的！」
PRINTFORMW 膨れ面をした%CALLNAME:TARGET%にギュっ、ギュっ、と玉を強く握られる…痛い！	PRINTFORMW 气鼓鼓的%CALLNAME:TARGET%用力捏了两下%CALLNAME:MASTER%的弹药库，好疼！
CALL PRINT_STR, @"「は、はい…_H_承知しました、%CNAME("二人称")%…しかし…」_W"	CALL PRINT_STR, @"「好，好的_H_没関系，%CALLNAME:MASTER%，请把%CNAME("二人称")%的最后一滴～啊～谁给%CALLNAME:TARGET%吧。」_W"
PRINTFORMW 「どうか、%CNAME("二人称")%の最後の一滴を…どうかこの%CALLNAME:TARGET%に恵んでください…」
CALL PRINT_STR, @"「射精していただけるまで……%CNAME("二人称")%を離しません……_BH_」_W"	CALL PRINT_STR, @"「在%CNAME("二人称")%射光之前……我不会放開的……_BH_」_W"
PRINTFORMW %CALLNAME:TARGET%に抱きしめられる。その魅惑的な身体に溺れてしまいそうで、頭がくらくらしてくる……	PRINTFORMW 沉迷在%CALLNAME:TARGET%诱人的身体里，脑袋变得昏昏沉沉的……
PRINTFORMW …ベッドの上で目が覚めると、すでに後始末は済んでおり、%CALLNAME:TARGET%の姿はこの場から消えていた。	PRINTFORMW 再清醒的时候，是躺在床上，干干净净地搭着被子的状态。而%CALLNAME:TARGET%已经不知道到哪里去了。
PRINTFORMW 「限界のようですね……ご奉仕はここまでにいたしましょう」	PRINTFORMW 「您好像已经到极限了呢……女仆的服侍要结束了……」
PRINTFORMW 「立ち上がれますか？入浴されるのであれば、お手伝いしますが…？」	PRINTFORMW 「看起来您的腿都软了呢，需要帮您清洗身体吗？」
CALL PRINT_STR, @"「ふあぁぁぁ……ペニスから…_HH_とろとろの精液が、こんなに……」_W"	CALL PRINT_STR, @"「啊恩～……的肉棒_HH_射出了这么多黏答答的精液出来……」_W"
CALL PRINT_STR, @"「この上ない快感です……%CNAME("一人称")%の穴は、もういっぱいで…精液が流れ出てしまっています……_BH_」_W"	CALL PRINT_STR, @"「这样好舒服哦，小穴里憋不住的精液，流出来了……_BH_」_W"
CALL PRINT_STR, @"「とても、素敵でした……_HH_」_W"	CALL PRINT_STR, @"「真厉害呐……_HH_」_W"
CALL PRINT_STR, @"「さすがですね……%CNAME("二人称")%_H_%CALLNAME:TARGET%はもう立ち上がれそうにありません……_HH_」_W"	CALL PRINT_STR, @"「不愧是……%CALLNAME:MASTER%_H_让%CALLNAME:TARGET%腿都有些发软呢……_HH_」_W"
CALL PRINT_STR, @"「後始末の前に、少し休憩させていただきますね……_HH_」_W"	CALL PRINT_STR, @"「休息一下再打扫吧……_HH_」_W"
PRINTFORMW 「よろしければ、%CNAME("二人称")%が体を綺麗にするお手伝いを致しましょうか？」	PRINTFORMW 「需要帮%CALLNAME:MASTER%清洗身体吗？」
PRINTFORMW 「あ……本当にただ綺麗にさせていただくだけですよ？」	PRINTFORMW 「啊……真的只是清洗而已……」
PRINTFORMW 「ご奉仕を終了します」	PRINTFORMW 「服侍结束了」
PRINTFORMW 疲れ果てているにも関わらず、メイドは精一杯いつも通りのお辞儀をして見せた。	PRINTFORMW 尽管可能有些疲惫，女仆仍然尽量标准地行了一个礼
PRINTFORMW 「も…もうご奉仕は終わり、ですか？」	PRINTFORMW 「要……要结束服侍了吗」
PRINTFORMW 「承知致しました……」	PRINTFORMW 「知道了……」
PRINTFORMW 「どうぞ……どこから始めますか？」	PRINTFORMW 「请随意……您想从哪里開始呢？」
PRINTFORMW 「あぁぁっ……そこばかり、触られると…おかしくなってしまいます…」	PRINTFORMW 「啊～一直摸那里的话，会变得奇怪起来的。」
PRINTFORMW 下腹部の紋様は撫でられる度にピンク色の光を放っている…	PRINTFORMW 被抚摸着的纹路散发着粉色的光芒
PRINTFORMW 「もう……もう駄目ですっ……これ以上は…！」	PRINTFORMW 「请……请不要再继续了啊。」
PRINTFORMW 淫紋は更に輝きを増して行く…	PRINTFORMW 淫纹的光芒更加耀眼了……
PRINTFORMW 「その、達したばかりなので…そこは、敏感で…」	PRINTFORMW 「啊，才刚刚去过，那里还……有点敏感。」
PRINTFORMW 「できればで構いませんので、優しく…お願いしますね。」	PRINTFORMW 「还请您尽可能的温柔一点。」
PRINTFORMW いつもの冷たい表情が、心なしか柔らかくなったような気がする。	PRINTFORMW 难得的，感觉没有表情的脸有一点点软化了下来。
PRINTFORMW 「%CNAME("二人称")%の命令であれば、拒絶など致しません」	PRINTFORMW 「只要是%CALLNAME:MASTER%的命令，不会拒绝的」
PRINTFORMW メイドは礼儀正しく答えると、愛撫を受け入れた……	PRINTFORMW 女仆恭敬的回答道，接受着爱抚……
PRINTFORMW 僅かに、ほんの僅かにではあるが笑っているように見える……	PRINTFORMW 似乎稍微有一点点笑容……
PRINTFORMW 「そこばかり、撫でられると…お腹の中が大変なことになってしまいます…」	PRINTFORMW 「一直抚摸那里的话，里面会变得不得了的呀」
PRINTFORMW 「%CNAME("一人称")%の一番大事な所が『欲しい欲しい』と言って、狂い始めるんです…」	PRINTFORMW 「%CNAME("一人称")% 最重要的地方会疯狂地说着想要啊」
PRINTFORMW 「あぁぁっ……そこばかり、触られると…おかしくなってしまいます…」	PRINTFORMW 「啊～一直摸那里的话，会变得奇怪起来的。」
PRINTFORMW 下腹部の紋様は撫でられる度にピンク色の光を放っている…	PRINTFORMW 被抚摸着的纹路散发着粉色的光芒
CALL PRINT_STR, @"「もう……もう駄目ですぅっ……これ、以上はぁぁっ…_BH_」_W"	CALL PRINT_STR, @"「请……请不要再继续了啊。_BH_」_W"
PRINTFORMW 淫紋は更に輝きを増して行く…	PRINTFORMW 淫纹的光芒更加耀眼了……
PRINTFORMW 「その、達したばかりなので…そこは、敏感で…」	PRINTFORMW 「啊，才刚刚去过，那里还……有点敏感。」
PRINTFORMW 「できれば優しく…お願いしますね。」	PRINTFORMW 「请您尽可能的温柔一点。」
PRINTFORMW いつもの冷たい表情が、心なしか柔らかくなったような気がする。	PRINTFORMW 难得的，感觉没有表情的脸有一点点软化了下来。
PRINTFORMW 「%CNAME("二人称")%の手、気持ちいいです…それに、とても安心します」	PRINTFORMW 「%CNAME("二人称")%的手，非常舒服，而且让人安心呢」
PRINTFORMW %CALLNAME:TARGET%は微笑みながらこちらを見ている。	PRINTFORMW %CALLNAME:TARGET%微笑地望向这边。
PRINTFORMW 「ん？感触はどうですか？」	PRINTFORMW 「哦？手感怎么样呢？」
PRINTFORMW 「どうぞ、お好きなように。」	PRINTFORMW 「随您喜欢吧。」
PRINTFORMW メイドはそれ以上反応することなく、ただ黙って愛撫を受けていた。	PRINTFORMW 女仆并没有再多的回应了，只是默默地接受着爱抚。
PRINTFORMW %CALLNAME:TARGET%は何も言わずに、こちらを見下ろしている……	PRINTFORMW %CALLNAME:TARGET%什么都没有说，只是平平静静地从上面看过来。
PRINTFORMW その目の奥には何かが流れているように感じる。	PRINTFORMW 总觉得眼神深处有什么东西在流动。
PRINTFORMW 「少し変わったご命令ですが……%CALLNAME:TARGET%、不快ではありませんよ。」	PRINTFORMW 「真是奇怪的要求呢……不过%CALLNAME:TARGET%并不讨厌就是了。」
PRINTFORMW 「%CNAME("二人称")%……流石にこれは、おかしいです……」	PRINTFORMW 「%CALLNAME:MASTER%……真的奇怪呐……」
PRINTFORMW 「そのようなことをされて…平気なのですか？」	PRINTFORMW 「这样的事也愿意去做吗」
CALL PRINT_STR, @"「あっ_H_あぁっ…_H_でも…そこ、良いです…もっと…」_W"	CALL PRINT_STR, @"「嘶哈～嘶哈～，请，请再舔一下那里」_W"
PRINTFORMW 「そんなことをなさらなくてもいいのに…まあ、%CNAME("二人称")%が望むのであれば構いませんが……」	PRINTFORMW 「这不是需要%CALLNAME:MASTER%做的事。不过如果您開心的话……」
PRINTFORMW %CALLNAME:TARGET%は、相変わらず無言のままこちらを見下ろしている。	PRINTFORMW 还是一如既往的沉默，%CALLNAME:TARGET%从上面看了下来。
PRINTFORMW ふと目が合うと、%CALLNAME:TARGET%は恥丘と下腹部を更にこちらへ密着させて、%CALLNAME:MASTER%の視界を遮った…	PRINTFORMW 眼神短暂的接触后，%CALLNAME:TARGET%更用力地压下去了耻丘，下降下来的小腹把%CALLNAME:MASTER%的视野遮住了。
CALL PRINT_STR, @"「ふぁぁ……んぁぁ、あぁ～……_BH_」_W"	CALL PRINT_STR, @"「啊～……啊哈～_BH_」_W"
PRINTFORMW 顔の上に座っている%CALLNAME:TARGET%は天を仰ぎ、快感を求めて貪欲に腰をくねらせている。	PRINTFORMW 跨坐在上面的%CALLNAME:TARGET%仰着头，因为贪图着快感不断地扭动着腰。
PRINTFORMW 「%CNAME("二人称")%、ここから降りてほしい時には、すぐにお言いつけくださいね…」	PRINTFORMW 「如果%CALLNAME:MASTER%感到厌烦的话，一定要说出来呦～您最听话的女仆%CALLNAME:TARGET%，一定会遵照您的命令的～」
PRINTFORMW 「%CALLNAME:TARGET%は従順なメイドですから、すぐに%CNAME("二人称")%の命令に従いますよ…」	PRINTFORMW 一边说着话，%CALLNAME:TARGET%却一边用丰厚的蜜汁四溢的耻丘把%CALLNAME:MASTER%的嘴压住了。
PRINTFORMW そう言いながらも%CALLNAME:TARGET%は、淫靡な蜜で満たされた恥丘を押し付けて%CALLNAME:MASTER%の口を塞いでしまった。	CALL PRINT_STR, @"「_H_啊哈～_H_嘶哈～」_W"
CALL PRINT_STR, @"「_H_あぁぁっ_H_あぁぁんっ」_W"	CALL PRINT_STR, @"「最喜欢您了……_BH_」_W"
CALL PRINT_STR, @"「ふふふ…よっぽど、お気に召したようですね……_BH_」_W"
PRINTFORMW 「ほらほら、もっと頑張らないと…この程度では女の子は満足しませんよ…」	PRINTFORMW 「您可得再努力一下了呢，这样的话女孩子不会舒服的呦～」
PRINTFORMW %CALLNAME:TARGET%は笑顔を浮かべながらこちらを見下ろしている。	PRINTFORMW %CALLNAME:TARGET%从上方看了下来，笑容已经很明显了。
CALL PRINT_STR, @"「ああ、%CNAME("二人称")%…その不服そうなお顔も、とっても可愛いですよ…_H_」_W"	CALL PRINT_STR, @"「%CALLNAME:MASTER%这不服气的眼神，真可爱呢_H_」_W"
PRINTFORMW %CALLNAME:TARGET%の恥丘が更に押し付けられ、止めどなく溢れ出る蜜が、%CALLNAME:MASTER%の口に流れ込んできた…	PRINTFORMW %CALLNAME:TARGET%的耻丘压得更紧了，不断露出的透明蜜汁灌进了%CALLNAME:MASTER%的嘴里。
CALL PRINT_STR, @"「どうぞ、頑張ってくださいね…_H_」_W"	CALL PRINT_STR, @"「再加把劲吧_H_」_W"
PRINTFORMW 頬を染めた%CALLNAME:TARGET%はこちらを見下ろしながら笑っている。	PRINTFORMW 红着脸的%CALLNAME:TARGET%从上面看了下来，脸上带着明显可见的笑容。
PRINTFORMW それと同時に、快楽を求めて、腰をくねくねと動かしながら擦り付けてくる……	PRINTFORMW 同时，轻轻地晃动着腰摩擦着寻求快乐
PRINTFORMW %CALLNAME:TARGET%は、黙ってこちらを見下ろしている。	PRINTFORMW %CALLNAME:TARGET%仍旧沉默着，只是平平静静地从上面看过来。
PRINTFORMW その目の奥には何かが流れているように感じる。	PRINTFORMW 总觉得眼神深处有什么东西在流动。
PRINTFORMW 「本当に、変わったご命令です……」	PRINTFORMW 「真是奇怪的要求呢……」
CALL PRINT_STR, @"「で、でも…悪い気分では、ありませんね……_BH_」_W"	CALL PRINT_STR, @"「不过也不坏～_BH_」_W"
PRINTFORMW 「ご希望であれば…」	PRINTFORMW 「如果您希望的话」
PRINTFORMW 「%CNAME("一人称")%が？自分の手で、ですか？」	PRINTFORMW 「想看%CNAME("一人称")%自己动手吗？」
PRINTFORMW 「承知致しました」	PRINTFORMW 「遵命」
PRINTFORMW 「承知致しました……」	PRINTFORMW 「遵命……」
PRINTFORMW %CALLNAME:TARGET%は%CALLNAME:MASTER%と見つめあうと、自らの敏感な場所を愛撫し始めた…	PRINTFORMW %CALLNAME:TARGET%和%CALLNAME:MASTER%对视着，開始爱抚起了自己敏感的地方。
PRINTFORMW 「%CNAME("二人称")%……また、斯様にして%CALLNAME:TARGET%をいじめるのですね」	PRINTFORMW 「%CALLNAME:MASTER%……总是这么欺负%CALLNAME:TARGET%呢」
PRINTFORMW 「%CNAME("二人称")%の方が%CALLNAME:TARGET%を悦ばせる事には長けていますのに…%CNAME("一人称")%自身にさせるなんて」	PRINTFORMW 「明明%CALLNAME:MASTER%可以让%CALLNAME:TARGET%变得更加的舒服，却让别人自己来」
CALL PRINT_STR, @"「ああ、%CALLNAME:TARGET%のココをいじめているのが%CNAME("二人称")%であればよかったのに…_BH_」_W"	CALL PRINT_STR, @"「如果是%CALLNAME:MASTER%在欺负着%CALLNAME:TARGET%的这里……_BH_」_W"
PRINTFORMW %CALLNAME:TARGET%の手の動きはより激しくなりつつある……	PRINTFORMW %CALLNAME:TARGET%手上的动作越来越激烈了……
PRINTFORMW 「仰せのままに……」	PRINTFORMW 「遵命……」
PRINTFORMW %CALLNAME:TARGET%は%CALLNAME:MASTER%と見つめあうと、自らの敏感な場所を愛撫し始めた…	PRINTFORMW %CALLNAME:TARGET%和%CALLNAME:MASTER%对视着，開始爱抚起了自己敏感的地方。
PRINTFORMW 「%CNAME("二人称")%、どうぞ心ゆくまでご覧になってください…」	PRINTFORMW 「请%CALLNAME:MASTER%好好地看着……」
PRINTFORMW %CALLNAME:TARGET%の顔は真っ赤に染まり切っている……	PRINTFORMW %CALLNAME:TARGET%的脸已经完全染上了一片绯红……
PRINTFORMW 「%CNAME("二人称")%……何故、見ているだけなのですか……？」	PRINTFORMW 「%CALLNAME:MASTER%……为什么只是看着……」
PRINTFORMW 自らの敏感な場所を愛撫している%CALLNAME:TARGET%は、潤んだ瞳で%CALLNAME:MASTER%を見つめている。	PRINTFORMW 爱抚着自己敏感的地方的%CALLNAME:TARGET%用湿润的眼神看向%CALLNAME:MASTER%。
PRINTFORMW 「%CNAME("二人称")%は%CNAME("一人称")%のマスターベーションをご覧になるのが好きなのですね」	PRINTFORMW 「%CNAME("二人称")%是喜欢看着%CNAME("一人称")%自慰呢」
PRINTFORMW 「それともやっぱり……一緒に気持ち良くなりたいのですか？」	PRINTFORMW 「还是想要……一起舒服起来呢」
PRINTFORMW %CALLNAME:TARGET%は微笑みながらこちらを誘っている…	PRINTFORMW %CALLNAME:TARGET%微笑着发出了邀请
PRINTFORMW 「仰せのままに……」	PRINTFORMW 「遵命……」
PRINTFORMW %CALLNAME:TARGET%は軽く頭を下げると、自らの敏感な場所を愛撫し始めた。	PRINTFORMW %CALLNAME:TARGET%低下了头，開始爱抚起了自己敏感的地方。
PRINTFORMW 「んぁっ……やはり、ここが好きなのですね……」	PRINTFORMW 「呐……果然是喜欢这里呢……」
CALL PRINT_STR, @"「ひぁっ……いつも胸ばかりいじめないでください…」_W"	CALL PRINT_STR, @"「啊……请不要总是欺负胸部」_W"
PRINTFORMW 乳房を愛撫され、%CALLNAME:TARGET%は体を大きく震わせた。	PRINTFORMW 被爱抚了胸部%CALLNAME:TARGET%身体猛地颤抖了一下。
CALL PRINT_STR, @"「す、吸っちゃだめっ…そこ、敏感でぇぇっ…_HH_」_W"	CALL PRINT_STR, @"「也、也不要吸那里啊，很…很敏感的！_HH_」_W"
PRINTFORMW 「意地悪です……そんなに、気持ちいい所ばかり……」	PRINTFORMW 「坏心眼呢……总是欺负敏感的地方……」
PRINTFORMW %CALLNAME:TARGET%は必死に%CALLNAME:MASTER%を止めようとしているが、その抵抗は無駄に終わっている…	PRINTFORMW %CALLNAME:TARGET%努力地作出想要阻止%CALLNAME:MASTER%的样子，然而看起来完全没有用力的样子
CALL PRINT_STR, @"「%CNAME("二人称")%…これでは、まるで赤ちゃんですね……_HH_」_W"	CALL PRINT_STR, @"「%CALLNAME:MASTER%，像个小孩子一样……_HH_」_W"
CALL PRINT_STR, @"「ふぁ、あ……そのように、強く吸われてはっ……_HH_」_W"	CALL PRINT_STR, @"「啊~不要吸得那么用力……_HH_」_W"
CALL PRINT_STR, @"「ふふ、赤ちゃんはこんないやらしい事、してはいけないんですよ……_HH_」_W"	CALL PRINT_STR, @"「但是小孩子可没有这么淫荡的手法的吧……_HH_」_W"
PRINTFORMW 笑顔の%CALLNAME:TARGET%は大きくて柔らかな乳房を押し付けてきた…	PRINTFORMW 嬉笑着的%CALLNAME:TARGET%向前挺了挺丰满的胸脯
PRINTFORMW 「喜んでいただけるのであれば」	PRINTFORMW 「您喜欢的话就好了」
PRINTFORMW 「お好きなだけ楽しんでください」	PRINTFORMW 「请您随意地享受吧」
PRINTFORMW 黙ってキスを要求している。	PRINTFORMW 默默地索求着吻。
PRINTFORMW 「あ…？口付け、ですか…？」	PRINTFORMW 「啊？要接吻吗？」
PRINTFORMW 「どうぞ、お好きなように…」	PRINTFORMW 「随您喜欢吧。」
CALL PRINT_STR, @"「ちゅばっ、ちゅ、ちゅぶっ、んむぅぅぅっ～、ぷぁ………ふぅー、ふぅー…_HH_」_W"	CALL PRINT_STR, @"「吧、吧、吧、恩~嘛~……呼……呼呼……_HH_」_W"
PRINTFORMW 長いキスを終え、%CALLNAME:TARGET%は激しい息使いをしている。	PRINTFORMW 一个长长的吻之后，%CALLNAME:TARGET%剧烈的喘息着。
PRINTFORMW 呼吸のために開かれた口から、可愛らしい舌先が覗いており……	PRINTFORMW 小嘴因为喘息而暂时无法合上，露出了可爱的舌尖。因为刚才的深吻大量分泌的透明唾液从嘴角流了出来……
PRINTFORMW あまりに深いキスをしていたせいか、口の端は唾液でべっとりと濡れている……
CALL PRINT_STR, @"「も、もう一度だけ、お願いします……_HH_」_W"	CALL PRINT_STR, @"「再、再来一次……_HH_」_W"
CALL PRINT_STR, @"「んむ、んぅぅ……ちゅっ…_HH_」_W"	CALL PRINT_STR, @"「唔嗯、唔~啾……_HH_」_W"
PRINTFORMW %CALLNAME:TARGET%は、黙ったままこちらに顔を近づけ、優しくキスをしてきた。	PRINTFORMW %CALLNAME:TARGET%默默地贴近了嘴唇，献上了一个温柔的吻。
CALL PRINT_STR, @"「口付け……とても安心します」_W"	CALL PRINT_STR, @"「接吻……会很安心」_W"
CALL PRINT_STR, @"「%CNAME("一人称")%、幸せです…ずっとキス、してください…_HH_」_W"	CALL PRINT_STR, @"「继续做快乐的事情吧~_HH_」_W"
PRINTFORMW 「緊張なさらなくても結構ですよ…」	PRINTFORMW 「您可以尽量的放轻松享受呦。」
PRINTFORMW %CALLNAME:TARGET%はその柔らかな唇を重ねてきた…	PRINTFORMW %CALLNAME:TARGET%柔软的嘴唇凑了过来
CALL PRINT_STR, @"「そ、その…キス、したいです……_HH_」_W"	CALL PRINT_STR, @"「想、想要亲亲……_HH_」_W"
PRINTFORMW %CALLNAME:TARGET%は目を細め、こちらを迎え入れるべく舌を突き出している……	PRINTFORMW %CALLNAME:TARGET%眯着眼主动地伸出了舌头迎接着……
CALL PRINT_STR, @"「んむぅ、ちゅぅっ_H_……んぅぅ～、ちゅっ_H_……じゅる……じゅぷっ……_HH_」_W"	CALL PRINT_STR, @"「姆啊~姆啾……姆啊~姆啾……滋……滋……_HH_」_W"
CALL PRINT_STR, @"「はぁ……はぁ……はぁー……だ、駄目です…_HH_」_W"	CALL PRINT_STR, @"「啊哈……啊哈……啊哈……不、不行啊_HH_」_W"
PRINTFORMW 「今までは、キスをすると心が落ち着くはずだったのに…」	CALL PRINT_STR, @"「明明之前接吻都会很安心，怎么现在越是接吻身体里就越是燥热……_HH_」_W"
CALL PRINT_STR, @"「でも今は違うんです…どんどん、体の中が熱くなってくるのです……_HH_」_W"
CALL PRINT_STR, @"「いいですよ……_HH_」_W"	CALL PRINT_STR, @"「可以呦……_HH_」_W"
PRINTFORMW %CALLNAME:TARGET%はこちらを迎え入れるべく舌を突き出している……	PRINTFORMW %CALLNAME:TARGET%主动地伸出了舌头迎接着……
CALL PRINT_STR, @"「んぅ…ちゅっ……ぷぁ……_HH_」_W"	CALL PRINT_STR, @"「姆啊~姆啾……哈……_HH_」_W"
CALL PRINT_STR, @"「とても、心が落ち着きます……」_W"	CALL PRINT_STR, @"「非常的安心呢……」_W"
PRINTFORMW %CALLNAME:TARGET%の唇をこじ開けて、無理やり舌を差し込んだ……	PRINTFORMW 粗暴的撬開%CALLNAME:TARGET%的唇，把舌头伸了进去……
PRINTFORMW %CALLNAME:TARGET%は乱暴なキスにも精一杯応えている。	PRINTFORMW %CALLNAME:TARGET%努力的迎合着。
PRINTFORMW 「お好きなようにどうぞ。」	PRINTFORMW 「如果您喜欢的话。」
PRINTFORMW 「しかし%CNAME("一人称")%は只のメイド、このようなことには慣れていません……。」	PRINTFORMW 「不过作为女仆%CNAME("二人称")%可能不太擅长这个……。」
PRINTFORMW 「そこです…もう少し優しくお願いしますね」	PRINTFORMW 「那里呢……请稍微温柔一点。」
CALL PRINT_STR, @"「申し訳ありません、すべて、受け止めきれなくて……」_W"	CALL PRINT_STR, @"「对不起，没有好好地全部接住……」_W"
PRINTFORMW %CALLNAME:TARGET%は、アソコから溢れた精液をふき取る%CALLNAME:MASTER%を済まなそうに見つめている	PRINTFORMW %CALLNAME:TARGET%看着%CALLNAME:MASTER%擦拭着股间溢出的白浊，眼神中全是惋惜的神色
CALL PRINT_STR, @"「大事な精液、このように拭い去ってしまうなんて、本当に勿体ない……」_W"	CALL PRINT_STR, @"「重要的汁液，就这么擦掉了，真的好浪费啊……」_W"
PRINTFORMW %CALLNAME:TARGET%は未だにブツブツと呟いている…	PRINTFORMW 仍然在碎碎念呢
PRINTFORMW 「あ……%CNAME("二人称")%は気になさらなくても…」	PRINTFORMW 「啊……其实不用劳烦%CALLNAME:MASTER%的」
PRINTFORMW 「本来であれば、このような事はメイドの責務でありますのに…」	PRINTFORMW 「清洁的工作本应是女仆的责任的」
PRINTFORMW 「%CNAME("二人称")%のご厚情に、心から感謝いたします」	PRINTFORMW 「非常感谢%CNAME("二人称")%的温柔呢」
CALL PRINT_STR, @"「あっ……そこ、優しく……」_W"	CALL PRINT_STR, @"「啊……那里，请轻一点……」_W"
PRINTFORMW 大事な場所に触れられた%CALLNAME:TARGET%は、ビクリと体をのけ反らせた…	PRINTFORMW 被捉住了関键部位的%CALLNAME:TARGET%身体突然弓了起来
CALL PRINT_STR, @"「お願いですっ、ゆっくり…刺激がっ、強すぎてっ_HH_」_W"	CALL PRINT_STR, @"「请……请轻一点，刺激度太强了！_HH_」_W"
PRINTFORMW %CALLNAME:TARGET%は%CALLNAME:MASTER%の手を掴むが、断続的に襲い来る快感に、抵抗する力も出ないようだ…	PRINTFORMW %CALLNAME:TARGET%捉住了的%CALLNAME:MASTER%手，却因为一阵阵的快感的冲击使不出力气来反抗
CALL PRINT_STR, @"「あぁ……ひぁぁぁ…ずっと、このようにされては、すぐに達してしまいます…_HH_」_W"	CALL PRINT_STR, @"「啊哈……啊哈……，一直这样的话，很容易就会去的…_HH_」_W"
CALL PRINT_STR, @"「また、そこをいじめるのですね……」_W"	CALL PRINT_STR, @"「又要欺负那里了吗……」_W"
CALL PRINT_STR, @"「あぁぁ～……どうか、優しくっ…」_W"	CALL PRINT_STR, @"「啊~请轻一点」_W"
PRINTFORMW 秘所を刺激され、%CALLNAME:TARGET%は無意識に両脚をギュッと閉じた…	PRINTFORMW 被刺激着的%CALLNAME:TARGET%下意识地夹紧了大腿
PRINTFORMW 「%CNAME("一人称")%などを悦ばせる必要はありませんのに」	PRINTFORMW 「其实您不必这样取悦%CNAME("一人称")%的」
PRINTFORMW 「本来それをするべきは、主人に仕えるメイドのはずですが…まあ、望まれるのであれば」	PRINTFORMW 「应该是女仆服侍主人才对啊，不过，既然您喜欢这样的话…」
PRINTFORMW 「あまり乱暴にならないようお願いします」	PRINTFORMW 「那就请您不要太过粗暴呢」
PRINTFORMW 「あ……それ以上押し込む必要があるのですか？」	PRINTFORMW 「啊……还要再往里推吗？」
PRINTFORMW 「指で、ですか？やさしくお願いしますね、%CNAME("二人称")%」	PRINTFORMW 「用手指吗？请%CNAME("二人称")%温柔一点」
PRINTFORMW 「んあぁっ……」	PRINTFORMW 「嗯哈~」
PRINTFORMW %CALLNAME:TARGET%喘ぎ声を漏らすと、背中を弓なりに反らせた	PRINTFORMW 一声轻微的喘息，%CALLNAME:TARGET%的身子弓了起来
PRINTFORMW 「指で、ですか？やさしくお願いしますね、%CNAME("二人称")%」	PRINTFORMW 「用手指吗？请%CNAME("二人称")%温柔一点」
PRINTFORMW 「指で、ですか？やさしくお願いしますね、%CNAME("二人称")%」	PRINTFORMW 「用手指吗？请%CNAME("二人称")%温柔一点」
PRINTFORMW 「もう、奥まで来てますっ……これ以上中には入りません、%CNAME("二人称")%…！」	PRINTFORMW 「已经很深了……不要再向里面推了%CNAME("二人称")%」
PRINTFORMW %CALLNAME:TARGET%太ももを閉じて抵抗するが、断続的に襲ってくる快感により、力が入らないようだ…	PRINTFORMW %CALLNAME:TARGET%夹住了大腿试图阻止，但是一阵阵的快感让她难以使出力气
PRINTFORMW 「んあぁっ……」	PRINTFORMW 「嗯啊~」
PRINTFORMW %CALLNAME:TARGET%は微かな喘ぎ声を漏らした…	PRINTFORMW %CALLNAME:TARGET%发出了一声轻微的喘息
PRINTFORMW 「お止め、ください……激し、すぎますっ……！」	PRINTFORMW 「请不要……太过激烈……」
PRINTFORMW 「ふぁぁ…%CNAME("二人称")%、指で、そのような所を弄られては…んぃぃっ！」	PRINTFORMW 「啊哈~%CNAME("二人称")%，请不要用手指挑逗…咿！」
PRINTFORMW %CALLNAME:MASTER%は指を二本に増やすと、更に奥深くにまで侵入させた…	PRINTFORMW %CALLNAME:MASTER%又加入了一根手指向更深处挖掘着
PRINTFORMW %CALLNAME:TARGET%は潤んだ瞳でこちらを見ている…	PRINTFORMW %CALLNAME:TARGET%用湿润的眼神看了过来
PRINTFORMW 「ん……」	PRINTFORMW 「嗯……」
PRINTFORMW メイドは微かな声を抑えながら、黙って受け入れている	PRINTFORMW 把轻微的声音憋了回去，女仆默默地承受着
PRINTFORMW 「ん……いいですよ」	PRINTFORMW 「嗯……好的」
PRINTFORMW %CALLNAME:TARGET%は命令に従い、Ｍ字開脚の姿勢で座ると、%CALLNAME:MASTER%に濡れそぼった秘所を見せつけてきた……	PRINTFORMW %CALLNAME:TARGET%服从了命令，用M字的坐姿打開了双腿，%CALLNAME:MASTER%面向展示着湿润的蜜所……
PRINTFORMW 「%CNAME("一人称")%は、本当に悪魔なのですよ？%CNAME("二人称")%が覚えているかは存じ上げませんが」	PRINTFORMW 「%CNAME("一人称")% 其实是恶魔呢，不知道%CNAME("二人称")%还是否记得」
PRINTFORMW 両足を開いて座り、人差し指を咥える。空いた手を秘所に伸ばし、二本指で膣口を広げて見せつけてきた……	PRINTFORMW 坐在那里分開了双腿，轻咬着一只手的食指，用另一只手的两只手指打開并展示着蜜穴
PRINTFORMW 「悪魔ですから、当然悪魔の力も行使できます」	PRINTFORMW 「所谓恶魔呢，那自然是有恶魔的本领」
PRINTFORMW 押し広げられた秘所から、一条の透明な粘液が流れ出てくる。	PRINTFORMW 被打開的蜜穴流出了一道清澈的黏液，不知道是不是%CALLNAME:MASTER%的错觉，总觉得里面的软肉在蠕动呢……
PRINTFORMW %CALLNAME:MASTER%の見ている幻覚だろうか、柔らかな肉が穴の中でうごめいているような感覚を覚える……	PRINTFORMW CALL PRINT_STR, @"「不想来亲自尝试一下吗~_HH_」_W"
CALL PRINT_STR, @"「試してみたいとは、思いませんか……_HH_」_W"
PRINTFORMW 「%CNAME("二人称")%、見るだけでよろしいのですか？」	PRINTFORMW 「%CNAME("二人称")%就那么想看吗？」
PRINTFORMW %CALLNAME:TARGET%は両足を開いて座り、人差し指を咥える。	PRINTFORMW %CALLNAME:TARGET%坐在那里分開了双腿，轻咬着一只手的食指，用另一只手的两只手指打開并展示着蜜穴
PRINTFORMW さらに、空いた手を秘所に伸ばし、二本指で膣口を広げて見せつけてきた……	PRINTFORMW CALL PRINT_STR, @"「接下来想做什么呢？~_HH_」_W"
CALL PRINT_STR, @"「次は、何を致しますか…_HH_」_W"
PRINTFORMW 「ん……いいですよ」	PRINTFORMW 「嗯……好的」
PRINTFORMW %CALLNAME:TARGET%は命令に従い、Ｍ字開脚の姿勢で座ると、%CALLNAME:MASTER%に秘所を見せつけてきた……	PRINTFORMW %CALLNAME:TARGET%服从了命令，用M字的坐姿打開了双腿，%CALLNAME:MASTER%面向展示着……
PRINTFORMW 「%CNAME("二人称")%のペニス……とてもご立派です……」	PRINTFORMW 「%CALLNAME:MASTER%的阴茎……真是雄伟呢……」
CALL PRINT_STR, @"「あはぁぁ……%CNAME("二人称")%のペニス……とても、ご立派ですっ……_BH_」_W"	CALL PRINT_STR, @"「啊……%CALLNAME:MASTER%的阴茎……真是雄伟呢……_BH_」_W"
PRINTFORMW %CALLNAME:TARGET%の顔は真っ赤に染まっている。	PRINTFORMW %CALLNAME:TARGET%的脸上泛着潮红。
PRINTFORMW 「%CNAME("二人称")%のペニス……挿入ってます……」	 PRINTFORMW 「%CALLNAME:MASTER%的阴茎……已经插进来了……」
PRINTFORMW %CALLNAME:TARGET%の顔は真っ赤に染まっている。	PRINTFORMW PRINTFORMW %CALLNAME:TARGET%的脸上泛着潮红。
CALL PRINT_STR, @"「はぁっ…はぁぁぁっ…_H_んぅぅ……あっ…_H_」_W"	CALL PRINT_STR, @"「嘶哈～嘶哈～～_H_嗯……啊_H_」_W"
CALL PRINT_STR, @"「やっと……全部、入りましたね…お腹の中、もういっぱいです……_BH_」_W"	CALL PRINT_STR, @"「终……终于完全进来了，里面撑得满满的……_BH_」_W"
PRINTFORMW %CALLNAME:TARGET%は切なそうな表情をしながら、自らの豊満な乳房を片手で持ち上げた。	PRINTFORMW %CALLNAME:TARGET%的眉毛紧蹙着，一只手撑扶着一只手则搭在自己丰满的乳房上。
CALL PRINT_STR, @"「%CNAME("二人称")%…%CALLNAME:TARGET%がご奉仕致しますから、心ゆくまで楽しんでくださいね……」_W"	CALL PRINT_STR, @"「%CALLNAME:MASTER%请尽情享受%CALLNAME:TARGET%的服侍吧～」_W"
CALL PRINT_STR, @"「この体勢だと…%CALLNAME:TARGET%は、すごく…その、感じてしまいます……_BH_」_W"	CALL PRINT_STR, @"「这个体位，%CALLNAME:TARGET%真的很容易有感觉……_BH_」_W"
PRINTFORMW %CALLNAME:TARGET%は%CALLNAME:MASTER%の体に手を置き、切なそうな表情でゆっくりと腰を振っている	PRINTFORMW 手撑在的%CALLNAME:MASTER%的身上，%CALLNAME:TARGET%皱着眉头慢慢地摇晃着腰
CALL PRINT_STR, @"「この体勢だと…いつでも%CNAME("二人称")%と口付けができますね……_BH_」_W"	CALL PRINT_STR, @"「这个体位，可以和%CALLNAME:MASTER%一边做一边亲吻呢……_BH_」_W"
PRINTFORMW そう言うと、%CALLNAME:TARGET%は%CALLNAME:MASTER%の頭を抱きしめてキスをしてきた。	PRINTFORMW 说罢了%CALLNAME:TARGET%就抱着%CALLNAME:MASTER%的头吻了过来。
CALL PRINT_STR, @"「くちゅ…ちゅぅ……くちゅっ…………_H_んぁ……_H_」_W"	CALL PRINT_STR, @"「库啾～～库啾～～～～库啾…………嗯哈……」_W"
PRINTFORMW その後、%CALLNAME:MASTER%が窒息死する寸前になって、ようやくキスが終わった……	PRINTFORMW 就%CALLNAME:MASTER%在怀疑自己要被憋死的时候，这个漫长的吻终于结束了……
PRINTFORMW %CALLNAME:TARGET%の目は蕩け切っている……離れた唇の間には透明な糸が引いていた……	PRINTFORMW %CALLNAME:TARGET%的眼神已经完全的迷离了……两个人的唇间牵起了透明的丝线……
PRINTFORMW 「後ろからですか……%CNAME("一人称")%を征服して気持ちよくなりたいのですか、%CNAME("二人称")%？」	PRINTFORMW 「想要从后边来了……这种体位，可以让%CALLNAME:MASTER%很有征服的快乐吧。」
PRINTFORMW %CALLNAME:TARGET%は四つん這いになると、丸くてむっちりとしたお尻を%CALLNAME:MASTER%の方へ突き出した。	PRINTFORMW %CALLNAME:TARGET%趴了下来，把浑圆的肉感臀部撅起来朝向了%CALLNAME:MASTER%这边。
CALL PRINT_STR, @"「おまんこを開いたり閉じたりして『おかえりなさいませ_BH_ご主人様～_BH_』…と言わせてみましょうか？」_W"	CALL PRINT_STR, @"「是不是还要一边摇晃着，一边扒開自己的蜜穴说“欢迎回家～_BH_%CALLNAME:MASTER%主人～_BH_”……」_W"
PRINTFORMW とはいえ実際に行動には移さず、振り向いてこちらを見つめている…	PRINTFORMW 说完话的却没有什么实际行动，只是扭过头来平静的看着。
PRINTFORMW 誘うような言葉に耐えきれなくなる。柔らかい尻を掴むと、硬く張りつめた肉棒を突き立てた。	PRINTFORMW 受不了的言语刺激，捉住了那丰满的臀部，将自己硬的发疼的肉棒刺了进去。
CALL PRINT_STR, @"「ふぁぁぁっ…_H_深いぃぃ_H_ご主人様…おかえり、なさいませぇっ…_H_……」_W"	CALL PRINT_STR, @"「嗯哈～_H_这么深……%CALLNAME:MASTER%主人～，欢·迎·回·家_H_”……」_W"
CALL PRINT_STR, @"「ふふ、%CALLNAME:TARGET%の中は、いかがですか……_BH_」_W"	CALL PRINT_STR, @"「%CALLNAME:TARGET%的里边，感觉怎么样呢～_BH_」_W"
PRINTFORMW 「ああ…本当に、本当に、入っていますぅ…」	PRINTFORMW 「确确实实的插进来了～」
PRINTFORMW %CALLNAME:TARGET%の声は微かに震えている。	PRINTFORMW %CALLNAME:TARGET%的声音稍微有些颤抖。
PRINTFORMW 「本当に入っています。」	PRINTFORMW 「确确实实的插进来了。」
PRINTFORMW %CALLNAME:TARGET%は報告書を読み上げるような調子でそう言った。	PRINTFORMW %CALLNAME:TARGET%用像汇报一样的语气说道。
CALL PRINT_STR, @"「この体位で交わっていると、%CALLNAME:TARGET%、とても感じてしまいます……_BH_」_W"	CALL PRINT_STR, @"「用这个体位做，%CALLNAME:TARGET%很容易有感觉呢……_BH_」_W"
PRINTFORMW 「ですから%CNAME("二人称")%…優しく、お願いしますね……」	PRINTFORMW 「所以%CALLNAME:MASTER%一定要温柔一点啊……」
PRINTFORMW 「それとも、%CNAME("二人称")%は%CALLNAME:TARGET%が達してしまう所をご覧になりたいのですか…？」	PRINTFORMW 「还是说，%CALLNAME:MASTER%是想看到%CALLNAME:TARGET%高潮的样子吗？」
CALL PRINT_STR, @" 「意地悪です……%CNAME("二人称")%_BH_」_W"	CALL PRINT_STR, @" 「坏心眼呢……%CALLNAME:MASTER%_BH_」_W"
CALL PRINT_STR, @" 「この体位で交わっていると、%CALLNAME:TARGET%、とても感じてしまいます……_BH_」_W"	CALL PRINT_STR, @" 「用这个体位做，%CALLNAME:TARGET%很容易有感觉呢……_BH_」_W"
PRINTFORMW 「ですから%CNAME("二人称")%…優しく、お願いしますね……」	PRINTFORMW 「所以%CALLNAME:MASTER%一定要温柔一点啊……」
PRINTFORMW 「それとも、%CNAME("二人称")%は…%CALLNAME:TARGET%が許しを請うまで弱点を責め立てるつもり…ですか？」	PRINTFORMW 「还是说，%CALLNAME:MASTER%是想狠狠的攻击%CALLNAME:TARGET%的弱点直到%CALLNAME:TARGET%求饶吗？」
PRINTFORMW 「%CNAME("二人称")%は、困ったお方です…でも、%CALLNAME:TARGET%は正真正銘の悪魔ですから、簡単にはいきませんよ…」	PRINTFORMW 「愚蠢的呦%CALLNAME:MASTER%～%CALLNAME:TARGET%可是货真价实的恶魔啊～」
PRINTFORMW 膣内の柔らかい肉壁が持ち主の意思に従い、きゅうきゅうと締め付けてくる…	PRINTFORMW 小穴里的软肉像响应主人的意识一般紧紧地缠了上来。
PRINTFORMW 「この姿勢……とても良いです。」	PRINTFORMW 「这个体位……很不错呢。」
PRINTFORMW %CALLNAME:TARGET%は%CALLNAME:MASTER%の抽送を精一杯受け止めている	PRINTFORMW %CALLNAME:TARGET%努力地迎合着%CALLNAME:MASTER%的冲击
PRINTFORMW それどころか、主導権を奪い取ろうとさえしている…	PRINTFORMW 或者说，试图在掌握主动权呢
CALL PRINT_STR, @"「あぁぁ～…_HH_も……もっと優しくっ、激しすぎますぅっ…」_W"	CALL PRINT_STR, @"「嗯哈～_HH_轻……轻一点，太激烈了」_W"
PRINTFORMW %CALLNAME:MASTER%に突かれている%CALLNAME:TARGET%の豊かな乳房は揺れて弾み、美しい形を見せている…	PRINTFORMW 被%CALLNAME:MASTER%重重地顶了一下，%CALLNAME:TARGET%丰满的肉球跳跃地展示着诱人的形状
CALL PRINT_STR, @"「優しくしてっ…このように激しいと、すぐに達してしまいます…ひぁぁっ…やめ、てぇ……」_W"	CALL PRINT_STR, @"「稍微轻些…这样的话太刺激了…很容易就去了，嘶哈~别再……」_W"
CALL PRINT_STR, @"「困りますっ…んんっ…まだ、逝きたくは、ないのです…」_W"	CALL PRINT_STR, @"「不想…嗯…不想这么快就去啊」_W"
PRINTFORMW しかし、%CALLNAME:TARGET%の要求を無視した%CALLNAME:MASTER%は、逆に責めの手をさらに強めた…	PRINTFORMW 然而并没有理会%CALLNAME:TARGET%的哀求，%CALLNAME:MASTER%反而加大了责备的力度…
CALL PRINT_STR, @"「ひぅぅ～っ…_HH_また、このように%CNAME("一人称")%をいじめて…いけない人です…」_W"	CALL PRINT_STR, @"「嘶～_HH_又在欺负%CNAME("一人称")%了，坏家伙~」_W"
CALL PRINT_STR, @"「素敵です……_BH_」_W"	CALL PRINT_STR, @"「很擅长嘛……_BH_」_W"
CALL PRINT_STR, @"「%CNAME("二人称")%の%CNAME("ペニス")%は本当に、気持ち良いです_H_」_W"	CALL PRINT_STR, @"「%CNAME("二人称")%的%CNAME("阴茎")%真的很不错呦_H_」_W"
CALL PRINT_STR, @"「んぁぁっ…_H_あぁ～～～～…_HH_」_W"	CALL PRINT_STR, @"「嗯哈～～～～啊_HH_」_W"
PRINTFORMW 「このような声は…お好きですか？……興奮していただけると嬉しいのですが…♪」	PRINTFORMW 「我发出这样的声音，是不是就会更有干劲了呢……♪」
PRINTFORMW 「やぁっ…ご主人様の大きなペニス、とっても素敵ですっ…%CALLNAME:TARGET%の魂を捧げたいくらいです……♪」	PRINTFORMW 「不行吗……亲老公的大鸡巴，肏的%CALLNAME:TARGET%好爽啊，要把%CALLNAME:TARGET%的魂儿给肏飞了啊……♪」
PRINTFORMW 「んっ、駄目です……おまんこ犯されすぎて壊れちゃいます……♪」	PRINTFORMW 「受不了了啊，小穴要被肏到坏掉了啊……♪」
CALL PRINT_STR, @"「あらあらぁ…もう、動き方が乱暴ですよ……_BH_」_W"	CALL PRINT_STR, @"「啊啦啊啦～动作粗暴起来了呢……_BH_」_W"
PRINTFORMW 「%CNAME("二人称")%ったら、夜に乱れる女性の方が好きなのですか…？」	PRINTFORMW 「%CNAME("二人称")%是喜欢这种在床上很粗俗的女孩子吗」
PRINTFORMW 「お疲れですか？主人に仕えるのはメイドの務め…しばらく休憩なさってください」	PRINTFORMW 「累了吗？服侍主人是女仆的职责，偶尔休息一下也可以的呦」
PRINTFORMW 「どうぞ、無理をなさらないよう…」	PRINTFORMW 「不用太勉强的」
PRINTFORMW %CALLNAME:TARGET%は自ら腰を動かし始めた……	PRINTFORMW %CALLNAME:TARGET%開始自己摇动起了腰……
PRINTFORMW 「私のことはお気になさらず…もっと激しくてもかまいません」	PRINTFORMW 「不用在意我的，再用力一些也没関系的」
PRINTFORMW 「%CALLNAME:TARGET%は悪魔のメイドですから、これでも人間の%CNAME("二人称")%よりは強いのですよ」	PRINTFORMW 「%CALLNAME:TARGET%可是恶魔女仆啊，身体是比人类要结实一些的」
PRINTFORMW %CALLNAME:TARGET%少し汗ばんだ顔で、励む%CALLNAME:MASTER%を見つめている	PRINTFORMW %CALLNAME:TARGET%只是面部有些微汗，从容地看向卖力的%CALLNAME:MASTER%
CALL PRINT_STR, @"「あらあら…怒ってしまわれましたか？難しいですね……_BH_」_W"	CALL PRINT_STR, @"「啊啦啊啦～是不是生气了呢？这么用力……_BH_」_W"
PRINTFORMW 相変わらず落ち着いているが、その顔には微かな笑みが浮かんでいる。	PRINTFORMW 还是很从容的样子，只不过脸上似乎有了淡淡的微笑
PRINTFORMW しかし、数回しか突かれていないにも関わらず、%CALLNAME:TARGET%の顔には玉の汗が浮かび、体は熱を持ち始めている…	PRINTFORMW 然而其实只是被用力地插了几下，大颗的汗珠開始出现在%CALLNAME:TARGET%的脸上，身体也似乎越来越热了
PRINTFORMW 「呼吸が荒くなっていますね……%CNAME("二人称")%」	PRINTFORMW 「呼吸变重了呢……%CALLNAME:MASTER%」
PRINTFORMW 「しかし…まだまだ頑張り続けていただきます…」	PRINTFORMW 「无论如何还是请继续加油吧」
PRINTFORMW 「頑張れば、もっと気持ちよくなれますからね…」	PRINTFORMW 「再努力一点点会变得更舒服呦」
PRINTFORMW 「『性感帯はどこ？』ですか……？それは、ご命令ですか……？」	PRINTFORMW 「哪里是敏感带……是命令吗……」
PRINTFORMW 「ええと…側面部の壁……そう、その辺りです、%CNAME("二人称")%」	PRINTFORMW 「侧腹的壁……就是那里呢%CALLNAME:MASTER%」
PRINTFORMW 「『どうされるのが好き？』ですか…？仕方ないですね……」	PRINTFORMW 「方式吗……真是拿%CNAME("二人称")%没办法呢，%CNAME("一人称")%喜欢先慢慢地戳着，然后再顶住慢慢的磨……就是那样哦%CALLNAME:MASTER%」
PRINTFORMW 「まず、ゆっくり突いていただいて…その後、少しペースを上げて中を擦られる…このような所ですね、%CNAME("二人称")%」	PRINTFORMW 「怎么没什么反应……%CNAME("二人称")%还真是急性子呢……」
PRINTFORMW 「……『反応がない』ですか……？%CNAME("二人称")%、焦ってはいけませんよ」	PRINTFORMW 「已经開始感觉了呢……真的呦～」
PRINTFORMW 「%CNAME("一人称")%は、すでに感じて来ています…本当ですよ？」	PRINTFORMW 女仆似乎带着一点点戏谑的笑容看着逐渐焦急的%CALLNAME:MASTER%
PRINTFORMW メイドは、からかうように微笑みながら、不安そうな%CALLNAME:MASTER%を見つめている
PRINTFORMW そんな中でも、%CALLNAME:TARGET%は何かに耐えるように、手を固く握りしめている…	PRINTFORMW 然而，看起来%CALLNAME:TARGET%的手指在努力地扣紧呢
PRINTFORMW 「ベッドでの%CALLNAME:TARGET%は冷たい、と…そう思われますか？」	PRINTFORMW 「觉得%CALLNAME:TARGET%在床事上有些冷淡吗？」
PRINTFORMW 「それは%CNAME("二人称")%の錯覚です、%CALLNAME:TARGET%、ご命令には可能な限り従っています。」	PRINTFORMW 「是%CALLNAME:MASTER%的错觉吧，%CALLNAME:MASTER%的命令%CALLNAME:TARGET%可是都照做了呢」
PRINTFORMW 「そのような事を考えるより…%CALLNAME:TARGET%の中で一滴残らず射精したくはないのですか？」	PRINTFORMW 「比起这种事……难道不会更想在%CALLNAME:TARGET%的里面被一滴不剩的榨出来吗？」
PRINTFORMW 「それとも、もう%CALLNAME:TARGET%の身体には飽きてしまわれたと？だとしたら悲しいです…」	PRINTFORMW 「还是说，已经厌倦了%CALLNAME:TARGET%的身体呢？真让人伤心呐」
PRINTFORMW …両手で目を覆って嘘泣きをするが、その両足は大きく開かれ、秘所が露わになっている	PRINTFORMW 用手遮住眼睛做状假哭，双腿却打開露出了之中的桃源
PRINTFORMW しかし、%CALLNAME:MASTER%に突き入れられると、%CALLNAME:TARGET%の口から甘い声が漏れる…	PRINTFORMW 伴随着%CALLNAME:MASTER%的插入，%CALLNAME:TARGET%的嘴里漏出了甘甜的喘息…赶忙用另一只手把嘴也遮住了，又開始发出来呜呜呜的假哭声
PRINTFORMW 慌てて片手で口を覆うと、また嘘泣きを始めたようだ…
CALL PRINT_STR, @"「んぁ……_BH_」_W"	CALL PRINT_STR, @"「嗯哈～_BH_」_W"
PRINTFORMW %CALLNAME:TARGET%は明らかに快感を覚えているようだが、必死で声を抑えている。	PRINTFORMW %CALLNAME:TARGET%一副明显是感受到了快乐的样子，却努力地把声音憋了回去。
PRINTFORMW 眉をしかめて耐えている様子がとても可愛らしい。	PRINTFORMW 蹙眉忍耐的样子，也非常的可爱呢。
PRINTFORMW 「従います。」	PRINTFORMW 「遵命。」
CALL PRINT_STR, @"「ここです…ここが、%CALLNAME:TARGET%の一番大事な所ですよ…_H_」_W"	CALL PRINT_STR, @"「这里呀这里～是%CALLNAME:TARGET%最重要的地方呦_H_」_W"
PRINTFORMW %CALLNAME:TARGET%は両手でハートを作ると、腹部に刻まれた淫紋の上に置いた。	PRINTFORMW %CALLNAME:TARGET%用两手比成了一个心形，放在小腹的心形淫纹上。
CALL PRINT_STR, @"「ここが、%CALLNAME:TARGET%の『中』です……_BH_」_W"	CALL PRINT_STR, @"「里面是%CALLNAME:TARGET%的……_BH_」_W"
PRINTFORMW %CALLNAME:TARGET%が両手を押し下げると、淫紋の刻まれている部分の肌が絞り出されて浮き上がった…	PRINTFORMW %CALLNAME:TARGET%把两手向下压，用光滑的打着淫纹的腹肉挤出了一个粉色边框的女肉桃心。
CALL PRINT_STR, @"「だから%CNAME("二人称")%はここをいじめては駄目ですよ……_BH_当然ここに射精するのも禁止です」_W"	CALL PRINT_STR, @"「%CALLNAME:MASTER%主人可千万不能欺负这里啊……_BH_，更不能往里面射精呦～」_W"
CALL PRINT_STR, @"「もし、一番大事な所に%CNAME("二人称")%がずぷずぷ、って入ってきて、一杯にされてしまったら……_BH_」_W"	CALL PRINT_STR, @"「如果最重要地方被%CALLNAME:MASTER%主人噗啾噗啾的灌满的话……_BH_」_W"
PRINTFORMW %CALLNAME:TARGET%がハートにしていた手を解いて、%CALLNAME:MASTER%の背中に回す……	PRINTFORMW %CALLNAME:TARGET%拿開了比心的双手，反去用手揽住%CALLNAME:MASTER%的后背，让两人的私处贴合得更加紧密，温热的吐息离%CALLNAME:MASTER%耳边越来越近。
PRINTFORMW 二人の秘所が更に密着し、熱い吐息が%CALLNAME:MASTER%の耳にかかる。	CALL PRINT_STR, @"「%CALLNAME:MASTER%主人最忠诚的恶魔女仆就会变成笨蛋恶魔肉壶的呀～_BH_」_W"
CALL PRINT_STR, @"「あなたの忠実なメイド悪魔は、いやらしい肉便器悪魔に変わってしまいます…_BH_」_W"
PRINTFORMW %CALLNAME:TARGET%は%NAMES("ベッド")%の上に恭しく横たわると両脚を広げた。	PRINTFORMW %CALLNAME:TARGET%恭恭敬敬的躺在床上分開了双腿。
PRINTFORMW その秘裂からはすでに大量の愛液が溢れ出ている。	PRINTFORMW 两腿间的蜜裂已经在大量的泌出蜜汁了。
PRINTFORMW 「%CALLNAME:TARGET%は準備ができています、いつでもどうぞ……」	PRINTFORMW 「%CALLNAME:TARGET%已经准备好了，请随意吧……」
PRINTFORMW 「従います。」	PRINTFORMW 「遵命。」
PRINTFORMW %CALLNAME:TARGET%畏まった様子で両脚を開いた。	PRINTFORMW %CALLNAME:TARGET%恭敬的打開了双腿。
PRINTFORMW 「仰せのままに……」	PRINTFORMW 「遵命……」
CALL PRINT_STR, @"「お……おぉぉ…激し、激しいです……」_W"	CALL PRINT_STR, @"「哦……哦~，好激烈的……」_W"
PRINTFORMW うつ伏せの%CALLNAME:TARGET%を後背位で激しく犯す。激しい抽送の度にその尻肉は形を変えている	PRINTFORMW 趴伏着的被从后面狠狠地侵犯了，激烈的撞击让臀肉都变了形
CALL PRINT_STR, @"「そ、そのようにしては、胸が、潰れてしまいます……！」_W"	CALL PRINT_STR, @"「太……太用了了，胸部被压住了啊！……」_W"
PRINTFORMW %CALLNAME:TARGET%を完全に組み敷いて、後ろからのしかかる。	PRINTFORMW 被完全压在身下的%CALLNAME:TARGET%，丰满到过分的乳房因为挤压也变形了，从背后也看得见呢……
PRINTFORMW 豊満な乳房は押しつぶされて変形し、胴体をはみ出して後ろからでも見えるほどだ…	CALL PRINT_STR, @"「唔……这个体位，好深，要受不了了_H_」_W"
CALL PRINT_STR, @"「うぅぅー_H_…この格好、深くて、もう駄目ですぅ_H_」_W"
PRINTFORMW 「後ろからですか……%CNAME("一人称")%を征服して気持ちよくなりたいのですか、%CNAME("二人称")%？」	PRINTFORMW 「又想要从后边来了……这种体位，可以让%CALLNAME:MASTER%很有征服的快乐吧。」
PRINTFORMW %CALLNAME:TARGET%は四つん這いになると、丸くてむっちりとしたお尻を%CALLNAME:MASTER%の方へ突き出した。	PRINTFORMW %CALLNAME:TARGET%趴了下来，把浑圆的肉感臀部撅起来朝向了%CALLNAME:MASTER%这边。
CALL PRINT_STR, @"「おまんこを開いたり閉じたりして『おかえりなさいませ_BH_ご主人様～_BH_』…と言わせてみましょうか？」_W"	CALL PRINT_STR, @"「是不是还要一边摇晃着，一边扒開自己的蜜穴说“欢迎回家～_BH_%CALLNAME:MASTER%主人～_BH_”……」_W"
PRINTFORMW とはいえ実際に行動には移さず、振り向いてこちらを見つめている…	PRINTFORMW 说完话的%CALLNAME:TARGET%却没有什么实际行动，只是扭过头来用渴望的眼神看着%CALLNAME:MASTER%
PRINTFORMW 誘うような言葉に耐えきれなくなる。柔らかい尻を掴むと、硬く張りつめた肉棒を突き立てた。	PRINTFORMW 受不了的言语刺激，捉住了那丰满的臀部，将自己硬的发疼的肉棒刺了进去。
CALL PRINT_STR, @"「ふぁぁぁっ…_H_深いぃぃ_H_ご主人様…おかえり、なさいませぇっ…_H_……」_W"	CALL PRINT_STR, @"「嗯哈～_H_这么深……%CALLNAME:MASTER%主人～，欢·迎·回·家_H_”……」_W"
CALL PRINT_STR, @"「また%CALLNAME:TARGET%をこのような格好にさせて……_BH_」_W"	CALL PRINT_STR, @"「又要用这种姿势和%CALLNAME:TARGET%做呢……_BH_」_W"
CALL PRINT_STR, @"「%CALLNAME:TARGET%を%CNAME("二人称")%のペニスに屈服させたいのですか……_BH_」_W"	CALL PRINT_STR, @"「是想%CALLNAME:TARGET%屈服在%CALLNAME:MASTER%的鸡鸡之下吗……_BH_」_W"
CALL PRINT_STR, @"「意地悪ですね……%CNAME("二人称")%……_BH_」_W"	CALL PRINT_STR, @"「坏心眼呢……%CALLNAME:MASTER%……_BH_」_W"
PRINTFORMW 「仰せのままに」	PRINTFORMW 「遵命」
PRINTFORMW %CALLNAME:TARGET%は畏まった様子で%CALLNAME:MASTER%に背を向けて跪くと…	PRINTFORMW %CALLNAME:TARGET%恭恭敬敬地背对着%CALLNAME:MASTER%跪坐下来，翘起来饱满的黑肉臀部，露出粉红的娇嫩蜜所来
PRINTFORMW むっちりとした褐色のお尻を持ち上げ、瑞々しいピンク色の秘所を露わにした…
PRINTFORMW 「%CNAME("二人称")%、後ろからご自由に%CNAME("一人称")%を犯してください…」	PRINTFORMW 「%CNAME("二人称")%可以随意地从后面侵犯%CNAME("一人称")% 」
PRINTFORMW 「仰せのままに。」	PRINTFORMW 「遵命。」
PRINTFORMW %CALLNAME:TARGET%は畏まった様子でお尻を持ち上げた。	PRINTFORMW %CALLNAME:TARGET%恭敬的抬起了臀部。
PRINTFORMW 「この体勢をご所望ですか……何故、ですか？」	PRINTFORMW 「想用这种体位啊……为什么呢？」
PRINTFORMW 「%CALLNAME:TARGET%には見当も着きません。」	PRINTFORMW 「%CALLNAME:TARGET%真的是一点也猜不到啊。」
PRINTFORMW 「従います……」	PRINTFORMW 「遵命……」
CALL PRINT_STR, @"「意地悪です……%CNAME("二人称")%……_H_今日この日に、このような体勢を選ばれるなど…」_W"	CALL PRINT_STR, @"「坏心眼呢……%CALLNAME:MASTER%……_H_在这种日子用这种体位～」_W"
CALL PRINT_STR, @"「しかし、%CALLNAME:TARGET%は悪魔です……人間である%CNAME("二人称")%の精子は、効果があるのでしょうか…_BH_」_W"	CALL PRINT_STR, @"「%CALLNAME:TARGET%可是恶魔啊……%CALLNAME:MASTER%的人类精子到底行不行呢……_BH_」_W"
CALL PRINT_STR, @"「もし、あるとしたら…%CALLNAME:TARGET%の目がハートになるまで滅茶苦茶にしてください…_HH_」_W"	CALL PRINT_STR, @"「如果不是狠狠地把%CALLNAME:TARGET%肏到眼睛里都是爱心_HH_，中出到%CALLNAME:TARGET%肚子都鼓起来的话……_HH_～」_W"
CALL PRINT_STR, @"「%CALLNAME:TARGET%のお腹がパンパンになるまで、中に出してください……_HH_」_W"	CALL PRINT_STR, @"「加油吧%CALLNAME:MASTER%……_H_呵呵～」_W"
CALL PRINT_STR, @"「応援していますよ、%CNAME("二人称")%……_H_ふふ…」_W"
PRINTFORMW 「太ももを抱きかかえて、激しく%CALLNAME:TARGET%の中に出し入れする…ですか？」	PRINTFORMW 「要抱着的大腿，狠狠的撞击%CALLNAME:TARGET%的里面吗？」
PRINTFORMW 「%CNAME("二人称")%の望みには従います……」	PRINTFORMW 「随%CNAME("二人称")%喜欢吧……」
PRINTFORMW %CALLNAME:TARGET%は無表情のままこちらを見ている。	PRINTFORMW %CALLNAME:TARGET%面无表情的看着。
CALL PRINT_STR, @"「しかし、%CNAME("二人称")%が最後まで我慢できなかった場合……_BH_」_W"	CALL PRINT_STR, @"「可是如果中途%CALLNAME:MASTER%撑不住的话……_BH_，鸡鸡就会被%CALLNAME:TARGET%的小穴挤出来的呦……呵呵～」_W"
CALL PRINT_STR, @"「ペニスは%CALLNAME:TARGET%のココから吐き出されてしまうかもしれませんね……ふふ」_W"	PRINTFORMW %CALLNAME:TARGET%的脸上浮现出恶意的笑容。
PRINTFORMW %CALLNAME:TARGET%の顔に、意地悪そうな笑みが浮かんだ…
PRINTFORMW 「従います。」	PRINTFORMW 「遵命。」
PRINTFORMW %CALLNAME:TARGET%は畏まった様子で受け入れる準備をした。	PRINTFORMW %CALLNAME:TARGET%恭敬地做好了准备。
PRINTFORMW 「仰せのままに。」	PRINTFORMW 「遵命。」
PRINTFORMW %CALLNAME:TARGET%が膝の上に座る。優しく抱きしめられ、頭が柔らかい胸の中に埋もれていく…	PRINTFORMW 坐在的大腿上，温柔的环抱住的头，将其埋进自己柔软的胸部里
CALL PRINT_STR, @"「暴れないでください、%CNAME("二人称")%…ゆっくりと味わってくださいね……_BH_」_W"	CALL PRINT_STR, @"「请不要乱动啊%CALLNAME:MASTER%，慢慢的品味……_BH_」_W"
CALL PRINT_STR, @"「いやぁ……_BH_%CNAME("二人称")%……そんなに突き上げられては…_H_」_W"	CALL PRINT_STR, @"「咿呀……_BH_，%CALLNAME:MASTER%……不要一直向上顶啊_H_」_W"
CALL PRINT_STR, @"「意地悪です、%CNAME("二人称")%……_H_ふふ…」_W"	CALL PRINT_STR, @"「坏心眼呢……%CALLNAME:MASTER%……_H_呵呵～」_W"
PRINTFORMW %CALLNAME:TARGET%の笑い声だけは聞こえるが、何も見えないので不安になってくる。	PRINTFORMW 因为只能听到%CALLNAME:TARGET%的笑声，但是什么都看不到而变得焦急了。
CALL PRINT_STR, @"「%CALLNAME:TARGET%の顔が見たいんですか？駄目ですよ%CNAME("二人称")%_H_上も下も、離しませんからね_BH_」_W"	CALL PRINT_STR, @"「我知道%CNAME("二人称")%想看到现在的%CALLNAME:TARGET%的样子，但是%CALLNAME:TARGET%不会放開%CALLNAME:MASTER%的_H_，上面也好下面也好～_BH_」_W"
CALL PRINT_STR, @"「%CNAME("一人称")%の体の中で迷子になってください…_H_」_W"	CALL PRINT_STR, @"「迷失在我的身体里吧_H_～」_W"
CALL PRINT_STR, @"「この体勢だと…いつでも%CNAME("二人称")%と口付けができますね……_BH_」_W"	CALL PRINT_STR, @"「这个体位，可以和%CALLNAME:MASTER%一边做一边亲吻呢……_BH_」_W"
PRINTFORMW そう言うと、%CALLNAME:TARGET%は%CALLNAME:MASTER%の頭を抱きしめてキスをしてきた。	PRINTFORMW 说罢了%CALLNAME:TARGET%就抱着%CALLNAME:MASTER%的头吻了过来。
CALL PRINT_STR, @"「くちゅ…ちゅぅ……くちゅっ…………_H_んぁ……_H_」_W"	CALL PRINT_STR, @"「库啾～～库啾～～～～库啾…………嗯哈……」_W"
PRINTFORMW その後、%CALLNAME:MASTER%が窒息死する寸前になって、ようやくキスが終わった……	PRINTFORMW 就%CALLNAME:MASTER%在怀疑自己要被憋死的时候，这个漫长的吻终于结束了……
PRINTFORMW %CALLNAME:TARGET%の目は蕩け切っている……離れた唇の間には透明な糸が引いていた……	PRINTFORMW %CALLNAME:TARGET%的眼神已经完全的迷离了……两个人的唇间牵起了透明的丝线……
PRINTFORMW 「仰せのままに。」	PRINTFORMW 「遵命。」
PRINTFORMW %CALLNAME:TARGET%は恭しく%CALLNAME:MASTER%の上に座った。	PRINTFORMW %CALLNAME:TARGET%恭敬的坐了上来。
PRINTFORMW 「従います。」	PRINTFORMW 「遵命。」
PRINTFORMW 「この体勢だと、%CNAME("二人称")%のお顔が見えませんね。」	PRINTFORMW 「这个体位看不到%CALLNAME:MASTER%的脸呢。」
PRINTFORMW 「%CNAME("二人称")%を抱きしめることも、口付けすることもできません。」	PRINTFORMW 「也抱不到%CALLNAME:MASTER%，也亲不到%CALLNAME:MASTER%。」
CALL PRINT_STR, @"「でも、%CNAME("二人称")%はからキスもできますし、乳首もお豆も、お好きなようにできるのですよね…_H_」_W"	CALL PRINT_STR, @"「%CALLNAME:MASTER%却能照顾得到的嘴巴，乳头，还有小豆豆_H_～」_W"
CALL PRINT_STR, @"「不公平ですよ、%CNAME("二人称")%……_H_ふふ…」_W"	CALL PRINT_STR, @"「坏心眼呢……%CALLNAME:MASTER%……_H_呵呵～」_W"
PRINTFORMW そう言って笑う%CALLNAME:TARGET%の表情を見ることは出来ない	PRINTFORMW 看不到笑着的%CALLNAME:TARGET%的表情，但是插在里面的阴茎却被紧紧地缠住了……
PRINTFORMW しかし、挿入されているペニスがきゅぅっと締め付けられるのを感じる……
PRINTFORMW 「従います。」	PRINTFORMW 「遵命。」
PRINTFORMW %CALLNAME:TARGET%は恭しく%CALLNAME:MASTER%の上に座った。	PRINTFORMW %CALLNAME:TARGET%恭敬的坐了上来。
PRINTFORMW %CALLNAME:MASTER%は完全に組み敷かれてしまっている……悪魔の力には敵いそうもない。	PRINTFORMW %CALLNAME:MASTER%被狠狠的推倒压住了……恶魔的力量真是惊人。
CALL PRINT_STR, @"「すべて、%CNAME("二人称")%のせいですよ……_H_%CNAME("一人称")%の体の事など、気にも留めてくださらない…」_W"	CALL PRINT_STR, @"「这都要怪%CALLNAME:MASTER%……呢_H_一点都不関心人家的身体状态～」_W"
PRINTFORMW %CALLNAME:TARGET%は不平を漏らしながら、頭を持ち上げて自ら腰を振っている。	PRINTFORMW 一边抱怨着，一边抬着头自顾自地扭动着腰。
CALL PRINT_STR, @"「んぁっ……んぁぁああっ_BH_それなのに、%CNAME("二人称")%に『自慰をやめろ』と命じられても……」_W"	CALL PRINT_STR, @"「嗯哈……嗯哈～～_BH_，%CNAME("二人称")%问我什么……有没有忍不住自慰……」_W"
CALL PRINT_STR, @"「そのようなこと、できるわけがありません……_BH_」_W"	CALL PRINT_STR, @"「怎么可能呢……_BH_」_W"
CALL PRINT_STR, @"「ぁあああぁぁっ…！！！%CNAME("二人称")%、強くしないでっ……_H_今、敏感でぇぇ…_BH_」_W"	CALL PRINT_STR, @"「啊啊啊啊！！！，不要这么用力顶啊%CALLNAME:MASTER%……_H_现在人家很敏感～_BH_」_W"
PRINTFORMW テンポよく突き上げてやると、%CALLNAME:TARGET%は大きく呼吸を乱す。同時に、結合部からは更に愛液が溢れ出てくる。	PRINTFORMW 被打乱了扭动的节奏，%CALLNAME:TARGET%深深的吸了几口气。不仅呼吸開始紊乱，连交合处也冒出的淫汁也越来越多了。
CALL PRINT_STR, @"「うぁっ、そこはぁっ…_BH_%CNAME("二人称", "どもり")%、許してくださいぃ…_H_はいっ、ご命令は絶対、ですか…？_」_W"	CALL PRINT_STR, @"「那是～～～_BH_，请、请%CNAME("二人称")%饶了我吧……_H_什么？这是命令？_BH_」_W"
CALL PRINT_STR, @"「申し訳っ、申し訳ありませんっ……しかし、%CNAME("二人称")%に毎日お目にかかっていると……_H_」_W"	CALL PRINT_STR, @"「对不起、对不起……只要跟%CALLNAME:MASTER%碰面的话我每天都……_H_每天都是想着%CALLNAME:MASTER%自慰……」_W"
CALL PRINT_STR, @"「毎日、%CNAME("二人称")%のことを思って自分を慰めてしまうのです……_H_」_W"	PRINTFORMW 回答完的%CALLNAME:TARGET%低下了头，却不敢跟目光相接。平素的冰山已经完全崩塌了，只剩下绯红色中的完全的雌性表情。
PRINTFORMW そう答えて%CALLNAME:TARGET%は頭を下げるが、こちらと目を合わせようとしない…
PRINTFORMW 普段の冷静さは完全に崩れ去っている。その頬は真っ赤に染まり、浮かべている表情は完全に雌そのものだ…
PRINTFORMW %CALLNAME:MASTER%は完全に組み敷かれてしまっている……悪魔の力には敵いそうもない。	PRINTFORMW %CALLNAME:MASTER%被狠狠的推倒压住了……恶魔的力量真是惊人。
PRINTFORMW %CALLNAME:TARGET%を見上げると、無表情ではあるものの、その瞳には涙が溜まっているようだ。	PRINTFORMW 从上方看了过来，虽然没有什么表情，但是眼神里仿佛要凝出水来。
PRINTFORMW 普段と比べて今日の腰の動きはとても激しい。膣内も催促するようにギュッと締めつけてきて、耐えられないほどだ……	PRINTFORMW 不同于以往，今天的动作幅度要狂野的多。膣肉也催促般地紧固着，让人难以忍受……
PRINTFORMW %CALLNAME:MASTER%は、思わず手を固く握る。口からは喘ぎ声が漏れてしまう。	PRINTFORMW %CALLNAME:MASTER%的手指变得僵硬了，口中也忍不住漏出了喘息。
CALL PRINT_STR, @"「なんて可愛らしい反応……%CNAME("一人称")%を誘惑していらっしゃるのですね…_BH_」_W"	CALL PRINT_STR, @"「这么可爱的反应……可别说%CNAME("二人称")%没勾引我啊～_BH_」_W"
PRINTFORMW 腰の動きは、さらに野性的で荒々しいものとなっていく……	PRINTFORMW 腰摆动的更加狂野了……
CALL PRINT_STR, @"「%CNAME("二人称")%が射精するまで……このペニスは、離しません…_BH_」_W"	CALL PRINT_STR, @"「%CALLNAME:MASTER%射进来以前……我都不会放開这肉棒的～_BH_」_W"
PRINTFORMW %CALLNAME:TARGET%は微笑みながら腰を動かしている。	PRINTFORMW %CALLNAME:TARGET%微微地笑着晃动着腰
PRINTFORMW %CALLNAME:MASTER%に跨った%CALLNAME:TARGET%はゆっくりと腰を下ろし、肉棒を少しずつ蜜壷の中へと納めていく…	PRINTFORMW 骑在上面的%CALLNAME:TARGET%慢慢的坐了下来，一点一点地把肉棒纳入了蜜洞之中。
CALL PRINT_STR, @"「あら…先端は入りましたが、全部納まってはいないようですね…_BH_」_W"	CALL PRINT_STR, @"「啊啦，已经顶到里面了，可是还有一截根部在外面呐～_BH_」_W"
CALL PRINT_STR, @"「まずは慣らしてから…その後ゆっくり、ゆっくり入れましょうね…_BH_」_W"	CALL PRINT_STR, @"「可以先习惯一下，然后慢慢地……慢慢地吞进去～_BH_」_W"
PRINTFORMW メイドの真剣な表情を見ているうちに悪戯心が湧いてきた%CALLNAME:MASTER%は、思い切り腰を突き上げた。	PRINTFORMW 看着女仆认真的神情，突然产生了恶作剧的心理，用力地向上顶了一下腰部。
CALL PRINT_STR, @"「んぃぃぃぃっ_HH_こんな…深いっ、深すぎてっ……おﾞぉぉぉっ_H_急に、動かないでくださいっ_BH_」_W"	CALL PRINT_STR, @"「咦咦咦咦咦！！！～_H_怎么……会太、太深了……噢噢噢噢～～～，不要马上開始动啊！_BH_」_W"
PRINTFORMW 突然の刺激に、%CALLNAME:TARGET%は天を仰ぎ獣のような悲鳴を上げた。膣内も痙攣するように動いている。	PRINTFORMW 突然被刺激到的%CALLNAME:TARGET%仰起头发出了野兽般的悲鸣，小穴痉挛般的运动起来。
PRINTFORMW やがて、%CALLNAME:TARGET%は全身の力が抜けてしまったのか、%CALLNAME:MASTER%の上に倒れこんでしまった。	PRINTFORMW 随后%CALLNAME:TARGET%仿佛全身脱力般的，瘫倒在%CALLNAME:MASTER%的身上。然而%CALLNAME:MASTER%并没有因此放过%CALLNAME:TARGET%，而是一下比一下迅猛地挺动着。
PRINTFORMW しかし%CALLNAME:MASTER%は%CALLNAME:TARGET%を許すことはなく、腰を動かす速度を上げていった。	CALL PRINT_STR, @"「骗人……啊啊啊！！！～_H_怎么……那么大_H_……哦哦～～～，嗯啊啊啊！！！欺负人啊咦咦咦咦！！！_BH_」_W"
CALL PRINT_STR, @"「嘘つきっ……ああぁぁ～っ_H_やぁっ、大きいぃ_H_……うぁぁぁっ、んあぁぁっ…！！酷いですぅぅっ…_BH_」_W"
CALL PRINT_STR, @"「はぁっ…はぁぁぁっ…_H_んぅぅ……あっ…_H_」_W"	CALL PRINT_STR, @"「嘶哈～嘶哈～～_H_嗯……啊_H_」_W"
CALL PRINT_STR, @"「やっと……全部、入りましたね…お腹の中、もういっぱいです……_BH_」_W"	CALL PRINT_STR, @"「终……终于完全进来了，里面撑得满满的……_BH_」_W"
PRINTFORMW %CALLNAME:TARGET%は切なそうな表情をしながら、自らの豊満な乳房を片手で持ち上げた。	PRINTFORMW %CALLNAME:TARGET%的眉毛紧蹙着，一只手撑扶着一只手则搭在自己丰满的乳房上。
CALL PRINT_STR, @"「%CNAME("二人称")%…%CALLNAME:TARGET%がご奉仕致しますから、心ゆくまで楽しんでくださいね……」_W"	CALL PRINT_STR, @"「%CALLNAME:MASTER%请尽情享受%CALLNAME:TARGET%的服侍吧～」_W"
PRINTFORMW %CALLNAME:MASTER%に跨った%CALLNAME:TARGET%はゆっくりと腰を下ろし、肉棒を少しずつ蜜壷の中へと納めていく…	PRINTFORMW 骑在上面的%CALLNAME:TARGET%慢慢的坐了下来，一点一点地把肉棒纳入了蜜洞之中。
CALL PRINT_STR, @"「すべて、入りました……_H_ここからは、このメイドがご奉仕させていただく時間です…_BH_」_W"	CALL PRINT_STR, @"「已经完全放进来了～_H_接下来是女仆的服务时间～_BH_」_W"
CALL PRINT_STR, @"「途中でやめる、などという選択肢は存在しませんよ…_BH_」_W"	CALL PRINT_STR, @"「可是没有中途停止的选项的呦～_BH_」_W"
PRINTFORMW %CALLNAME:TARGET%は微笑みながら腰を振り始めた。	PRINTFORMW %CALLNAME:TARGET%微笑着開始摆动起腰。
PRINTFORMW 「仰せのままに。」	PRINTFORMW 「遵命。」
PRINTFORMW %CALLNAME:TARGET%は恭しく%CALLNAME:MASTER%の上に跨った。	PRINTFORMW %CALLNAME:TARGET%恭敬的坐了上来。
PRINTFORMW 「ん……流石です%CNAME("二人称")%、すごいですね…」	PRINTFORMW 「嗯……不愧是%CALLNAME:MASTER%，真厉害呐。」
CALL PRINT_STR, @"「ひぁっ、ふあぁぁっ…ペニスが、%CNAME("一人称")%の中で、とても頑張っていますね_HH_」_W"	CALL PRINT_STR, @"「嘶哈~嘶哈，肉棒这么努力地在里面顶弄着_HH_」_W"
PRINTFORMW 「主導権を取りたい…？ダメですよ…♪」	PRINTFORMW 「想要夺回主导权吗…不行呦~」
PRINTFORMW 「あ……」	PRINTFORMW 「啊……」
PRINTFORMW 敏感な場所を責められた%CALLNAME:TARGET%は軽く叫び声をあげる。	PRINTFORMW 被攻击到敏感点的%CALLNAME:TARGET%轻轻地叫了一声，身体仍然在迎合着%CALLNAME:MASTER%的冲击。
PRINTFORMW しかし、その体は未だ%CALLNAME:MASTER%の抽送を受け入れている…
CALL PRINT_STR, @"「ああ…_HH_これから少し、いけない事をさせていただきますね……%CNAME("二人称")%」_W"	CALL PRINT_STR, @"「啊啊啊……_HH_在做坏事呢……%CALLNAME:MASTER%」_W"
PRINTFORMW 蜜壷の中で肉棒がキュっと締め付けられ、まるで牢獄に囚われているような感覚を覚える。	PRINTFORMW 感觉蜜洞中的肉棒一下子被紧固住了，被関押在蜜洞的监狱里中了。
CALL PRINT_STR, @"「%CNAME("二人称")%の弱点はここですよね…_HH_ここに%CALLNAME:TARGET%のＧスポットを擦りつけると…」_W"	CALL PRINT_STR, @"「这里是%CALLNAME:MASTER%的敏感点吧……_HH_如果用%CALLNAME:TARGET%的G点去摩擦这里的话……」_W"
PRINTFORMW %CALLNAME:TARGET%の言葉通り、蜜壷の中の柔肉が、まるで獄卒のようにペニスの敏感な部分を拷問し始めた…	PRINTFORMW 正如%CALLNAME:TARGET%所言，蜜洞监狱的媚肉狱卒開始折磨起肉棒的弱点了……
CALL PRINT_STR, @"「あらあら……_HH_」_W"	CALL PRINT_STR, @"「啊啦啊啦……_HH_」_W"
CALL PRINT_STR, @"「やぁぁっ…！いけません…これ以上、突き上げられてはぁっ…！」_W"	CALL PRINT_STR, @"「别闹了！不要，不要再顶上来了啊！」_W"
CALL PRINT_STR, @"「はぁっ……あはぁぁっ_HH_気持ち良すぎて……腰に力が入りません」_W"	CALL PRINT_STR, @"「啊哈……啊哈~_HH_，好舒服……腰上要使不出力气了」_W"
PRINTFORMW 喘ぎ声をあげる%CALLNAME:TARGET%の目は焦点を結んでいない。腰の動きも遅くなりつつある。	PRINTFORMW 眼神迷离地喘息着，%CALLNAME:TARGET%腰部的摆动越来越慢了
PRINTFORMW 「意地悪ですね…主導権を取り返し、%CALLNAME:TARGET%を組み敷いて、散々に犯し尽くすつもりなのですね？」	PRINTFORMW 「坏心眼呢，想要夺回主导权，然后把%CALLNAME:TARGET%压在身下狠狠地蹂躏吗？」
CALL PRINT_STR, @"「んあっ……さ、流石です%CNAME("二人称")%、すごいですね。」_W"	CALL PRINT_STR, @"「嗯哈……不、不愧是%CALLNAME:MASTER%，真厉害呐。」_W"
CALL PRINT_STR, @"「気持ちのいい場所まで、届いています_HH_」_W"	CALL PRINT_STR, @"「顶到了舒服的地方了呢_HH_」_W"
PRINTFORMW %CALLNAME:TARGET%は腰をより激しくくねらせ、貪欲に快楽をむさぼり始めた。	PRINTFORMW %CALLNAME:TARGET%更大幅度地晃动起腰肢，開始贪图更多的快乐。
PRINTFORMW 「ん……流石ですね、%CNAME("二人称")%。」	PRINTFORMW 「嗯……不愧是%CALLNAME:MASTER%呢。」
CALL PRINT_STR, @"「ご恩にはお応えしないと…そちらも、気持ち良くして差し上げます……_HH_」_W"	CALL PRINT_STR, @"「作为回礼，会让您也变得舒服起来的～……_HH_」_W"
PRINTFORMW %CALLNAME:TARGET%は腰をより激しくくねらせ始めた……	PRINTFORMW %CALLNAME:TARGET%的腰肢開始了更大幅度的扭动……
CALL PRINT_STR, @"「んぁ……_HH_%CNAME("二人称")%…ま、またそのような所を…」_W"	CALL PRINT_STR, @"「嗯啊……_HH_%CALLNAME:MASTER%怎、怎么又在顶着那里。」_W"
CALL PRINT_STR, @"「そ……そこばかりっ…_HH_%CALLNAME:TARGET%、すぐに逝ってしまいます……」_W"	CALL PRINT_STR, @"「一……一直顶那里_HH_的话，%CALLNAME:TARGET%会很容易去的呀……」_W"
CALL PRINT_STR, @"「そんなに……%CNAME("一人称")%が達し続ける姿をご覧になりたいのですか……_HH_」_W"	CALL PRINT_STR, @"「什么呀……喜欢看人家不停地去的样子_HH_……」_W"
CALL PRINT_STR, @"「ぁやぁぁっ…またっ、また逝きますっ、%CNAME("二人称")%のおちんぽ凄すぎて……」_W"	CALL PRINT_STR, @"「哎呀～又、又、又要去了呀，%CALLNAME:MASTER%的鸡巴好厉害啊……人家完全、完全、完全承受不住了啦～」_W"
CALL PRINT_STR, @"「%CNAME("一人称")%っ、%CNAME("一人称")%もう、我慢できませんっ…_H_」_W"	PRINTFORMW 轻咬住下唇，坏笑地看着，用尖细的声音像念台词一样说着羞耻的话语。
PRINTFORMW 下唇を噛んで、ぎこちない笑みを浮かべ、縮こまった声で恥ずかしい言葉を口にした。	CALL PRINT_STR, @"「脑子里只能想着%CALLNAME:MASTER%的鸡巴了啊，要变成知道鸡巴的笨蛋了啦～～～」_W"
CALL PRINT_STR, @"「頭の中が%CNAME("二人称")%のおちんぽで一杯ですっ…」_W"
CALL PRINT_STR, @"「おちんぽの事しか考えられない雌豚になってしまいます…_H_」_W"
PRINTFORMW 「ぶひぶひ～……ふふ……」	PRINTFORMW 「噗嗤……哈哈……」
PRINTFORMW どちらからともなくお互いが笑ったが、交わっている下半身の動きはさらに激しくなっていく。	PRINTFORMW 两个人先后都被逗笑了，然而泛着白沫的激烈交合的下体的动作却越演越烈了。
CALL PRINT_STR, @"「_HH_%CNAME("二人称")%…どうぞ、少し落ち着いてください。」_W"
CALL PRINT_STR, @"「%CALLNAME:TARGET%のおまんこは逃げませんから…_HH_」_W"	CALL PRINT_STR, @"「_HH_%CALLNAME:MASTER%请冷静一点啊。」_W"
CALL PRINT_STR, @"「そのように突き上げられると、%CALLNAME:TARGET%はすぐに、良くなってしまいます…_HH_」_W"	CALL PRINT_STR, @"「%CALLNAME:TARGET%的小穴不会逃跑的啊～_HH_」_W"
CALL PRINT_STR, @"「小穴被这样突刺着，%CALLNAME:TARGET%好爽啊～_HH_」_W"
PRINTFORMW 敏感なところを責め立てられ、膣内の締め付けが強くなる。	PRINTFORMW 被责备到敏感处的小穴一下子缩紧了。
PRINTFORMW 温かい愛液が被裂から染み出し、太ももを伝って肉棒にまとわりつき、玉をも濡らしているようだ。	PRINTFORMW 感觉到有不少温热的爱液被从小穴中挤了出来，有的顺着大腿流了下去，有的黏黏的沿着肉杆打湿了蛋蛋。
PRINTFORMW %CALLNAME:TARGET%は情熱的な目でこちらを見つめながら、黙って%CALLNAME:MASTER%の突き上げを受け入れている。	PRINTFORMW %CALLNAME:TARGET%用动情的眼神看过来，默默承受着%CALLNAME:MASTER%的突刺。
PRINTFORMW 「ん……流石ですね、%CNAME("二人称")%。」	PRINTFORMW 「嗯……不愧是%CALLNAME:MASTER%呢。」
CALL PRINT_STR, @"「そこを、更に突いていただけますか……_HH_」_W"	CALL PRINT_STR, @"「可以再多戳刺一下那里呦～……_HH_」_W"
CALL PRINT_STR, @"「ん……この体勢だと、一番奥まで届きますねぇ……_BH_」_W"	CALL PRINT_STR, @"「嗯……这种情况下顶到最里面啊～……_BH_」_W"
CALL PRINT_STR, @"「んぅぅ～っ……_BH_」_W"	CALL PRINT_STR, @"「嗯哼～……_BH_」_W"
PRINTFORMW 最奥部を刺激された%CALLNAME:TARGET%は、微かな喘ぎ声を上げながら快感に耐えている。	PRINTFORMW 最深处被刺激到了，%CALLNAME:TARGET%微微地喘息着承受着快感。
CALL PRINT_STR, @"「あらあら……_BH_」_W"	CALL PRINT_STR, @"「啊拉啊拉～……_BH_」_W"
PRINTFORMW 腰を振るスピードが遅くなり、子宮口が亀頭に擦りつけられる。	PRINTFORMW 的动作放慢了下来，用子宫口研磨着肉棒的前端。
CALL PRINT_STR, @"「わかりますよ……_HH_『誰かさん』が、またいけない事をしたがっていますね…_H_」_W"	CALL PRINT_STR, @"「可以感觉的得到呢～……_HH_有人又想要做坏事情。」_W"
PRINTFORMW 最奥部を刺激された%CALLNAME:TARGET%は、喘ぎ声を上げながら快感に耐えている。	PRINTFORMW 最深处被刺激到的%CALLNAME:TARGET%喘息着承受着快感。
CALL PRINT_STR, @"「あぁっ、あぁぁぁ……_HH_%CNAME("二人称")%、よろしければ手をこちらに…」_W"	CALL PRINT_STR, @"「啊哈～啊哈……_HH_，%CALLNAME:MASTER%，请把您的手给我。」_W"
PRINTFORMW %CALLNAME:TARGET%は%CALLNAME:MASTER%の手を取ると、自らの下腹部に押し当てた。	PRINTFORMW %CALLNAME:TARGET%抓住了%CALLNAME:MASTER%的手，牵引着放在了自己的小腹上。
CALL PRINT_STR, @"「ここですよ……_HH_丁度、ハートの模様の先端の所です。この内側でペニスと子宮口がキスしているんですよ_HH_」_W"	CALL PRINT_STR, @"「就是这里啦～……_HH_，那个粉色心形的尖尖的里面，肉棒在和子宫口接吻呐_HH_」_W"
CALL PRINT_STR, @"「あぁっ、んぉぉ……_HH_本当に、意地悪です…お腹の中、気持ちいいのに…淫紋まで撫でられるとぉっ…_HH_。」_W"	CALL PRINT_STR, @"「啊哈～噢噢噢……_HH_，真是坏心眼呢，里面顶弄着还在外面这么刺激着纹路_HH_。」_W"
PRINTFORMW %CALLNAME:TARGET%は、掴んだ手を下腹部に押し付けながら、唇を%CALLNAME:MASTER%に向けてキスを求めている。	PRINTFORMW %CALLNAME:TARGET%把%CALLNAME:MASTER%的手紧紧地按在自己的小腹上，同时嘴唇開始向%CALLNAME:MASTER%索求着吻。
CALL PRINT_STR, @"「うぅぅ……んぁっ_HH_%CNAME("二人称")%は、少しメイドに対して厳しすぎますっ……」_W"	CALL PRINT_STR, @"「呜呜……嗯哈_HH_，您对自己的女仆还真是苛责呢……」_W"
CALL PRINT_STR, @"「あぁぁ……_HH_また、こんないけない事を、なさりたいのですか…」_W"	CALL PRINT_STR, @"「啊啊～……_HH_又想要做坏事情吗。」_W"
CALL PRINT_STR, @"「駄目です…_H_この中は%CNAME("二人称")%の赤ちゃんがいる場所なんですよ…」_W"	CALL PRINT_STR, @"「不可以呢～_H_里面可是%CALLNAME:MASTER%的孩子住的地方啊。」_W"
CALL PRINT_STR, @"「%CNAME("二人称")%がそんな場所に射精してしまったら、赤ちゃんが精液の味を覚えてしまいます…」_W"	CALL PRINT_STR, @"「%CALLNAME:MASTER%若是这么顶弄着射进去的话，里面的孩子会记住精液的味道啊呀。」_W"
CALL PRINT_STR, @"「将来、%CALLNAME:TARGET%と同じような、ふしだらな悪魔に育ってしまいます_HH_いやぁぁ……また、激しくっ_HH_」_W"	CALL PRINT_STR, @"「以后会变成像%CALLNAME:TARGET%一样闻到味道就两腿发软的笨蛋恶魔的呀_HH_……啊啊～……您更粗暴了呢_HH_。」_W"
PRINTFORMW 口ではそう言っているが、膣肉と子宮口はまったく緩む様子がない……	PRINTFORMW 虽然嘴上这么说着，膣肉和子宫口却没有一点点松開的意思呢……
CALL PRINT_STR, @"「中が気持ちよくて…もう我慢できませんっ、早く%CNAME("二人称")%の精液を恵んでください…_HH_」_W"	CALL PRINT_STR, @"「里面……里面要受不了了，快点把%CALLNAME:MASTER%的精液射进来吧~_HH_」_W"
CALL PRINT_STR, @"「啊呀～……_HH_您又来了。」_W"
CALL PRINT_STR, @"「每次都责弄着这么深的地方_HH_您这么做很開心吗。」_W"
CALL PRINT_STR, @"「啊啊啊……对、对不起，请您不要拔出去啊，%CALLNAME:TARGET%很開……哦哦哦哦～～！_HH_。」_W"
PRINTFORMW 只是拔出去了一半，在%CALLNAME:TARGET%的央求结束前又重重的撞击在子宫口上……
CALL PRINT_STR, @"「やぁぁっ……_H_また、ですか…？」_W"	CALL PRINT_STR, @"「离、离不開了呀～……_HH_」_W"
CALL PRINT_STR, @"「いつも、このような深い所をいじめるのですね_H_それも、とっても楽しそうに…」_W"	PRINTFORMW %CALLNAME:TARGET%紧紧地抱住%CALLNAME:MASTER%，贪求着哪怕一丝一毫的贴近。
CALL PRINT_STR, @"「あぁぁっ……も、申し訳ありません、引き抜かないでっ、%CALLNAME:TARGET%にお慈悲を……ひぁぁぁっ～～_HH_。」_W"
PRINTFORMW ペニスを半分だけ引き抜き、%CALLNAME:TARGET%のおねだりが終わる前に、子宮口めがけて思い切り突き上げる……
CALL PRINT_STR, @"「は、離れないでくださいぃ……_HH_」_W"
PRINTFORMW %CALLNAME:TARGET%は少しでも密着しようとして、%CALLNAME:MASTER%をぎゅっと抱き締めている。
CALL PRINT_STR, @"「ペニスが、奥まで入っているのを感じます…_HH_。」_W"	CALL PRINT_STR, @"「肉棒插得好深喔_HH_。」_W"
CALL PRINT_STR, @"「子宮をこのように犯されるのは…_HH_とても、とても気持ちいいです…。」_W"	CALL PRINT_STR, @"「子宫…被这样干_HH_，觉得好爽好舒服。」_W"
CALL PRINT_STR, @"「体中がふわふわとした感覚に包まれて、力が抜けてしまいます…_HH_」_W"	CALL PRINT_STR, @"「感觉全身发软，一点力气都没有了…_HH_」_W"
CALL PRINT_STR, @"「%CNAME("二人称")%も…びゅびゅーっ、と…射精なさりたいですか…_H_」_W"	CALL PRINT_STR, @"「%CALLNAME:MASTER%想要把把精液射进来吗」_W"
CALL PRINT_STR, @"「やぁぁっ……_H_また、ですか…？」_W"	CALL PRINT_STR, @"「啊呀～……_H_您又来了。」_W"
CALL PRINT_STR, @"「いつも、このような深い所をいじめるのですね_H_それも、とっても楽しそうに…」_W"	CALL PRINT_STR, @"「每次都责弄着这么深的地方_H_您这么做很開心吗。」_W"
PRINTFORMW 腰を振っていた%CALLNAME:TARGET%は、突然大きく息を吸って眉をひそめた。	PRINTFORMW 正在摇晃着腰部的%CALLNAME:TARGET%突然吸了一口凉气，眉毛打起了结来。
PRINTFORMW 「ひぅ……そんな……」	PRINTFORMW 「嘶……怎么会……」
PRINTFORMW 少しムードが下がったような気がする……	PRINTFORMW 感觉气氛有点降低了呢……
PRINTFORMW 抽送を受け入れていた%CALLNAME:TARGET%は突然体を縮こまらせた。	PRINTFORMW 正在承受着冲击的%CALLNAME:TARGET%的身体突然蜷缩了起来。
PRINTFORMW 「あ！……お待ち、ください……！」	PRINTFORMW 「啊！……等一下！……」
PRINTFORMW 拒絶はしていないものの、明らかに受け入れている様子ではない……	PRINTFORMW 虽然并没有拒绝，但是明显感觉并不是太能接受……
CALL PRINT_STR, @"「ううぅ～……_HH_やはり……少し無理があります…」_W"	CALL PRINT_STR, @"「呜呜呜～……_HH_，太……太勉强了。」_W"
PRINTFORMW 明らかに%CALLNAME:TARGET%の呼吸が乱れているのを感じる	PRINTFORMW 明显感觉到的%CALLNAME:TARGET%节奏被打乱了，温软的穴肉也因为巨大的刺激而痉挛着……
PRINTFORMW 大きな刺激を受け、温かく柔らかい肉穴が痙攣する……
CALL PRINT_STR, @"「い、いけません……_HH_このまま続けていたら、ご奉仕ができなくなってしまいます…」_W"	CALL PRINT_STR, @"「不、不妙啊……_HH_，这样下去、会失去主导权的啊。」_W"
CALL PRINT_STR, @"「しかし、関係ありません…どうせ、体の内側も、外側も…全て_HH_堕とされて_HH_いますっ_HH_」_W"	CALL PRINT_STR, @"「无所谓了，反正早已经从内到外全都沦_HH_陷_HH_了。」_W"
PRINTFORMW しばらくすると、膣内の刺激と疼きに耐えきれなくなった%CALLNAME:TARGET%は%CALLNAME:MASTER%の唇を求め始めた。	PRINTFORMW 片刻之后，难以平息小穴里的刺激和悸动，%CALLNAME:TARGET%開始索要着%CALLNAME:MASTER%的嘴唇。
PRINTFORMW 「ひぅ……そんな……」	PRINTFORMW 「嘶……怎么会……」
CALL PRINT_STR, @"「あぅぅっ…あぁ～……_HH_そのように、こじ開けられると……_HH_」_W"	CALL PRINT_STR, @"「啊呜～啊哈～……_HH_，被顶開了呐_HH_……」_W"
CALL PRINT_STR, @"「今日はとても危ない日です…特に、何の対策もなしに子宮の中に射精されてしまったら…_HH_」_W"	CALL PRINT_STR, @"「今天可是非常不妙的日子呐，如果没有任何安全措施结这么射进子宫里面。_HH_……」_W"
CALL PRINT_STR, @"「%CNAME("一人称")%、確実に妊娠してしまいます……_HH_」_W"	CALL PRINT_STR, @"「就不可能不怀孕啊……_HH_」_W"
PRINTFORMW しかし、%CALLNAME:TARGET%の両脚は%CALLNAME:MASTER%の腰に回されている…	PRINTFORMW %CALLNAME:TARGET%的双腿缠上了%CALLNAME:MASTER%的腰。把嘴唇凑近了脸庞，在%CALLNAME:MASTER%的耳边轻轻地喘息着……
PRINTFORMW そして、唇が%CALLNAME:MASTER%の耳に寄せられ、微かな囁きが聞こえてくる……
CALL PRINT_STR, @"「%CNAME("二人称")%の……欲しい、です……_HH_」_W"	CALL PRINT_STR, @"「想要、一个、%CALLNAME:MASTER%的……_HH_」_W"
PRINTFORMW 媚びるような声を出しながら、%CALLNAME:TARGET%が蛸のように体を巻き付けてくる。	PRINTFORMW 娇呼了一声，身体像八爪鱼似地缠了上来。
CALL PRINT_STR, @"「どうか……ゆっくりお願いします_HH_」_W"	CALL PRINT_STR, @"「请……请慢一点_HH_」_W"
CALL PRINT_STR, @"「%CNAME("二人称")%の……凄すぎて…このままだと、%CALLNAME:TARGET%はすぐに達してしまいます…_HH_」_W"	CALL PRINT_STR, @"「%CALLNAME:MASTER%的……太厉害，再这样下去的话，%CALLNAME:TARGET%马上又要去了。_HH_」_W"
CALL PRINT_STR, @"「少し……恐いです_HH_体に全く力が入りません……」_W"	CALL PRINT_STR, @"「好……好害怕,_HH_身体的哪里都用不上力气……」_W"
CALL PRINT_STR, @"「一緒に……_HH_一緒に逝きたい、です……_HH_」_W"	CALL PRINT_STR, @"「想一起去_HH_……想一起去……_HH_」_W"
PRINTFORMW 余りの快感のせいか、%CALLNAME:TARGET%の口からは涎が垂れており、瞳孔は焦点が合っていない……	PRINTFORMW 透明的唾液从%CALLNAME:TARGET%的嘴角流了出来，瞳孔因为巨大而连续的快感已经完全失去焦点了……
PRINTFORML [1] 容赦なく責め続ける	PRINTFORML [1] 继续毫不留情地责备
PRINTFORML [2] ゆっくり優しく動く	PRINTFORML [2] 放慢速率温柔地运动
CALL PRINT_STR, @"「いいぃっ…！あぁぁぁぁっ_HH_かはぁ……ふぅっ……ふぅっ_HH_」_W"	CALL PRINT_STR, @"「咦咦咦～～啊啊啊！……_HH_，咔咔咔……哈……哈_HH_」_W"
PRINTFORMW 巨大な衝撃と、断続的に襲ってくる快感に呼吸もままならず、声にならない声を上げている。	PRINTFORMW 狂暴的冲击带来的巨大的快感，让不停悲鸣着的连气都换不过来，发出了不像样子的声音。
PRINTFORMW %CALLNAME:TARGET%は、何とか%CALLNAME:MASTER%の腰を掴む…	PRINTFORMW 勉勉强强地，%CALLNAME:TARGET%用手撑住的%CALLNAME:MASTER%腰部，但因为高潮带来的脱力，只能用轻如微风似乎的力气向外推着……
PRINTFORMW 絶頂による脱力で、押し返す力はそよ風に吹かれた程度でしかない……
CALL PRINT_STR, @"「どうか、や、やめっ…………_HH_」_W"	CALL PRINT_STR, @"「要、要、要……要……_HH_」_W"
PRINTFORMW しかし、言葉の途中で激しく突き入れられ、懇願は獣のような喘ぎに変わってしまう……	PRINTFORMW 然而还没说出来半句话，声音就又被狂暴的冲击给打成了雌兽的悲鸣……
CALL PRINT_STR, @"「も、もう駄目です、逃げられないです……_HH_」_W"	CALL PRINT_STR, @"「逃、逃不掉了……_HH_」_W"
CALL PRINT_STR, @"「%CNAME("二人称")%のペニスの奴隷になってしまいます……_HH_」_W"	CALL PRINT_STR, @"「要变成%CNAME("二人称")%的肉棒的奴隶了……_HH_」_W"
CALL PRINT_STR, @"「%CNAME("二人称")%、とても優しいですね、ぁぁ…あぁぁ……_HH_はい？まだ怖いか、ですか？」_W"	CALL PRINT_STR, @"「%CALLNAME:MASTER%真是温柔呐，啊哈～啊哈……_HH_，什、什么，还害怕吗？」_W"
CALL PRINT_STR, @"「とても、とても怖いです……_HH_」_W"	CALL PRINT_STR, @"「非常，非常害怕呀……_HH_」_W"
CALL PRINT_STR, @"「快感はゆっくりですが…%CNAME("二人称")%に愛されている場所から…」_W"	CALL PRINT_STR, @"「快感慢慢的，但是不停地从被%CALLNAME:MASTER%疼爱的地方……一下、一下地溢出来……_HH_」_W"
CALL PRINT_STR, @"「ずっと……少しずつ、少しずつ、溢れてきて……_HH_」_W"	CALL PRINT_STR, @"「像要被潮水淹没了一样……_HH_已经淹没到这里了……」_W"
CALL PRINT_STR, @"「まるで潮が満ちてくるかのようです……_HH_もう、ここは水浸しです……」_W"	PRINTFORMW 已经流出了眼泪的%CALLNAME:TARGET%错開了目光，轻轻咬住了自己的手指。
PRINTFORMW 涙を流す%CALLNAME:TARGET%は目を反らし、そっと自らの指を噛んだ。	CALL PRINT_STR, @"「快感要、要冲进脑子里了_HH_，好可怕……快、抱、抱住我啊……」_W"
CALL PRINT_STR, @"「快感が、脳の中を駆け巡っていて_HH_とても怖いです……どうか、だ、抱きしめて……」_W"	PRINTFORMW 怜惜的地抱紧了女仆颤抖着的滚烫肉体……
PRINTFORMW 憐れむようにメイドの火照って震える体を抱きしめる……	PRINTFORMW 好像心跳一样，小穴一下一下用让人发疼的力道紧缩着，淫水止不住地流了出来。
PRINTFORMW 心臓が跳ねるかのように、蜜壷が一気に締まり、愛液がとめどなく溢れ出てくる。	CALL PRINT_STR, @"「呜……呜…呜_HH_～～～呜呜呜！！！哈……哈……哈……好……好幸福_HH_」_W"
CALL PRINT_STR, @"「うぅ……う…うぅっ_HH_～～～うぅぅっ！！ふー…ふー…ふー……とっても、幸せです_HH_」_W"
CALL PRINT_STR, @"「このように深いと……すぐに、赤ちゃんができてしまいそうです……」_W"	CALL PRINT_STR, @"「插得这么深……很容易会有小宝宝的……」_W"
CALL PRINT_STR, @"「%CNAME("一人称")%…まだ、妊娠したくないです……」_W"	CALL PRINT_STR, @"「%CNAME("一人称")% 现在还不想怀孕呐……」_W"
CALL PRINT_STR, @"「し、しかし…何故か…それが、刺激的に思えるのです……」_W"	CALL PRINT_STR, @"「但、但是又好刺激……」_W"
CALL PRINT_STR, @"「子宮の中で、直接濃厚な精液を出されたら…ど、どのような感覚なのでしょう……_HH_」_W"	CALL PRINT_STR, @"「如果被直接在子宫里浓浓地内射了，会、会是什么感觉呢……_HH_」_W"
PRINTFORMW %CALLNAME:TARGET%はすでに快感に蕩け切った、至福の表情を浮かべている……	PRINTFORMW %CALLNAME:TARGET%已经是完全沉浸在快乐之中的表情了……
CALL PRINT_STR, @"「%CNAME("二人称")%は本当にいけない人です……_HH_」_W"	CALL PRINT_STR, @"「%CALLNAME:MASTER%真是坏心眼呢……_HH_」_W"
CALL PRINT_STR, @"「%CNAME("一人称")%のこのような所まで自分の物にしないと気が済まないのですか……_HH_」_W"	CALL PRINT_STR, @"「就连人家的这里也要宣布占领吗……_HH_」_W"
CALL PRINT_STR, @"「しかし、入れただけでは駄目ですよ%CNAME("二人称")%…とろとろで、ぷるぷるの、例の物が必要です……_HH_」_W"	CALL PRINT_STR, @"「光这样可不行呢%CALLNAME:MASTER%，还得要浓浓的，噗噜噗噜的……_HH_」_W"
PRINTFORMW %CALLNAME:TARGET%はすでに快感に蕩け切った、至福の表情を浮かべている……	PRINTFORMW %CALLNAME:TARGET%已经是完全沉浸在快乐之中的表情了……
PRINTFORMW 「ん……_HH_」	PRINTFORMW 「嗯……_HH_」
PRINTFORMW 「優しくお願いします……%CNAME("二人称")%」	PRINTFORMW 「还请温柔一点吧……%CALLNAME:MASTER%」
PRINTFORMW 「手でご奉仕すればよいのですね？かしこまりました……」	PRINTFORMW 「用手来服侍您吗？知道了……」
CALL PRINT_STR, @"「あらあら…この様子だと、そろそろ降参ですか……_HH_」_W"	CALL PRINT_STR, @"「啊啦啊啦~这样就快要投降了吗……_HH_」_W"
PRINTFORMW ペニスを握っている%CALLNAME:TARGET%に異常を感じる、笑いながら手の動きを緩めている…	PRINTFORMW 感受到手中肉棒异状的%CALLNAME:TARGET%，微笑的放慢了套弄的速度
CALL PRINT_STR, @"「出したいですか……？こっそり腰を持ち上げていますね…_HH_」_W"	CALL PRINT_STR, @"「想要释放吗……在偷偷地向上挺动着腰呢~_HH_」_W"
CALL PRINT_STR, @"「でも、まだですよ…気持ちよく射精されたいのなら、しっかりお願いして頂かないと…_HH_」_W"	CALL PRINT_STR, @"「不过还不行呦~想要舒舒服服地射出来地话，要好好地恳求呢_HH_」_W"
PRINTFORMW %CALLNAME:TARGET%の笑顔はさらに嗜虐的なものになる…	PRINTFORMW %CALLNAME:TARGET%的脸上浮现出愈加肆虐的笑容
PRINTFORML [1] %CALLNAME:TARGET%にお願いする	PRINTFORML [1] 恳求%CALLNAME:TARGET%
PRINTFORML [2] %CALLNAME:TARGET%にお願いしない	PRINTFORML [2] 不恳求%CALLNAME:TARGET%
PRINTFORML [3] 断じてお願いなどしない	PRINTFORML [3] 坚决不恳求%CALLNAME:TARGET%
CALL PRINT_STR, @"「あらあら…とってもいい子ですね_HH_」_W"	CALL PRINT_STR, @"「啊啦啊啦~这样才是好孩子嘛~_HH_」_W"
PRINTFORMW %CALLNAME:TARGET%は微笑むと、突然ペニスを激しくしごき始めた…	PRINTFORMW %CALLNAME:TARGET%微笑着，手上套弄的速度突然加快了许多
PRINTFORMW 洪水のようにこみあげてくる快感に我慢できそうにない…	PRINTFORMW 无法忍受潮水般涌上来的快感
PRINTFORMW 或いは……長い間焦らされて蓄積した破壊的な快感に……	PRINTFORMW 或者不如说……长期寸止累积的毁灭样的快乐吧……
PRINTFORMW %CALLNAME:MASTER%腰を跳ね上げながら、精を放ってしまった……	PRINTFORMW %CALLNAME:MASTER%一边挺起腰一边爆发了……
CALL PRINT_STR, @"「ほら、出てきました…ふふ…_HH_」_W"	CALL PRINT_STR, @"「要射出来了~呵呵~_HH_」_W"
CALL PRINT_STR, @"「もう、強情なんですから…_HH_」_W"	CALL PRINT_STR, @"「很矜持嘛~_HH_」_W"
PRINTFORMW %CALLNAME:TARGET%は笑顔のまま、玉をゆっくりと上下に揺すりながらいじくり回している…	PRINTFORMW %CALLNAME:TARGET%仍旧微笑了，玉手不紧不慢地上下套弄着
PRINTFORMW %CALLNAME:MASTER%が腰を持ち上げると、%CALLNAME:TARGET%もそれに合わせて手を上に挙げる。	PRINTFORMW 如果%CALLNAME:MASTER%向上挺起了一点点腰，%CALLNAME:TARGET%的手就紧跟着上移一点点。完美契合的速度让%CALLNAME:MASTER%始终无法的最重要的一点刺激
PRINTFORMW 絶妙なペースで、%CALLNAME:MASTER%の一番敏感な部分を刺激しないように焦らしている…	CALL PRINT_STR, @"「好好地恳求呢，就可以舒服起来了呦~_HH_」_W"
CALL PRINT_STR, @"「正式にお願いしてくだされば、気持ちよくして差し上げますのに…_HH_」_W"
CALL PRINT_STR, @"「どうあっても、お願いするつもりはないのですね…」_W"	CALL PRINT_STR, @"「无论如何都不愿意请求吗」_W"
PRINTFORMW 愛撫を続ける%CALLNAME:TARGET%の手は徐々に下へと移動し、最終的にペニスの根元で止まった。	PRINTFORMW 一边套弄着，%CALLNAME:TARGET%的手一边缓缓地向下移动,最终停在了肉棒的根部
CALL PRINT_STR, @"「少し、お仕置きが必要ですね…_HH_」_W"	CALL PRINT_STR, @"「就要给予一点点惩罚呢~_HH_」_W"
PRINTFORMW %CALLNAME:TARGET%は突然、細い指で%CALLNAME:MASTER%のペニスの根元を締め付けた。	PRINTFORMW %CALLNAME:TARGET%突然用纤细的指头掐住了%CALLNAME:MASTER%肉棒的根部，与此同时，套弄肉棒的速度渐渐地加快了……
PRINTFORMW 同時に、竿をしごく速度も徐々に早くなっていく……	CALL PRINT_STR, @"「其实您就是想要被惩罚吧~_HH_」_W"
CALL PRINT_STR, @"「本当は、お仕置きをご所望だったのではないですか…_HH_」_W"	PRINTFORMW 原本就在爆发边缘的肉棒，在不断的责备下已经无法忍耐了。
PRINTFORMW 射精直前のペニスは、絶え間ない攻めにとても耐えきれそうにない…	PRINTFORMW 然而唯一的出口却被%CALLNAME:TARGET%的手指给掐住了……大量的急冲冲的精液被堵在尿管里。
PRINTFORMW しかし唯一の出口は%CALLNAME:TARGET%の指によって締め付けられている……	PRINTFORMW 无法射精的干高潮的快感和被堵住的痛感交织在一起涌进了大脑……
PRINTFORMW 押し寄せる大量の精液が尿管の中で堰き止められている。	CALL PRINT_STR, @"「还是无论如何都不愿意恳求么~_HH_」_W"
PRINTFORMW 絶頂の快感と精液を堰き止められる苦痛が絡み合い、脳内を駆け巡る……	CALL PRINT_STR, @"「没办法没办法，这次就放过您吧~_HH_……不过要再等十秒呢」_W"
CALL PRINT_STR, @"「まだ、おねだりをする気にはなりませんか…_HH_」_W"
CALL PRINT_STR, @"「仕方ありませんね、今回は許して差し上げます…_HH_……十秒後に、ですけどね」_W"
CALL PRINT_STR, @"「あれあれ…？手に力が入らなくなってしまいました_HH_」_W"	CALL PRINT_STR, @"「哎呀哎呀~手上没力气了呢_HH_」_W"
PRINTFORMW 不意に、%CALLNAME:MASTER%のペニスを締め付けていた指が緩む。	PRINTFORMW 一点心理准备都没有，过量的精液涌出感觉就这么冲进了%CALLNAME:MASTER%的大脑……
PRINTFORMW 心の準備ができないままに大量の精液が噴出し、快感が脳内に流れ込む。	PRINTFORMW %CALLNAME:MASTER%的身体像一只虾子一样反弓起来，一股一股的白浊从肉棒中射出……
PRINTFORMW %CALLNAME:MASTER%は海老のように仰け反り、ペニスからドクン、ドクンと白濁が流れ出る……	CALL PRINT_STR, @"「啊啦啊啦，射的好远呢~用力地挺腰的样子，也好可爱~_HH_」_W"
CALL PRINT_STR, @"「あらあら、遠くまで飛びましたね…力いっぱい腰を突き上げて、可愛らしいです…_HH_」_W"	PRINTFORMW 然而%CALLNAME:MASTER%已经听不到%CALLNAME:TARGET%在说什么了，大脑中只有一片混杂着疼痛的白色……
PRINTFORMW しかし%CALLNAME:TARGET%の言葉は既に%CALLNAME:MASTER%には届かない
PRINTFORMW 脳内は痛み混じりの真っ白な快感で埋め尽くされている……
CFLAG:射精管理プレイ = 0	CFLAG:11001 = 0
CALL PRINT_STR, @"「気持ち良いですか…_HH_」_W"	CALL PRINT_STR, @"「觉得舒服吗~_HH_」_W"
PRINTFORMW 「何も考えなくて結構です、我慢できなくなったら射精なさってください…」	PRINTFORMW 「不用顾忌什么，忍不住了就直接射出来吧。」
PRINTFORMW しかし、%CALLNAME:TARGET%の目の奥には、異様な光がぼんやりと流れている……	PRINTFORMW 然而在%CALLNAME:TARGET%的眼中深处，隐约的流动着异样的光……
CALL PRINT_STR, @"「誠心誠意、ご奉仕させていただきますね……」_W"	CALL PRINT_STR, @"「要全面地进行服侍呢……」_W"
PRINTFORMW %CALLNAME:TARGET%は%CALLNAME:MASTER%の表情を窺いながら、手を緩めることなくペニスを弄んでいる。	PRINTFORMW %CALLNAME:TARGET%一边注意着%CALLNAME:MASTER%的表情，一边不紧不慢地套弄着的肉棒。
CALL PRINT_STR, @"「本当に、いやらしい形です……_HH_」_W"	CALL PRINT_STR, @"「真是下流的形状_HH_……」_W"
PRINTFORMW %CALLNAME:TARGET%は恍惚とした表情でペニスに奉仕している。	PRINTFORMW %CALLNAME:TARGET%一脸渴望地套弄着的肉棒。
PRINTFORMW 「ご奉仕させていただきますね……」	PRINTFORMW 「请让我来服侍您……」
PRINTFORMW 「このようにしたら……更に、気持ちよくなりますか？」	PRINTFORMW 「这样的话……会比较舒服吧」
PRINTFORMW 「どうぞ、安心してお楽しみください」	PRINTFORMW 「您就请安心地享受就好」
PRINTFORMW 「あ…それが、お望みなら……」	PRINTFORMW 「啊，如果您喜欢的话……」
CALL PRINT_STR, @"「あ……では、このやんちゃな子に、口付けをさせていただきます……_HH_」_W"	CALL PRINT_STR, @"「啊……让我去亲这个坏家伙……_HH_」_W"
PRINTFORMW %CALLNAME:TARGET%は目を閉じると、突き出した唇を近づける…	PRINTFORMW %CALLNAME:TARGET%闭上眼，撅起嘴唇凑了过来
CALL PRINT_STR, @"「んむぅ～…_H_」_W"	CALL PRINT_STR, @"「姆~」_W"
PRINTFORMW 長い長いキスの後、%CALLNAME:TARGET%は舌先でちろちろと肉棒の先端を舐めしている…	PRINTFORMW 一个长长的亲吻，结束之后，%CALLNAME:TARGET%还用舌头轻轻地舔了一下肉棒的先端
PRINTFORMW 「このような事で、満足していただけるなら……」	PRINTFORMW 「如果这样能让您满意的话……」
PRINTFORMW %CALLNAME:TARGET%は顔をしかめると、目を閉じて唇を突き出した…	PRINTFORMW %CALLNAME:TARGET%皱了皱眉头，闭上眼睛把嘴唇凑了过来
PRINTFORMW 「うぅ……」	PRINTFORMW 「唔……」
PRINTFORMW %CALLNAME:TARGET%は少し、消極的に見える…	PRINTFORMW %CALLNAME:TARGET%看起来不太情愿的样子
PRINTFORMW 「このような事……次からはお受けしませんからね……」	PRINTFORMW 「这种事……下次请不要……」
PRINTFORMW 「本当にそれが必要であるなら……」	PRINTFORMW 「如果您需要的话……」
PRINTFORMW %CALLNAME:TARGET%は舌を突き出すと、手を使って%CALLNAME:MASTER%のペニスを支える	PRINTFORMW %CALLNAME:TARGET%伸出了舌尖，用手扶着%CALLNAME:MASTER%的肉棒，一圈一圈的轻轻地舔着清理着先端
PRINTFORMW そして、先端を優しく、くるくると舐め始める…	PRINTFORMW 舌头认真地舔舐着，甚至连包皮和肉棒的连接处也没有放过
PRINTFORMW 包皮の内側の雁首まで、舌先を使って一心不乱に舐め清めていく…	PRINTFORMW 「清理好了」
PRINTFORMW 结束的时候，%CALLNAME:TARGET%突然把丰厚的嘴唇凑了上来，吻住了肉棒的先端，并用力地吮吸了几下
PRINTFORMW それが終わると、%CALLNAME:TARGET%はふっくらとした唇を突き出した…	CALL PRINT_STR, @"「姆啊……喜欢肉棒老师~」_W"
PRINTFORMW 肉棒の先端に口付けをすると、ちゅっ、ちゅっ、と強く吸う。
CALL PRINT_STR, @"「むぁ……おちんぽ様、愛しています…_H_」_W"
PRINTFORMW 「まだ…少しだけ、残っていますね……」	PRINTFORMW 「还是多多少少有一些……」
PRINTFORMW 「これは……他の女の匂いに違いないですね」	PRINTFORMW 「这味道……是其他女人的味道呢」
PRINTFORMW %CALLNAME:TARGET%はペニスに顔を寄せると匂いを嗅ぐ。	PRINTFORMW %CALLNAME:TARGET%凑近了肉棒闻了闻
PRINTFORMW そして、%CALLNAME:TARGET%はペニスを口に含んでしゃぶり始めた。	PRINTFORMW 说罢，%CALLNAME:TARGET%把肉棒含进了嘴里，開始吮吸了起来
PRINTFORMW まるで怒っているかのように吸引する力が増し、舌はペニスの周りで暴れまわっている	PRINTFORMW 像是在赌气似的，吮吸的力度很大，舌头也在肉棒的周围搅动着
CALL PRINT_STR, @"「うぅっ、んん……」_W"	CALL PRINT_STR, @"「唔，嗯嗯……」_W"
PRINTFORMW %CALLNAME:TARGET%の暖かな唾液が、肉棒を伝って%CALLNAME:MASTER%の睾丸まで流れ落ちてくる…	PRINTFORMW 大量的透明的温热唾液从%CALLNAME:TARGET%流了出来，顺着坚硬的肉杆流到了%CALLNAME:MASTER%的睾丸上。
PRINTFORMW しばらくして、%CALLNAME:MASTER%の下半身の力が抜けてしまうと、%CALLNAME:TARGET%はペニスを吐き出した。	PRINTFORMW 过了半晌，%CALLNAME:MASTER%都觉得自己下半身都瘫软了，%CALLNAME:TARGET%才把肉棒从口中吐了出来。
CALL PRINT_STR, @"「ぷはぁっ！……はー……はー…」_W"	CALL PRINT_STR, @"「噗哈！……哈~……哈~」_W"
CALL PRINT_STR, @"「やっと匂いが無くなって来ましたね…」_W"	CALL PRINT_STR, @"「已经没有味道了呦~」_W"
CALL PRINT_STR, @"「次は、どうしましょう……%CALLNAME:TARGET%の『中』の匂いを染み込ませるのはどうでしょうか…_HH_」_W"	CALL PRINT_STR, @"「接下来……要不要考虑……染上%CALLNAME:TARGET%里面的味道呢？_HH_」_W"
CALL PRINT_STR, @"「うむうぅ、んぅぅ……」_W"	CALL PRINT_STR, @"「唔唔唔，嗯嗯……_」_W"
CALL PRINT_STR, @"「…ちゅぷっ……くちゅ…ちゅっ_H_ペニスが、ビクビク震えています……_」_W"	CALL PRINT_STR, @"「…啾扑哧、咕啾…啾。肉棒颤抖起来了……_」_W"
PRINTFORMW %CALLNAME:TARGET%は責めを緩めない…暖かな口内が、頬がへこむ程に強く吸い着いてくる。	PRINTFORMW 并没有放慢口中苛责的程度，%CALLNAME:TARGET%的面颊甚至凹陷了下去，温暖的口穴中强大的吸力让%CALLNAME:MASTER%难以把持……
PRINTFORMW %CALLNAME:MASTER%の我慢は徐々に限界に近づく…	PRINTFORMW 不仅如此，%CALLNAME:TARGET%的双手也动了起来，開始揉搓起%CALLNAME:MASTER%的蛋蛋……
PRINTFORMW それだけでなく、%CALLNAME:TARGET%は両手を使って%CALLNAME:MASTER%の玉を揉みしだき始めた……	CALL PRINT_STR, @"「啾卟扑哧、啾噜…呜…嗯卟……里面的每一滴，都是属于%CALLNAME:MASTER%的_HH_」_W"
CALL PRINT_STR, @"「じゅぶぷちゅ、じゅる…んぅ…んぶっ……この中身の一滴一滴全てが、%CNAME("二人称")%の物なのですね…_HH_」_W"
CALL PRINT_STR, @"「うむうぅ、んぅぅ……」_W"	CALL PRINT_STR, @"「唔唔唔，嗯哈……」_W"
PRINTFORMW まるで極上のご馳走に出会ったかのように、%CALLNAME:TARGET%はしゃぶるのをやめようとしない……	PRINTFORMW 像是对待至上的美食一样，%CALLNAME:TARGET%不停地吮吸着……
PRINTFORMW 「どうぞ、安心してお楽しみください」	PRINTFORMW 「请您安心地享受吧」
CALL PRINT_STR, @"「…ちゅぷっ……くちゅ…ちゅっ_H_じゅるじゅる……_H__」_W"	CALL PRINT_STR, @"「…啾扑哧、咕啾…啾。呲溜呲溜……_」_W"
PRINTFORMW 「ご主人様…この悪い子は、どのように噛み切ればよろしいでしょう……」	PRINTFORMW %CNAME("二人称")%%CNAME("二人称")%说，我把这个害人的家伙咬下来怎么样……
CALL PRINT_STR, @"「くすっ、冗談です……%CALLNAME:TARGET%はそのような事、考えてはいませんよ……_HH_」_W"	CALL PRINT_STR, @"「噗嗤，開玩笑的……%CALLNAME:TARGET%才不舍得~_HH_」_W"
CALL PRINT_STR, @"「…ちゅぷっ……くちゅ…ちゅっ_H_じゅるじゅる……_H_」_W"	CALL PRINT_STR, @"「…啾扑哧、咕啾…啾。呲溜呲溜……_」_W"
PRINTFORMW 「いかがですか？気持ち良いですか？」	PRINTFORMW 「怎么样，舒服吗？」
CALL PRINT_STR, @"「%CNAME("二人称")%の物…大きすぎて、ご奉仕するのが一苦労です……_HH_」_W"	CALL PRINT_STR, @"「%CALLNAME:MASTER%的这个下流的东西太大了，侍奉起来很辛苦的_HH_……」_W"
PRINTFORMW 「射精なさる際は、%CALLNAME:TARGET%にお知らせくださいね」	PRINTFORMW 「如果您快要射了，请说一声」
PRINTFORMW 「胸を使ってご奉仕を？」	PRINTFORMW 「用胸部来服侍您吗？」
PRINTFORMW 「わかりました。」	PRINTFORMW 「好的。」
CALL PRINT_STR, @"「どうか暴れないで…メイドのご奉仕をお楽しみくださいね……_HH_」_W"	CALL PRINT_STR, @"「请不要挣扎，享受女仆的服务吧_HH_……」_W"
CALL PRINT_STR, @"「どうか暴れないで…メイドのご奉仕をお楽しみください」_W"	CALL PRINT_STR, @"「请不要挣扎，享受女仆的服务吧」_W"
PRINTFORMW 「%CNAME("一人称")%の胸が、お好きなのですか？」	PRINTFORMW 「喜欢%CNAME("一人称")%的胸部吗？」
PRINTFORMW 「%CNAME("二人称")%に気に入っていただけたなら、嬉しいです」	PRINTFORMW 「%CNAME("二人称")%喜欢就好了」
PRINTFORMW 「胸を使ってご奉仕を？」	PRINTFORMW 「用胸部来服侍您吗？」
PRINTFORMW 「わかりました。」	PRINTFORMW 「好的。」
PRINTFORMW 「これは……とても、元気ですね」	PRINTFORMW 「非常的有精神呢，这里」
PRINTFORMW 「それで、%CNAME("二人称")%はこの悪い子を使って…何をなさるおつもりですか？」	PRINTFORMW 「那么，%CNAME("二人称")%是想用这个坏家伙干什么呢~」
PRINTFORMW 「太ももの間で摩擦を……不可解な要求ですね……」	PRINTFORMW 「想在大腿之间摩擦吗……真是奇怪的要求……」
PRINTFORMW 「…はい、そう望まれるのなら」	PRINTFORMW 「不过既然是您希望的话」
PRINTFORMW 「とても、元気ですね」	PRINTFORMW 「非常的有精神呢」
PRINTFORMW 「張りつめていて、反り返っていて…とても恐ろしいです…」	PRINTFORMW 「夸张地反翘着，看起来好吓人」
PRINTFORMW 「それで、%CNAME("二人称")%はこの悪い子を使って…何をなさるおつもりですか？」	PRINTFORMW 「那么，%CNAME("二人称")%是想用这个坏家伙干什么呢~」
PRINTFORMW 「%CNAME("二人称")%は準備ができているようですね…」	PRINTFORMW 「看来%CNAME("二人称")%准备開始了」
PRINTFORMW 「契約ですから…%CNAME("二人称")%はどうぞお好きなだけ、楽しんでくださいね…」	PRINTFORMW 「根据契约，请%CNAME("二人称")%随意享受」
PRINTFORMW 「見てください、この狂暴そうな悪い子…ココに入りたいのですよね？」	PRINTFORMW 「看看这个气势汹汹的坏家伙，是不是想进到这里呢~」
PRINTFORMW 脚を開くと、瑞々しい秘所が露わになる。	PRINTFORMW 张開了双腿，露出了股间的娇嫩蜜所
PRINTFORMW 「構いませんよ…しかし、今は…」	PRINTFORMW 「可以呦~不过不是现在」
PRINTFORMW 体の上に座った%CALLNAME:TARGET%が%CALLNAME:MASTER%の目を覆う。	PRINTFORMW 坐在%CALLNAME:MASTER%的身上，%CALLNAME:TARGET%遮住了%CALLNAME:MASTER%的眼睛
PRINTFORMW 「まずはゆっくり……少しずつという事に致しましょう…」	PRINTFORMW 「要先慢慢地……一点一点地…插进去~」
PRINTFORMW %CALLNAME:MASTER%のペニスがしなやかな肉の壁に挟まれ、締め付けられるような快感を覚える…	PRINTFORMW %CALLNAME:MASTER%感觉自己的肉棒被紧实的肉壁夹住了，强烈地挤压感给肉棒带来了巨大的快感
PRINTFORMW 「あらあら……気持ちいいのですか？ペニスが中で震えていますよ？」	PRINTFORMW 「啊啦啊啦……就这么舒服吗？肉棒在里面颤抖起来了~非常非常的想要射精呢，是想让%CALLNAME:TARGET%怀孕吗？」
PRINTFORMW 「射精したくてたまらないですか？%CALLNAME:TARGET%を孕ませたいのですか？」	PRINTFORMW 松開了遮住双眼的手，%CALLNAME:MASTER%发现%CALLNAME:TARGET%正用极具肉感的大腿挤压着自己的肉棒
PRINTFORMW 不意に、目を覆っていた手が離れると…	PRINTFORMW 「没想到吧~一点点都没有插进去哦~」
PRINTFORMW %CALLNAME:TARGET%がふっくらとした太ももでペニスを締め付けている光景が目に入る…	CALL PRINT_STR, @"「抖动的更厉害了呢，是快要忍不住了吗_HH_……」_W"
PRINTFORMW 「しかし、残念ですね……本当は、挿入などされていないのですよ…」	CALL PRINT_STR, @"「真可惜呢，一滴也射不进去哦~」_W"
CALL PRINT_STR, @"「先ほどよりもビクビクしていますね…我慢できないのですか……_HH_」_W"
CALL PRINT_STR, @"「本当に惜しいです、これでは一滴も…中には入りませんよ」_W"
PRINTFORMW 「%CNAME("一人称")%の太ももで気持ち良くなりたいのですか？」	PRINTFORMW 「%CNAME("一人称")% 的大腿舒服吗？」
PRINTFORMW 「メイドとして常に立ち仕事をする身ですので…太ももには、少し自信があります…」	PRINTFORMW 「身为女仆，平时又在做运动，对大腿的力量还是有些自信的呦」
PRINTFORMW 「我慢も遠慮もなさらず、射精なさってくださいね…」	PRINTFORMW 「不要忍耐了，乖乖地射出来吧~」
PRINTFORMW 「次は、太ももを使って、%CNAME("二人称")%にお楽しみ頂きます…」	PRINTFORMW 「接下来将用大腿来服饰%CNAME("二人称")%」
PRINTFORMW 「%CNAME("一人称")%の太ももで気持ち良くなりたいのですか？」	PRINTFORMW 「%CNAME("一人称")% 的大腿舒服吗？」
PRINTFORMW 「メイドとして常に立ち仕事をする身ですので…太ももには、少し自信があります…」	PRINTFORMW 「身为女仆，平时又在做运动，对大腿的力量还是有些自信的呦」
PRINTFORMW 「心行くまでお楽しみくださいね…」	PRINTFORMW 「请尽情的享受吧~」
PRINTFORMW 「太ももに射精したいのですか？構いませんよ」	PRINTFORMW 「想用大腿来发泄吗？没问题」
PRINTFORMW %CALLNAME:TARGET%は手早く準備を始めた…	PRINTFORMW %CALLNAME:TARGET%快速地做好了准备
PRINTFORMW 「ちょっと変わったやり方ですが…お試しになりますか？」	PRINTFORMW 「来试一试其他的娱乐方式吧」
PRINTFORMW %CALLNAME:TARGET%は%CALLNAME:MASTER%のペニスを踏みつけると、爪先を柔軟に動かして刺激し始めた…	PRINTFORMW %CALLNAME:TARGET%用脚踩住%CALLNAME:MASTER%的肉棒，灵活的脚趾拨弄着
PRINTFORMW 「足を使う……ですか？」	PRINTFORMW 「想要用脚来吗……」
PRINTFORMW 「うーん…では、このまま動かないようお願いいたしますね」	PRINTFORMW 「唔…那请您就先保持这样不要动」
PRINTFORMW 「見事なまでの勃起ですね…何を期待なさっているのでしょう？」	PRINTFORMW 「这么厉害的勃起着，是在期待着什么呢？」
PRINTFORMW 「踏まれるだけで気持ちいいのですか？もうこんなに大きくなっていますよ…」	PRINTFORMW 「只是被踩着就这么舒服吗？已经变得这么大了~」
PRINTFORMW 「ペニスが震え始めましたね…少々お待ちください―」	PRINTFORMW 「肉棒開始抖动起来了呢，等一下——」
PRINTFORMW 突然、%CALLNAME:MASTER%の肉棒が痛みを感じるほどに強く踏まれた。	PRINTFORMW 踏在肉榜上的力度突然变大了一下，把%CALLNAME:MASTER%的肉棒踩到了一个会感到疼痛的角度；之后又像是像警告一样的几次踩踏
PRINTFORMW それから警告するように、ぐにぐにと何度も踏みつけられる。	CALL PRINT_STR, @"「即使是再舒服，大腿也不能动哦……」_W"
CALL PRINT_STR, @"「更に気持ち良くなりたいのであれば、どうぞ、脚を動かさないよう……」_W"	CALL PRINT_STR, @"「要像一只听话的狗狗那样，乖乖地把大腿敞開，伸着舌头等着主人的奖励哦_HH_……」_W"
CALL PRINT_STR, @"「脚を開いて舌を出して…犬のようにお行儀よく、ご主人様のご褒美を待ちましょうね……_HH_」_W"
CALL PRINT_STR, @"「如果狗狗再不听话的话，就只能把狗狗绑起来，把那两颗发情的源头拿出来了~_HH_……」_W"
CALL PRINT_STR, @"「もし、お行儀が悪ければ…縛り上げて発情の原因を『取り除く』だけですから……_HH_」_W"	PRINTFORMW 玉足上的力道渐渐地加大了，一会儿用两只灵活的脚趾玩弄着龟头，一会儿则对着勃起到极限的肉棒踩踏着
PRINTFORMW 玉を徐々に強く踏まれる…かと思えば両足で亀頭をいじられ…そして、限界まで勃起した肉棒を踏まれ…	PRINTFORMW 「啊啦啊啦，小狗狗快不行了呢~」
PRINTFORMW 「あらあら、子犬ちゃんはもう駄目みたいですね？」	PRINTFORMW 用脚狠狠地踩住了肉棒，然后晃蹭着脚面
PRINTFORMW ペニスをひときわ強く踏みつけると、足の裏でぐりぐりと擦る。	PRINTFORMW 「小狗狗不能现在就投降哦，%CNAME("一人称")%还没有玩够呢」
PRINTFORMW 「しかし、降参するには早いですよ、子犬ちゃん…%CNAME("一人称")%はまだまだ楽しみたいのです…」	PRINTFORMW 之后又是没有止境的足交地狱
PRINTFORMW そこからは、いつ終わるともわからない足コキ地獄が続いた…
PRINTFORMW 「見事なまでの勃起ですね…こんなに大きくして、何を期待なさっているのでしょう？」	PRINTFORMW 「这么厉害的勃起着，已经变得这么大了，是在期待着什么呢？」
PRINTFORMW 「気持ちいいご褒美ですか…？それとも、痛い痛いお仕置きですか？」	PRINTFORMW 「是想要舒舒服服的奖励呢，还是痛痛快快的惩罚呢？」
PRINTFORMW 「ペニスが震え始めましたね……それよりも、答えていただけない場合、思い切り踏んでしまいますよ？」	PRINTFORMW 「肉棒開始抖动起来了呢，再不回答就要狠狠地踩下去了~」
PRINTFORMW %CALLNAME:TARGET%はペニスを軽く爪先で蹴りつつ、%CALLNAME:MASTER%の顔色を窺いながら微笑んでいる。	PRINTFORMW 轻轻地用大脚趾踢着阴茎，%CALLNAME:TARGET%微笑地观察着%CALLNAME:MASTER%的神色
PRINTFORMW 「また足での奉仕をご所望ですか…？」	PRINTFORMW 「还是想让用脚吗…」
PRINTFORMW 「今回からは少し力加減を変更いたしましょうか？」	PRINTFORMW 「这次要不要考虑力度稍微大一点呢？」
PRINTFORMW 「本当に変態なのですね…いつも踏まれる事を求めて、踏まれるとこんなに大きくして…」	PRINTFORMW 「真是变态呢，总是想被踩，一踩还变的这么大~」
PRINTFORMW 「しかも罵られるとビクビク震えて…%CNAME("二人称")%はそれ程までに興奮しているのですか？」	PRINTFORMW 「一骂就又有很精神地挺动了几下呢，这也能让%CNAME("二人称")%这么兴奋的吗」
PRINTFORMW 「色魔」（ぐに）	PRINTFORMW 「色鬼~」（踩）
PRINTFORMW 「ド変態」（ぐに）	PRINTFORMW 「大变态~」（踩）
PRINTFORMW 「節操無し」（げしっ）	PRINTFORMW 「到处沾花惹草~」（用力踩）
PRINTFORMW 「発情期の種犬」（げしっ）	PRINTFORMW 「发情的种狗~」（用力踩）
CALL PRINT_STR, @"「あらあら、そういえば…種犬のほうがご主人様ではおかしいですね……_HH_」_W"	CALL PRINT_STR, @"「啊啦啊啦，种狗主人要不行了呢~_HH_……」_W"
PRINTFORMW 「見事なまでの勃起ですね…何を期待なさっているのでしょう？」	PRINTFORMW 「这么厉害的勃起着，是在期待着什么呢？」
PRINTFORMW 「気持ちいいご褒美ですか…？それとも、痛い痛いお仕置きですか？」	PRINTFORMW 「是想要舒舒服服的奖励呢，还是痛痛快快的惩罚呢？」
PRINTFORMW 「恥ずかしがらず、足を開いてください…主人を急かすなど、本当はしたくないのですよ…？」	PRINTFORMW 「要乖乖的地张開大腿，一字一句的不能焦急的说出来哦~」
PRINTFORMW %CALLNAME:TARGET%はそっとペニスを踏みつけると、微笑みながら%CALLNAME:MASTER%を見下ろした。	PRINTFORMW 轻轻地踩着阴茎，%CALLNAME:TARGET%微笑地俯视着%CALLNAME:MASTER%
PRINTFORMW 「また足での奉仕をご所望ですか…？」	PRINTFORMW 「还是想让用脚吗…」
PRINTFORMW 「承知しました…」	PRINTFORMW 「遵命…」
CALL PRINT_STR, @"「はい？ご、ごっこ遊び…ですか？」_W"	CALL PRINT_STR, @"「啊？要，要玩角色扮演吗？」_W"
CALL PRINT_STR, @"「%CNAME("一人称")%は何の役をすれば？え？新婚の夫婦？」_W"	CALL PRINT_STR, @"「要扮演什么？嗯？新婚妻子？」_W"
CALL PRINT_STR, @"「…本当に……おかしなご命令です……_BH_」_W"	CALL PRINT_STR, @"「呀，真是……奇怪的要求啊……_BH_」_W"
CALL PRINT_STR, @"「はい？ごっこ遊び…ですか？」_W"	CALL PRINT_STR, @"「啊？要玩角色扮演吗？」_W"
CALL PRINT_STR, @"「%CNAME("一人称")%は何の役をすれば？え？新婚の夫婦？」_W"	CALL PRINT_STR, @"「要扮演什么？嗯？新婚妻子？」_W"
CALL PRINT_STR, @"「わかりました……」_W"	CALL PRINT_STR, @"「遵命……」_W"
CALL PRINT_STR, @"「あ……またですか…_H_」_W"	CALL PRINT_STR, @"「啊……又来了_H_」_W"
CALL PRINT_STR, @"「構いませんよ……愛する旦那様～…_HH_」_W"	CALL PRINT_STR, @"「好的呢……亲爱的老公～～～_HH_」_W"
CALL PRINT_STR, @"「お帰りなさいませ、今日も一日お疲れさまでした…」_W"	CALL PRINT_STR, @"「欢迎回家，一天辛苦了呢，亲爱的～」_W"
CALL PRINT_STR, @"「まずはお食事にしますか？お風呂にしますか？それとも…%CNAME("一人称")%、ですか……_BH_」_W"	CALL PRINT_STR, @"「那亲爱的是要先吃饭，先洗澡还是……先吃我呢～～～_BH_」_W"
CALL PRINT_STR, @"「お帰りなさいませ、今日も一日お疲れさまでした…」_W"	CALL PRINT_STR, @"「欢迎回家，一天辛苦了呢，亲爱的～」_W"
CALL PRINT_STR, @"「まずはお食事にしますか、お風呂にしますか……_HH_」_W"	CALL PRINT_STR, @"「那亲爱的是要先吃饭，先洗澡还是……_HH_」_W"
CALL PRINT_STR, @"「いえ…それよりも、まずは%CNAME("二人称")%を頂きたいです……ふふ_HH_」_W"	CALL PRINT_STR, @"「先让我吃掉%CNAME("二人称")%呢……咯咯_HH_」_W"
CALL PRINT_STR, @"「お帰りなさいませ、今日も一日お疲れさまでした…」_W"	CALL PRINT_STR, @"「欢迎回家，一天辛苦了呢，亲爱的～」_W"
CALL PRINT_STR, @"「まず%CNAME("一人称")%にしますか？或いは%CNAME("一人称")%ですか？それとも…%CNAME("一人称")%、ですか？_HH_」_W"	CALL PRINT_STR, @"「那亲爱的是要先吃我，先吃我，还是先吃我呢？_HH_」_W"
PRINTFORMW 違いが判らない……	PRINTFORMW 有什么区别吗啊喂……
CALL PRINT_STR, @"「今夜、%CNAME("二人称")%の妻になれば…家賃を待っていただけるのですか？」_W"	CALL PRINT_STR, @"「扮演妻子陪老师做一次，就可以免除房租吗？」_W"
CALL PRINT_STR, @"「わ、わかりました……お金、本当にないですし……一回だけですからね……」_W"	CALL PRINT_STR, @"「那……那好吧……实在是没有钱了……只有这一次……」_W"
PRINTFORMW %CALLNAME:TARGET%もじもじしながら頭を下げ、胸の前で両手を交差させている……	PRINTFORMW %CALLNAME:TARGET%扭扭捏捏地低着头说道，双手不情愿样的交叉在胸前……
PRINTFORMW 今日の設定は生活に困った女性なのだろうか？	PRINTFORMW 今天的SCENE是困境中的女租客吗？
CALL PRINT_STR, @"「新妻オプション追加してくれるの？！パパって本当にやさしい！」_W"	CALL PRINT_STR, @"「扮演妻子可以加钱吗，老师真是慷慨啊！」_W"
CALL PRINT_STR, @"「%CNAME("二人称")%何言ってるの？こんなの演技だし……マジなわけないでしょ？！」_W"	CALL PRINT_STR, @"「%CNAME("二人称")%说什么？其实是真的想……不可能啦！只是扮演而已，怎么可能是真的呐！」_W"
PRINTFORMW %CALLNAME:TARGET%は腕組みをして、大声で話している……	PRINTFORMW %CALLNAME:TARGET%双手抱在胸前，大声地和对话着……
PRINTFORMW どうやら援助交際のロールプレイをしているようだ………	PRINTFORMW 这是在扮演援交的JK吗……
CALL PRINT_STR, @"「はい？また、ごっこ遊び…ですか？」_W"	CALL PRINT_STR, @"「啊？又要玩角色扮演吗？」_W"
CALL PRINT_STR, @"「わかりました。」_W"	CALL PRINT_STR, @"「遵命。」_W"
PRINTFORMW 「%CNAME("二人称")%は本当に、このように扱われて喜ぶ方がいると思うのですか？」	PRINTFORMW 「%CNAME("二人称")%真的觉得，有人会希望这样被对待吗？」
PRINTFORMW 「もしそのような方が存在したとしても…%CNAME("一人称")%は違います」	PRINTFORMW 「即使有那样的人……也不会是我」
PRINTFORMW 「我々が結んでいるのは、一般的な主従契約であるということをお忘れなきように」	PRINTFORMW 「请记住我们之间只是契约関系而已」
PRINTFORMW 少し体が震えてはいたが、メイドの眼差しは力強いものだった	PRINTFORMW 尽管身体有些轻微的颤抖，但是女仆的眼神非常清亮
CALL PRINT_STR, @"「やめて……もう、お豆は、やめてくださいっ_HH_」_W"	CALL PRINT_STR, @"「别再……别再挑逗小豆豆了啊_HH_」_W"
CALL PRINT_STR, @"「何度も逝ってしまって……敏感なのです…_HH_」_W"	CALL PRINT_STR, @"「去了太多次……好敏感_HH_」_W"
PRINTFORMW %CALLNAME:TARGET%は両足をギュッと閉じた…	PRINTFORMW %CALLNAME:TARGET%紧紧地夹住了大腿
CALL PRINT_STR, @"「お豆、もう無理です……_BH_」_W"	CALL PRINT_STR, @"「阴蒂、不行了……_BH_」_W"
PRINTFORMW %CALLNAME:TARGET%は自分を落ち着かせようと絶え間なく呼吸をしている。	PRINTFORMW %CALLNAME:TARGET%不停地喘着气，想要让自己能够平静下来。
PRINTFORMW 普段の冷たい仮面のような表情が徐々に溶けていく……	PRINTFORMW 素日里的冰冷的面具開始慢慢融化了……
CALL PRINT_STR, @"「何度も逝ってしまって……お豆、とても敏感でっ」_W"	CALL PRINT_STR, @"「去了太多次了……小豆豆现在还非常的敏感」_W"
CALL PRINT_STR, @"「どうか…ゆっくり、優しく……_HH_」_W"	CALL PRINT_STR, @"「请您慢慢地、温柔一些……_HH_」_W"
PRINTFORMW 抗議しながらも、%CALLNAME:TARGET%は自らの太ももをゆっくりと擦り合わせている…	PRINTFORMW 一边抱怨着，%CALLNAME:TARGET%夹住的大腿一边慢慢地相互摩擦着
CALL PRINT_STR, @"「ひぁぁっ…あぁ～っ、あぁぁぁぁっ……_H_お豆がぁっ_H_」_W"	CALL PRINT_STR, @"「啊哈～啊哈～啊哈～……小豆豆_H_」_W"
PRINTFORMW %CALLNAME:TARGET%は自分を落ち着かせようと絶え間なく呼吸をしているが、効果はないようだ。	PRINTFORMW %CALLNAME:TARGET%不停地喘着气，想要让自己能够平静下来。然而一点效果都没有。
PRINTFORMW 表情は、普段の冷たい仮面のようなそれではなく、さらなる刺激への欲望に満ちている……	PRINTFORMW 取代平日里冷冰冰面孔的，是被挑逗后满脸的欲求呢……
CALL PRINT_STR, @"「こんなっ……こんなに素敵なのは……初めてです……_HH_」_W"	CALL PRINT_STR, @"「天呐……这么厉害的……从来没有过……_HH_」_W"
CALL PRINT_STR, @"「ああぁんっ、ひぁっ……あぁぁぁ～っ_H_お腹の中がっ、滅茶苦茶ですよぉ…_HH_」_W"	CALL PRINT_STR, @"「啊哈～啊哈～啊哈～，里面已经一塌糊涂了……_HH_」_W"
PRINTFORMW %CALLNAME:TARGET%は自分を落ち着かせようと絶え間なく呼吸をしている。	PRINTFORMW %CALLNAME:TARGET%不停地喘着气但是一点都平静不下来。
PRINTFORMW 顔は既に真っ赤に染まっており、その目は完全に蕩け切っている。	PRINTFORMW 脸上早已经是绯红一片，眼神也完完全全地迷离了。
CALL PRINT_STR, @"「んぁっ…やぁぁ、あぁ～～っ……_BH_」_W"	CALL PRINT_STR, @"「啊哈～啊哈～啊哈～……_BH_」_W"
PRINTFORMW %CALLNAME:TARGET%は自分を落ち着かせようと絶え間なく呼吸をしている。。	PRINTFORMW %CALLNAME:TARGET%不停地喘着气，想要让自己能够平静下来。
PRINTFORMW 普段の冷たい仮面のような表情が徐々に溶けていく……	PRINTFORMW 素日里的冰冷面具開始融化了……
CALL PRINT_STR, @"「そんなっ……おまんこが、もう…もう……壊れてしまいます……_HH_」_W"	CALL PRINT_STR, @"「天呐……小穴已经……已经……要坏掉了……_HH_」_W"
CALL PRINT_STR, @"「%CNAME("二人称")%の性欲は強すぎます……普通の女の子では確実に壊れてしまいます……_HH_」_W"	CALL PRINT_STR, @"「%CALLNAME:MASTER%的欲望好强啊……一般的女孩子肯定会被弄坏的吧……_HH_」_W"
CALL PRINT_STR, @"「他の方が被害を受けては困りますから…どうか、全てを%CNAME("一人称")%に叩きつけてください…_HH_」_W"	CALL PRINT_STR, @"「不能让这个坏家伙祸害别人啊……请全部、全部发泄在我的里面吧～_HH_」_W"
PRINTFORMW %CALLNAME:TARGET%は「戦闘続行」！と冗談を言った。	PRINTFORMW %CALLNAME:TARGET%使用了「战斗续行」！開玩笑的。
CALL PRINT_STR, @"「あっぁっ、あぁぅっ……ひぁぁぁぁっ……うぅ_H_」_W"	CALL PRINT_STR, @"「啊哈～啊哈～啊哈～……额_H_」_W"
PRINTFORMW %CALLNAME:TARGET%は自分を落ち着かせようと絶え間なく呼吸をしているが、ほぼ効果はないようだ。	PRINTFORMW %CALLNAME:TARGET%不停地喘着气，想要让自己能够平静下来。然而几乎一点效果都没有。
PRINTFORMW 表情は、普段の冷たい仮面のようなそれではなく、快楽の中に浸っている様子が見て取れる……	PRINTFORMW 取代平日里冷冰冰面孔的，是一副沉浸在快乐中的表情……
CALL PRINT_STR, @"「胸が、ふわふわして……こんなの初めてです……_HH_」_W"	CALL PRINT_STR, @"「胸部酥酥麻麻的……从来没有过……_HH_」_W"
PRINTFORMW %CALLNAME:TARGET%は艶めかしく喘ぎ、豊満な乳房が呼吸に合わせて揺れている。	PRINTFORMW %CALLNAME:TARGET%娇喘着，丰满的胸部随着呼吸抖动着
CALL PRINT_STR, @"「ふぁっ…ぁ、あぁぁ～～っ……_BH_」_W"	CALL PRINT_STR, @"「啊哈～啊哈～啊哈～……_BH_」_W"
PRINTFORMW %CALLNAME:TARGET%は自らの敏感な胸部を抱きしめ、激しく喘いでいる	PRINTFORMW %CALLNAME:TARGET%双臂环抱着保护住自己敏感的胸部，剧烈地喘息着
PRINTFORMW %CALLNAME:TARGET%は快楽に溺れ始めているようだ……	PRINTFORMW %CALLNAME:TARGET%開始感受到快乐了呢……
CALL PRINT_STR, @"「とても、気持ち良いです……胸が、張ってきてしまいました……_BH_」_W"	CALL PRINT_STR, @"「太舒服了啦……胸部变得好胀……_BH_」_W"
PRINTFORMW 徹底的に責められた%CALLNAME:TARGET%の胸の先端はピンと立ち、真っ白い母乳が球になって染み出している	PRINTFORMW 受到了过量的刺激的%CALLNAME:TARGET%胸部的尖端挺立着，几滴白色的乳汁沁了出来悬挂在乳珠上
CALL PRINT_STR, @"「パンパンに張っていて、妙な感覚です…よろしければ…吸って、いただけませんか…？」_W"	CALL PRINT_STR, @"「真的胀的好难受啦，来，帮我吸一下吧」_W"
PRINTFORMW そう言うと、%CALLNAME:TARGET%が豊満な胸をこちらに突き出すと、浮き出た母乳の玉が%CALLNAME:MASTER%の鼻先に迫る…	PRINTFORMW 说着%CALLNAME:TARGET%挺起了丰满的胸部靠了过来， 挺立着的乳珠甚至要凑到%CALLNAME:MASTER%的鼻子上了
PRINTFORMW ミルクの香りに交じって、仄かに%CALLNAME:TARGET%の匂いがする。%CALLNAME:MASTER%はしゃぶりつかずにはいられない…	PRINTFORMW 闻到了一股淡淡的奶香味，还夹杂了一点点%CALLNAME:TARGET%的体味呢。%CALLNAME:MASTER%情不自禁地咬了上去
CALL PRINT_STR, @"「あぁ…ぁ…どうか優しくっ……しゃぶりつきながら、揉まないでください……やめてっ…また、逝って…うぅっ_HH_」_W"	CALL PRINT_STR, @"「啊…啊…轻一点……不要一边吸一边像挤奶一样揉着胸部啊……等一下，又要去了…唔_HH_」_W"
CALL PRINT_STR, @"「とても、気持ち良いです……胸が、ふわふわします……_BH_」_W"	CALL PRINT_STR, @"「太舒服了啦……胸部酥酥麻麻的……_BH_」_W"
PRINTFORMW 徹底的に責められた%CALLNAME:TARGET%の胸の先端はピンと立ち、呼吸に合わせて%CALLNAME:MASTER%の目の前で上下に揺れている。	PRINTFORMW 受到了过量的刺激的%CALLNAME:TARGET%的胸部的尖端挺立着，随着呼吸在%CALLNAME:MASTER%的视野里一上一下地抖动
CALL PRINT_STR, @"「いつも胸ばかり責められている気がします…少しは、大きくなったように見えますか？」_W"	CALL PRINT_STR, @"「一直欺负胸部，感觉是不是变大了呢？」_W"
CALL PRINT_STR, @"「あぁぁ…やめてください……また、逝ってしまいます…_HH_」_W"	CALL PRINT_STR, @"「啊…别闹了……又要去了啊…_HH_」_W"
CALL PRINT_STR, @"「あんっ…あぁぁっ…はぁぁぁ～……うぅっ…_H_」_W"	CALL PRINT_STR, @"「啊哈～啊哈～啊哈～……额_H_」_W"
PRINTFORMW %CALLNAME:TARGET%は快楽から逃れようと絶え間なく呼吸をしているが。ほぼ効果はないようだ。	PRINTFORMW %CALLNAME:TARGET%不停地喘着气，想要让自己尽快地摆脱过量的快乐。然而几乎一点效果都没有。
PRINTFORMW 表情は、普段の冷たい仮面のようなそれではなく、快楽の中に浸っている様子が見て取れる……	PRINTFORMW 取代平日里冷冰冰面孔的，是一副沉浸在快乐中的表情……
PRINTFORMW 「っ……痛いっ…！」	PRINTFORMW 「嘶……好痛」
PRINTFORMW 「どうして、このようなことを…」	PRINTFORMW 「为什么，会这么痛？」
PRINTFORMW 「恐いです…どうして……」	PRINTFORMW 「好害怕……为什么」
PRINTFORMW %CALLNAME:TARGET%はメイドとしての体面を維持しようと努めている。	PRINTFORMW 还努力的想维持一个体面的女仆的形象。
PRINTFORMW しかし残念ながら…その体は完全に快楽の味を覚え込んでしまっているようだ。	PRINTFORMW 然而很遗憾……身体却自发的记住了快乐的味道。
PRINTFORMW 氷の仮面のような表情は崩れ落ち、その下からは快楽に溺れた雌の顔が覗いている……	PRINTFORMW 冰冷的面具崩裂開来，下面露出的是沉迷在快乐中的雌性的面容……
PRINTFORMW 「あぁ……まさか……」	PRINTFORMW 「啊……怎么会……」
PRINTFORMW 「生きた魂を手に入れるだけのつもりが、こんな事になってしまうとは……」	PRINTFORMW 「本来只是想取得维生的灵魂，并没有想到会……」
CALL PRINT_STR, @"「これでは……もう、逃げられませんね……_BH_」_W"	CALL PRINT_STR, @"「这样的话……逃、逃不掉了啊……_BH_」_W"
PRINTFORMW 「ご自身だけでそんなに興奮できるのですか…？」	PRINTFORMW 「自己来也可以那么兴奋的吗？」
PRINTFORMW 「それとも、%CNAME("二人称")%は…%CALLNAME:TARGET%に見られて興奮していたんですか？」	PRINTFORMW 「还是说，是被%CALLNAME:TARGET%看着让%CALLNAME:MASTER%变得这么兴奋了呢？」
PRINTFORMW 「あ……お腹の上に……」	PRINTFORMW 「啊……射在肚子上了……」
PRINTFORMW ペニスがビクビクと震え、%CALLNAME:MASTER%は%CALLNAME:TARGET%のお腹に刻まれた淫紋の上に射精する。	PRINTFORMW 肉棒一翘一翘的，%CALLNAME:MASTER%狠狠地喷射在%CALLNAME:TARGET%的小腹的粉色纹路上
PRINTFORMW 「とても……熱いです……お腹の中まで、伝わってきます…」	PRINTFORMW 「好……好烫啊……里面一下子就有感觉了」
PRINTFORMW 撒き散らされた白濁に覆われたピンク色の模様が仄かに輝き始める…	PRINTFORMW 被泼溅出的乳白色覆盖的粉色纹路開始隐隐的发亮
CALL PRINT_STR, @"「あはぁ……心なしか…お腹が空いてきてしまいました_HH_」_W"	CALL PRINT_STR, @"「啊哈~肚子里面好空…好像要_HH_」_W"
PRINTFORMW 「わざと淫紋の上に出しましたね……」	PRINTFORMW 「故意在向淫纹上喷射吗……」
PRINTFORMW 真っ白な精液が、小麦色の引き締まったお腹に刻まれた淫紋に撒き散らされている。	PRINTFORMW 大量的乳白色精液滴覆盖在小麦色的结实小腹和上面的粉色纹路上
PRINTFORMW それに伴い、%CALLNAME:TARGET%の呼吸は徐々に激しいものへと変わっていく。	PRINTFORMW 跟随着%CALLNAME:TARGET%有些急促的呼吸一上一下地起伏着
PRINTFORMW %CALLNAME:MASTER%が果てると、真っ白な精液が小麦色の引き締まったお腹に撒き散らされた。	PRINTFORMW 伴随着%CALLNAME:MASTER%的爆发，大量的乳白色精液滴覆盖在小麦色的结实小腹上
PRINTFORMW 白濁の雫は徐々に形を変え、黒い肌の上に白い模様が形成され始めている…	PRINTFORMW 甚至还有開始汇聚的乳白色，慢慢地在黑肉上形成了一滩白渍
PRINTFORMW 「あ……全部、顔に……」	PRINTFORMW 「啊……全部都射在脸上了……」
PRINTFORMW %CALLNAME:TARGET%は舌を伸ばして口の周りの精液をぺろりと舐め取ると、満足そうな表情を浮かべた。	PRINTFORMW %CALLNAME:TARGET%伸出舌尖，一圈圈地舔舐着嘴唇和嘴唇周边的精液，漏出了满意的神情
CALL PRINT_STR, @"「んぁ……とても美味しかったです、ご馳走様でした…_HH_」_W"	CALL PRINT_STR, @"「嗯啊~真是美味呢，谢谢款待~_HH_」_W"
PRINTFORMW 命令に従い、%CALLNAME:TARGET%は顔をこちらに向けて%CALLNAME:MASTER%の射精を受け止めた。	PRINTFORMW 听从了命令，%CALLNAME:TARGET%扬起脸庞承接着%CALLNAME:MASTER%的爆发，大量的精液被喷射在的脸上，然后顺着面部的轮廓流下
PRINTFORMW 顔に向かって吐き出された精液は、輪郭に沿って徐々に垂れ堕ちていく…	PRINTFORMW 然而因为过于黏稠的原因，还是有大量的液体留在了脸部，形成了一张乳白色的面膜
PRINTFORMW しかし、濃厚すぎた精液は、膜のような状態で顔に貼り付いたままになっている。	PRINTFORMW 过多的白浊甚至让%CALLNAME:TARGET%的眼睛都睁不開了
PRINTFORMW その量も余りに多すぎて、%CALLNAME:TARGET%は目も開けられないようだ。	PRINTFORMW 并没有做任何清洁，%CALLNAME:TARGET%仍然扬着脸向%CALLNAME:MASTER%展示着……
PRINTFORMW それを拭き取ろうともせず、%CALLNAME:TARGET%は依然%CALLNAME:MASTER%に向かって顔を向けて見せている……
PRINTFORMW %CALLNAME:MASTER%が果てると、大量の精液が%CALLNAME:TARGET%の顔に撒き散らされた。	PRINTFORMW 伴随着%CALLNAME:MASTER%的爆发，大量的精液被射在了%CALLNAME:TARGET%的脸上
PRINTFORMW 額、眉毛、鼻先、唇…到る所に白く濁った液体が貼り付いている。	PRINTFORMW 额头，眉毛，鼻尖，嘴唇，到处都是浑浊的液体
PRINTFORMW %CALLNAME:MASTER%が射精し終わった後で、%CALLNAME:TARGET%はティッシュで顔をサッと拭いた。	PRINTFORMW 待%CALLNAME:MASTER%喷射完毕后，%CALLNAME:TARGET%用纸巾简单地清理了一下自己的面部
PRINTFORMW 「あらあら…そんなに興奮したんですか？」	PRINTFORMW 「啊啦啊啦，变得这么兴奋的吗？」
PRINTFORMW 「びゅびゅー、って噴き出して……まるで壊れた蛇口みたいです…」	PRINTFORMW 「噗噗的大量地喷出来了……像坏掉的水龙头一样呢」
PRINTFORMW 「射精の瞬間に、腰が跳ね上がって、睾丸がキュッと縮んで…%CNAME("一人称")%、もう一度見たいです…」	PRINTFORMW 「努力地挺着腰缩紧蛋蛋射精的样子，就%CNAME("一人称")%让再看一看吧~」
PRINTFORMW 「あらあら…そんなに興奮したんですか？」	PRINTFORMW 「啊啦啊啦，变得这么兴奋的吗？」
PRINTFORMW 「びゅびゅー、ってこんなに沢山噴き出して……」	PRINTFORMW 「噗噗的大量射出来了呢……」
CALL PRINT_STR, @"「気持ちよさそうに腰を突き上げて、とても可愛いですね……_BH_」_W"	CALL PRINT_STR, @"「舒服地腰都挺直了的样子，很可爱呢……_BH_」_W"
PRINTFORMW 「興奮しているようですね、こんなにたくさん出されるなんて…」	PRINTFORMW 「看来您很兴奋呢，射出来那么多」
PRINTFORMW 「そうですね、休憩なさいますか？それともこのまま続きを？」	PRINTFORMW 「所以，是先休息一下还是继续呢？」
PRINTFORMW 「ご自身だけでそんなに興奮できるのですか…？」	PRINTFORMW 「自己来也可以那么兴奋的吗？」

PRINTFORMW 「それとも、%CNAME("二人称")%は…%CALLNAME:TARGET%に見られて興奮していたんですか？」	PRINTFORMW 「还是说，是被%CALLNAME:TARGET%看着让%CALLNAME:MASTER%变得这么兴奋了呢
PRINTFORMW 「全部脚に出してまったのですね…」	PRINTFORMW 「全部都射在脚上了呢」
PRINTFORMW 「とても熱くて、べっとりしてます…」	PRINTFORMW 「热热的，而且好黏~」
CALL PRINT_STR, @"「本当に、変態ですね…_HH_」_W"	CALL PRINT_STR, @"「真是变态呢_HH_」_W"
PRINTFORMW 「%CNAME("二人称")%は脚に出すのがお好きなようですね」	PRINTFORMW 「%CNAME("二人称")%喜欢射在脚上吗」
PRINTFORMW 「構いませんよ、どこに出すのも%CNAME("二人称")%の自由です」	PRINTFORMW 「没什么，想射在哪里是%CNAME("二人称")%的自由」
PRINTFORMW 「ただ、後始末をするのは少し手間ですが」	PRINTFORMW 「只是打理起来有些麻烦罢了」
PRINTFORMW 「あらあら…また%CNAME("一人称")%の脚にこんなに沢山……」	PRINTFORMW 「啊啦啊啦，又在%CNAME("一人称")%的脚上射了这么多」
PRINTFORMW 「足の指に貼りついて不快です…見てくださいよ%CNAME("二人称")%」	PRINTFORMW 「真恶心呀，都黏在脚趾上了，%CNAME("二人称")%看」
PRINTFORMW %CALLNAME:TARGET%は%CALLNAME:MASTER%の目の前に足を突き出すと、指を大きく開いて見せた。	PRINTFORMW %CALLNAME:TARGET%把玉足伸到了%CALLNAME:MASTER%的面前，为了展示把脚趾灵活地分開，粘稠的精液在中间连成了丝
PRINTFORMW 指の間ではドロドロとした精液が糸を引いている…	PRINTFORMW 「把这么多又黏又臭的射在%CNAME("一人称")%的脚上，真变态啊%CALLNAME:MASTER%」
PRINTFORMW 「臭くてねばついた精液をこんなに沢山%CNAME("一人称")%の脚に出すなんて、%CNAME("二人称")%は本当に変態ですね」
PRINTFORMW 「あれ？%CNAME("二人称")%、%CNAME("一人称")%の脚ばかりご覧になっていますね」	PRINTFORMW 「啊咧，%CNAME("二人称")%怎么在这么用心地看%CNAME("一人称")%的脚呀」
PRINTFORMW 「精液が付いた%CNAME("一人称")%の脚…そんなにお好きなのですか？」	PRINTFORMW 「是喜欢%CNAME("一人称")%脚上沾满自己的汁液的样子吗」
PRINTFORMW %CALLNAME:TARGET%がゆらゆらと左右に脚を揺らすのを、%CALLNAME:MASTER%はつい目線で追ってしまう	PRINTFORMW %CALLNAME:TARGET%调皮地左右轻轻晃了晃自己的脚，%CALLNAME:MASTER%的目光下意识地跟随着移动
PRINTFORMW 「んふふ、変態ですね…今回だけは特別に、%CNAME("二人称")%にも後始末を手伝うことを許可しましょう」	PRINTFORMW 「嗯哼~，大变态，就这一次哦，特别允许%CNAME("二人称")%帮%CNAME("一人称")%做做清洁吧」
PRINTFORMW 「感謝しながら、舌で舐めて奇麗にしてください…少しで構いませんよ」	PRINTFORMW 「要心怀感激地，一点点用舌头舔干净呦~」
PRINTFORMW 白くねばつく足が%CALLNAME:MASTER%の口元に突き出される……	PRINTFORMW 沾着白浊的玉足凑近了%CALLNAME:MASTER%的嘴边……
PRINTFORMW 「あらあら…また%CNAME("一人称")%の脚に出されたのですね」	PRINTFORMW 「啊啦啊啦，又射在%CNAME("一人称")%的脚上了」
PRINTFORMW 「本当に変わった好みをしていらっしゃいますね……」	PRINTFORMW 「这是什么奇怪的癖好啊……」
PRINTFORMW %CALLNAME:TARGET%が精液まみれの脚を軽く揺らす光景に、%CALLNAME:MASTER%の目は吸い寄せられてしまう…	PRINTFORMW %CALLNAME:TARGET%轻轻地晃动着沾着白浊的脚，%CALLNAME:MASTER%的目光不由自主的跟随着
PRINTFORMW 「ご主人様の…変態」	PRINTFORMW 「大·变·态」
PRINTFORMW 「また脚に出されたのですね」	PRINTFORMW 「又射在脚上了吗」
PRINTFORMW 「どうぞ、後始末は%CNAME("一人称")%にお任せください」	PRINTFORMW 「请让%CNAME("一人称")%先打理一下」
PRINTFORMW 「あら、ここに出してしまったのですか？」	PRINTFORMW 「啊啦，射在大腿上了吗？」
CALL PRINT_STR, @"「もしかすると…中で出すつもりが、我慢できなかったのですか？んふふ…_HH_」_W"	CALL PRINT_STR, @"「还是说，想要射在里面，但是没撑住提前投降了呢？嗯哼~_HH_」_W"
PRINTFORMW %CALLNAME:TARGET%の小麦色をした引き締まった内腿は撒き散らされた白濁で彩られている	PRINTFORMW %CALLNAME:TARGET%小麦色皮肤的结实的大腿内侧，布满了爆发出来的乳白浑浊
PRINTFORMW 大事な所が危険な精液に覆われている様は、どこか淫靡な眺めだ…	PRINTFORMW 重要的地方周围被危险的种汁包围，看起来显得有些淫霏
PRINTFORMW 「うぅ…口の中に出したのですね」	PRINTFORMW 「唔…在口中射出来了吗」
PRINTFORMW 「これで満足なのですか？」	PRINTFORMW 「这样的话满意了吗？」
CALL PRINT_STR, @"「うぅん、うぅ…じゅるるっ……」_W"	CALL PRINT_STR, @"「唔嗯、唔~啾……」_W"
PRINTFORMW %CALLNAME:TARGET%は絶頂に震えるペニスを咥え込み、必死で精液を嚥下している。	PRINTFORMW %CALLNAME:TARGET%用口穴接住爆发的肉棒，努力的吞咽着射出的种汁。
CALL PRINT_STR, @"「うううっ……！げぉっ！げほっ！……」_W"	CALL PRINT_STR, @"「唔唔……！咳！咳！……」_W"
PRINTFORMW しかし射精量が多すぎたのか、飲みきれなかった精液が鼻から逆流し、%CALLNAME:TARGET%は激しくむせ返っている。	PRINTFORMW 然而射出的量实在是太大了，来不及吞咽的精液甚至冲进了鼻腔里，被呛到的%CALLNAME:TARGET%剧烈地咳嗽起来
CALL PRINT_STR, @"「ごっほ！ごほっ！……ぶはぁっ！」_W"	CALL PRINT_STR, @"「咳！咳！……哇！」_W"
PRINTFORMW 耐えきれなかったのか%CALLNAME:TARGET%は下を向いて咳き込む。	PRINTFORMW 实在是无法坚持的%CALLNAME:TARGET%低下头，剧烈地咳嗽着，过了一小会儿才终于缓过气，抬起头来
PRINTFORMW しばらくして呼吸が落ち着くと、ようやく頭を上げた	PRINTFORMW 来不及吞咽的大量的子种汁从%CALLNAME:TARGET%的口中溢出，染白了%CALLNAME:TARGET%的下颌
PRINTFORMW 飲みきれなかった大量の精液が口から溢れ、%CALLNAME:TARGET%の顎を白く染める	PRINTFORMW 甚至有一些沿着%CALLNAME:TARGET%纤细的脖子缓缓地流下，在褐色的皮肤上留下来一行行乳白色的痕迹……
PRINTFORMW また他の一部は%CALLNAME:TARGET%の細い首を流れ落ち、褐色の肌の上に白い痕跡を残している……	PRINTFORMW %CALLNAME:TARGET%的眼神迷离着……
PRINTFORMW %CALLNAME:TARGET%の目は完全に蕩け切っている……	CALL PRINT_STR, @"「没関系的~可以再来一次的……好浓……好多……_HH_」_W"
CALL PRINT_STR, @"「問題、ありません…それよりももう一度……もっと濃い精液を……もっと沢山……_HH_」_W"
CALL PRINT_STR, @"「うぅん、うぅ…じゅるるっ……_HH_」_W"	CALL PRINT_STR, @"「唔嗯、唔~啾……_HH_」_W"
PRINTFORMW %CALLNAME:TARGET%は激しく吸いつきながら、精液をゴクゴクと飲み下していく	PRINTFORMW %CALLNAME:TARGET%努力的吮吸着，咕咚咕咚的将子种汁吞咽下去
CALL PRINT_STR, @"「はー……はー……_HH_」_W"	CALL PRINT_STR, @"「哈……哈……_HH_」_W"
PRINTFORMW 自慢気に口を開けると、呼吸に合わせて震える舌が突き出されているのが見える…	PRINTFORMW 像是炫耀似的张開嘴展示着，伸出来的舌头随着呼吸微微地颤动……已经一滴都不剩的全部吞下去了
PRINTFORMW …一滴残らず飲んでしまったようだ
PRINTFORMW その後、舌を伸ばしながらこちらに近づき、射精直後の敏感なペニスをとらえてねっとりと舐め始めた……
CALL PRINT_STR, @"「うぅん、うっ……げほっ！げほっ！_HH_」_W"	CALL PRINT_STR, @"「唔嗯、唔……咳！咳！_HH_」_W"
PRINTFORMW 努力の甲斐なく、飲みきれなかった精液が口の端から溢れ出てくる	PRINTFORMW 尽管已经很努力了，但仍不能全部咽下去，白色的汁液从嘴角溢了出来
PRINTFORMW %CALLNAME:TARGET%は零した精液を手で受けると、口元まで持って行き、再び飲み込んだ	PRINTFORMW %CALLNAME:TARGET%用手鞠住流出的汁液，凑到嘴边又重新喝了下去
CALL PRINT_STR, @"「はぁ……ご満足いただけたのであれば幸いですが」_W"	CALL PRINT_STR, @"「哈……希望您可以满意呢」_W"
PRINTFORMW %CALLNAME:TARGET%はそう言いながら、口の端をペロリと舐めた。	PRINTFORMW %CALLNAME:TARGET%一边说着，一边快速地舔了舔嘴角
CALL PRINT_STR, @"「はー……はー……_HH_」_W"	CALL PRINT_STR, @"「哈……哈……_HH_」_W"
PRINTFORMW %CALLNAME:TARGET%は頭を下げ、口の中に発射された精液をゆっくりと吐き出している	PRINTFORMW %CALLNAME:TARGET%低下头，让射进嘴里的子种汁慢慢地流出来
CALL PRINT_STR, @"「これでご満足いただけたのであれば幸いですが……」_W"	CALL PRINT_STR, @"「希望这样您可以满意……」_W"
PRINTFORMW 「%CNAME("二人称")%…沢山、お出しになりましたね」	PRINTFORMW 「%CALLNAME:MASTER%射了好多精液出来喔」
PRINTFORMW 「%CNAME("二人称")%は%CALLNAME:TARGET%の胸がとてもお好きなようですね……」	PRINTFORMW 「看来%CNAME("二人称")%是很喜欢%CALLNAME:TARGET%的胸部……」
PRINTFORMW 「全て胸に出されましたね、とてもいっぱいです。」	PRINTFORMW 「全都射在胸部上了，好多呢。」
PRINTFORMW 大量の精液が双丘に発射され、胸の谷間やふっくらとした曲線をゆっくりと滑り落ちていった。	PRINTFORMW 大量的精液被射在乳峰上，有的流进了乳沟，有的顺着圆润丰满的曲线缓缓滑下
PRINTFORMW 白濁は、チョコレートの上のミルクのように%CALLNAME:TARGET%の双丘に貼り付き、呼吸のたびに震えている	PRINTFORMW 还有一些，就黏在%CALLNAME:TARGET%的双峰上，像是滴在巧克力上的牛奶滴，随着%CALLNAME:TARGET%的呼吸，跟随者丰满的双峰抖动着
PRINTFORMW %CALLNAME:TARGET%は胸元を見つめると、指で円を描くように精液を胸に塗りたくっていく	PRINTFORMW %CALLNAME:TARGET%低头看着自己的胸部，用手指画着圆，把白浊在胸部上涂開
CALL PRINT_STR, @"「%CALLNAME:TARGET%の全身を%CNAME("二人称")%の匂いで染め上げてしまうおつもりですか…_HH_」_W"	CALL PRINT_STR, @"「是想把%CALLNAME:TARGET%的全身都染上您的味道吗~_HH_」_W"
PRINTFORMW 「%CNAME("二人称")%の精液…胸の谷間から溢れてしまっています……」	PRINTFORMW 「%CALLNAME:MASTER%居然射到都从乳沟里溢出来了……」
PRINTFORMW 白く粘り気のある精液が、小麦色の双丘の上に飛び散っている	PRINTFORMW 乳白色的粘稠精液在深色皮肤的乳峰上弥散開来
PRINTFORMW 流れ落ちた白濁の跡がたまらなく扇情的だ……	PRINTFORMW 流下的淡白色的液体痕迹显得无比的淫荡……
CALL PRINT_STR, @"「少し大袈裟です……_HH_本当に%CALLNAME:TARGET%のおっぱいが好きなのですね」_W"	CALL PRINT_STR, @"「真是夸张呢……_HH_就这么喜欢%CALLNAME:TARGET%的胸部吗」_W"
PRINTFORMW 「…ここは%CNAME("二人称")%の大好きなおっぱいですよ……」	PRINTFORMW 「噢啦~这是%CALLNAME:MASTER%最喜欢的胸部……」
PRINTFORMW 「どうぞお気遣いなく…」	PRINTFORMW 「不用客气哦~」
PRINTFORMW 「沢山射精してくださいね」	PRINTFORMW 「满满地射出来吧」
PRINTFORMW 「ここが本当にお好きなようですね……」	PRINTFORMW 「看来您是真的很喜欢这里呢……」
PRINTFORMW 「あらあら……手の中で射精して興奮していらっしゃるんですか」	PRINTFORMW 「啊啦啊啦……兴奋地直接在手上射出来了吗」
PRINTFORMW 「構わないのですよ…ご満足いただければ、それで……」	PRINTFORMW 「不过无所谓啦，您感到满足就可以了……」
CALL PRINT_STR, @"「手で出すのがお好きなようですね……本当に変態なんですから_HH_」_W"	CALL PRINT_STR, @"「喜欢射在手上吗……真是变态呢_HH_」_W"
PRINTFORMW 「%CALLNAME:TARGET%の手を見てください…ねばねばの精液が指の間で糸を引いてますよ」	PRINTFORMW 「%CALLNAME:TARGET%张開手展示着，粘稠的种汁在指缝间牵起了桥梁」
CALL PRINT_STR, @"「全部、この手の中にありますよ……ふふ…_HH_」_W"	CALL PRINT_STR, @"「全·部·都·是·哦~，呵呵~_HH_」_W"
CALL PRINT_STR, @"「手で出すのがお好きなようですね……本当に変わった好みですね」_W"	CALL PRINT_STR, @"「喜欢射在手上吗……真是奇怪的癖好呢」_W"
PRINTFORMW 「このまま続けてよろしいですか？それとも一度手を洗いましょうか……？」	PRINTFORMW 「您是想要就这样继续呢？还是需要洗一洗手再继续呢……」
CALL PRINT_STR, @"「あ……%CNAME("一人称")%の質問でまた興奮してしまったようですね_HH_」_W"	CALL PRINT_STR, @"「啊……看来我的问题让您更兴奋了呢~_HH_」_W"
CALL PRINT_STR, @"「手で出すのがお好きなようですね……本当に変わった好みです」_W"	CALL PRINT_STR, @"「喜欢射在手上吗……真是奇怪的癖好」_W"
PRINTFORMW 「もしよろしければ…%CALLNAME:TARGET%に一度手をきれいにする時間をいただけますか？」	PRINTFORMW 「如果可以的话，请让%CALLNAME:TARGET%做一下清洁再继续服侍」
PRINTFORMW 「あ……満足なさったようですね。」	PRINTFORMW 「啊……看起来您很满意呢。」
CALL PRINT_STR, @"「んぁぁ、お腹の中が、ビクビクして……_HH_」_W"	CALL PRINT_STR, @"「呐，開始在里面一震一震的_HH_……」_W"
CALL PRINT_STR, @"「我慢できません…さあ、さあ……_HH_」_W"	CALL PRINT_STR, @"「不要忍耐了~来嘛来嘛~~_HH_」_W"
PRINTFORMW %CALLNAME:TARGET%はこちらに動きを合わせながら%CALLNAME:MASTER%に動くよう促している。	PRINTFORMW %CALLNAME:TARGET%開始配合着%CALLNAME:MASTER%的动作催促着。
CALL PRINT_STR, @"「ふぁぁぁ…欲望に、負けてしまいましたね…ご主人様_HH_」_W"	CALL PRINT_STR, @"「哦呵呵呵~您败给了欲望呢~~_HH_」_W"
CALL PRINT_STR, @"「もう……なぜそんなに腰を振るのが遅いのですか_HH_」_W"	CALL PRINT_STR, @"「哎呀~怎么动作变得这么慢呐~_HH_」_W"
CALL PRINT_STR, @"「この調子では百年たっても%CALLNAME:TARGET%を逝かせることはできませんよ…_HH_」_W"	CALL PRINT_STR, @"「这样慢吞吞的，再干一百年%CALLNAME:TARGET%也不会高潮的呦~_HH_」_W"
CALL PRINT_STR, @"「もっと早く……あら、どうして出してしまうんですか…_HH_」_W"	CALL PRINT_STR, @"「快点动起……哎呀~怎么这就射出来了呀~_HH_」_W"
CALL PRINT_STR, @"「本当に仕方のないおちんちんですね……_HH_」_W"	CALL PRINT_STR, @"「真是不像话的鸡鸡呢……_HH_」_W"
CALL PRINT_STR, @"「もう…そんなに激しくして、どういうおつもりですか…_HH_」_W"	CALL PRINT_STR, @"「呦呦呦~顶的那么用力，您是想干什么啊~_HH_」_W"
CALL PRINT_STR, @"「力だけでは%CALLNAME:TARGET%を屈服させることはできませんよ……_HH_」_W"	CALL PRINT_STR, @"「光凭蛮力可是征服不了%CALLNAME:TARGET%的呦……_HH_」_W"
CALL PRINT_STR, @"「熟達した戦士のように、中をかき回して、突き上げて頂かないと…_HH_」_W"	CALL PRINT_STR, @"「需要像个成熟的战士一样，需要在里面搅动着，突刺着~~_HH_」_W"
PRINTFORMW %CALLNAME:TARGET%はそう言いながら積極的に腰を振っている。	PRINTFORMW %CALLNAME:TARGET%一边说着一边主动的晃起了腰。
CALL PRINT_STR, @"「むー…どうして、おちんちんが白旗上げてしまってるんですか……_HH_」_W"	CALL PRINT_STR, @"「啧~怎么才两下鸡鸡老师就举起白旗了啊_HH_……」_W"
CALL PRINT_STR, @"「始めと比べて一回り大きくなっているようですね…とても楽しみです……_HH_」_W"	CALL PRINT_STR, @"「您好像已经比一開始胀大了一圈呢~真刺激啊……_HH_」_W"
CALL PRINT_STR, @"「はい、『締めすぎ』ですか？%CNAME("二人称")%が%CALLNAME:TARGET%を暴走させたのが悪いんですよ…_HH_」_W"	CALL PRINT_STR, @"「什么，不要夹那么紧？没办法呀，您弄得%CALLNAME:TARGET%的身体已经不听话了啊~_HH_」_W"
PRINTFORMW %CALLNAME:TARGET%は舌なめずりをすると、少しの隙間もないほどにペニスをきつく締め付けた……	PRINTFORMW %CALLNAME:TARGET%用舌尖舔着自己的嘴唇，小穴紧缩到和肉棒之间一点点缝隙都没有了……
CALL PRINT_STR, @"「どうしました？きつすぎて抜けないのですか？落ち着いてください……_HH_」_W"	CALL PRINT_STR, @"「怎么啦？太紧了拔不出来了？不要慌哦……_HH_」_W"
PRINTFORMW 熱い吐息が耳元に迫る……	PRINTFORMW 温热的气息凑近了耳旁……
CALL PRINT_STR, @"「%CNAME("二人称")%はただびゅるびゅると射精していただけば良いのです~_HH_」_W"	CALL PRINT_STR, @"「您只要什么都管地噗噜噗噜的全部射进来~_HH_」_W"
CALL PRINT_STR, @"「おちんちんを%CALLNAME:TARGET%の柔らかいおまんこでたっぷり絞って差し上げます_HH_」_W"	CALL PRINT_STR, @"「鸡鸡君就会变得软趴趴的被%CALLNAME:TARGET%的淫穴挤出来喔~_HH_」_W"
PRINTFORMW 押し寄せる快感に耐えられず、堰を切ったように精液が溢れ出す……	PRINTFORMW 在多重的官能刺激下精液像决堤似地冲了出来……
CALL PRINT_STR, @"「いけませんね…そのように可愛らしい声を出されますと、興奮してしまいます……_HH_」_W"	CALL PRINT_STR, @"「不行啊~您发出那么可爱的声音，会害得我更兴奋呀……_HH_」_W"
CALL PRINT_STR, @"「どうしました？中が気持ちよくて、我慢できませんか？_HH_」_W"	CALL PRINT_STR, @"「什么啊？里面太爽了要忍不住了？_HH_」_W"
CALL PRINT_STR, @"「情けないご主人様……いいですよ、全部出してください…_HH_」_W"	CALL PRINT_STR, @"「真是没出息的主人啊……来吧，全部射进来把_HH_」_W"
CALL PRINT_STR, @"「メイドとして……情けないご主人様も全部受け止めてあげます…_HH_」_W"	CALL PRINT_STR, @"「作为您的女仆……再没出息的主人都会全部包容的呦~_HH_」_W"
CALL PRINT_STR, @"「あぁぁっ、いやっ…来たぁっ……来てますぅぅっ……_HH_」_W"	CALL PRINT_STR, @"「啊哈哈，不行了呢~来了……来了~~~_HH_」_W"
CALL PRINT_STR, @"「んぁっ、中でビクビクしてます……_HH_」_W"	CALL PRINT_STR, @"「呐，開始在里面一震一震的_HH_……」_W"
PRINTFORMW %CALLNAME:TARGET%は%CALLNAME:MASTER%を優しく抱きしめた。	PRINTFORMW %CALLNAME:TARGET%温柔地抱住了%CALLNAME:MASTER%。
CALL PRINT_STR, @"「あれあれ、何故突き上げるのをやめてしまうのですか？……_HH_」_W"	CALL PRINT_STR, @"「啊咧啊咧，怎么不敢向上顶了呢？_HH_……」_W"
PRINTFORMW %CALLNAME:TARGET%はニヤニヤと笑いながら腰をさらに大きく動かす。	PRINTFORMW 坏笑着加大了摆动的幅度。
CALL PRINT_STR, @"「んんっ、中で膨らんでいますよ？……_HH_」_W"	CALL PRINT_STR, @"「呐呐，在里面胀大了呦？_HH_……」_W"
CALL PRINT_STR, @"「%CNAME("二人称")%、動きが激しいです……_HH_」_W"	CALL PRINT_STR, @"「%CALLNAME:MASTER%的动作更粗暴了呢_HH_……」_W"
CALL PRINT_STR, @"「%CALLNAME:TARGET%は、もう準備ができていますよ……_HH_」_W"	CALL PRINT_STR, @"「%CALLNAME:TARGET%已经准备好了_HH_……」_W"
CALL PRINT_STR, @"「あ……熱い……_H_」_W"	CALL PRINT_STR, @"「啊……好烫_H_……」_W"
PRINTFORMW %CALLNAME:TARGET%はぎゅっと目を閉じた。	PRINTFORMW %CALLNAME:TARGET%皱着眉头闭上了眼睛。
PRINTFORMW 「ん……まだ、続けられますか？」	PRINTFORMW 「嗯……您还要继续吗？」
CALL PRINT_STR, @"「たったこれだけでびゅーびゅーと射精してしまうなんて…本当に情けないですね…_HH_」_W"	CALL PRINT_STR, @"「只是这样就噗噗地射出来了么~真是没出息呀~_HH_」_W"
PRINTFORMW 「これだけで射精してしまうとは……」	PRINTFORMW 「就这样射出来了吗……」
PRINTFORMW 「まあ……構いませんけれど。」	PRINTFORMW 「嘛……随便您吧。」
CALL PRINT_STR, @"「たったこれだけでびゅーびゅーと射精してしまうなんて…本当に変態ですね…_HH_」_W"	CALL PRINT_STR, @"「只是这样就噗噗地射出来了么~真是变态呢~_HH_」_W"
PRINTFORMW %CALLNAME:TARGET%は笑いながら、ぐいぐいと腰を押し付けてくる。	PRINTFORMW 一边嘲笑着，%CALLNAME:TARGET%一边加大了腰上的力度。
PRINTFORMW 「頑張ってくださいね%CNAME("二人称")%、この調子では後が持ちませんよ……ふふふ…」	PRINTFORMW 「要加油哦%CALLNAME:TARGET%，就这样射干净的话可是没有机会进行接下来的……呵呵呵~」
PRINTFORMW 「このようなことで射精できるのですね……」	PRINTFORMW 「这样也能射出来吗……」
PRINTFORMW 「本当に……いえ、お好きなのであれば構いません。」	PRINTFORMW 「真是……呐，您喜欢就好了。」
CALL PRINT_STR, @"「沢山出ましたね…本当におっぱいがお好きなのですね…_HH_」_W"	CALL PRINT_STR, @"「射出来不少呢~看来您是真的喜欢胸部呢~_HH_」_W"
PRINTFORMW %CALLNAME:TARGET%は豊満な乳房をさらに密着させてきた…	PRINTFORMW %CALLNAME:TARGET%将丰满的乳房更紧密地压迫上来。
CALL PRINT_STR, @"「あらあら…もっともっと、出してくださっても構いませんよ…_HH_」_W"	CALL PRINT_STR, @"「啊啦啊啦~您还可以继续射出来更多的吧~_HH_」_W"
PRINTFORMW 「とても幸せそうですね……」	PRINTFORMW 「看起来您很喜欢这样呢……」
CALL PRINT_STR, @"「その……直接入れていただいたほうが…%CNAME("二人称")%も気持ちいいのではないですか…_HH_」_W"	CALL PRINT_STR, @"「那个……直接进来的话…%CALLNAME:MASTER%会比较舒服吧_HH_。」_W"
CALL PRINT_STR, @"「あ……はい？%CNAME("一人称")%の事なら、問題ありません_HH_」_W"	CALL PRINT_STR, @"「啊……啊？我吗，没问题的呦。_HH_。」_W"
CALL PRINT_STR, @"「えぐられるような角度も、体内に残る熱い熱い愛情も、全てが……素晴らしく思えるのです_HH_」_W"	CALL PRINT_STR, @"「不管是棱角的刮擦，还是留在体内的热热的爱情，都……都很喜欢_HH_。」_W"
CALL PRINT_STR, @"「そして…もし、子供ができたら…ずっと、%CALLNAME:TARGET%をお傍に置いてくださいますか……_HH_。」_W"	CALL PRINT_STR, @"「而且有了孩子的话，就可以一直留在%CALLNAME:MASTER%身边了吧……_HH_。」_W"
PRINTFORML [1] お言葉に甘える！	PRINTFORML [1] 坦诚相奸～
PRINTFORML [2] それでも着ける	PRINTFORML [2] 还是做好安全措施为好
CALL PRINT_STR, @"「少しずつ、入ってきますね……とても硬いです……_HH_」_W"	CALL PRINT_STR, @"「一点点地进来了……好硬啊……_HH_」_W"
CALL PRINT_STR, @"「何度味わっても味わい尽くせません……おまんこが気持ち良くて狂ってしまいそうです……_HH_。」_W"	CALL PRINT_STR, @"「尝过多少次都还想要啊……小穴里都快乐的要发疯了……_HH_。」_W"
CALL SETFLAG, "ゴムキャンセル", PLAYER	CALL SETFLAG, "避孕套中止", PLAYER
PRINTFORML 「むぅ……」	PRINTFORML 「哼……」
PRINTFORML 「着けるならご自分でなさってください！%CNAME("一人称")%に期待しないでください！」	PRINTFORML 「要戴的话%CNAME("二人称")%自己带好了！别指望我会帮%CNAME("二人称")%戴！」
PRINTFORML 「メイドがなぜこのような事をしなければいけないのですか！%CNAME("一人称")%は拒否しますからね！」	PRINTFORML 「哪有女仆做这种工作的！自己动手哇！」
PRINTFORML %CALLNAME:TARGET%は%CALLNAME:MASTER%の気遣いに感謝の眼差しを向けている。	PRINTFORML %CALLNAME:TARGET%因采取了安全措施向%CALLNAME:MASTER%报以致谢的眼神。
PRINTFORML 「あ…コンドームを切らしてしまったようですね……」	PRINTFORML 「啊，没有了吗……」

PRINTFORML 「残念でしたね……%CNAME("二人称")%。」	PRINTFORML 「真遗憾呢……%CALLNAME:MASTER%。」
CALL PRINT_STR, @"「その……今日は……_HH_……」_W"	CALL PRINT_STR, @"「那个……今天的话……_HH_……」_W"
CALL PRINT_STR, @"「そのまま、入れていただきたいのです……しかし、今日は危険日なので……」_W"	CALL PRINT_STR, @"「想要直接插进来吗……可是今天是危险日啊……」_W"
CALL PRINT_STR, @"「本当に……今回だけですからね！絶対に、絶対に中には出さないでくださいね！_HH_」_W"	CALL PRINT_STR, @"「切……只有这一次啊！一定，一定不要射在里面！_HH_」_W"
PRINTFORMW 「いけません！」	PRINTFORMW 「不行！」
PRINTFORMW 「前回は中に射精しましたよね！？悪魔であっても妊娠の危険はあるんですよ！」	PRINTFORMW 「上一次就直接射在里面了！就算是恶魔也可能会怀孕的！」
CALL PRINT_STR, @"「これ以上……中に出されてしまうようなことがあれば……_HH_」_W"	CALL PRINT_STR, @"「还……还在里面出来了那么多……_HH_」_W"
PRINTFORMW 「%CNAME("二人称")%！%CNAME("二人称")%！もう近寄らないでください！」	PRINTFORMW 「%CNAME("二人称")%！%CNAME("二人称")%！不要再靠近我啊！」
PRINTFORMW しかし、%CALLNAME:MASTER%を押しのけようとする悪魔の手には全く力が入っていないようだ……	PRINTFORMW 试图把%CALLNAME:MASTER%推開，然而恶魔的手上却好像一点点力道都没有呢……
CALL PRINT_STR, @"「……いやらしいんですから…本当に、これが最後の一回ですからね！_HH_」_W"	CALL PRINT_STR, @"「可……可恶，这真的是最后一次了！_HH_」_W"
PRINTFORMW 「そういえば、少し暑いですね……」	PRINTFORMW 「总觉得，有些热呢……」
PRINTFORMW %CALLNAME:TARGET%は%CALLNAME:MASTER%の視線を避けるようにしながら、身にまとった衣服を一枚ずつ脱いでいった…	PRINTFORMW 避開%CALLNAME:MASTER%的视线，%CALLNAME:TARGET%把身上的衣服一件件地脱了下来
PRINTFORMW 「では……どうぞ、ご随意に」	PRINTFORMW 「呐……随便您吧」
PRINTFORMW %CALLNAME:TARGET%は恭しく衣服を脱いだ…	PRINTFORMW %CALLNAME:TARGET%恭恭敬敬地把衣服脱了下来
PRINTFORMW 衣服を脱いだ%CALLNAME:TARGET%が立っている。滑らかな褐色の肌が光を反射している様子が魅惑的だ。	PRINTFORMW 被剥了个干净的%CALLNAME:TARGET%站在那里，滑嫩的褐色皮肤反射出诱人的光
PRINTFORMW 片手を豊満な胸の前に置き、もう片方の手で恥ずかしい場所を隠している	PRINTFORMW 一只手搭在丰满的胸前，一只手遮掩着含羞的地方
PRINTFORMW その落ち着かない姿は……いつものクールなメイドのものとはかけ離れていた……	PRINTFORMW 这么局促的站姿……不像是平日里那个冷冷的女仆呢……
PRINTFORMW 「女性の服は、男性のものほど単純な造りではないのです」	PRINTFORMW 「女孩子的衣服，不像男孩子那么方便呢」
PRINTFORMW 「来てください、%CALLNAME:TARGET%が%CNAME("二人称")%に教えて差し上げます」	PRINTFORMW 「来，%CALLNAME:TARGET%来教%CNAME("二人称")%」
PRINTFORMW 「これだけを……脱ぐのですか？」	PRINTFORMW 「这一件……也要脱掉吗？」
PRINTFORMW 「注文が複雑なんですから…」	PRINTFORMW 「真是过分的要求呢~」
CALL PRINT_STR, @"「はぁ……う……うぅっ……はぁぁ…_HH_」_W"	CALL PRINT_STR, @"「嘶哈……嗯……嗯……嘶哈_HH_」_W"
CALL PRINT_STR, @"「いやぁ…いやです……_HH_」_W"	CALL PRINT_STR, @"「讨厌……_HH_」_W"
CALL PRINT_STR, @"「ん……_HH_」_W"	CALL PRINT_STR, @"「嗯……_HH_」_W"
CALL PRINT_STR, @"「そんなに、激しく出されては……_HH_」_W"	CALL PRINT_STR, @"「怎么射的这么凶……_HH_」_W"
CALL PRINT_STR, @"「等一下……我还没做好心理准备……」_W"
CALL PRINT_STR, @"「お待ちください……心の準備が……」_W"	CALL PRINT_STR, @"「射进来了……讨厌……_HH_」_W"
CALL PRINT_STR, @"「中に、こんなに……恥ずかしいです……_HH_」_W"
CALL PRINT_STR, @"「あ…直接、中に……_BH_」_W"	CALL PRINT_STR, @"「直接就……_BH_」_W"
CALL PRINT_STR, @"「%CNAME("二人称")%の精液は恐ろしいです……_HH_」_W"	CALL PRINT_STR, @"「真是可怕呢，%CALLNAME:MASTER%的种汁……_HH_」_W"
CALL PRINT_STR, @"「とても濃くてべたべたで、糊のようですね……おまんこも子宮口も塞がれてしまいそう…_HH_」_W"	CALL PRINT_STR, @"「非常浓厚，粘稠的像浆糊一样……好像要把小穴和子宫口都糊住了_HH_」_W"
CALL PRINT_STR, @"「もう少し量が少なければ、一滴も垂れてこなかった事でしょうね……_HH_」_W"	CALL PRINT_STR, @"「如果不是射太多，一滴都漏不出来的呀……_HH_」_W"
PRINTFORMW %CALLNAME:TARGET%は溢れ出る精液を掬い取ると、指を口に含み、陶酔しながら味見をしている……	PRINTFORMW %CALLNAME:TARGET%从溢出的汁液中抹了一点到手之间，把手指含入嘴里如痴如醉地品尝着……
CALL PRINT_STR, @"「%CNAME("二人称")%の精子に囲まれた卵子は、きっと逃げられないのでしょうね……_W"	CALL PRINT_STR, @"「卵子被一群%CALLNAME:MASTER%的精子围着，想跑都跑不掉……呵呵，是个女人都会被这个坏东西弄怀孕的呀～_HH_」_W"
CALL PRINT_STR, @"「ふふ…女性というのは、そんな悪いことをされた結果、妊娠するのですよ…_HH_」_W"
CALL PRINT_STR, @"「哦、……啊呜，哦、呜呜_HH_」_W"
CALL PRINT_STR, @"「あ、……あぅ、あ、うぅ_HH_」_W"	CALL PRINT_STR, @"「厉、厉害……好厉害_HH_。」_W"
CALL PRINT_STR, @"「す、すごいです……すご過ぎます_HH_」_W"	CALL PRINT_STR, @"「子宫里……啊哼～全都是满满的种子……_HH_」_W"
CALL PRINT_STR, @"「お腹の中……あふぅぅ…精子でいっぱいです……_HH_」_W"
CALL PRINT_STR, @"「……いやぁ……_HH_」_W"	CALL PRINT_STR, @"「……讨厌……_HH_」_W"
PRINTFORMW %CALLNAME:TARGET%は両足を開き、首を伸ばして自分の股間から溢れ出る白濁を見つめている……	PRINTFORMW %CALLNAME:TARGET%分開了双腿，伸着头看着自己股间涌出的白浊……
CALL PRINT_STR, @"「こんなに沢山……中に収まり切りません……_HH_」_W"	CALL PRINT_STR, @"「射这么多……里面装不下啦……_HH_」_W"
CALL PRINT_STR, @"「勿体ない……_HH_貴重な精液が流れ出てしまっています……」_W"	CALL PRINT_STR, @"「好浪费……_HH_就这么让宝贵的子种汁流出来……」_W"
CALL PRINT_STR, @"「はい？……流れた分よりも多く、また注ぎ込んでくださる、ですか？_HH_」_W"	CALL PRINT_STR, @"「说什么……会再射给我比这流出来的更多的？_HH_」_W"
CALL PRINT_STR, @"「いやぁ……もうお腹いっぱいです…これ以上注ぎ込まれたら…_HH_」_W"	CALL PRINT_STR, @"「讨厌……里面早就满满的啦，再射就会把肚子撑起来了，像怀着%CALLNAME:MASTER%大人的孩子一样……_HH_」_W"
CALL PRINT_STR, @"「%CNAME("二人称")%の子供を妊娠した時のようなお腹になってしまいます……_HH_」_W"
PRINTFORMW 「沢山出ましたね、溢れるほどに……」	PRINTFORMW 「射的这么多，都溢出来了……」
PRINTFORMW 「興奮しすぎではないですか？」	PRINTFORMW 「您有点过于兴奋了呢。」
CALL PRINT_STR, @"「はぁ……はぁ……はぁ……_HH_」_W"	CALL PRINT_STR, @"「啊哈……啊哈……啊哈……_HH_」_W"
PRINTFORMW 息を荒げる%CALLNAME:TARGET%の目の焦点は合っていないようだ……	PRINTFORMW 喘息着的%CALLNAME:TARGET%的眼神涣散着……
CALL PRINT_STR, @"「……とても……気持ち良かったです……_HH_」_W"	CALL PRINT_STR, @"「……好……好舒服……_HH_」_W"
PRINTFORMW 乳白色に濁った液体が%CALLNAME:TARGET%の両足の間の秘所から流れ出ている……	PRINTFORMW 乳白色的浑浊从%CALLNAME:TARGET%的双腿之间的秘所中流出……
PRINTFORMW 体の力が抜けた%CALLNAME:TARGET%は身動きが取れないようだ……	PRINTFORMW 看来瘫软的%CALLNAME:TARGET%是一时没办法打理自己了……
CALL PRINT_STR, @"「んぅ……んぅ……んん……はぁぁ…_HH_」_W"	CALL PRINT_STR, @"「嗯……嗯……嗯……啊哈~_HH_」_W"
PRINTFORMW 激しい行為を終えたにも関わらず、%CALLNAME:TARGET%はいまだ余韻に浸って恍惚としている…	PRINTFORMW 尽管已经结束了激烈的行为，%CALLNAME:TARGET%却仍沉浸在余韵的恍惚里
CALL PRINT_STR, @"「あはぁ……はぁ……ぁはぁぁ……_HH_」_W"	CALL PRINT_STR, @"「啊哈……啊哈……啊哈……_HH_」_W"
PRINTFORMW 筋肉が強張っているのか、今も微かに体が震えている	PRINTFORMW 或许是肌肉仍紧张着，身体仍在微微地颤抖
CALL PRINT_STR, @"「んぅ……んぅ……んん……はぁぁ…_HH_」_W"	CALL PRINT_STR, @"「嗯……嗯……嗯……啊哈~_HH_」_W"
PRINTFORMW 激しい行為を終えたにも関わらず、%CALLNAME:TARGET%の体はまだ緩んでいない……	PRINTFORMW 尽管已经结束了激烈的行为，%CALLNAME:TARGET%的身体却仍旧没放松下来……
PRINTFORMW 可愛らしい足の指が、ぴくぴくと痙攣している……	PRINTFORMW 可爱的小脚趾仍然微微地弯曲抽搐着……
PRINTFORMW 「とても……素敵です……%CNAME("二人称")%……」	PRINTFORMW 「好……好厉害呢……%CALLNAME:MASTER%……」
PRINTFORMW 不良在庫の山を前に、%CALLNAME:MASTER%和%CALLNAME:TARGET%頭を抱えた…
PRINTFORMW 「ん……？」	PRINTFORMW 「嗯……？」
PRINTFORMW 「この感覚は？……錯覚でしょうか？」	PRINTFORMW 「这感觉是？……错觉吗？」
PRINTFORMW 「淫紋の影響なのでしょうか……」	PRINTFORMW 「居然是淫纹带来的影响吗……」
PRINTFORMW 行為中、%CALLNAME:TARGET%はゆっくりと動きを止めた	PRINTFORMW 欢爱中%CALLNAME:TARGET%的动作渐渐停了下来
PRINTFORMW 「もし、%CNAME("二人称")%が……再生可能な魂を持っていなかったとしたら……」	PRINTFORMW 「真有%CNAME("二人称")%的啊%CALLNAME:MASTER%……如果不是拥有可以再生的灵魂的话……」
PRINTFORMW 「これは……とても危険です……」	PRINTFORMW 「这……很危险……」
PRINTFORMW 「ですから%CNAME("二人称")%であっても、可能な限り避けたほうがいいかもしれませんね…」	PRINTFORMW 「即使是%CALLNAME:MASTER%，也要尽可能的避免……」
CALL PRINT_STR, @"「ん……ひぁぁ、あ……お、お待ちくださいっ！_HH_」_W"	CALL PRINT_STR, @"「嗯……嘶哈~啊……等，等一等啊！_HH_」_W"
CALL PRINT_STR, @"「んあぁぁぁぁぁ！も、ダメです…逝くっ……逝っちゃ、あぁぁぁっ_HH_」_W"	CALL PRINT_STR, @"「嗯啊啊啊啊啊！忍不住了，去了……去了啊~_HH_」_W"
PRINTFORMW 必死で抑えようとするものの、吸精の快感が%CALLNAME:TARGET%を強制的に絶頂へと導く……	PRINTFORMW 努力地想要停下，但吸能带来的快感强行地把%CALLNAME:TARGET%送上了高潮……
CALL PRINT_STR, @"「ふあぁ……ああっ……ふあぁぁ……」_W"	CALL PRINT_STR, @"「啊哈……啊哈……啊哈……」_W"
PRINTFORMW 「この感覚…病みつきになってしまいそうです……しかし…」	PRINTFORMW 「虽然……这感觉很让人上瘾，但是……」
PRINTFORMW 「しかし、%CNAME("一人称")%のこの体質が…%CNAME("二人称")%にとって悪影響にならないか、とても心配です……」	PRINTFORMW 「但是，%CNAME("一人称")%的身体变成了这个怪样子……我真的很担心会对%CNAME("二人称")%不好……」
PRINTFORMW 「精力を吸い取り……魂を奪い取る……こんな%CNAME("一人称")%は……」	PRINTFORMW 「吸取能量……剥夺灵魂……我……」
PRINTFORMW 軽く首を振って、%CALLNAME:TARGET%は背を向けた。	PRINTFORMW 轻轻地摇了摇头，%CALLNAME:TARGET%背过了身去
PRINTFORML [1] 「大丈夫だ」と慰めるように優しく抱きしめる	PRINTFORML [1] 轻轻地抱住安慰她不会有事的
PRINTFORML [2] 後ろから耳を甘噛みし、淫紋を愛撫する	PRINTFORML [2] 从后面轻轻地咬她的耳朵并爱抚淫纹
PRINTFORMW %CALLNAME:TARGET%は軽くため息をついた。	PRINTFORMW %CALLNAME:TARGET%轻轻地叹了一口
PRINTFORMW 「%CNAME("一人称")%は本当に心配なのですよ…%CNAME("二人称")%には無限に魂があるとしても……」	PRINTFORMW 「我真的很担心……尽管%CALLNAME:MASTER%有那样的灵魂……」
PRINTFORMW 「悪魔は魂なしには生きられないのです……魚が水なしでは生きられないように……」	PRINTFORMW 「恶魔离不開灵魂，就像鱼儿离不開水……也许有的恶魔可以吧，但是%CNAME("一人称")%的身体已经……」
PRINTFORMW 「いえ、一部の悪魔はそうではないかもしれませんが…しかし%CNAME("一人称")%の体は既に……」	PRINTFORMW 「啊……啊……并不是因为淫纹，应该是当年被动过什么手脚，但是具体的已经不记得了」
PRINTFORMW 「うぅ……淫紋のせいではないのです…昔、体に何かをされたはずなのですが…正確には覚えていなくて…」	PRINTFORMW 「%CNAME("一人称")%是因为不想再伤害到人才找到%CNAME("二人称")%的，可是每次向%CNAME("二人称")%索要的灵魂越来越多」
PRINTFORMW 「%CNAME("一人称")%は、もう誰も傷つけたくなくて%CNAME("二人称")%のような方を探していました」
PRINTFORMW 「しかし、毎回%CNAME("二人称")%が奪われる魂の量は増えていく一方です…」
PRINTFORMW 「%CNAME("一人称")%は本当に%CNAME("二人称")%の体が心配なのです」	PRINTFORMW 「%CNAME("一人称")%真的很担心%CNAME("二人称")%的身体」
PRINTFORMW 「は……はい？魂など全てあげてもいい？そのような冗談はおやめください」	PRINTFORMW 「什……什么？即使整个灵魂都无所谓？不要開这种玩笑啊」
PRINTFORMW 「そんな風に女性をからかうなんて……いえ、違います！%CNAME("一人称")%は照れてなどいません！」	PRINTFORMW 「这种骗小女生的话……不……不……%CNAME("一人称")%才没有含羞！」
PRINTFORMW 「しかし…考えてみると、%CNAME("一人称")%も自分の過去と向き合う必要があるのかもしれません」	PRINTFORMW 「倒是提醒了%CNAME("一人称")%，%CNAME("一人称")%也许是该面对自己的过去了」
PRINTFORMW 「もしかしたら、この体から魂が離れないようにする方法があるかも…」	PRINTFORMW 「应该会有什么办法让这副身体不要离不開灵魂的」
PRINTFORMW 「え？もしそれが上手くいったら契約はどうなるのか、ですか？」	PRINTFORMW 「啊？如果有那一天还会待在%CNAME("二人称")%身边吗？」
PRINTFORMW 「ん…%CALLNAME:TARGET%は、魂が不要になった後の事は考えていません…メイドを続けることはないと思いますが」	PRINTFORMW 「嗯……不需要灵魂之后，%CALLNAME:TARGET%还没有想过，应该不会继续做女仆了吧」
PRINTFORML [1] これからも自分のメイドでいて欲しい	PRINTFORML [1] 请留下继续做我的女仆吧
PRINTFORML [2] ずっと一緒にいて欲しい	PRINTFORML [2] 请一直的陪伴在我身边吧
PRINTFORMW 「あら……不可能、ではないですが」	PRINTFORMW 「啊啦……也不是不可以呢」
PRINTFORMW 「しかし、それは%CNAME("二人称")%の態度次第ですね」	PRINTFORMW 「不过那要看%CNAME("二人称")%的表现啦」
PRINTFORMW 「主人がメイドを選ぶように、メイドだって主人を選ぶのですよ」	PRINTFORMW 「主人挑选女仆，女仆也是要挑选主人的！」
PRINTFORMW 「いえ、%CNAME("二人称")%の伴侶となる資格など…%CNAME("一人称")%にはありません……」	PRINTFORMW 「算了吧，作为终身的伴侣，%CNAME("一人称")%没有这个资格……」
PRINTFORMW 少しの間沈黙が続いた……	PRINTFORMW 陷入了短暂的沉默……
PRINTFORMW 「%CNAME("二人称")%、ありがとうございます……」	PRINTFORMW 「谢谢%CNAME("二人称")%……」
PRINTFORMW %CALLNAME:TARGET%は淡々とした声でそう言った	PRINTFORMW 是%CALLNAME:TARGET%的很轻的声音
CFLAG:初めての吸精事件 = 1	CFLAG:11002 = 1
CALL PRINT_STR, @"「お待ちください…そんな場所を触られると、おかしくなってしまいますよ？」_W"	CALL PRINT_STR, @"「别闹啊……不，不要摸那里，会变得奇怪起来的？」_W"
CALL PRINT_STR, @"「お待ちを……いけません、本当に…！」_W"	CALL PRINT_STR, @"「别闹……在认真的说事情！」_W"
CALL PRINT_STR, @"「待って……あぁぁ～っ…駄目です、はぁっ…はぁっ…やめて……_HH_」_W"	CALL PRINT_STR, @"「别……啊哈~不要，哈~哈~停下来……_HH_」_W"
PRINTFORMW %CALLNAME:TARGET%の瞳は徐々に快感の色に染まっていく	PRINTFORMW %CALLNAME:TARGET%的眼瞳渐渐地被快乐的颜色淹没了
CALL PRINT_STR, @"「離してください、もう駄目です……_HH_ぁはあ……んぁぁ……」_W"	CALL PRINT_STR, @"「放開我、我不能……_HH_啊哈~嗯啊~……」_W"
PRINTFORMW %CALLNAME:TARGET%の艶かしい肉体も徐々に熱を帯びていく	PRINTFORMW %CALLNAME:TARGET%色情的肉体也渐渐地变得滚烫了起来
CALL PRINT_STR, @"「はぁ…はぁ……もう……もう……何も考えられません……ああぁ…んぁあっ……」_W"	CALL PRINT_STR, @"「嗯哈~嗯哈~已经……已经……什么都不想考虑了……啊哈~嗯啊~……」_W"
CALL PRINT_STR, @"「どうか……もっと%CALLNAME:TARGET%をいじめてください……_HH_ご主人様……」_W"	CALL PRINT_STR, @"「请……请更多地欺负我……_HH_主人……」_W"
CFLAG:初めての吸精事件 = 2	CFLAG:11002 = 2
PRINTFORMW 「どうか……やめてください……」	PRINTFORMW 「请……请不要……」
PRINTFORMW 「こんな快感……はぁ…はぁ…病みつきになってしまいます」	PRINTFORMW 「这种快乐……啊哈~啊哈~，会上瘾的啊」
PRINTFORMW 「これ以上は……どうか許してください。」	PRINTFORMW 「请……请不要再继续了啊。」
PRINTFORMW 「あぁ…達して、しまいました…それに、またこんなに吸い取ってしまって……」	PRINTFORMW 「啊，才刚刚去过……又，又吸了这么多……」
CALL PRINT_STR, @"「んぁぁぁぁ……_HH_この感覚、ずっと味わっていたいです……」_W"	CALL PRINT_STR, @"「嗯啊啊啊啊啊啊~……_HH_离不開这种感觉了……」_W"
PRINTFORMW %CALLNAME:TARGET%の顔は快楽の表情で埋め尽くされている…	PRINTFORMW %CALLNAME:TARGET%的脸上全都是快乐的表情
PRINTFORMW 「あらあら、これで終わりではないですよね？」	PRINTFORMW 「啊啦啊啦，不会这样就不行了吧」
CALL PRINT_STR, @"「もっと……_HH_もっと、欲しいです……」_W"	CALL PRINT_STR, @"「还想……_HH_还想要更多啊……」_W"
PRINTFORMW 「頑張ってくださいね、愛しい人…」	PRINTFORMW 「请加油吧，亲爱的~」
CALL PRINT_STR, @"「耐えられませんでした……どうか今回は、お許しください…_H_」_W"	CALL PRINT_STR, @"「要不然……今天就算了吧_H_」_W"
PRINTFORMW 「自分を抑えようと努力はしているのですが、%CALLNAME:TARGET%は吸精の快感を忘れられないのです…」	PRINTFORMW 「努力地克制着自己，%CALLNAME:TARGET%并没有迷失在吸能带来的快乐中」
PRINTFORMW 「また、粗相をしてしまいました……」	PRINTFORMW 「又来了……」
PRINTFORMW 「快感に流されて……我を忘れてしまうのです……」	PRINTFORMW 「我自己控制不住……一到快乐的时候……」
PRINTFORMW %CALLNAME:TARGET%は顔をしかめている…吸精があまり好きではないようだ	PRINTFORMW %CALLNAME:TARGET%皱着眉头，好像并不喜欢吸能这种行为
PRINTFORMW 「しかし……これは本来、女性にとっては幸せな感覚なのでしょうか？」	PRINTFORMW 「可是……这不是会给女性带来快乐的感觉吗？」
STR:ＥＮＤタイトル = パトラＥＮＤ STR:ＥＮＤ标题 = 帕图拉的终局
STR:エンディング += "2_多くの日々が過ぎた…/"	STR:エンディング += "2_空空如也/"
STR:エンディング += "3_時間が経つにつれ…/"	STR:エンディング += "3_复归常人/"
PRINTFORMW ある日の朝、%CALLNAME:TARGET%はひっそりと姿を消した。	PRINTFORMW 就在某一天的清晨，%CALLNAME:TARGET%悄悄地离開了
PRINTFORMW 来た時と同じように、スーツケースだけを持って。	PRINTFORMW 就像她来的时候一样，只带走了随身携带的箱子
PRINTFORMW 「申し訳ありません。たとえ魂が得られるとしても、ここでは安心して眠れないのです。」	PRINTFORMW 「很抱歉，即使有了再多的灵魂，也终是难以安眠」
PRINTFORMW そう書かれたメモが残されていた。	PRINTFORMW 留下纸条上这么写着
PRINTFORMW まるで存在しなかったかのように、%CALLNAME:TARGET%は二度と姿を現さなかった。	PRINTFORMW 好像不曾存在过一样，%CALLNAME:TARGET%再也没有出现过。
PRINTFORMW END【再度流浪】に到達しました。パトラはあなたのもとを永遠に去りました。	PRINTFORMW 达成了结局【再度流浪】，帕图拉永远地离開了你
PRINTFORMW 作者注：他のエンディングを見たい場合は、次の週ではもっと優しく接してあげてみてください	PRINTFORMW 作者注：如果想要尝试其他结局的话，请在下一次更加温柔地对待她
PRINTFORMW 何はともあれ、パトラに興味を持っていただきありがとうございます。	PRINTFORMW 无论如何，感谢您对帕图拉的垂青
PRINTFORMW 多くの日々が過ぎた…%CALLNAME:TARGET%は未だメイドとして%CALLNAME:MASTER%に仕えている。	PRINTFORMW 日子一天天地过去了，%CALLNAME:TARGET%依然作为女仆侍奉左右
PRINTFORMW ベッドの上、廊下、キッチン……どこの場所にも奉仕の思い出がある。	PRINTFORMW 床上，走廊上，厨房里……每个地方都有着进行侍奉的回忆呢
PRINTFORMW 表面上は普通のメイドだが、実際の関係は%CALLNAME:TARGET%と%CALLNAME:MASTER%だけが知っている。	PRINTFORMW 虽说在表面面上还是%CALLNAME:MASTER%的女仆，不过实际関系，只有%CALLNAME:TARGET%和%CALLNAME:MASTER%自己才清楚吧
PRINTFORMW この結末に至る少し前に…何があったのかはわからない。	PRINTFORMW 就在叙述结局的这一会儿，就不知道一起跑到哪里去了呢。
PRINTFORML それはともかく……つまり、%CALLNAME:MASTER%はお互いの間に愛情と甘美な時間があれば…	PRINTFORMW 先不管了……总之，%CALLNAME:MASTER%相信，彼此之间的爱和甜蜜，足以让%CALLNAME:TARGET%变得幸福起来
PRINTFORMW %CALLNAME:TARGET%を十分に幸せにできると信じている。	PRINTFORMW 而%CALLNAME:TARGET%呢，则把装着过去的箱子锁住了，并把钥匙交给了%CALLNAME:MASTER%
PRINTFORMW そして%CALLNAME:TARGET%は過去が封じられた箱を施錠し、その鍵を%CALLNAME:MASTER%に渡した。	PRINTFORMW 就这么彼此托付着，两个人像故事里的人一样幸（性）福的生活了下去，并且……
PRINTFORMW お互いに信頼しあう二人は、物語のように幸福な（そしてエッチな）生活を送った。そして……	PRINTFORMW 永远，永远没有打開帕图拉的箱子
PRINTFORMW 永遠に、永遠に、%CALLNAME:TARGET%の箱が開けられることはなかった。
PRINTFORMW END【復旧常人】に到達しました。パトラはあなたと幸せな生活を送っています。	PRINTFORMW 达成了结局【复归常人】，帕图拉和你一起幸福的生活了下去
PRINTFORMW 作者注：これはパトラの“GOOD END”です。おめでとうございます。	PRINTFORMW 作者注：这个就是帕图拉的“GOODEND”了，恭喜
PRINTFORMW 他のエンディングを見たい場合は、次の週ではもっと情報を集めてみてください	PRINTFORMW 如果想要尝试其他结局的话，请在下一次多多搜集一些信息吧
PRINTFORMW 何はともあれ、パトラに興味を持っていただきありがとうございます。	PRINTFORMW 无论如何，感谢您对帕图拉的垂青
PRINTFORMW 時間が経つにつれ…%CALLNAME:MASTER%は徐々に何かがおかしいと感じるようになる。	PRINTFORMW 随着时间的流逝，%CALLNAME:MASTER%渐渐的感觉有些不对
PRINTFORMW 酔っていても眠っていても、%CALLNAME:TARGET%は過去の事について言及している。	PRINTFORMW 醉酒后也好，睡梦中也好，%CALLNAME:TARGET%仍然会提到一些……过去的事
PRINTFORMW しかし、それらの記憶は既に箱の中に封印されているのでは？	PRINTFORMW 可是，那些记忆不是已经被封印在箱子里了吗？
PRINTFORMW 「いいえ、そんな呪術は聞いたことがありません。」	PRINTFORMW 「没有，没听说过那样的法术。如果真的封存记忆的话，一点一滴都不会记得」
PRINTFORMW 「本当に記憶が封印されているのだとしたら、少しだって思い出せないはずです」
PRINTFORMW 質問を受けて%CALLNAME:FINDCHARA(NO, 1)%はそう答える。	PRINTFORMW 被询问的%CALLNAME:FINDCHARA(NO, 1)%这么回答道
PRINTFORMW ……それは好奇心からなのか、あるいは%CALLNAME:TARGET%が心配だったからなのか。	PRINTFORMW 是出于好奇心呢，亦或是出于对帕图拉的関心呢
PRINTFORMW ある日、%CALLNAME:MASTER%はついに%CALLNAME:TARGET%の持ってきた箱を開けてみた。	PRINTFORMW %CALLNAME:MASTER%最终在某一天独自打開了那个帕图拉随身带来的箱子
PRINTFORMW しかし―箱の中には、何もない。	PRINTFORMW 但是——箱子里并没有任何的东西
PRINTFORML その後は、今まで通りの生活が続いた。違うところがあるとすれば…	PRINTFORMW 之后呢，生活仍然如同往日一般地进行着，如果要说有什么不同，大概就是%CALLNAME:MASTER%对%CALLNAME:TARGET%更加的関心了吧
PRINTFORMW %CALLNAME:MASTER%が%CALLNAME:TARGET%に対して更に興味を持つようになったという所か。	PRINTFORMW %CALLNAME:TARGET%也以所期待的身份陪伴着%CALLNAME:MASTER%
PRINTFORMW %CALLNAME:TARGET%も今まで通りの関係のまま%CALLNAME:MASTER%の傍に仕えている。	PRINTFORMW 至于%CALLNAME:TARGET%的箱子，不知道什么时候，就悄悄地不见了
PRINTFORMW ちなみに、%CALLNAME:TARGET%の持ってきたあの箱はいつの間にかなくなっている。	PRINTFORMW 倒也正常，空空如也的箱子，还有什么一直留存着的必要吗？
PRINTFORMW 何の変哲もない空っぽの箱をいつまでも取っておく理由など、もうないのだから。
PRINTFORMW END【時間が経つにつれ…】に到達しました。パトラはあなたと幸せな生活を送っています。	PRINTFORMW 达成了结局【空空如也】，帕图拉和你一起幸福的生活了下去
PRINTFORMW 作者注：これはおそらくパトラの“TRUE END”です。おめでとうございます。	PRINTFORMW 作者注：这个大概就是帕图拉的“TUREEND”了，恭喜
PRINTFORMW 余談ですが“パトラ”という名前は“パンドラ”にちなんでいます。	PRINTFORMW 在这里多嘴一句，“帕图拉”是“潘多拉”的谐音，这曾在告白口上时提到过，再次的强调一下
PRINTFORMW 告白口上内でも触れましたが、念のために。
PRINTFORMW 他のエンディングを見たい場合は、次の週ではもう少し自由に遊んでみてください	PRINTFORMW 如果想要尝试其他结局的话，请在下一次随意游玩吧
PRINTFORMW 何はともあれ、パトラに興味を持っていただきありがとうございます。	PRINTFORMW 无论如何，感谢您对帕图拉的垂青