//文件: EVENT_K14_DAILY.ERB
CALL PRINT_STR, @"「%TEXTR("んっ……/じゅるっ/ぷはぁっ")%_H_ ……なんだよ%CNAMET(ARG, "一人称")%がしちゃワリぃのかよ？」_L"	CALL PRINT_STR, @"「%TEXTR("嗯……/成熟的/噗哈")%_H_ ……什么嘛.%CNAMET(ARG, "一人称")%已经起床了？」_L"
PRINTFORMW %CALLNAME:ARG%はぺろりと口端についた精液を舐めとった。	PRINTFORMW %CALLNAME:ARG%舔了舔口边的精液
CALL PRINT_STR, @"「%TEXTR("ぺろっ/んふっ/フフッ")%_H_ どーしたんだ？ %CNAMET(ARG, "主人")%_H_」_L"	CALL PRINT_STR, @"「%TEXTR("吐舌/嗯哼/呵呵")%_H_ 怎么了？%CNAMET(ARG, "主人")%_H_」_L"
PRINTFORMW %CALLNAME:ARG%は何事もなかったように朝支度を始めました。	PRINTFORMW %CALLNAME:ARG%像什么事都没有发生一样开始做早上的准备。
CALL PRINT_STR, @"「%TEXTR("ちゅる/ふはぁ/ん～")%_H_ なんだよ？ こーゆーの好きだろ？」_L"	CALL PRINT_STR, @"「%TEXTR("么么嗯/噗哈/嗯~～")%_H_ 什么啊？你喜欢这样吧？」_L"
PRINTFORMW %CALLNAME:MASTER%が頷くと%CALLNAME:ARG%は満足そうに片付けを始めた。	PRINTFORMW 当%CALLNAME:MASTER%点头时，%CALLNAME:ARG%看起来很满足地开始收拾起来
PRINTFORML 「……%TEXTR("んんっ/げほっ")%！？ な、なんだよ……起きてたのかよ……」	PRINTFORML 「……%TEXTR("嗯，嗯/咳咳")%！？什、什么啊……起来了啊……」
PRINTFORMW %CALLNAME:ARG%は%TEXTR("気まずそうに/バツが悪そうに/いそいそと")%片付け始めた。	PRINTFORMW %CALLNAME:ARG%是u%TEXTR("看起来不舒服/像是被骂了一样/兴冲冲地")%开始收拾
PRINTFORML 「……%TEXTR("んんっ/げほっ")%！？ ……%CNAMET(ARG, "一人称")%が早く元に戻る為だから……そういう事だから……」	PRINTFORML 「……%TEXTR("嗯，嗯/咳咳")%！？ ……%CNAMET(ARG, "一人称")%为了尽快恢复原状……正因为如此……」
PRINTFORMW そういう事らしいです。	PRINTFORMW 好像是那样的事的呢
PRINTFORML 「……あ ……%CNAMET(ARG, "二人称")%は何も見ていない。%CNAMET(ARG, "一人称")%は何もしていない」	PRINTFORML 「……啊 ……%CNAMET(ARG, "二人称")%什么都没看见。%CNAMET(ARG, "一人称")%什么都没做」
PRINTFORMW %CALLNAME:ARG%は足早に%CALLNAME:MASTER%の部屋から出ていきました。	PRINTFORMW %CALLNAME:ARG%很快就从%CALLNAME:MASTER%的房间里走了出来。
PRINTFORMW KOJO_GREETING_K14, %ARGS%, %CSTR:ARG:朝駆け%	PRINTFORMW KOJO_GREETING_K14, %ARGS%, %CSTR:ARG:朝袭%
PRINTFORML 「今日は体育があるぜ？」	PRINTFORML 「今天有体育课吗？」
PRINTFORMW %CALLNAME:ARG%は%TEXTR("イキイキ/ウキウキ")%している。	PRINTFORMW 看起来%CALLNAME:ARG%很%TEXTR("兴奋/高兴")%。
PRINTFORML 「今日は体育がある……けど、日差しが強すぎるな」	PRINTFORML 「今天有体育课……但是，太阳光太强了」
PRINTFORMW %CALLNAME:ARG%は太陽を恨みがましく睨み付けている。	PRINTFORMW %CALLNAME:ARG%は怀恨在心地盯着太阳。
PRINTFORML 「体育があるから体操着忘れんなよ？」	PRINTFORML 「等一下有体育课，别忘了穿体操服哦？」
PRINTFORMW %CALLNAME:ARG%が%CALLNAME:MASTER%の体操着入れを投げ渡してきた。	PRINTFORMW %CALLNAME:ARG%把%CALLNAME:MASTER%体操服交给我。
PRINTFORML 「%TEXTR("ん……/ふあぁ、/くはぁあ、")%おはよ……」	PRINTFORML 「%TEXTR("嗯……/打着哈欠、/早……")%早上好……」
PRINTFORMW %CALLNAME:ARG%は眠気眼をこすっている。	PRINTFORMW %CALLNAME:ARG%は揉着困倦的眼睛
PRINTFORML 「ん……はよ」	PRINTFORML 「嗯……哈哈」
PRINTFORMW %CALLNAME:ARG%は眠そうに朝の挨拶をしてきた。。	PRINTFORMW %CALLNAME:ARG%睡眼惺忪地打招呼。
PRINTFORML 「もうメシ出来てるぜ？」	PRINTFORML 「饭已经做好了吗？」
PRINTFORMW %CALLNAME:ARG%はお腹が空いているようです。	PRINTFORMW %CALLNAME:ARG%好像肚子饿了。
PRINTFORML 「ん……%CNAMET(ARG,"二人称")%と二人っきりか」	PRINTFORML 「嗯……和%CNAMET(ARG,"二人称")%两人独处」
PRINTFORMW %CALLNAME:ARG%は%CALLNAME:MASTER%の隣に座った。	PRINTFORMW %CALLNAME:ARG%坐在%CALLNAME:MASTER%的旁边。
PRINTFORML 「よっ！ ……って、なんだよ%CNAMET(ARG,"二人称")%だけかよ」	PRINTFORML 「哟！……什么啊，只有%CNAMET(ARG,"二人称")%在啊？」
PRINTFORMW %CALLNAME:ARG%はそう言いつつもどこか嬉しそうだ。	PRINTFORMW %CALLNAME:ARG%虽然这么说，但好像很开心的样子
PRINTFORML 「ウイーっす……お、%CNAMET(ARG,"一人称")%だけか」	PRINTFORML 「嗯……哦，只有%CNAMET(ARG,"一人称")%在吗？」
PRINTFORMW %CALLNAME:MASTER%を確認した%CALLNAME:ARG%は微笑んだ。	PRINTFORMW %CALLNAME:MASTER%确认了%CALLNAME:ARG%微笑着。
PRINTFORML 「なんだ、%CNAMET(ARG, "二人称")%と二人かよ……」	PRINTFORML 「什么啊，和%CNAMET(ARG, "二人称")%两个人啊……」
PRINTFORMW %CALLNAME:ARG%は%CALLNAME:MASTER%と少し距離を開けて座った。	PRINTFORMW %CALLNAME:ARG%与%CALLNAME:MASTER%稍微拉开距离坐了下来。
PRINTFORML 「よっ！ ……って、%CNAMET(ARG,"二人称")%だけか」	PRINTFORML 「哟！……只有%CNAMET(ARG,"二人称")%在吗？」
PRINTFORMW %CALLNAME:ARG%は微妙そうな顔つきだ。	PRINTFORMW %CALLNAME:ARG%的表情很微妙。
PRINTFORML 「ん……ハァァアア」	PRINTFORML 「嗯……唉」
PRINTFORMW %CALLNAME:ARG%は%CALLNAME:MASTER%の顔を見て盛大なため息を吐いた。	PRINTFORMW %CALLNAME:ARG%看到%CALLNAME:MASTER%を的脸，叹了口气。
PRINTFORML 「ただいまぁ、腹減ったぁ～」	PRINTFORML 「我回来啦，肚子饿了~」
PRINTFORMW %CALLNAME:ARG%はバタバタと帰ってきた。	PRINTFORMW %CALLNAME:ARG%吧嗒吧嗒地回来了。
PRINTFORML 「はぁ～疲れた……おっと、ただいま」	PRINTFORML 「啊~累坏了……哎呀，我回来了」
PRINTFORMW %CALLNAME:ARG%は疲れた様子で帰ってきた。	PRINTFORMW %CALLNAME:ARG%疲惫地回来了。
PRINTFORML 「ただいまっと、……今日は日差しがキツかった」	PRINTFORML 「我回来了……今天阳光好刺眼。」
PRINTFORMW %CALLNAME:ARG%はダルそうに帰ってきた。	PRINTFORMW %CALLNAME:ARG%懒洋洋地回来了。
PRINTFORML 「おかえりぃ……何だよ%CNAMET(ARG, "一人称")%が迎えに来ちゃ悪いのかよ！？」	PRINTFORML 「不好意思……什么嘛，%CNAMET(ARG, "一人称")%来接你不好吗！？」
PRINTFORMW 玄関まで迎えに来た%CALLNAME:ARG%は少し恥ずかしそうだ。	PRINTFORMW 到门口迎接了%CALLNAME:ARG%有点害羞。
PRINTFORML 「お帰りなさいませ%CNAMET(ARG, "主人")%……なんつってな」	PRINTFORML 「欢迎回来，%CNAMET(ARG, "主人")%…………怎么说呢？」
PRINTFORMW メイド服姿の%CALLNAME:ARG%が%CALLNAME:MASTER%を出迎えてくれた。	PRINTFORMW 女仆装身姿的%CALLNAME:ARG%迎接了%CALLNAME:MASTER%。
PRINTFORML 「フェリシエルさんが用意してくれたんだけど……どうだ？」	PRINTFORML 「弗理希艾尔桑为我准备的……怎么样？」
PRINTFORML 「意外と似合ってんだろ？」	PRINTFORML 「意外的很适合我吧？」
PRINTFORMW %CALLNAME:ARG%は%TEXTR("笑顔で/すまし顔で/腰をピンと伸ばしながら")%スカートを翻して一回りして見せた。	PRINTFORMW %CALLNAME:ARG%是%TEXTR("用笑容/装出一副若无其事的样子/一边挺着腰")%转了一圈给我看。
PRINTFORML 「おかえりぃ……寄り道してきたのか？」	PRINTFORML 「欢迎回来，……绕道过来了吗？」
PRINTFORMW どうやら%CALLNAME:ARG%は帰りが遅かった%CALLNAME:MASTER%を心配していたようだ。	PRINTFORMW  看来%CALLNAME:ARG%很担心晚回来的%CALLNAME:MASTER%。
PRINTFORML 「ん～おかえりぃ～」	PRINTFORML 「嗯~回来了~」
PRINTFORMW %CALLNAME:ARG%は居間でテレビを観ている。	PRINTFORMW %CALLNAME:ARG%は在客厅里看电视。
PRINTFORML 「おかえりぃ～……あ、クソっ！？」	PRINTFORML 「喂～……啊，可恶！？」
PRINTFORMW %CALLNAME:ARG%はゲームをしながら%CALLNAME:MASTER%にパタパタと手を振った。	PRINTFORMW %CALLNAME:ARG%一边玩游戏一边向%CALLNAME:MASTER%扑腾扑腾挥手。
PRINTFORML 「おかえりぃ……なんだ寄り道してきたのか？」	PRINTFORML 「欢迎回来……你是怎么绕道来这的？」
PRINTFORMW どうやら%CALLNAME:ARG%はお土産を期待しているようだ。	PRINTFORMW 看来%CALLNAME:ARG%在期待着特产。
PRINTFORML 「よっ！ なんだ遅かったじゃないか」	PRINTFORML 「哟！怎么这么晚啊！」
PRINTFORMW %CALLNAME:ARG%が出迎えてくれました。	PRINTFORMW %CALLNAME:ARG%が前来迎接。
PRINTFORML 「おう……%CNAMET(ARG, "二人称")%も食うか？」	PRINTFORML 「哦……%CNAMET(ARG, "二人称")%也要吃吗？」
PRINTFORMW %CALLNAME:ARG%は自分の持っていたお菓子を差し出してきた。	PRINTFORMW %CALLNAME:ARG%拿出了自己带的点心。
PRINTFORML 「遅かったな？ そうだな……%TEXTR("先生に怒られたな/エロ本でも拾ったな/財布を落としたな")%？」	PRINTFORML 「迟到了吧？是……%TEXTR("被老师骂了/还捡到了色情杂志呢/钱包丢了")%？」
PRINTFORMW %CALLNAME:ARG%は遅れてきた%CALLNAME:MASTER%に的外れな推理を披露し始めた。	PRINTFORMW %CALLNAME:ARG%开始对迟到的%CALLNAME:MASTER%做出偏离目标的推理。
PRINTFORML 「ふっふっ……」	PRINTFORML 「嘿咻嘿咻……」
PRINTFORMW %CALLNAME:ARG%は筋トレしているようだ。	PRINTFORMW %CALLNAME:ARG%好像在锻炼肌肉。
PRINTFORML 「ん、……よぅ」	PRINTFORML 「嗯，……呦」
PRINTFORMW %CALLNAME:ARG%は片手間に挨拶してきました。	PRINTFORMW %CALLNAME:ARG%很费事地打了招呼。
PRINTFORML 「あ～……ダルい……」	PRINTFORML 「啊～……好无聊……」
PRINTFORMW %CALLNAME:ARG%は日差しを避けるようにダレている。	PRINTFORMW %CALLNAME:ARG%像是在躲避阳光一样地懒散着。
PRINTFORML 「なんか用か？」	PRINTFORML 「有什么事吗？」
PRINTFORMW %CALLNAME:MASTER%に呼び出された%CALLNAME:ARG%が入室してきました。	PRINTFORMW 被%CALLNAME:MASTER%叫到的%CALLNAME:ARG%进了房间。
PRINTFORML 「……なんか用か？」	PRINTFORML 「……你有什么事吗？」
PRINTFORMW %CALLNAME:MASTER%に呼び出された%CALLNAME:ARG%が%TEXTR("ぶっきらぼうに/面倒くさそうに/あくびをしながら")%入室してきました。	PRINTFORMW 被%CALLNAME:MASTER%叫到的的%CALLNAME:ARG%が%TEXTR("粗鲁地/看起来很麻烦的样子/一边打哈欠")%进入房间了
PRINTFORML 「う～っス……ッケ、お盛んだねぇ」	PRINTFORML 「嗯……很好玩吗？」
PRINTFORML 　%CALLNAME:ARG%はイチャついてる%CALLNAME:MASTER%達を確認すると目を細めた。	PRINTFORML 　%CALLNAME:ARG%确认了捣乱的是%CALLNAME:MASTER%后眯起了眼睛。
//PRINTFORML  「要不要再来一次？」
//PRINTFORML  %CALLNAME:ARG%握紧了拳头
PRINTFORML 「失礼するぜ」	PRINTFORML 「失礼了」
PRINTFORMW %CALLNAME:ARG%が入室してきました。	PRINTFORMW %CALLNAME:ARG%进入了房间。
PRINTFORML 「……失礼するぜ」	PRINTFORML 「……失礼了」
PRINTFORMW %CALLNAME:ARG%が%TEXTR("ぶっきらぼうに/面倒くさそうに/あくびをしながら")%入室してきました。	PRINTFORMW %CALLNAME:ARG%%TEXTR("粗鲁地/看起来很麻烦的样子/一边打哈欠")%进入房间了。
PRINTFORMW 「ちわッス」	PRINTFORMW 「在闲聊吗？」
PRINTFORMW 「ちわッス」	PRINTFORMW 「闲聊」
PRINTFORMW 『あ……先生こんちわッス』	PRINTFORMW 『啊……老师早上好』
PRINTFORMW 『ちわッス』	PRINTFORMW 『闲聊.JPG』
PRINTFORMW %CALLNAME:MASTER%に呼び出された%CALLNAME:ARG%が入室してきました。	PRINTFORMW  被%CALLNAME:MASTER%叫到的%CALLNAME:ARG%进入了房间。
PRINTFORMW %CALLNAME:MASTER%に呼び出された%CALLNAME:ARG%が%TEXTR("ぶっきらぼうに/面倒くさそうに/あくびをしながら")%入室してきました。	PRINTFORMW 被%CALLNAME:MASTER%叫到的%CALLNAME:ARG%%TEXTR("粗鲁地/看起来很麻烦的样子/一边打哈欠")%进入了房间。
PRINTFORMW 「あー……喉乾いた」	PRINTFORMW 「啊……喉咙好渴」
PRINTFORML 「……色男は良いねぇ」	PRINTFORML 「……色鬼，就这！」
PRINTFORML %CALLNAME:ARG%は%CALLNAME:MASTER%を軽蔑した目で見送った。	PRINTFORML %CALLNAME:ARG%用轻蔑的眼光目送着%CALLNAME:MASTER%。
PRINTFORML 「あ？ 今日はもう終わりで良いのか？」	PRINTFORML 「啊？今天就结束可以吗？」
PRINTFORMW %CALLNAME:ARG%は%TEXTR("いそいそと/手早く")%帰り支度を始めました。	PRINTFORMW %CALLNAME:ARG%是%TEXTR("兴冲冲地/麻利")%开始准备回去了。
PRINTFORML 「全く……%CNAMET(ARG, "一人称")%に弁当なんて頼むなよ」	PRINTFORML 「真是的……不要把便当拜托给%CNAMET(ARG, "一人称")%哦」
PRINTFORMW 　%CALLNAME:ARG%と全体的に茶色い弁当を一緒に食べました。	PRINTFORMW 　和%CALLNAME:ARG%一起吃了茶色的便当。
PRINTFORML 「悪いが今日は簡単なモノだぜ？」	PRINTFORML 「不好意思，今天是简单的食物哦？」
PRINTFORMW 　%CALLNAME:ARG%と手作りサンドイッチを一緒に食べました。	PRINTFORMW 　和%CALLNAME:ARG%亲手做的三明治一起吃了。
PRINTFORML 「コレは実質の%CALLNAME:FINDCHARA(NO, 1)%さんの弁当だな」	PRINTFORML 「这好像是の%CALLNAME:FINDCHARA(NO, 1)%桑的便当啊」
PRINTFORMW 　%CALLNAME:ARG%と昨日の残り物が詰められた弁当を一緒に食べました。	PRINTFORMW 　和%CALLNAME:ARG%昨天剩下的东西一起吃了便当。
PRINTFORML 「うぅ……お腹いっぱいだ……胃が小さくなってんのか？」	PRINTFORML 「嗯……肚子饱了……是胃变小了吗？」
PRINTFORML 　%CALLNAME:ARG%は途中まで食べてお腹いっぱいになってしまったらしい。	PRINTFORML 　%CALLNAME:ARG%好像吃到一半就吃饱了。
PRINTFORMW 「……ほら、あーん」	PRINTFORMW 「……给你的，啊」
//PRINTFORMW 「好吃吗？」
PRINTFORML 「今日は偶々早く起きたからな」	PRINTFORML 「偶尔会起得早啊，给这是你的」
PRINTFORMW 　%CALLNAME:ARG%の手作り弁当を一緒に食べました。	PRINTFORMW 　一起吃了%CALLNAME:ARG%亲手做的便当。
PRINTFORML 「%CNAMET(ARG, "二人称")%は料理とかしないのか？」	PRINTFORML 「%CNAMET(ARG, "二人称")%不做饭吗？」
PRINTFORMW 　%CALLNAME:ARG%と簡素な海苔弁当を一緒に食べました。	PRINTFORMW 　和%CALLNAME:ARG%一起吃了简单的海苔便当。
PRINTFORML 「男料理なら多少は出来んだがなぁ……」	PRINTFORML 「如果是男性料理的话多少还能做出来啊……」
PRINTFORMW 　%CALLNAME:ARG%と日の丸弁当を一緒に食べました。	PRINTFORMW 　和%CALLNAME:ARG%一起吃了日之丸便当。
PRINTFORML 「ちょっ！？ いきなりおっぱじめんな！」	PRINTFORML 「等一下！？不要一下子就起哄了！」
PRINTFORMW %CALLNAME:ARG%は%TEXTR("慌てて/急いで")%退出しました。	PRINTFORMW %CALLNAME:ARG%是%TEXTR("慌慌张张/快点儿")%走了~了。
PRINTFORML 「ふーん……ほー……へぇー」	PRINTFORML 「嗯……呼……嘿！不要吵到我」
PRINTFORMW %CALLNAME:ARG%の視線が%TEXTR("冷たいです/痛いです/突き刺さります")%。	PRINTFORMW %CALLNAME:ARG%的视线%TEXTR("很冷/很痛/刺进去")%。
PRINTFORML 「はいはい、いつものね……いや、慣れてしまった自分が嫌だわ……」	PRINTFORML 「是是，还是老样子呢……不，讨厌习惯了的自己……」
PRINTFORMW %CALLNAME:ARG%は複雑そうな顔をしている。	PRINTFORMW %CALLNAME:ARG%表情复杂。
PRINTFORML 「……本当に節操がねぇな！？」	PRINTFORML 「……真是没节操啊！？」
PRINTFORMW %CALLNAME:ARG%は%CALLNAME:MASTER%にツッコミを入れました。	PRINTFORMW %CALLNAME:ARG%吐槽了%CALLNAME:MASTER%。
PRINTFORML 「あー……うん、外出てるわ」	PRINTFORML 「啊……嗯，我出去了」
PRINTFORMW %CALLNAME:ARG%は%TEXTR("そわそわと/顔を赤らめて")%退出しました。	PRINTFORMW %CALLNAME:ARG%%TEXTR("そ慌慌张张/红着脸")%出去了。
PRINTFORML 「うぅ……あくまで%CNAME("一人称")%が元に戻るまでだぞ！」	PRINTFORML 「うぅ……あくまで%CNAME("一人称")%が元に返回までだぞ！」
PRINTFORML 「死ぬ……死ぬっ！」	PRINTFORML 「要死……快要死了！」
PRINTFORML 「太陽と暑さのタブルパンチで%TEXTR("溶ける/灰になる/普通に死ぬ")%ッ！！」	PRINTFORML 「随着阳光和热量的双重冲击下%TEXTR("熔化/化为灰烬/普通地死去")%！！」
PRINTFORML 「ああっづぅう～～～」	PRINTFORML 「啊啊啊～～～」
PRINTFORML 「……氷うま……氷うま」	PRINTFORML 「……好冰……好冰呀」
PRINTFORML 「汗ヤバい……」	PRINTFORML 「大汗淋漓…………」
PRINTFORML 「……なんだよ？　暑いんだからアッチ行けよ。シッシッ！」	PRINTFORML 「……什么啊？天气热，走那边吧。咻咻！」
PRINTFORML 「あぁ～良い汗かいたぜ」	PRINTFORML 「啊~出了好多汗啊」
PRINTFORML 「なんだぁ？ %CNAME("二人称")%は%TEXTR("へばっちまった/疲れちまった")%のか？」	PRINTFORML 「什么啊？ %CNAME("二人称")%是%TEXTR("要走了/累了")%のか？」
PRINTFORML 「今日は日差しが強すぎだ……」	PRINTFORML 「今天阳光太强了……」
PRINTFORML 「コレさえなければなぁ……」	PRINTFORML 「要是没有这个就好了……」
PRINTFORML 「……汗臭いな」	PRINTFORML 「……有汗臭味啊。」
PRINTFORML 「%TEXTR("制汗剤/ボディペーパー/タオル")%はっと……汗臭いんだから近寄るなよ？」	PRINTFORML 「有%TEXTR("止汗剂/手纸/毛巾")%吗……有汗臭味，别靠近我啊？」
PRINTFORML 「%CNAME("二人称")%は%TEXTR("運動嫌いな/へばっちまった/疲れちまった")%のか？ ……情けないなぁ」	PRINTFORML 「%CNAME("二人称")%是%TEXTR("讨厌运动/要走了/累了")%的吗？……真没出息啊」
PRINTFORML 「早く戻りたいぜ……」	PRINTFORML 「好想早点回去啊……」
PRINTFORML 「……汗臭いな」	PRINTFORML 「……有汗臭味啊」
PRINTFORML 「%TEXTR("制汗剤/ボディペーパー/タオル")%はっと……」	PRINTFORML 「%TEXTR("制汗剤/ボディペーパー/毛巾")%没有吗……」
PRINTFORML 「むにゃむにゃ……」	PRINTFORML 「姆呀姆呀……」
PRINTFORML 「吸血鬼だから……昼に眠い……」	PRINTFORML 「因为是吸血鬼……白天很困…………」
PRINTFORML 「んん……あと五分……」	PRINTFORML 「嗯……还有五分钟………」
PRINTFORML 「ZZzz……すぐ起きるから……」	PRINTFORML 「ZZzz……我马上就起床……」
PRINTFORML 「ハァ……夢か……」	PRINTFORML 「哈……是梦吗……」
PRINTFORML 「……起きた時に男に戻ってるんじゃないかって最近怖くなるんだ」	PRINTFORML 「……最近几天总会害怕起床时我会变回男生」
PRINTFORML 「んん……あぁ～……%CNAME("二人称")%か」	PRINTFORML 「嗯……啊～……%CNAME("二人称")%吗」
PRINTFORML 「はぁ……嫌な夢を見たぜ……」	PRINTFORML 「哈……做了个噩梦………」
PRINTFORML 「んん……ふぁあ……」	PRINTFORML 「嗯……啊啊……」
PRINTFORML 「……ハァ……起きたら戻ってるって事はねーか」	PRINTFORML 「……哈……起床了就回来了吗？」
PRINTFORML 「なんで%CNAME("一人称")%がこんなことを……」	PRINTFORML 「为什么%CNAME("一人称")%会变成这样……」
PRINTFORML 「%CNAME("二人称", "どもり")%……%TEXTR("な、殴りてぇ/殴って良いか？/ぶっ飛ばすぞ？")%」	PRINTFORML 「%CNAME("二人称", "どもり")%……%TEXTR("喂，想打你！/可以打你吗？/我要打爆你的头！")%」
PRINTFORML 「な、何で%CNAME("一人称")%がこんな格好を……」	PRINTFORML 「为什么%CNAME("一人称")%穿成这样……」
PRINTFORML 「コ、コラッ！？ %TEXTR("撮影禁止だ/動画を撮るな")%！！」	PRINTFORML 「喂，喂！？ %TEXTR("禁止拍照/不要拍视频")%！！」
PRINTFORML 「%CNAME("一人称")%の尊厳が死んでしまう……」	PRINTFORML 「%CNAME("一人称")%的尊严正在消失……」
PRINTFORML 「何笑ってんだよバーカ♪」	PRINTFORML 「笑什么啊，笨蛋」
PRINTFORML 「はぁ……%CNAME("二人称")%は本当に変態だな」	PRINTFORML 「哈……%CNAME("二人称")%真是变态啊」
PRINTFORML 「呆れてモノも言えんぞ……」	PRINTFORML 「吓得说不出话来……」
PRINTFORML 「……ハァァアアッ」	PRINTFORML 「……啊啊啊啊」
PRINTFORML 「よくもまぁ、堂々とそんな事出来るな」	PRINTFORML 「亏你能堂堂正正地做那种事啊」
PRINTFORML 「くッ……本当にいい加減にしろよ？」	PRINTFORML 「呃……真的适可而止吧？！」
PRINTFORML 「変態には何を言っても無駄か？」	PRINTFORML 「对变态说什么都没用吗？」
PRINTFORML 「%CNAME("一人称")%は哀しくて涙が出そうだ」	PRINTFORML %CNAME("一人称")%悲伤得哭出了眼泪
PRINTFORML 「あっはっはっは……はぁ」	PRINTFORML 「啊哈哈……哈！」
PRINTFORML 「……いや、もう何でもない」	PRINTFORML 「……不，已经没什么了」
PRINTFORML 「ふぅぅううう……はぁぁああ」	PRINTFORML 「呜呜呜……啊啊啊」
PRINTFORML 「変な写真撮ってないだろうな……？」	PRINTFORML 「没拍奇怪的照片吧……？？」
PRINTFORML 「撮るなら言えよ。ポーズくらいならとっても……いや何でもない」	PRINTFORML 「要拍就说。如果只是姿势的话……不，没什么。」
PRINTFORML 「隠し撮りは止めろよな」	PRINTFORML 「不要再偷拍我了吧」
PRINTFORML 「……え？ いや、別に、隠し撮りじゃなければ良いとかそう言うんじゃねーよ！」	PRINTFORML 「……啊？不，并不是说如果不是偷拍就好了之类的话！」
PRINTFORML 「隠し撮りは犯罪だぞ？」	PRINTFORML 「偷拍是犯罪哟？」
PRINTFORML 「撮るなら言えよ……」	PRINTFORML 「要拍就说……」
PRINTFORML 「おいっ！」	PRINTFORML 「喂！」
PRINTFORML 「変な写真撮ってないだろうな！」	PRINTFORML 「没拍奇怪的照片吧！！」
PRINTFORML 「ボリボリ……」	PRINTFORML 「卟啉卟啉……」
PRINTFORML 「あ、服汚さないようにしないと……」	PRINTFORML 「啊，不能弄脏衣服的话……」
PRINTFORML 「はぁ……メイドって大変だな」	PRINTFORML 「哈……女仆好辛苦啊」
PRINTFORML 「%CNAME("主人")%、そこに居られると掃除の邪魔だぜ？」	PRINTFORML 「%CNAME("主人")%、呆在那里的话会妨碍打扫的吧？」
PRINTFORML 「えーと……これはココに仕舞えば良いのか？」	PRINTFORML 「嗯……这个在这里工作就可以吗？」
PRINTFORML 「ふー……少し休憩っと」	PRINTFORML 「呼……稍微休息一下」
PRINTFORML 「このアイス食べて良いか？」	PRINTFORML 「这个冰淇淋可以吃吗？」
PRINTFORML 「今日は面白いテレビやってないな」	PRINTFORML 「今天没有看有趣的电视啊」
PRINTFORML 「一緒に筋トレでもするか？」	PRINTFORML 「一起锻炼肌肉吗？」
PRINTFORML 「夜の散歩でも一緒に行くか？」	PRINTFORML 「晚上一起去散步吗？」
PRINTFORML 「満月が出てると気持ちが……なんて嘘だけどな」	PRINTFORML 「满月出来的时候心情会……虽然是谎言」
PRINTFORML 「なぁなぁ、宿題写させてくんねーか？」	PRINTFORML 「什么呀，作业让我抄一下？」
PRINTFORML 「ふぁ……眠くなってきたぜ」	PRINTFORML 「啊……我困了」
PRINTFORML 「この部活って何する部活なんだ？」	PRINTFORML 「这个社团是做什么的？」
PRINTFORML 「掃除でもするか……」	PRINTFORML 「打扫一下吧………」
PRINTFORML 「全く……こんな身体になった所為で昼はダルいぜ」	PRINTFORML 「真是的……是因为这样的身体才变了白天过的很艰难」
PRINTFORML 「なんか……イカ臭いぞ」	PRINTFORML 「总觉得……有股鱼腥味。」
PRINTFORML 「最近日傘を差してる所為で病弱だと思われてる……」	PRINTFORML 「最近因为经常撑着阳伞被认为体弱多病……」
PRINTFORML 「変なところに触るなよ？」	PRINTFORML 「不要碰奇怪的地方哦？」
PRINTFORML 「この漫画の続きって持ってきてないの？」	PRINTFORML 「你没有把这部漫画的续集带来吗？」
PRINTFORML 「ゲームはあんまり得意じゃないんだよ！」	PRINTFORML 「我不太擅长玩游戏哦！」
PRINTFORML 「むにゃ……ちぃすーたろか」	PRINTFORML 「哎呀……知不知道」
PRINTFORML 「むにゃ……ごはんまだぁ」	PRINTFORML 「哎呀……饭还没好吗」
PRINTFORML 「むにゃ……この中に筋肉が」	PRINTFORML 「哎呀……你有肌肉吗？」
PRINTFORMW 「お……雨だ。傘持ってきてるか？」	PRINTFORMW 「啊……下雨了。有带伞吗？」
PRINTFORMW 「ちょうど良かった。入れてくれ」	PRINTFORMW 「刚刚好。让我进去吧」
PRINTFORMW 「……いや、%CNAME("一人称")%はこう言うのはいいって……」	PRINTFORMW 「……没有啦、%CNAME("一人称")%是这样说的……」
PRINTFORML 「なぁ……もうダメなんだ……」	PRINTFORML 「啊……已经不行了……」
PRINTFORMW 　%CALLNAME:TARGET%は%CALLNAME:MASTER%を押し倒し、%CALLNAME:MASTER%の首筋に噛み付く。	PRINTFORMW 　%CALLNAME:TARGET%推倒了%CALLNAME:MASTER%咬了%CALLNAME:MASTER%的脖子。
PRINTFORMW 　吸血と共に%CALLNAME:MASTER%は魂が奪われる感覚に陥った。	PRINTFORMW 　%CALLNAME:MASTER%与吸血鬼一起陷入了灵魂被夺走的感觉。
PRINTFORMW 「一緒に風呂に入らないかって？」	PRINTFORMW 「你说要不要一起洗澡？」
PRINTFORML 「ハッ！ イヤに決まってんだろう」	PRINTFORML 「哈哈！当然不愿意吧」
PRINTFORMW %CALLNAME:TARGET%に鼻で笑われてしまいました。	PRINTFORMW 被%CALLNAME:TARGET%指着鼻子笑了笑。
PRINTFORML 「ん……おやすみ」	PRINTFORML 「嗯……晚安」
PRINTFORMW 　%CALLNAME:TARGET%は%CALLNAME:MASTER%に啄ばむ様に就寝のキスをしてきた。	PRINTFORMW 　%CALLNAME:TARGET%像在%CALLNAME:MASTER%上啄食一样，和她进行了睡前接吻。
PRINTFORMW 「お、おう寝るのね……」	PRINTFORMW 「哦，睡吧………」
PRINTFORMW 「……クソっ身構えちまったじゃねーか」	PRINTFORMW 「……这不是摆出了一副臭架子吗？」
PRINTFORMW 「馬鹿を言うんじゃないよ馬鹿！ とっとと部屋に戻るぞ馬鹿！！」	PRINTFORMW 「别胡说了，笨蛋！快还给我回房间！！」
PRINTFORML 「……本当にスマンね」	PRINTFORML 「……真的是对不起」
PRINTFORMW %CALLNAME:TARGET%は%CALLNAME:MASTER%を引きずりながら%TEXTS("現在位置")%を後にしました。	PRINTFORMW %CALLNAME:TARGET%一边拖着%CALLNAME:MASTER%离开了%TEXTS("現在位置")%。
PRINTFORML 「する事がないって？ 一緒に運動でもするか？ ……ソッチの運動じゃねーよ！」	PRINTFORML 「有要做的事？一起运动吗？…不是那种的运动啦！」
PRINTFORMW 　%CALLNAME:TARGET%は%CALLNAME:MASTER%を威嚇しています。	PRINTFORMW 　%CALLNAME:TARGET%在威胁着%CALLNAME:MASTER%。
PRINTFORML 「お？　今日はもう終わりか」	PRINTFORML 「哦？今天已经结束了吗？」
PRINTFORMW 　%CALLNAME:TARGET%は大きく伸びをしている。	PRINTFORMW 　%CALLNAME:TARGET%用很大的动作伸展身体。
PRINTFORMW 　%CALLNAME:TARGET%は複雑な表情で%CALLNAME:MASTER%を見ている。	PRINTFORMW 　%CALLNAME:TARGET%用复杂的表情看着%CALLNAME:MASTER%。
GREETING = おはよーさん	GREETING = おはよー桑
PRINTFORML 「うわっ！？　いきなり抱きついてくんじゃねぇ！？」	PRINTFORML 「哇！？不要突然抱住我！？」
PRINTFORMW 　%CALLNAME:TARGET%は驚いて%CALLNAME:MASTER%を突き飛ばした。	PRINTFORMW 　%CALLNAME:TARGET%吓得把%CALLNAME:MASTER%踢飞了。
PRINTFORML 「止めろっ！　汗が気持ち悪いんだよっ！」	PRINTFORML 「住手！汗好恶心啊！」
PRINTFORMW 　%CALLNAME:TARGET%は不快そうに%CALLNAME:MASTER%から距離をとった。	PRINTFORMW 　%CALLNAME:TARGET%不快地和%CALLNAME:MASTER%拉开了距离。
PRINTFORML 「ああぁあぁーっ！？　クソっ暑いんだよ！」	PRINTFORML 「啊啊啊啊！？好热啊！」
PRINTFORML 　%CALLNAME:MASTER%に捕まった%CALLNAME:TARGET%が腕の中でもがいている。	PRINTFORML 　被%CALLNAME:MASTER%抓住的%CALLNAME:TARGET%在怀里扭动着。
PRINTFORMW 　暑い……。	PRINTFORMW 　好热……。
PRINTFORML 「せめて汗を拭いてからにしろよっ！！」	PRINTFORML 「至少先把汗擦干吧！！」
PRINTFORML 　%CALLNAME:TARGET%は%CALLNAME:MASTER%の頭を雑巾でわしゃわしゃと拭いた。	PRINTFORML 　%CALLNAME:TARGET%用抹布擦了%CALLNAME:MASTER%的头。
PRINTFORMW 　臭い……。	PRINTFORMW 　好臭……。
PRINTFORML 　%CALLNAME:MASTER%が%CALLNAME:TARGET%にハグすると%CALLNAME:TARGET%は%CALLNAME:MASTER%の背中に手を回してきた。	PRINTFORML 　当%CALLNAME:MASTER%拥抱%CALLNAME:TARGET%的时候%CALLNAME:TARGET%把手转到了%CALLNAME:MASTER%的背后。
PRINTFORML 　柔らかい%CALLNAME:TARGET%の肢体に包まれると首筋にちくりと痛みが走る。	PRINTFORML 　被柔软的%CALLNAME:TARGET%的肢体包裹着的话，脖颈里就会隐隐作痛。
PRINTFORMW 「……あぁスマンスマン。ちょうど良い位置に首筋があったからさ」	PRINTFORMW 「……啊，对不起。位置上正好有个脖颈」
PRINTFORMW %CALLNAME:MASTER%は少し「騙された！」と思いました。	PRINTFORMW %CALLNAME:MASTER%稍微想一下「我被骗了！」。
PRINTFORML 「ん……その、スマンっ！！」	PRINTFORML 「嗯……那个、抱歉！！」
PRINTFORML 　%CALLNAME:MASTER%が%CALLNAME:TARGET%に抱きつくと%CALLNAME:MASTER%の首筋に鋭い痛みが走る。	PRINTFORML 　当%CALLNAME:MASTER%抱住%CALLNAME:TARGET%的时候%CALLNAME:MASTER%的脖子开始剧烈疼痛。
PRINTFORMW 　どうやら%CALLNAME:TARGET%は%CALLNAME:MASTER%の血を吸っているようだ。	PRINTFORMW 　看来%CALLNAME:TARGET%在吸%CALLNAME:MASTER%的血。
PRINTFORML 「はいはい、%GREETING%」	PRINTFORML 「是是、%GREETING%」
PRINTFORMW 　%CALLNAME:TARGET%はにこやかにハグを返してきた。	PRINTFORMW 　%CALLNAME:TARGET%笑嘻嘻地把拥抱还给了我。
PRINTFORML 「はいはい、%GREETING%……全く、調子狂うぜ」	PRINTFORML 「是是、%GREETING%…真是的，你真是个疯子」
PRINTFORMW 　%CALLNAME:TARGET%は頭をポリポリと掻いている。	PRINTFORMW 　%CALLNAME:TARGET%在咯吱咯吱地饶头。
PRINTFORML 「ん、んんっ！？　……ったく、物好きなヤツだぜ」	PRINTFORML 「嗯，嗯！？…真是个不好意思的家伙啊」
PRINTFORMW 　%CALLNAME:TARGET%は恥ずかしそうにキスを受け入れてくれた。	PRINTFORMW 　%CALLNAME:TARGET%有点害羞接受了的接吻。
PRINTFORML 「……ッ！？　あんまりフザケんじゃねーぞ……」	PRINTFORML 「……！？别太当真了……」
PRINTFORMW 　%CALLNAME:TARGET%の目は今にも%CALLNAME:MASTER%を殺してしまいそうだ。	PRINTFORMW 　%CALLNAME:TARGET%的眼睛眼看就要杀了%CALLNAME:MASTER%。
PRINTFORML 「んっ！？　止めろよ、そう言う事はっ！」	PRINTFORML 「嗯！？住手吧，这种事！」
PRINTFORMW 　%CALLNAME:TARGET%は%CALLNAME:MASTER%をジト目でねめつけている。	PRINTFORMW 　%CALLNAME:TARGET%斜眼盯着%CALLNAME:MASTER%。
PRINTFORML 「ん……ったく、%CNAME("主人")%、メイドに手出しは禁止だぜ？」	PRINTFORML 「嗯%CNAME("主人")%、禁止对女仆动手哦？」
PRINTFORMW 　%CALLNAME:TARGET%は少し気恥ずかしそうだ。	PRINTFORMW 　%CALLNAME:TARGET%有点害羞。
PRINTFORML 「……ッ！？　言ってもわからねーようだな？」	PRINTFORML 「……！？说了也不知道吧？」
PRINTFORMW 　%CALLNAME:TARGET%は%CALLNAME:MASTER%の頭を思いっきり殴りつけた。	PRINTFORMW 　%CALLNAME:TARGET%狠狠地打了%CALLNAME:MASTER%的头。
PRINTFORML 「ん……%CNAME("主人")%はホントに物好きだな？」	PRINTFORML 「嗯……%CNAME("主人")%真的很喜欢这样吧？」
PRINTFORMW 　%CALLNAME:TARGET%は頭をポリポリと掻いている。	PRINTFORMW 　%CALLNAME:TARGET%的头在咯吱咯吱地抓着。
PRINTFORML 「ん……ったく、今度から御代でも貰おうかな？」	PRINTFORML 「嗯……真是的，下次要给我补偿吗？」
PRINTFORML 「ん……全く、調子狂うぜ」	PRINTFORML 「嗯……真是的，疯了」
PRINTFORML 「変態かバカだとは思っていたが%CNAME("一人称")%の予想を上回る度し難さだぞ？」	PRINTFORML 「原以为是变态和笨蛋，但却比%CNAME("一人称")%的预想还要变态？」
PRINTFORMW 　%CALLNAME:TARGET%は呆れているようだ。	PRINTFORMW 　%CALLNAME:TARGET%好像在发呆。
PRINTFORML 「……っ！？　何しやがる変態っ！！」	PRINTFORML 「……诶！？变态想干什么！」
PRINTFORML 「お、おま！？　バカヤローっ！！」	PRINTFORML 「哦，欢迎！？混蛋！！」
PRINTFORMW 　%CALLNAME:TARGET%は%CALLNAME:MASTER%の頭を押さえて制止している。	PRINTFORMW 　%CALLNAME:TARGET%按着%CALLNAME:MASTER%的头制止着。
PRINTFORML 「……あーもう！　好きにしろよっ！！」	PRINTFORML 「……啊，真是的！随你的便！！」
PRINTFORMW %CALLNAME:TARGET%は顔を真っ赤にしながら両足を広げた。	PRINTFORMW %CALLNAME:TARGET%红着脸张开了两腿。
PRINTFORML 「……っ！？　本当にわかんねー奴だなっ！！」	PRINTFORML 「……诶！？真是个搞不懂的家伙啊！！」
PRINTFORMW 　%CALLNAME:TARGET%は%CALLNAME:MASTER%を吸血鬼の怪力に任せてぶん殴った。	PRINTFORMW 　%CALLNAME:TARGET%把%CALLNAME:MASTER%借着吸血鬼的怪力，狠狠地揍了一顿
PRINTFORMW 　%CALLNAME:MASTER%の体力 300	PRINTFORMW 　%CALLNAME:MASTER%の体力 500
PRINTFORML 「そ、そう言うのは止めろって！！」	PRINTFORML 「不要那样说！！」
PRINTFORMW 　%CALLNAME:TARGET%は腰を捻ってむず痒そうにしている。	PRINTFORMW 　%CALLNAME:TARGET%扭了腰，痒痒的。
PRINTFORMW 　%CALLNAME:TARGET%はにこやかに挨拶を返してきた。	PRINTFORMW 　%CALLNAME:TARGET%笑嘻嘻地回了招呼。
PRINTFORMW 　%CALLNAME:TARGET%は眠そうに大欠伸をしている。	PRINTFORMW 　%CALLNAME:TARGET%像是在睡眠中打哈欠。
PRINTFORML 「はいはい、%GREETING%……全く、調子狂うぜ」	PRINTFORML 「是是、%GREETING%……真是的，疯了」
PRINTFORML 「ん……ふぁあぁ」	PRINTFORML 「嗯……啊哈哈」
PRINTFORMW 　%CALLNAME:TARGET%は眠そうに欠伸をしている。	PRINTFORMW 　%CALLNAME:TARGET%困倦地打哈欠。
PRINTFORMW 「もう終わり！ もう御終いじゃボケぇっ！！」	PRINTFORMW 「已经结束了！结束了就别装傻吧！！！」
PRINTFORMW 「あーーあちゅい……」	PRINTFORMW 「啊—啊—啊中……」
PRINTFORMW 「あーー涼しい」	PRINTFORMW 「啊—凉快」
PRINTFORML 「デキるメイドって感じだろ？　……力仕事は任せろ」	PRINTFORML 「你觉得我像女仆吧？……把活交给我吧。」
PRINTFORMW 　%CALLNAME:TARGET%はそう言うと力こぶが出来ないマッスルポーズをした。	PRINTFORMW 　%CALLNAME:TARGET%那样说的话，做出了一个连我不能都做不到的姿势。
PRINTFORML 「%CNAME("二人称", "どもり")%はただメイド服が好きなだけだろうが！」	PRINTFORML 「%CNAME("二人称", "どもり")%只是喜欢女仆装而已！」
PRINTFORMW 　そう吠える%CALLNAME:TARGET%の頬は若干緩んでいる。	PRINTFORMW 　那样说%CALLNAME:TARGET%的脸颊微微一动。
PRINTFORML 「は、恥ずかしいこと言うなよ！」	PRINTFORML 「不要说这么丢脸的话！」
PRINTFORMW 　%CALLNAME:TARGET%は顔を赤くしている。	PRINTFORMW 　%CALLNAME:TARGET%は红着脸いる。
PRINTFORML 「な、なんだよいきなり……」	PRINTFORML 「什么啊，突然这样……」
PRINTFORMW 　%CALLNAME:TARGET%の頬は若干緩んでいる。	PRINTFORMW 　%CALLNAME:TARGET%的脸颊微微一动。
PRINTFORML 「%CNAME("主人")%はホントにメイド服がお好きでございますねぇ？」	PRINTFORML 「%CNAME("主人")%真的很喜欢女仆装吧？」
PRINTFORMW 　%CALLNAME:TARGET%はすまし顔のつもりだがその顔は真っ赤だ。	PRINTFORMW 　%CALLNAME:TARGET%本想装模作样的，可是脸却是通红的。
PRINTFORML 「%CNAME("主人", "どもり")%？ そんな事ばかり言ってると殴りますわよ？」	PRINTFORML 「%CNAME("主人", "どもり")%？老是说那种话的话会揍你的哦？」
PRINTFORMW 　%CALLNAME:TARGET%は顔を赤くしてプルプルと震えている。	PRINTFORMW 　%CALLNAME:TARGET%红着脸声音颤抖着说。
PRINTFORML 「はぁ？　ただメイド服でスケベな事がしたいだけじゃないのかぁ？」	PRINTFORML 「哈？只是想看女仆装的色鬼而已吗？」
PRINTFORMW 　%CALLNAME:TARGET%はジト目で%CALLNAME:MASTER%を見つめている。	PRINTFORMW 　%CALLNAME:TARGET%斜眼看了%CALLNAME:MASTER%。
PRINTFORML 「ん……な、なんだよ」	PRINTFORML 「嗯……什、什么啊」
PRINTFORMW 　%CALLNAME:TARGET%は顔を背けているが耳まで真っ赤になっている。	PRINTFORMW 　%CALLNAME:TARGET%背过脸，耳朵都红了。
PRINTFORML 「%CNAME("一人称", "どもり")%なんかにそんな事言って楽しいのかよ…？」	PRINTFORML 「对%CNAME("一人称", "どもり")%说那种话会开心吗……？」
PRINTFORMW 　%CALLNAME:TARGET%は顔を赤くしている。	PRINTFORMW 　%CALLNAME:TARGET%红着脸。
PRINTFORMW 「はぁ？　そう言うのは別の娘に言えよ」	PRINTFORMW 「哈？别跟别人说了」
PRINTFORML 「あー……その、%CNAME("主人")%？」	PRINTFORML 「啊……那个、%CNAME("主人")%？」
PRINTFORML 　%CALLNAME:TARGET%の視線は%CALLNAME:MASTER%の首筋を見つめている。	PRINTFORML 　%CALLNAME:TARGET%的视线看到了%CALLNAME:MASTER%的脖颈。
PRINTFORMW 　%CALLNAME:MASTER%が肩を差し出すと%CALLNAME:TARGET%は静々と%CALLNAME:MASTER%の首筋に噛みついた。	PRINTFORMW 　%CALLNAME:MASTER%伸出肩膀%CALLNAME:TARGET%静静地咬着%CALLNAME:MASTER%的脖子。
PRINTFORML 「ごくりっ……いや、なんでもない」	PRINTFORML 「唔咽……不，没什么」
PRINTFORMW 　%CALLNAME:TARGET%は%CALLNAME:MASTER%の首筋を見つめている。	PRINTFORMW 　%CALLNAME:TARGET%看到了%CALLNAME:MASTER%的脖颈。
PRINTFORML 「メイド服って結構動きやすいな」	PRINTFORML 「女仆装打扮起来很容易移动啊」
PRINTFORMW 　%CALLNAME:TARGET%はその場で一回転して見せた。	PRINTFORMW 　%CALLNAME:TARGET%当场转了一圈。
PRINTFORML 「メイドらしい事……？ %TEXTR("オムライスにハートマーク/一緒にチェキを撮る/はい、あ～ん")%とか？」	PRINTFORML 「有女仆味的事……？%TEXTR("蛋包饭上的心形标记/一起拍拍立得/是，啊")%之类的？」
PRINTFORMW 　それはメイド喫茶だと%CALLNAME:MASTER%は思った。	PRINTFORMW 　%CALLNAME:MASTER%觉得这是女仆咖啡馆？
PRINTFORML 「あ……別にメイドを馬鹿にしたワケではないっスから！？」	PRINTFORML 「啊……这不是我故意要嘲讽女仆的理由！？」
PRINTFORMW 　%CALLNAME:TARGET%は%CALLNAME:FINDCHARA(NO, 1)%にペコペコと弁明を始めた。	PRINTFORMW 　%CALLNAME:TARGET%跟%CALLNAME:FINDCHARA(NO, 1)%那里啪嗒啪嗒地辩白。
PRINTFORML 「あんま他の娘に頼るとフェリシエルさんが拗ねちまうぜ？」	PRINTFORML 「拜托其他的女生的话弗理希艾尔桑会闹别扭的吧？」
PRINTFORMW 　%CALLNAME:TARGET%はニヤニヤと%CALLNAME:MASTER%に言ってきた。	PRINTFORMW 　%CALLNAME:TARGET%对%CALLNAME:MASTER%说了。
PRINTFORML 　しかし不意に視線を感じ後ろを振り向くとそこには%CALLNAME:FINDCHARA(NO, 1)%が笑顔で立っていた。	PRINTFORML 　但是突然感受到了视线回头一看%CALLNAME:FINDCHARA(NO, 1)%笑着站在那里。
PRINTFORMW 「あーいや、その……なんでもないです」	PRINTFORMW 「あ啊，不，那个……没什么。」
PRINTFORML 「吸血鬼になった所為で昼に眠くなる……」	PRINTFORML 「变成了吸血鬼，白天会犯困……」
PRINTFORMW 　%CALLNAME:TARGET%の目は眠たげだ。	PRINTFORMW 　%CALLNAME:TARGET%の眼睛快闭上的。
PRINTFORML 「あー……喉が渇く」	PRINTFORML 「啊……口渴」
PRINTFORMW 　そう言うと%CALLNAME:TARGET%はお茶を一気に飲み干した。	PRINTFORMW 　这样说着，%CALLNAME:TARGET%一口气喝干了茶。
PRINTFORML 「ごくりっ……その、スマン！」	PRINTFORML 「唔咽……那个，抱歉！」
PRINTFORML 　%CALLNAME:TARGET%は%CALLNAME:MASTER%に抱きつき、首筋に噛み付いた。	PRINTFORML 　%CALLNAME:TARGET%抱住%CALLNAME:MASTER%咬着脖子。
PRINTFORML 「夜の散歩にでも行こうかな……？」	PRINTFORML 「晚上去散步吧……？」
PRINTFORML 　%CALLNAME:TARGET%はこんな真夜中に一人で出かけようとしている。	PRINTFORML 　%CALLNAME:TARGET%就在这深更半夜里一个人出门。
PRINTFORMW 　%CALLNAME:MASTER%は何とか%CALLNAME:TARGET%を押し止めた。	PRINTFORMW 　%CALLNAME:MASTER%设法阻止了%CALLNAME:TARGET%。
PRINTFORML 「今日は少し日差しがキツい……」	PRINTFORML 「今天阳光有点刺眼……」
PRINTFORMW 　少しでも影を求めてか%CALLNAME:TARGET%は%CALLNAME:MASTER%に身体を預けている。	PRINTFORMW 　为了寻求影子，%CALLNAME:TARGET%把身体躲在%CALLNAME:MASTER%身后。
PRINTFORML 「%CNAME("二人称")%たちには感謝してんるだけど……な」	PRINTFORML 「虽然我很感谢%CNAME("二人称")%他们……的」
PRINTFORMW 　%CALLNAME:TARGET%は少し複雑そうな顔をしている。	PRINTFORMW 　%CALLNAME:TARGET%的表情有点复杂。
PRINTFORML 「この部室はいつ来てもお菓子があるな」	PRINTFORML 「来了这个房间也有点心啊」
PRINTFORMW 　%CALLNAME:TARGET%はお菓子を遠慮なく食べている。	PRINTFORMW 　%CALLNAME:TARGET%毫不客气地吃着点心。
PRINTFORML 「……ハァ　ん？　ああ、最近クラスの男共が若干煩わしくてな」	PRINTFORML 「……哈？啊，最近班上的男生都有点烦啊」
PRINTFORMW 　%CALLNAME:TARGET%はため息を一つ吐いた。	PRINTFORMW 　%CALLNAME:TARGET%吐出了一声叹息。
PRINTFORMW 「……%CNAME("二人称")%以外に触らせっかよ」	PRINTFORMW 「……除了%CNAME("二人称")%以外，别碰我」
PRINTFORML 「ふぁあ……眠いぜ」	PRINTFORML 「啊啊……困死了」
PRINTFORML 「じ、自分で拭けるっつーの！」	PRINTFORML 「那么，我自己来擦吧！」
PRINTFORMW 　%CALLNAME:TARGET%は%CALLNAME:MASTER%からタオルを奪い取った。	PRINTFORMW 　%CALLNAME:TARGET%从%CALLNAME:MASTER%那里夺取了毛巾。
PRINTFORMW シャワーを浴びながら%CALLNAME:TARGET%は%TEXTR("懐かしいヒーローソング/熱いロボソン/有名なロックソング")%を歌っている。	PRINTFORMW 沐浴在淋雨中的%CALLNAME:TARGET%唱出了%TEXTR("令人怀念的英雄歌曲/热血机器人战斗曲/有名的摇滚歌曲")%。
PRINTFORML 「……ぶっ飛ばすぞ？」	PRINTFORML 「……我要打爆你的头！」
PRINTFORMW %CALLNAME:TARGET%は今にも%CALLNAME:MASTER%をぶん殴りそうだ	PRINTFORMW %CALLNAME:TARGET%眼看就要揍%CALLNAME:MASTER%
PRINTFORML 「……%CNAME("二人称")%は本当にしょうがないヤツだな？」	PRINTFORML 「……%CNAME("二人称")%真的是让人没办法的家伙吗？」
PRINTFORMW %CALLNAME:TARGET%は%CALLNAME:MASTER%の行動に呆れている。	PRINTFORMW %CALLNAME:TARGET%对%CALLNAME:MASTER%的行动感到惊讶。。
PRINTFORML 「んんっ……部活やってた時を思い出すぜ」	PRINTFORML 「嗯……我想起了之前参加社团活动的时候」
PRINTFORMW %CALLNAME:TARGET%は少し物憂げだ。	PRINTFORMW %CALLNAME:TARGET%有点无精打采。
PRINTFORML 「ん……ったく舌に噛み付いちまうぞ？」	PRINTFORML 「嗯……会咬住舌头的哦？」
PRINTFORMW 　%CALLNAME:TARGET%はそう言うと舌を絡めてきた。	PRINTFORMW 　%CALLNAME:TARGET%这么一说就把舌头缠在了一起。
PRINTFORML 「ん……ちゅぷ」	PRINTFORML 「嗯……普通」
PRINTFORMW 　キスをすると%CALLNAME:TARGET%は%CALLNAME:MASTER%の首に手を回してきた。	PRINTFORMW 　接吻后%CALLNAME:TARGET%把手转到了%CALLNAME:MASTER%的脖子上。
PRINTFORML 「ッ！？　ふざけんなよっ！」	PRINTFORML 「！？别开玩笑了！」
PRINTFORMW 　%CALLNAME:TARGET%は思いっきり引っ叩いた。	PRINTFORMW 　%CALLNAME:TARGET%狠狠地揍了一顿。
PRINTFORML 「……っ！　ふんっ！」	PRINTFORML 「……嘿！哼！」
PRINTFORMW 　%CALLNAME:TARGET%は%CALLNAME:MASTER%からそっぽを向いてしまった。	PRINTFORMW 　%CALLNAME:TARGET%从%CALLNAME:MASTER%身上转过身去。
PRINTFORML 「……ったく、色情魔めっ」	PRINTFORML 「……色鬼！」
PRINTFORMW 　%CALLNAME:TARGET%は%CALLNAME:MASTER%をジト目でこちらでねめつけている。	PRINTFORMW 　%CALLNAME:TARGET%斜眼看着%CALLNAME:MASTER%在这里睡着。
PRINTFORML 「ん……%CNAME("一人称")%とキスして何が楽しいんだか」	PRINTFORML 「嗯……和%CNAME("一人称")%接吻有什么开心的？」
PRINTFORMW 　%CALLNAME:TARGET%は不服そうな顔をしている。	PRINTFORMW 　%CALLNAME:TARGET%一脸不服的样子。。
PRINTFORML 「男の膝枕って……まぁいいやちょうど眠かったんだ」	PRINTFORML 「男人的枕膝……算了，我正好困了」
PRINTFORMW 　%CALLNAME:TARGET%は%CALLNAME:MASTER%の膝でうつらうつらし始めた。	PRINTFORMW 　%CALLNAME:TARGET%开始在%CALLNAME:MASTER%的膝盖上昏昏欲睡。
PRINTFORMW 「お、ありがとさん」	PRINTFORMW 「哦，谢谢你」
PRINTFORMW 「うん？　ありがとう」	PRINTFORMW 「嗯？谢谢你」
PRINTFORMW 「噛み付いちまうぞー？」	PRINTFORMW 「我会忍不住要咬你哦？」
PRINTFORML 「んじゅる……」	PRINTFORML 「嗯，知道了……」
PRINTFORMW 　%CALLNAME:TARGET%は愛おしそうに%CALLNAME:MASTER%のモノをしゃぶっている。	PRINTFORMW 　%CALLNAME:TARGET%可爱地吮吸着%CALLNAME:MASTER%的东西。
PRINTFORML 「んじゅる……なんだよ？　早く元に戻る為だぞ」	PRINTFORML 「嗯，知道了……什么啊？为了早日恢复原状」
PRINTFORMW 　%CALLNAME:TARGET%は%CALLNAME:MASTER%のモノを雑にしゃぶっている。	PRINTFORMW 　%CALLNAME:TARGET%在杂乱地吮吸着%CALLNAME:MASTER%的东西。
PRINTFORML 「スキあり！」	PRINTFORML 「有破绽！」
PRINTFORMW 　%CALLNAME:TARGET%は愛おしそうに%CALLNAME:MASTER%の唇に唇を重ねた。	PRINTFORMW 　爱怜地将嘴唇重叠在%CALLNAME:MASTER%的唇上。
PRINTFORML 「んちゅ……あぅ！？　ただ血が欲しくなっただけだ！」	PRINTFORML 「嗯……啊！？只是想要血而已！」
PRINTFORMW 　%CALLNAME:TARGET%は%CALLNAME:MASTER%に触れるような軽いキスをした。	PRINTFORMW 　%CALLNAME:TARGET%轻吻了%CALLNAME:MASTER%。
PRINTFORMW 「……ほらよ%SAVESTR:お茶%だぜ」	PRINTFORMW 「……ほらよ%SAVESTR:茶%だぜ」
PRINTFORMW 「一緒にゲームでもするか？」	PRINTFORMW 「一緒に游戏でもするか？」
PRINTFORMW 「ふぅ……」	PRINTFORMW 「呼…………」
PRINTFORMW 「ふぅ……」	PRINTFORMW 「呼……」
PRINTFORMW 「ん……ちょっと失礼するぜ」	PRINTFORMW 「嗯……我要失陪一下」
PRINTFORML 「……%CNAME("一人称")%がドッチのトイレに入ってるのか気になるってのか？」	PRINTFORML 「……你在意%CNAME("一人称")%是不是进了厕所？」
PRINTFORMW 　%CALLNAME:TARGET%は目に見えて不機嫌そうになった。	PRINTFORMW 　%CALLNAME:TARGET%用讨厌的眼神。
PRINTFORML 「……ふんっ！！」	PRINTFORML 「……哼！」
PRINTFORMW 　%CALLNAME:MASTER%は思いっきりぶっ飛ばされた。	PRINTFORMW 　%CALLNAME:MASTER%被狠狠地揍飞了。
PRINTFORMW 「あんまりふざけるなよ？」	PRINTFORMW 「别开玩笑了？」
PRINTFORML 「あ、あんまり変な事するなよ？」	PRINTFORML 「啊，不要做太奇怪的事啊？」
PRINTFORMW 　%CALLNAME:TARGET%はむず痒そうにしている。	PRINTFORMW 　%CALLNAME:TARGET%痒痒的。
PRINTFORML 「はぁ……何故%CNAME("一人称")%はこんなヤツに頼らなきゃいけないんだ」	PRINTFORML 「哈……为什么%CNAME("一人称")%必须依赖这样的人呢」
PRINTFORMW 　%CALLNAME:TARGET%は明らかに落胆している。	PRINTFORMW 　%CALLNAME:TARGET%显然很沮丧。
PRINTFORML 「バ、バカじゃねーのか！？」	PRINTFORML 「哇，你不是笨蛋吗！？」
PRINTFORMW 　%CALLNAME:TARGET%は身を捩って最後の抵抗をしている。	PRINTFORMW 　%CALLNAME:TARGET%扭曲着身体做着最后的抵抗。
PRINTFORMW KOJO_DAILYCOM_K14, %ARGS%：合意無し	PRINTFORMW KOJO_DAILYCOM_K14, %ARGS%：合意没有
PRINTFORML 「パンツ見せてくれってお前……」	PRINTFORML 「展示内裤给你看一下……」
PRINTFORML 「……仕方ねーなぁ」	PRINTFORML 「……没办法啊」
PRINTFORMW 「あんま他の娘に頼むんじゃねーぞ？」	PRINTFORMW 「不要拜托其他的女生哦？」
PRINTFORML 「ハァ！？　パンツ見せてくれだぁ！？　……ふざけやがって」	PRINTFORML 「哈！？让我展示内裤一下吧！？…开玩笑的」
PRINTFORML 「そう言うのは他の娘に……言ったらダメだな」	PRINTFORML 「说这话的是对别的女生……不能说啊」
PRINTFORMW 「……ハァ、仕方ねーか。%CNAME("二人称")%が捕まったら%CNAME("一人称")%が戻れなくなる」	PRINTFORMW 「……啊，没办法啊。如果抓住了%CNAME("二人称")%，%CNAME("一人称")%就回不来了」
PRINTFORML 「……ハァ、もう勝手に見てくれ」	PRINTFORML 「……啊，随你的便吧」
PRINTFORMW 　%CALLNAME:TARGET%は%CALLNAME:MASTER%を憐憫の目で見ている。	PRINTFORMW 　%CALLNAME:TARGET%用怜悯的眼光看着%CALLNAME:MASTER%。
PRINTFORML 「パンツ？　仕方ねーなぁ」	PRINTFORML 「胖次？没办法啊」
PRINTFORMW 　%CALLNAME:TARGET%は徐に下半身を露出させた。	PRINTFORMW 　%CALLNAME:TARGET%渐渐露出了下半身。
PRINTFORML 「%CNAME("二人称")%……本当に節操がねーな」	PRINTFORML 「%CNAME("二人称")%……真没节操啊」
PRINTFORMW 　%CALLNAME:TARGET%は恥ずかしそうに下半身を露出させた。	PRINTFORMW 　%CALLNAME:TARGET%露出了自己的身体。
PRINTFORMW 「%CNAME("二人称")%……性犯罪者にだけはなるんじゃないぞ……」	PRINTFORMW 「%CNAME("二人称")%……不仅仅是性犯罪者……」
PRINTFORMW 「ン……？ 何だよジロジロ見てからに？」	PRINTFORMW 「嗯……？什么啊，等我慢慢看了之后？休想」
PRINTFORML 「その視線……見せて欲しいのは丸わかりだが、あいにく今日は可愛いのは穿いていないぜ？」	PRINTFORML 「那个视线……我完全知道你想看什么，但是不巧今天没有穿可爱的衣服哦？」
PRINTFORMW %CALLNAME:TARGET%はパタパタとスカートをたくし上げた。	PRINTFORMW %CALLNAME:TARGET%啪嗒啪嗒地把裙子弄到手。
PRINTFORML 「その視線……見せて欲しいのは丸わかりなんだよ」	PRINTFORML 「那个视线……我完全知道你想看什么」
PRINTFORMW %CALLNAME:TARGET%は羞恥心に頬を染めながらもスカートをたくし上げた。	PRINTFORMW %CALLNAME:TARGET%的脸被羞耻心染红，同时也把裙子撩起。
PRINTFORML 「なんだぁ？ そんなに見たかったのかぁ？ だけど%TEXTR("コレだぜ/残念だったな")%？」	PRINTFORML 「什么啊？那么想看吗？但是%TEXTR("就是这个/真遗憾啊")%？」
PRINTFORMW %CALLNAME:TARGET%は%TEXTR("楽しそうに/ニヤケつつ/能天気に")%スカートをパタパタとめくっている。	PRINTFORMW %CALLNAME:TARGET%是%TEXTR("快乐地/一边笑/开朗地")%吧嗒吧嗒地翻着裙子。
PRINTFORML 「なんだぁ？ そんなに見たかったのかぁ？ 本当にバカなヤツだなぁ」	PRINTFORML 「什么啊？那么想看吗？真是个笨蛋啊」
PRINTFORMW %CALLNAME:TARGET%は%TEXTR("羞恥心/気恥ずかしさ")%に頬を少しだけ染めています。	PRINTFORMW %CALLNAME:TARGET%稍微染了一点在脸上%TEXTR("羞耻心/害羞")%。
PRINTFORML 「ハッハッハ、%TEXTR("きょうはコイツだぜ/残念だったな")%」	PRINTFORML 「哈哈哈，%TEXTR("今天是这家伙/真遗憾啊")%」
PRINTFORMW %CALLNAME:TARGET%は%PANTIES(TARGET, "略")%をマジマジを見せつけてきました。	PRINTFORMW %CALLNAME:TARGET%把%PANTIES(TARGET, "略")%真的给人看了。
PRINTFORML 「……その情熱を他の所に向けられないのか？」	PRINTFORML 「……你不能把那个热情转向其他地方吗？」
PRINTFORMW %CALLNAME:TARGET%は呆れ顔で%CALLNAME:MASTER%が満足するまで%PANTIES(TARGET, "略")%を見せてくれました。。	PRINTFORMW %CALLNAME:TARGET%用惊讶的表情让我看到了%PANTIES(TARGET, "略")%，直到%CALLNAME:MASTER%满足为止。
PRINTFORML 「%TEXTR("うぅん/むにゃ/ZZzz")%……%TEXTR("やめろよぉ/あっちいけよぉ/眠いんだよぉ")%、%TEXTR("へんたい/ばか/ぱんつまん")%」	PRINTFORML 「%TEXTR("嗯，嗯/软绵绵/ZZzz")%……%TEXTR("快住手！/在那边哦/好困啊")%、%TEXTR("变态/笨蛋/白痴")%」
PRINTFORMW %CALLNAME:TARGET%は眠いながらも腕をブンブンと振って%CALLNAME:MASTER%を威嚇しています。	PRINTFORMW %CALLNAME:TARGET%虽然很困，但还是振臂恐吓着%CALLNAME:MASTER%。
PRINTFORML 「……%CNAME("二人称")%いつもこんな事やってんのか？ だけど残念だったなぁ？」	PRINTFORML 「………%CNAME("二人称")%总是做这种事吗？但是很遗憾啊？」
PRINTFORMW しかし%CALLNAME:TARGET%は大股開きで座っているために僅かな隙間から大事な部分が見えそうだ。	PRINTFORMW 但是因为%CALLNAME:TARGET%大踏步地坐着，从仅有的缝隙中似乎能看到重要的部分。
PRINTFORML 「……%CNAME("二人称")%いつもこんな事やってんのか？ 普通に引くわ……」	PRINTFORML 「……%CNAME("二人称")%总是做这种事吗？普通的垃圾……」
PRINTFORMW %CALLNAME:TARGET%は可哀そうな生き物を見る目で%CALLNAME:MASTER%を見ています。	PRINTFORMW %CALLNAME:TARGET%用看到可怜生物的眼睛看着%CALLNAME:MASTER%。
PRINTFORML 「……挨拶する前にする事がそれかよ」	PRINTFORML 「……在打招呼前做的事就是那样啊」
PRINTFORMW 　%CALLNAME:TARGET%は呆れ顔だ。	PRINTFORMW 　%CALLNAME:TARGET%是一张目瞪口呆的脸。
PRINTFORML 「なぁ……きょ、今日は止めておかないか……？ あ、あぅ……」	PRINTFORML 「啊……今天不停下来吗……？啊，啊……」
PRINTFORMW %CALLNAME:MASTER%に詰め寄られた%CALLNAME:TARGET%は顔を赤らめて抵抗を止めました。	PRINTFORMW 被%CALLNAME:MASTER%逼迫的%CALLNAME:TARGET%红着脸停止了抵抗。
PRINTFORML 「な、何すんだっ！？ やめっ！ オワァーっ！？」	PRINTFORML 「什、干什么！？住手！哇！？」
PRINTFORMW %CALLNAME:MASTER%がスカートを捲ろうとすると%CALLNAME:TARGET%は盛大に抵抗しました。	PRINTFORMW 当%CALLNAME:MASTER%卷着裙子的时候，%CALLNAME:TARGET%进行了激烈的抵抗。
PRINTFORML 「な、何すんじゃい！？ や、止めてーっ！！」	PRINTFORML 「什么、干什么！？住手！哇！？」
PRINTFORMW %CALLNAME:MASTER%は嫌がる%CALLNAME:TARGET%のスカートを無理矢理捲りました。	PRINTFORMW %CALLNAME:MASTER%强行卷了讨厌的%CALLNAME:TARGET%的裙子。
PRINTFORML 「はっはっは残念だったなぁ！ %CNAME("二人称")%が期待しているようなパンツは穿いてないぜ！」	PRINTFORML 「哈哈好遗憾啊！没有穿%CNAME("二人称")%期待的胖次哦！」
PRINTFORML 「全く……本当に仕方のないヤツだなぁ？」	PRINTFORML 「真是的……真是没办法的家伙啊？」
PRINTFORMW %CALLNAME:TARGET%はほんの少しだけスカートを捲り上げて%CALLNAME:MASTER%を誘っています。	PRINTFORMW %CALLNAME:TARGET%卷起一点点的裙子诱惑着%CALLNAME:MASTER%。
PRINTFORML 「……%CNAME("一人称")%は%CNAME("二人称")%に頼らないといけないことを激しく後悔している」	PRINTFORML 「「……%CNAME("一人称")%强烈地后悔必须依靠%CNAME("二人称")%」
PRINTFORMW %CALLNAME:TARGET%は%CALLNAME:MASTER%を可哀そうな生き物を見る目で見ている。	PRINTFORMW %CALLNAME:TARGET%用眼睛看着可怜的生物。
PRINTFORML 「……女の子のパンツが見たいと言う男のサガは分かる……分かるが%CNAME("二人称")%は明け透けすぎる」	PRINTFORML 「……说想看女孩子胖次的男人的下面明白……虽然明白，但是%CNAME("二人称")%太过直白」
PRINTFORMW %CALLNAME:TARGET%は呆れ顔でスカートを捲って見せた。	PRINTFORMW %CALLNAME:TARGET%用惊讶的表情卷着裙子给人看。
PRINTFORMW KOJO_DATE_K14, %ARGS%(同棲していない)	PRINTFORMW KOJO_DATE_K14, %ARGS%(同居していない)
PRINTFORMW KOJO_DATE_K14, %ARGS%(同棲中)	PRINTFORMW KOJO_DATE_K14, %ARGS%(同居中)
//文件: EVENT_K14_SELECT.ERB
PRINTFORMW %CALLNAME:MASTER%は%CALLNAME:TARGET%に見えるように襟元を緩めた。	PRINTFORMW %CALLNAME:MASTER%向%CALLNAME:TARGET%一样松开了领口。
PRINTFORML 「今日はもう良いっつーの！」	PRINTFORML 「今天已经好了！」
PRINTFORML 「ごくっ・・・いや、なんでもない」	PRINTFORML 「哼……・・・不，没什么」
PRINTFORML 「いや、大丈夫・・・大丈夫だ」	PRINTFORML 「不，没关系，・・・真没关系。」
PRINTFORML 「今日はもう大丈夫だから・・・」	PRINTFORML 「今天已经没事了……」
PRINTFORML 「ごくっ・・・おい、節度って知ってるか？」	PRINTFORML 「够了……喂，你知道节制吗？」
PRINTFORML 「いや、そんなには飲まん・・・！」	PRINTFORML 「不，喝得那么多…！」
PRINTFORML 「今日はもう飲んだだろ！　あんま誘惑すんじゃねえ！」	PRINTFORML 「今天已经喝够了！不要诱惑我！」
PRINTFORML 「ふー・・・あんまり誘惑してくれるなよ？」	PRINTFORML 「呼……・・・不要太诱惑我了吧？」
PRINTFORML 「ん～なんだ？　また吸って欲しいのか？」	PRINTFORML 「嗯~什么？你还想再吸吗？」
PRINTFORML 「いや、そんなには飲まねーよ」	PRINTFORML 「不，我不喝那么多」
PRINTFORML 「ふー・・・いや、あんま飲み過ぎると人間離れしちまいそうだしな」	PRINTFORML 「呼……不，喝多了的话，你作为人类会出问题的。」
PRINTFORML 「今日はもう飲んだから大丈夫だ」	PRINTFORML 「今天已经喝了，没关系。」
PRINTFORMW 今日はもう血は充分なようだ。	PRINTFORMW 今天血已经够了。
PRINTFORML 「い、いや……だから別に良いって！」	PRINTFORML 「不、不……所以说没什么好的！」
PRINTFORMW シキは誘惑を振り払うように大きく手を振って断った。	PRINTFORMW 织为了摆脱诱惑，用力挥着手拒绝了。。
PRINTFORMW %CALLNAME:TARGET%は%CALLNAME:MASTER%の首筋を見つめているが、まだ吸血衝動の自制が利く様だ。	PRINTFORMW %CALLNAME:TARGET%看到了%CALLNAME:MASTER%的脖子，但好像还是吸血冲动的自制力很强。
PRINTFORML 「・・・そんなに吸わせたいのか？」	PRINTFORML 「・・・那么想让我吸吗？」
PRINTFORMW %CALLNAME:TARGET%は観念したようにため息を吐いた。	PRINTFORMW %CALLNAME:TARGET%像是认了似的叹了一口气。
PRINTFORML 「・・・ん」	PRINTFORML 「・・恩」
PRINTFORML %CALLNAME:TARGET%は%CALLNAME:MASTER%に顔を近づけるとそのまま%CALLNAME:MASTER%にキスをした。	PRINTFORML %CALLNAME:TARGET%把脸靠近%CALLNAME:MASTER%就这样和%CALLNAME:MASTER%接吻了。
PRINTFORMW チクリとした痛みが走る。どうやら唇を少し傷つけられたようだ。	PRINTFORMW 一阵刺痛。看来嘴唇受了点儿伤。
PRINTFORMW 「んちゅ・・・ふー・・・ごちそうさん！」	PRINTFORMW 「恩・・・呼・・・佳肴桑！」
PRINTFORML 　%CALLNAME:MASTER%の魂0.01	PRINTFORML 　%CALLNAME:MASTER%之魂0。01
PRINTFORMW 　%CALLNAME:TARGET%の魂+0.01	PRINTFORMW 　%CALLNAME:TARGET%之魂+0.。01
PRINTFORML 「・・・じゃあ、ちょっともらうぞ」	PRINTFORML 「・・・那我就要一点吧」
PRINTFORML %CALLNAME:TARGET%は%CALLNAME:MASTER%の手を取ると手の端に噛みついた。	PRINTFORML %CALLNAME:TARGET%拿起%CALLNAME:MASTER%的手，咬到了手的边缘。
PRINTFORMW チクリとした痛みが走り、%CALLNAME:TARGET%が%CALLNAME:MASTER%の手から血を吸い始めた。	PRINTFORMW 突然一阵剧痛，%CALLNAME:TARGET%从%CALLNAME:MASTER%的手中开始吸血。
PRINTFORML 「だ、大丈夫だっつーの！」	PRINTFORML 「没关系的！」
PRINTFORML 「ごくっ・・・いや、なんでもない」	PRINTFORML 「哼……不，没什么」
PRINTFORML 「いや、大丈夫・・・大丈夫だ」	PRINTFORML 「不，没关系。」
PRINTFORML 「その、大丈夫だから・・・」	PRINTFORML 「那个，没关系……」
PRINTFORML 「いや、今は飲まん・・・！」	PRINTFORML 「不，现在就喝吧…！」
PRINTFORML 「いや、今は良いって・・・」	PRINTFORML 「不，现在说好的……」
PRINTFORML 「ん～・・・あんまり誘惑してくれるなよ？」	PRINTFORML 「嗯～・・不要太诱惑我了？」
PRINTFORML 「今はそんな必要な感じしねぇ」	PRINTFORML 「现在没有那种必要的感觉」
PRINTFORML 「いや、大丈夫だから」	PRINTFORML 「不，没关系」
PRINTFORML 「んー・・・いや、あんま飲み過ぎると人間離れしちまいそうだしな」	PRINTFORML 「嗯……不，喝多了的话，作为人类会出问题的。」
PRINTFORML 「今は大丈夫だから」	PRINTFORML 「现在没关系」
PRINTFORML 「・・・な、なんだよ」	PRINTFORML 「・・・什、什么啊」
PRINTFORML %CALLNAME:TARGET%は戸惑いながらも%CALLNAME:MASTER%の首筋を見つめ、喉をごくりと鳴らした。	PRINTFORML %CALLNAME:TARGET%困惑地凝视着%CALLNAME:MASTER%的脖子，喉咙呼噜呼噜地响。。
PRINTFORMW %CALLNAME:MASTER%が許可を出すと%CALLNAME:TARGET%は恐る恐る顔を近づける。	PRINTFORMW 当%CALLNAME:MASTER%得到许可后，%CALLNAME:TARGET%战战兢兢地靠近他。。
PRINTFORML 「はむっ・・・」	PRINTFORML 「哈哈……」
PRINTFORML %CALLNAME:TARGET%は%CALLNAME:MASTER%の首筋に牙を立てた。	PRINTFORML %CALLNAME:TARGET%把牙竖在了%CALLNAME:MASTER%的脖颈上。
PRINTFORMW チクリとした痛みを感じると、%CALLNAME:MASTER%は次に何かを奪われる感覚に陥った。	PRINTFORMW 当感觉到隐隐作痛的时候，%CALLNAME:MASTER%陷入了接下来会被夺走什么的感觉。
PRINTFORML 「ぷはっ・・・！！　ん、ありがとう」	PRINTFORML 「噗…！嗯，谢谢」
PRINTFORML しかし次の瞬間には%CALLNAME:TARGET%は首筋から口を離してしまった。	PRINTFORML 但是下一个瞬间，%CALLNAME:TARGET%就从脖子里脱口而出了。
PRINTFORMW あれでは一口程も血を吸えてないように思えた。	PRINTFORMW 我觉得那样的话一口也不能吸血。。
PRINTFORML 「・・・や、やっぱ良い！　大丈夫だ！」	PRINTFORML 「・・・果然很好！没关系！」
PRINTFORML %CALLNAME:MASTER%の首筋に%CALLNAME:TARGET%の舌先が少し触れるがすぐに離れてしまった。	PRINTFORML %CALLNAME:TARGET%的舌尖稍微碰了一下，马上就出口了。。
PRINTFORMW どうやら直前で怖気づいてしまったようだ。	PRINTFORMW 好像在快要开始的时候害怕起来了。。
PRINTFORML 「い、いや、結構だ！」	PRINTFORML 「不，不，不用了！」
PRINTFORML 「の、飲めってか？　・・・む、無理だ！」	PRINTFORML 「能喝吗？・・・嗯，不行！」
PRINTFORML 「だ、大丈夫だから・・・」	PRINTFORML 「但是，没关系……」
PRINTFORML 「%TEXTR("う/あ/ん")%・・・%TEXTR("うあ/んあ/ああ")%・・・」	PRINTFORML 「%TEXTR("嗯/啊！/嗯")%・・・%TEXTR("嗯啊！/嗯啊！/啊！啊！")%・・・」
PRINTFORML 「が、ガマンできなっ・・・」	PRINTFORML 「但是，不能忍耐……」
PRINTFORML %CALLNAME:TARGET%はどこか虚ろな表情のまま%CALLNAME:MASTER%の肩に噛みついた。	PRINTFORML %CALLNAME:TARGET%带着空虚的表情咬着%CALLNAME:MASTER%的肩膀。
PRINTFORMW すると%CALLNAME:TARGET%はゴクゴクと喉を鳴らすほど血を吸い始めた。	PRINTFORMW 于是%CALLNAME:TARGET%开始吸血，喉咙都要呼噜呼噜地响了。
PRINTFORML 　%CALLNAME:MASTER%の魂0.35	PRINTFORML 　%CALLNAME:MASTER%之魂0。35
PRINTFORMW 　%CALLNAME:TARGET%の魂+0.35	PRINTFORMW 　%CALLNAME:TARGET%之魂+0.。35
PRINTFORML 「じゃ、じゃあちょっとだけ・・・」	PRINTFORML 「那就稍微…」
PRINTFORML 「か、渇きが治まらんのだ・・・」	PRINTFORML 「啊，口渴止住了……」
PRINTFORML 「すまん・・・いただくぞ」	PRINTFORML 「对不起，我要吸了。」
PRINTFORMW %CALLNAME:TARGET%は恐る恐る%CALLNAME:MASTER%の首筋に噛みついた。	PRINTFORMW %CALLNAME:TARGET%战战兢兢地咬着%CALLNAME:MASTER%的脖子。
PRINTFORML 　%CALLNAME:MASTER%の魂0.02	PRINTFORML 　%CALLNAME:MASTER%之魂0。02
PRINTFORMW 　%CALLNAME:TARGET%の魂+0.02	PRINTFORMW 　%CALLNAME:TARGET%之魂+0.。02
PRINTFORML 「いや、大丈夫だ・・・多分」	PRINTFORML 「不，没关系…大概」
PRINTFORML 「今日はそんなに渇いてないから平気だ」	PRINTFORML 「今天不怎么渴，没关系。」
PRINTFORML 「んー・・・今は遠慮しておくぜ」	PRINTFORML 「嗯……现在就不客气了」
PRINTFORML 「%TEXTR("ぐっ/んっ")%・・・か、渇きが・・・っ」	PRINTFORML 「%TEXTR("好香/嗯")%・・・啊，口渴了……」
PRINTFORML 「・・・%TEXTR("すまん/すまねぇ")%」	PRINTFORML 「・・・%TEXTR("对不起/对不起~")%」
PRINTFORML %CALLNAME:TARGET%は%TEXTR("肉食獣のような/飢えた獣のような/サディスティックな")%表情で%CALLNAME:MASTER%の肩に噛みついた。	PRINTFORML %CALLNAME:TARGET%是%TEXTR("像肉食动物一样/像饿了的野兽一样/安全的")%用表情咬住了%CALLNAME:MASTER%的肩膀。
PRINTFORMW %CALLNAME:TARGET%はゴクゴクと喉を鳴らすほど血を吸い始めた。	PRINTFORMW %CALLNAME:TARGET%开始吸血，喉咙呼噜呼噜地响。
PRINTFORML 　%CALLNAME:MASTER%の魂0.30	PRINTFORML 　%CALLNAME:MASTER%之魂0。30
PRINTFORMW 　%CALLNAME:TARGET%の魂+0.30	PRINTFORMW 　%CALLNAME:TARGET%之魂+0.。30
PRINTFORML 「すまん、%TEXTR("少し貰うぞ/喉が渇くんだ")%」	PRINTFORML 「对不起，%TEXTR("有点想要。/喉咙有点渴。")%」
PRINTFORML 「じゃあ・・・%TEXTR("少し/ちょっと")%だけ・・・」	PRINTFORML 「那么……%TEXTR("一点点/有点")%只是……」
PRINTFORML 「・・・あ、ありがとう」	PRINTFORML 「・・啊，谢谢」
PRINTFORMW %CALLNAME:TARGET%はそっと%CALLNAME:MASTER%の首筋に噛みついた。	PRINTFORMW %CALLNAME:TARGET%在悄然的%CALLNAME:MASTER%的脖子上咬了一口。
PRINTFORML 　%CALLNAME:MASTER%の魂0.03	PRINTFORML 　%CALLNAME:MASTER%之魂0。03
PRINTFORMW 　%CALLNAME:TARGET%の魂+0.03	PRINTFORMW 　%CALLNAME:TARGET%之魂+0.。03
PRINTFORML 「%TEXTR("んー/あー")%・・・今日は%TEXTR("平気だな/大丈夫だ")%」	PRINTFORML 「%TEXTR("嗯/啊！")%・・・今天是%TEXTR("没关系啊/没关系")%」
PRINTFORML 「いや、今日はそんなに渇いてないな」	PRINTFORML 「不，今天不怎么渴啊」
PRINTFORML 「%TEXTR("うーん/あー")%、今は遠慮しておくよ」	PRINTFORML 「%TEXTR("嗯，嗯/啊！")%现在就不客气了」
PRINTFORMW %CALLNAME:TARGET%は%CALLNAME:MASTER%の首筋を%TEXTR("チラと/少し")%見るが、まだ吸血衝動の自制が利く様だ。	PRINTFORMW %CALLNAME:TARGET%把%CALLNAME:MASTER%的脖颈露出来%TEXTR("一闪/一点点")%看上去，吸血冲动的自制还很有效。。
PRINTFORML 「%TEXTR("うが/ああ/んあ")%・・・%TEXTR("スマン/すまねぇ")%」	PRINTFORML 「%TEXTR("手臂/啊啊！/嗯啊")%・・・%TEXTR("抱歉/对不起")%」
PRINTFORML 「%TEXTR("ぐっ/んっ")%・・・スマン、渇いてっ」	PRINTFORML 「%TEXTR("好香/嗯")%・・・抱歉，口渴了」
PRINTFORML 「・・・%TEXTR("すまん/すまねぇ/ありがとう")%」	PRINTFORML 「・・・%TEXTR("对不起/对不起/谢谢你")%」
PRINTFORML 　%CALLNAME:MASTER%の魂0.25	PRINTFORML 　%CALLNAME:MASTER%之魂0。25
PRINTFORMW 　%CALLNAME:TARGET%の魂+0.25	PRINTFORMW 　%CALLNAME:TARGET%之魂+0.。25
PRINTFORML 「%TEXTR("んー/うーん/あー")%・・・%TEXTR("じゃあ貰おっか/失礼するぜ")%」	PRINTFORML 「%TEXTR("嗯/嗯，嗯/啊！")%・・・%TEXTR("那我就收下了。/失礼了")%」
PRINTFORML 「%TEXTR("まあ/う～ん")%、渇く前に%TEXTR("飲んでおくか/吸わせて貰うぞ")%」	PRINTFORML 「%TEXTR("哎呀！/嗯~")%在口渴之前%TEXTR("要喝吗？/让我吸吧。")%」
PRINTFORML 「悪いな・・・%TEXTR("いつもいつも/感謝はしてるんだぜ？")%」	PRINTFORML 「不好……%TEXTR("总是麻烦你/我会感谢你的。")%」
PRINTFORMW %CALLNAME:TARGET%は%CALLNAME:MASTER%の首筋に噛みついた。	PRINTFORMW %CALLNAME:TARGET%咬了%CALLNAME:MASTER%的脖子。
PRINTFORML 　%CALLNAME:MASTER%の魂0.04	PRINTFORML 　%CALLNAME:MASTER%之魂0。04
PRINTFORMW 　%CALLNAME:TARGET%の魂+0.04	PRINTFORMW 　%CALLNAME:TARGET%之魂+0.。04
PRINTFORML 「今日は%TEXTR("平気だな/大丈夫だ")%」	PRINTFORML 「今天是%TEXTR("没关系啊/没关系")%」
PRINTFORML 「いや、今日はそんなに渇いてない%TEXTR("な/ぞ")%」	PRINTFORML 「不，今天不怎么渴%TEXTR("啊/哟！/哟！")%」
PRINTFORML 「%TEXTR("スマン/すまねぇ")%、渇きがヤベェ・・・」	PRINTFORML 「%TEXTR("抱歉/对不起")%、口渴了……」
PRINTFORML 「%TEXTR("んぐっ/ごくり")%・・・%TEXTR("スマン/すまねぇ")%、%TEXTR("喉が/渇きが/限界っぽい")%・・・」	PRINTFORML 「%TEXTR("呜呜/唔咽")%・・・%TEXTR("抱歉/对不起")%、%TEXTR("嗓子哑了/口渴/界限，界限")%・・・」
PRINTFORMW %CALLNAME:TARGET%はゴクゴクと喉を鳴らすほど血を吸い始めた。	PRINTFORMW %CALLNAME:TARGET%开始吸血，喉咙呼噜呼噜地响。。
PRINTFORML 「そうだな、今のうちに%TEXTR("吸って/補給して/飲んで")%おくか」	PRINTFORML 「そうだな、今のうちに%TEXTR("吸一口/补给一下/让我喝")%おくか」
PRINTFORML 「%TEXTR("スマン/すまねぇ")%、渇く前に%TEXTR("飲ませてくれ/吸わせて貰うぞ")%」	PRINTFORML 「%TEXTR("抱歉/对不起")%、在口渴之前%TEXTR("让我喝一口/让我")%」
PRINTFORML 「悪いな、%TEXTR("いつも/いつもいつも/ありがとう")%」	PRINTFORML 「悪いな、%TEXTR("いつも/いつもいつも/ありがとう")%」「不好意思啊，%TEXTR("总是/经常/谢谢你")%」
PRINTFORMW %CALLNAME:TARGET%はいつもの様に%CALLNAME:MASTER%の首筋に噛みついた。	PRINTFORMW %CALLNAME:TARGET%就是这样%CALLNAME:MASTER%的脖子上咬了一口。。
//文件: EVENT_K14_SHOP.ERB
PRINTFORMW 「頼みぃ～？　はぁ仕方ねぇな」	PRINTFORMW 「拜托了～？啊，没办法啊」
PRINTFORMW 「ハイハイ、何だよ？」	PRINTFORMW 「是什么啊？」
PRINTFORMW 「頼ってくれても良いんだぜ？」	PRINTFORMW 「可以依赖我吗？」
PRINTFORML 「あう……」	PRINTFORML 「啊……」
PRINTFORMW 　%CALLNAME:TARGET%は顔を真っ赤にして俯いてしまう。	PRINTFORMW 　%CALLNAME:TARGET%红着脸低着头。
PRINTFORML 「%CNAME("二人称")%は……本当にバカだ……」	PRINTFORML 「%CNAME("二人称")%是……真是个笨蛋……」
PRINTFORML 　%CALLNAME:TARGET%は意を決したようにその真っ赤な顔を上げる。	PRINTFORML 　%CALLNAME:TARGET%决定了要抬起那通红的脸。
PRINTFORMW 　その瞳には涙を認め、今にも零れてしまいそうだ。	PRINTFORMW 　那眼眸中承认了泪水，眼看就要流出了。
PRINTFORML 「そんな事言われたら……もう男に戻れないじゃんか」	PRINTFORML 「如果被说了那样的话……已经回不到男人的程度了吧」
PRINTFORMW 　%CALLNAME:TARGET%は%CALLNAME:MASTER%に身体を寄せ、啄ばむ様なキスをした。	PRINTFORMW 　%CALLNAME:TARGET%把身体靠近%CALLNAME:MASTER%，和她像啄食一样接吻。
PRINTFORML 「……ハァ？　ぶっ飛ばすぞ」	PRINTFORML 「……哈？我要揍你」
PRINTFORMW 　%CALLNAME:TARGET%の目は今にも%CALLNAME:MASTER%を殺しそうな目付きだ。	PRINTFORMW 　%CALLNAME:TARGET%的眼睛眼看就要杀了%CALLNAME:MASTER%。
PRINTFORML 「……あんまりふざけんなよ？」	PRINTFORML 「……别开什么玩笑了？」
PRINTFORMW 　%CALLNAME:TARGET%は面倒臭そうに返答してきた。	PRINTFORMW 　%CALLNAME:TARGET%很麻利地回答了。
PRINTFORML 「はぁ……他にちゃんとした良い女が居るだろう」	PRINTFORML 「哈……还有其他作为你的好女人吧」
PRINTFORMW 　%CALLNAME:TARGET%は少し顔を赤くしたが直ぐに頭を振った。	PRINTFORMW 　%CALLNAME:TARGET%稍微红了脸的马上摇了摇头。
PRINTFORML 「きょ、今日は……っ」	PRINTFORML 「今天……嗯」
PRINTFORMW 　%CALLNAME:TARGET%は顔を真っ赤にして俯いてしまった。	PRINTFORMW 　%CALLNAME:TARGET%红着脸低着头。
PRINTFORML 「ふ、ふざけんなよ！　バーカバーカぁ！！」	PRINTFORML 「哼，别开玩笑了！笨蛋笨蛋！」
PRINTFORMW 　%CALLNAME:TARGET%は顔を赤くしながら下半身を手で隠した。	PRINTFORMW 　%CALLNAME:TARGET%红着脸用手遮住了下半身。
PRINTFORML 　%CALLNAME:TARGET%はジト目で%CALLNAME:MASTER%の事をねめつける。	PRINTFORML 　%CALLNAME:TARGET%用斜眼鄙视%CALLNAME:MASTER%。
PRINTFORMW 「%CNAME("二人称")%は本当にバカだな」	PRINTFORMW 「%CNAME("二人称")%真是个笨蛋啊」
PRINTFORML 「またかよ……」	PRINTFORML 「又来了……」
PRINTFORMW 　%CALLNAME:TARGET%は%CALLNAME:MASTER%に軽蔑の視線を送っている。	PRINTFORMW 　%CALLNAME:TARGET%对%CALLNAME:MASTER%投以轻蔑的目光。
PRINTFORML 「パンツパンツってお前……」	PRINTFORML 「胖次不给你……」
PRINTFORML %CALLNAME:TARGET%は呆れ顔だ。	PRINTFORML %CALLNAME:TARGET%是一张目瞪口呆的脸。。
PRINTFORML 「……全くもってサイテーだな。こんなヤツに頼らなきゃならないなんて」	PRINTFORML 「……真是太差劲了。居然不得不依赖这样的家伙」
PRINTFORML %CALLNAME:TARGET%は冷たい視線を%CALLNAME:MASTER%に向けながら服を脱ぎ始めた。	PRINTFORML %CALLNAME:TARGET%冷眼看着%CALLNAME:MASTER%开始脱下衣服。
PRINTFORML 「アッハッハ……%CNAME("一人称")%は%CNAME("二人称")%の事を最高に軽蔑しているぞ」	PRINTFORML 「啊哈哈哈……%CNAME("一人称")%最看不起%CNAME("二人称")%了」
PRINTFORML %CALLNAME:TARGET%の目は全く笑っていない。	PRINTFORML %CALLNAME:TARGET%的眼睛完全没有笑容。
PRINTFORML 「馬鹿か%CNAME("二人称")%？ あ、バカだったなスマンスマン」	PRINTFORML 「笨蛋？%CNAME("二人称")%？啊，笨蛋啊」
PRINTFORML %CALLNAME:TARGET%は%CALLNAME:MASTER%を鼻で笑った。	PRINTFORML %CALLNAME:TARGET%指着鼻子笑了笑%CALLNAME:MASTER%。
PRINTFORML 「頭大丈夫か？ %CALLNAME:FINDCHARA(NO, 1)%さんに診てもらうか？」	PRINTFORML 「脑袋没问题吗？%CALLNAME:FINDCHARA(NO, 1)%桑给%CNAME("二人称")%看一下病吗？」
PRINTFORML %CALLNAME:TARGET%は可哀そうな人を見るような目で%CALLNAME:MASTER%を見ている。	PRINTFORML %CALLNAME:TARGET%用眼睛看着可怜的人。。
PRINTFORML 「はぁ！？　……四六時中エロい事を要求されそうで嫌だ」	PRINTFORML 「哈！？…讨厌被要求整天色情的事情。」
PRINTFORMW 　%CALLNAME:MASTER%の信用がない！	PRINTFORMW 　没有%CALLNAME:MASTER%的信任！
PRINTFORML 「……ハァ　早く戻る為に仕方ないか」	PRINTFORML 「……啊，为了早点变回去没办法吗？」
PRINTFORMW 　%CALLNAME:TARGET%はそう言いつつも顔が少し笑っている。	PRINTFORMW 　%CALLNAME:TARGET%虽然这么说，但脸上还是微微地笑着。
PRINTFORML 「嫌だよ面倒臭い……」	PRINTFORML 「讨厌啊麻烦啊……」
PRINTFORMW 　%CALLNAME:TARGET%は取り付く島もない！	PRINTFORMW 　%CALLNAME:TARGET%没有便当给你！
PRINTFORML 「まぁ……構わないけどよ」	PRINTFORML 「嘛……虽然没关系」
PRINTFORMW 　%CALLNAME:TARGET%はそう言って恥ずかしそうに頭を掻いている。	PRINTFORMW 　%CALLNAME:TARGET%一边说着一边挠着自己的头。
PRINTFORML 「全く……そう言うのは%CALLNAME:FINDCHARA(NO, 1)%さんに頼めよ……」	PRINTFORML 「真是的……这样说的话就拜托%CALLNAME:FINDCHARA(NO, 1)%桑了……」
PRINTFORMW 　%CALLNAME:TARGET%はそう言いつつも少し嬉しそうだ。	PRINTFORMW 　%CALLNAME:TARGET%虽然这么说，但好像有点开心。
PRINTFORML 「まぁ%CNAME("一人称")%も妊娠なんて絶対にゴメンだしな」	PRINTFORML 「嘛，%CNAME("一人称")%怀孕什么的绝对是不可能的」
PRINTFORML %CALLNAME:TARGET%は頭を掻きながらピルを受け取りました。	PRINTFORML %CALLNAME:TARGET%一边挠着头一边吃口服避孕药。
PRINTFORMW これで好き放題中出ししても大丈夫ですね！	PRINTFORMW 这样就可以在直接中出出来了吧！
PRINTFORML 「はいはい、ピルね」	PRINTFORML 「是口服避孕药吧」
PRINTFORMW %CALLNAME:TARGET%はピルを受け取りました。	PRINTFORMW %CALLNAME:TARGET%接受了口服避孕药。
PRINTFORML 「止めるのは構わないけどちゃんと避妊はしてくれよ……」	PRINTFORML 「停下来也没关系，不过不跟%CALLNAME:MASTER%酱避孕的话……」
PRINTFORMW %CALLNAME:TARGET%は渋々ピルの服用を止めました。	PRINTFORMW %CALLNAME:TARGET%勉勉强强停止了口服避孕药的服用。
PRINTFORML 「ハァ……まぁ、性犯罪者予備軍を野放しにするわけにはいかないか」	PRINTFORML 「哈……嘛，性犯罪者预备军怎么可能放任不管呢？」
PRINTFORMW 　%CALLNAME:TARGET%はしぶしぶと言った様子で了承した。	PRINTFORMW 　%CALLNAME:TARGET%勉勉强强地答应了。
PRINTFORML 「ハァ、やっと肩の荷が下りるぜ」	PRINTFORML 「哈，终于卸下肩上的重任了」
PRINTFORMW 　%CALLNAME:TARGET%は肩をポキポキと鳴らした。	PRINTFORMW 　%CALLNAME:TARGET%啪嗒啪嗒地拍着肩膀。
PRINTFORML 「……ねじ切るぞ」	PRINTFORML 「……滚开」
PRINTFORML 　%CALLNAME:TARGET%の極寒の視線だけで人を殺せそうだ。	PRINTFORML 　只靠%CALLNAME:TARGET%那冷冷的视线就可以杀人。
PRINTFORMW 「そう言うのは他の娘に頼んでくれ」	PRINTFORMW 「那样说的话请拜托别人。」
PRINTFORMW 「……仕方ねーなぁ。わかったよ」	PRINTFORMW 「……没办法啊。我知道了」
PRINTFORML 「あ？ 買い物に付き合えって？ まあ構わないけどさ……」	PRINTFORML 「啊？能陪我买东西吗？不过也没关系……」
PRINTFORMW 　%CALLNAME:TARGET%は渋々買い物に付き合ってくれるようです。	PRINTFORMW 　%CALLNAME:TARGET%似乎很愿意陪我去购物。
PRINTFORML 「こ、こんな格好で買い物行けって……%CNAME("一人称")%は変態じゃあねえんだぞ！」	PRINTFORML 「这、穿着这样的衣服去买东西……%CNAME("一人称")%不是变态哦！」
PRINTFORMW 　%CALLNAME:MASTER%は%CALLNAME:TARGET%の手を掴んで無理矢理出かけました。	PRINTFORMW 　%CALLNAME:MASTER%抓住%CALLNAME:TARGET%的手强行出门了。
PRINTFORMW 「買い物？ %CNAME("一人称")%も行くわ」	PRINTFORMW 「买东西？%CNAME("一人称")%也要去」
PRINTFORMW 「買い物？ まあ、構わないけどさ」	PRINTFORMW 「买东西？嘛，没关系」
PRINTFORMW 「えっと財布何処だっけ？」	PRINTFORMW 「钱包在哪里？」
PRINTFORMW 「え？ %CNAME("一人称")%も一緒に行くのか？」	PRINTFORMW 「啊？%CNAME("一人称")%也一起去吗？」
PRINTFORMW 「なんか奢ってくれんなら行くぜ」	PRINTFORMW 「如果请客的话我就去」
PRINTFORMW 「ふぁあぁ……ん、%CNAME("一人称")%も眠気覚ましに歩きたい……」	PRINTFORMW 「啊啊啊……嗯，%CNAME("一人称")%也想带着倦怠的心情走下去……」
PRINTFORMW 「ん、いってら～」	PRINTFORMW 「嗯，说起来~」
PRINTFORMW 「ついでにポテチも買ってきてくれ」	PRINTFORMW 「顺便把薯片也买来。」
PRINTFORMW 「あんまり無駄使いしてると%CALLNAME:FINDCHARA(NO, 1)%さんに怒られるぜ」	PRINTFORMW 「太浪费的话会被%CALLNAME:FINDCHARA(NO, 1)%桑骂的」
PRINTFORMW 「%CNAME("一人称")%もコンビニ行ってこようかな……」	PRINTFORMW 「%CNAME("一人称")%也去便利店吧……」
PRINTFORMW 「途中で警察に捕まるんじゃないぞ」	PRINTFORMW 「不要在中途被警察抓住哦」
PRINTFORMW 「エロ本とか拾ってくるんじゃないぞ」	PRINTFORMW 「不要捡色情杂志什么的来哦」
PRINTFORML 「……%CNAME("二人称")%はエロ本を読みすぎだ！」	PRINTFORML 「……%CNAME("二人称")%看了太多色情书籍了！」
PRINTFORML 　嫌がる%CALLNAME:TARGET%を無理矢理連れ出しました。	PRINTFORML 　强行带出讨厌的%CALLNAME:TARGET%。
PRINTFORML 　%CALLNAME:TARGET%は下腹部を押さえてモジモジとしている。	PRINTFORML 　%CALLNAME:TARGET%按着下腹部模棱两可的样子。
PRINTFORML 「こ……これは違……っ！？」	PRINTFORML 「这……这个不对……诶！？」
PRINTFORML 　%CALLNAME:MASTER%は%CALLNAME:TARGET%の手を掴んで無理矢理出かけました。	PRINTFORML 　%CALLNAME:MASTER%抓住%CALLNAME:TARGET%的手强行出门了。
PRINTFORML 「クッソ……変態ヤローめ……っ！」	PRINTFORML 「可恶……变态混蛋……嘿！」
PRINTFORML 　%CALLNAME:MASTER%は顔を赤くして%CALLNAME:MASTER%に履いてるパンツを手渡しました。	PRINTFORML 　%CALLNAME:MASTER%亲手交给了正在穿的胖次。
PRINTFORML 「くっ……ホントに%CNAME("二人称")%は変態だな」	PRINTFORML 「呃……%CNAME("二人称")%真是变态啊」
PRINTFORML 　%CALLNAME:MASTER%に氷の視線が突き刺さります。	PRINTFORML 　冰冷的视线刺入%CALLNAME:MASTER%。
PRINTFORML 「裸とかよりかは全然マシだが……」	PRINTFORML 「比起裸体什么的完全好……」
PRINTFORML 　%CALLNAME:TARGET%は%CALLNAME:MASTER%の言葉に呆れている。	PRINTFORML 　%CALLNAME:TARGET%对%CALLNAME:MASTER%的话感到惊讶。
PRINTFORML 「アッハッハ、後で覚えとけよコノヤロー……っ！！」	PRINTFORML 「啊哈哈哈，以后再记住吧，小子……哼！」
PRINTFORML 　%CALLNAME:TARGET%は完全に怒り心頭のようです。	PRINTFORML 　%CALLNAME:TARGET%完全像愤怒的头脑一样。
PRINTFORML 「あぁ？ 嫌な予感しかしねぇぞ……」	PRINTFORML 「啊？只有讨厌的预感……」
PRINTFORML 　%CALLNAME:TARGET%はジト目で%CALLNAME:MASTER%を見据えています。	PRINTFORML 　%CALLNAME:TARGET%斜眼看着%CALLNAME:MASTER%。
PRINTFORML 「ハァ……さっさと何買うか決めろよ」	PRINTFORML 「哈……快决定买什么吧。」
PRINTFORMW 　%CALLNAME:TARGET%は完全に呆れています。	PRINTFORMW 　%CALLNAME:TARGET%完全被惊呆了。
PRINTFORML 「……会計お願いします」	PRINTFORML 「……请结账」
PRINTFORMW 　%CALLNAME:TARGET%は少し恥ずかしそうに会計を済ませました。	PRINTFORMW 　%CALLNAME:TARGET%带着些许的害羞结了账。
PRINTFORMW 　%CALLNAME:TARGET%は店員の無遠慮な目線に無言で耐えています。	PRINTFORMW 　%CALLNAME:TARGET%默默地忍受着店员毫不客气的目光。
PRINTFORML 「……チっ」	PRINTFORML 「……奇怪」
PRINTFORMW 　%CALLNAME:TARGET%は店員の無遠慮な目線にイライラしています。	PRINTFORMW 　%CALLNAME:TARGET%看到店员毫不客气的眼神很烦躁。
PRINTFORML 「……これ」	PRINTFORML 「……要这个」
PRINTFORML 　%CALLNAME:TARGET%はエロ本を買う中学生のような態度で会計を済ませました。	PRINTFORML 　%CALLNAME:TARGET%以买色情书的中学生的态度结账了。
PRINTFORMW 「は、早く終わらせてくれっ！」	PRINTFORMW 「快点结束吧！」
PRINTFORMW 「……さっさと決めないと%CNAME("二人称")%をコロス」	PRINTFORMW 「……不快点决定的话就把%CNAME("二人称")%留在这」
PRINTFORMW 「早く出よう！ 今すぐ出ようッ！！」	PRINTFORMW 「快点出门吧！现在马上出发吧！！」
PRINTFORMW 「……こう言うのもあるのか」	PRINTFORMW 「……有这么说吗？」
PRINTFORMW 「……ごくりっ」	PRINTFORMW 「……唔姆」
PRINTFORMW 「すげぇ……いや、興味ないけどな！」	PRINTFORMW 「好厉害……不，我没兴趣！」
PRINTFORMW 「いろんな物売ってんな……」	PRINTFORMW 「卖各种各样的东西啊……」
PRINTFORMW 「……%CNAME("二人称")%って優柔不断なのか？」	PRINTFORMW 「……%CNAME("二人称")%是优柔寡断的吗？」
PRINTFORMW 「は……早く決めてくれ」	PRINTFORMW 「哈……快点决定吧。」
PRINTFORMW 「%CNAME("二人称")%は何を買うんだ？」	PRINTFORMW 「%CNAME("二人称")%要买什么？」
PRINTFORML 「はぁ、もうこんな事は……言っても無駄か」	PRINTFORML 「啊，这样的事情已经……说了也没用吗？」
PRINTFORML 　%CALLNAME:TARGET%は%CALLNAME:MASTER%の脛に蹴りを入れた。痛い！	PRINTFORML 　%CALLNAME:TARGET%踢了%CALLNAME:MASTER%的小腿。好痛！
PRINTFORMW 　%CALLNAME:MASTER%の体力 100	PRINTFORMW 　%CALLNAME:MASTER%的体力100
PRINTFORML 「コイツで許してやるよッ！！」	PRINTFORML 「我就原谅他吧！」
PRINTFORML 　%CALLNAME:TARGET%は%CALLNAME:MASTER%の鳩尾に鋭い突きを繰り出しました。	PRINTFORML 　%CALLNAME:TARGET%对%CALLNAME:MASTER%的屁股发出尖锐的刺击。
PRINTFORMW 　%CALLNAME:MASTER%の体力 200	PRINTFORMW 　%CALLNAME:MASTER%的体力200
PRINTFORML 「%CNAME("二人称")%なんの為に買い物行ったんだ？」	PRINTFORML 「你是为了什么而去买东西的？」
PRINTFORMW 　%CALLNAME:TARGET%は%CALLNAME:MASTER%の行動に不思議そうです。	PRINTFORMW 　%CALLNAME:TARGET%对%CALLNAME:MASTER%的行动好像很不可思议。
PRINTFORML 「%CNAME("二人称")%と一緒にいるとこれでもマシって思うのが感覚狂ってる」	PRINTFORML 「和%CNAME("二人称")%在一起的话，会觉得这样也挺好的，感觉很乱」
PRINTFORMW 　%CALLNAME:TARGET%は自分自身の頬を叩いて気を直しています。	PRINTFORMW 　%CALLNAME:TARGET%敲打着自己的脸颊，调整心情。

//文件: EVENT_K14_シキ.ERB
LOCALS = オレ_おれ	LOCALS = 俺_俺
LOCALS = お前_おまえ	LOCALS = 你_你
LOCALS = あんた_あんた	LOCALS = 你_你
LOCALS = 委員長_いんちょう	LOCALS = 班长_班长
LOCALS = %CALLNAME:PLAYER%くん_%CALLNAME:PLAYER%くん	LOCALS = %CALLNAME:PLAYER%君_%CALLNAME:PLAYER%君
LOCALS = %CALLNAME:PLAYER%ちゃん_%CALLNAME:PLAYER%ちゃん	LOCALS = %CALLNAME:PLAYER%酱_%CALLNAME:PLAYER%酱
LOCALS = %CALLNAME:PLAYER%さん_%CALLNAME:PLAYER%さん	LOCALS = %CALLNAME:PLAYER%桑_%CALLNAME:PLAYER%桑
LOCALS = 先輩_せんぱい	LOCALS = 前輩_前輩
LOCALS = 先生_せんせい	LOCALS = 老师_老师
LOCALS = ゴシュジン様_ごしゅじんさま	LOCALS = 主人大人_主人大人
LOCALS = %CALLNAME:ASSI%くん_%CALLNAME:ASSI%くん	LOCALS = %CALLNAME:ASSI%君_%CALLNAME:ASSI%君
LOCALS = %CALLNAME:ASSI%ちゃん_%CALLNAME:ASSI%ちゃん	LOCALS = %CALLNAME:ASSI%酱_%CALLNAME:ASSI%酱
LOCALS = %CALLNAME:ASSI%さん_%CALLNAME:ASSI%さん	LOCALS = %CALLNAME:ASSI%桑_%CALLNAME:ASSI%桑
どうしても処女の血が吸いたかった変態吸血鬼に○ッドナイトブリス的な事をされた。	被一个无论如何都想吸処女血的変態吸血鬼袭击了、吃了一招Midnight Bliss。
しかも素質があったのか吸血鬼に変質してしまい、男にも戻れなくなった。	而且不知道是因为有这种素質还是怎么回事、总之变成了一个吸血鬼、而且也回不去男儿身了。
PRINTFORML 「……%CNAMET(FINDCHARA(NO, 1), "二人称")%と性交すれば元に戻れるかもしれません」	PRINTFORML 「……和%CNAMET(FINDCHARA(NO, 1), "二人称")%性交的话说不定就能变回原样」
PRINTFORMW そう%CALLNAME:FINDCHARA(NO, 1)%が語ると目の前の少女が項垂れる。	PRINTFORMW 在%CALLNAME:FINDCHARA(NO, 1)%如此说明的同时、面前的少女低下了头。
PRINTFORML 目の前の少女は吸血鬼に襲われている所を偶々通りかかり、偶々助けたのだが……。	PRINTFORML 面前的这个少女被偶然路过的吸血鬼所襲击、又被自己偶然地给救下了……。
PRINTFORML どうやら助けた時にはすでに吸血されており、肉体は吸血鬼へと変質していた。	PRINTFORML 但是救过来的时候就已经被吸了血、肉体也開始向吸血鬼转变了。
PRINTFORMW ついでに男から少女へと変質していたらしい。	PRINTFORMW 最终从男性变成了少女。
PRINTFORML そうして%CALLNAME:MASTER%と%CALLNAME:TARGET%は%CALLNAME:FINDCHARA(NO, 1)%の力を借りて魂の取引を行った。	PRINTFORML 于是%CALLNAME:MASTER%和%CALLNAME:TARGET%准备和%CALLNAME:FINDCHARA(NO, 1)%做点魂的交易、给她出点力。
PRINTFORMW 「うぅ……何で%CNAME("一人称")%がこんな目に……」	PRINTFORMW 「呜……为什么%CNAME("一人称")%会遇到这种事……」
PRINTFORMW %NAME:ARG%は%CALLNAME:MASTER%の"%CSTR:ARG:関係%"として、(昼)の部室に顔を出してくれます。	PRINTFORMW %NAME:ARG%作为%CALLNAME:MASTER%的"%CSTR:ARG:関係%"、(昼)会在部室里露面。
PRINTFORMW 「さ、さっさと触れば良いだろうが」	PRINTFORMW 「那么，赶紧做完吧。」
CALL PRINT_STR, @"「%TEXTR("ハァっ/ふっ/んんっ")%_H_　そこっ……良いっ_H_」_W"	CALL PRINT_STR, @"「%TEXTR("哈！/呼/嗯，嗯")%_H_ 那里……好吧_H_」_W"
CALL PRINT_STR, @"「%TEXTR("んあっ/くぅっ/ふぐっ")%_H_　や、やめ……%TEXTR("んなっ/ろっ")%_H_」_W"	CALL PRINT_STR, @"「%TEXTR("嗯啊/嗯……/别")%_H_呀，算了……%TEXTR("嗯，嗯/H！")%_H_」_W"
CALL PRINT_STR, @"「%TEXTR("あっ/ふっ/んっ")%_H_　く、くすぐったいだけだっ！」_W"	CALL PRINT_STR, @"「%TEXTR("啊！/噗/嗯")%_H_只、只是痒痒！」_W"
PRINTFORMW 「……%TEXTR("んんっ/あっ/ぐっ")%　……べ、別に」	PRINTFORMW 「……%TEXTR("嗯，嗯/啊！/咕")%　……没什么。」
PRINTFORMW 「……%TEXTR("ふっ/ふーっ/はぁっ")%　……すー……はぁーっ」	PRINTFORMW 「……%TEXTR("噗/呼—/哈！")%　……好……哈哈」
PRINTFORMW 「%TEXTR("あっ/ふっ/んっ")%　……くすぐったいだけだっ！」	PRINTFORMW 「%TEXTR("啊！/噗/嗯")%　……只是痒痒！」
PRINTFORMW 「こ、こう言うの……す、好きなんだろ？」	PRINTFORMW 「这、这样说……喜欢吧？」
CALL PRINT_STR, @"「%TEXTR("ハァっ/ふぅっ/んんっ")%_H_　あっ_H_……ごめっ腰止まんなっ_H_」_W"	CALL PRINT_STR, @"「%TEXTR("哈！/呼呼/嗯，嗯")%_H_啊_H_……你的腰停止了_H_」_W"
CALL PRINT_STR, @"「%TEXTR("んああっ/くふぅっ/ふぐぅっ")%_H_H_　そ、そこっ_H_　もっとっ_H_」_W"	CALL PRINT_STR, @"「%TEXTR("嗯啊啊/呼呼/嗯，嗯")%_H_H_ 那、那就是_H_更多_H_」_W"
CALL PRINT_STR, @"「%TEXTR("あぁあっ/ふぅぐっ/んんんっ")%_H_　もっと奥まで……っ_H_」_W"	CALL PRINT_STR, @"「%TEXTR("啊啊啊/呼呼/嗯，嗯")%_H_到更深处……的_H_」_W"
CALL PRINT_STR, @"「%TEXTR("ハァっ/ふっ/んっ")%_H_　なんかっ……良いっ_H_」_W"	CALL PRINT_STR, @"「%TEXTR("哈！/噗/嗯")%H什么的……好吧_H_」_W"
CALL PRINT_STR, @"「%TEXTR("んあっ/くぅっ/ふぅっ")%_H_　はぁはぁ……きもち_H_」_W"	CALL PRINT_STR, @"「%TEXTR("嗯啊/嗯……/呼呼")%H哈……感受_H_」_W"
CALL PRINT_STR, @"「%TEXTR("あっ/ふっ/んっ")%_H_　んんっ……深いっ」_W"	CALL PRINT_STR, @"「%TEXTR("啊！/噗/嗯")%_H_　ん嗯……深一点_H_」_W"
PRINTFORMW 「や、やめ……汚いだろっ！？」	PRINTFORMW 「呀，算了……很脏吧！？」
CALL PRINT_STR, @"「%TEXTR("ハァっ/ふぅっ/んんっ")%_H_　あっ_H_……き、汚くないだろ？」_W"	CALL PRINT_STR, @"「%TEXTR("哈！/呼呼/嗯，嗯")%H啊H……你不脏吧？」_W"
CALL PRINT_STR, @"「%TEXTR("あつっ/ふぐっ/つぅっ")%_H_　……い、息吹きかけんなぁ_H_」_W"	CALL PRINT_STR, @"「%TEXTR("压力/河豚/嗯，嗯")%H……喂，呼气吧_H_」_W"
CALL PRINT_STR, @"「%TEXTR("あぁっ/うぅっ/んっ")%_H_　や、やめっ……っ_H_」_W"	CALL PRINT_STR, @"「%TEXTR("啊啊啊/呜呜/嗯")%H呀，住手……っ_H_」_W"
CALL PRINT_STR, @"「%TEXTR("ハァっ/ふぅっ/んんっ")%_H_　あっ_H_……ごめっ腰止まんなっ_H_」_W"	CALL PRINT_STR, @"「%TEXTR("哈！/呼呼/嗯，嗯")%H啊H……你的腰停止了_H_」_W"
CALL PRINT_STR, @"「%TEXTR("んああっ/くふぅっ/ふぐぅっ")%_H_H_　そ、そこっ_H_　もっとっ_H_」_W"	CALL PRINT_STR, @"「%TEXTR("嗯啊啊/呼呼/嗯，嗯")%H H那、那就是H更多_H_」_W"
CALL PRINT_STR, @"「%TEXTR("あぁあっ/ふぅぐっ/んんんっ")%_H_　もっと奥まで……っ_H_」_W"	CALL PRINT_STR, @"「%TEXTR("啊啊啊啊啊/呼呼/嗯，嗯")%H到更深处……っ_H_」_W"
CALL PRINT_STR, @"「%TEXTR("ハっ/ふっ/んっ")%_H_　き、キモチ悪いだけだっ！」_W"	CALL PRINT_STR, @"「%TEXTR("哈！/噗/嗯")%只是心情不好而已！」_W"
CALL PRINT_STR, @"「%TEXTR("んあっ/くぅっ/ぐぅっ")%_H_　そ、そこっ、やめっ！」_W"	CALL PRINT_STR, @"「%TEXTR("嗯啊/嗯……/呜呜")%Hそ、那里、停下！」_W"
CALL PRINT_STR, @"「%TEXTR("あぁっ/ふぅっ/んんっ")%_H_　そんなとこっ、舐めっ、止めっ！」_W"	CALL PRINT_STR, @"「%TEXTR("啊啊啊/呼呼/嗯，嗯")%H那样的话，舔，停止！」_W"
CALL PRINT_STR, @"「ぐぅっ_H_ 止めっ……そこは、違っ！？」_W"	CALL PRINT_STR, @"「呜H停下……这是不对的！？」_W"
PRINTFORMW 「ぐっ……止めっ、そこは……違っ！？」	PRINTFORMW 「唔……停下来，那里是……不对！？」
PRINTFORMW 「%TEXTR("ぐぅ/はぁ/うあっ")%……おなﾞか……へんなるっ」	PRINTFORMW 「%TEXTR("呜呜/哈！/啊啊！")%……喂……嘿嘿嘿」
PRINTFORMW 「%TEXTR("ぐぅ/はぁ/うあっ")%……%TEXTR("ぐっ/うぅ/はっ")%、おﾞしり、止めっ」	PRINTFORMW 「%TEXTR("呜呜/哈！/啊啊！")%……%TEXTR("咕/呜呜/哈哈")%、屁股、停止」
PRINTFORMW 「%TEXTR("ぐぅ/はぁ/うあっ")%……ふーっ……ふーっ……」	PRINTFORMW 「%TEXTR("呜呜/哈！/啊啊！")%……呼……呼……」
PRINTFORMW 「%TEXTR("ふーっ/はあぁ/ううぅっ")%……ぐぅ……オカシくなるっ」	PRINTFORMW 「%TEXTR("呼—/哈哈/呜呜")%……嗯……会变成人妖的」
PRINTFORMW 「%TEXTR("ふーっ/はあぁ/ううぅっ")%……お尻は、止めっ……ろっ！」	PRINTFORMW 「%TEXTR("呼—/哈哈/呜呜")%……屁股，停下来……滚！」
PRINTFORMW 「%TEXTR("ふーっ/はあぁ/ううぅっ")%……ふっふっふっ……」	PRINTFORMW 「%TEXTR("呼—/哈哈/呜呜")%……呼呼呼……」
PRINTFORMW 「%TEXTR("ハァハァ/ぐぅっ/んあっ")%……そこは、%TEXTR("違っ/止めっ")%」	PRINTFORMW 「%TEXTR("哈哈哈/呜呜/嗯啊")%……那里是…%TEXTR("不同/停止")%」
PRINTFORMW 「%TEXTR("ハァハァ/ぐぅっ/んあっ")%……へんなっ……感じっ」	PRINTFORMW 「%TEXTR("哈哈哈/呜呜/嗯啊")%……嗯……感觉」
PRINTFORMW 「%TEXTR("ハァハァ/ぐぅっ/んあっ")%……はぁ……はぁ……」	PRINTFORMW 「%TEXTR("哈哈哈/呜呜/嗯啊")%……哈……哈……」
CALL PRINT_STR, @"「%TEXTR("ふっ/はっ/へぁっ")%_H_ ……%TEXTR("こんなのっ/あたまっ/おしりっ")%、%TEXTR("オカシくなる/変なるっ/壊れるっ")%_H_H_」_W"	CALL PRINT_STR, @"「%TEXTR("噗/哈哈/嘿嘿")%_H_ ……%TEXTR("这样啊/哪里/屁股")%、%TEXTR("变得奇怪/变了啊/坏掉了")%_H_H_」_W"
CALL PRINT_STR, @"「%TEXTR("ふっ/はっ/へぁっ")%_H_ ……%TEXTR("はぁっ/ふぅっ/ぐんっ")%、%TEXTR("あﾞあぁあﾞっ/はぁー、はぁー/")%_H_H_」_W"	CALL PRINT_STR, @"「%TEXTR("噗/哈哈/嘿嘿")%_H_ ……%TEXTR("哈！/呼呼/忽然")%、%TEXTR("啊啊啊啊啊/哈，哈/")%_H_H_」_W"
PRINTFORMW 「%TEXTR("ハァハァ/ぐぅっ/んあっ")%……はぁ……こんなのっ」	PRINTFORMW 「%TEXTR("哈哈哈/呜呜/嗯啊")%……哈……这样啊」
STR:エンディング += "1_シキ：夜を駆ける①/"	STR:エンディング += "1_織：在夜晚奔跑①/"
PRINTFORMW ―夜を駆ける①―	PRINTFORMW ―在夜晚奔跑①―
PRINTFORML %CALLNAME:TARGET%と出会ってから数日後の事……	PRINTFORML 和%CALLNAME:TARGET%相遇几天后的事……
PRINTFORML %CALLNAME:MASTER%は夜中に小腹が減り、%CALLNAME:FINDCHARA(NO, 1)%も寝ていた為にコンビニに行く事にした。	PRINTFORML %CALLNAME:MASTER%半夜肚子饿了，%CALLNAME:FINDCHARA(NO, 1)%也睡了，所以决定去便利店。
PRINTFORMW 好きな物を何個か買いコンビニを出た所で見知った顔がふと目に映る。	PRINTFORMW 买了几个喜欢的东西走出便利店，偶然看到了一张熟悉的脸。
PRINTFORML %CALLNAME:TARGET%だ。	PRINTFORML 是%CALLNAME:TARGET%。
PRINTFORML 宵闇でも目立つ銀髪は早々いない。そんな%CALLNAME:TARGET%を目で追ってしまう。	PRINTFORML 即使在夜色中也很显眼的银发并不早。用目光追逐着那样的%CALLNAME:TARGET%。
PRINTFORMW 声を掛けようかと迷っている内に%CALLNAME:TARGET%は路地裏へと消えてしまった。	PRINTFORMW 在犹豫要不要打个招呼的时候，%CALLNAME:TARGET%就消失在小巷里了。。
PRINTFORML %CALLNAME:MASTER%は少し気になってしまい、路地裏を覗く。	PRINTFORML 稍微有点在意，窥视着小巷里。
PRINTFORML しかし、そこには%CALLNAME:TARGET%の姿はなかった……。	PRINTFORML 但是，那里没有%CALLNAME:TARGET%的身影……。
PRINTFORMW 吸血鬼の力を持ってすれば瞬きをする間に遥か遠くまで行く事が可能だろう。	PRINTFORMW 如果拥有吸血鬼的力量的话，眨眼之间就能走到遥远的地方吧。
PRINTFORML %CALLNAME:MASTER%は何となく気になって路地裏に踏み入れた。	PRINTFORML %CALLNAME:MASTER%无意中进入了小巷。
PRINTFORMW その瞬間の事だった。	PRINTFORMW 那一瞬间的事。
PRINTFORMW ――世界が裏返った。	PRINTFORMW ——世界逆转了。
PRINTFORML %CALLNAME:MASTER%は背筋に氷柱を突き刺されたような悪寒に身体を蝕まれ、	PRINTFORML %CALLNAME:MASTER%的身体被冰冷的冰柱刺入脊背，
PRINTFORML 足は地面に縫い付けられたように一歩も動かない。	PRINTFORML 脚象缝在地上一样一步也不动。。
PRINTFORMW ドォンドォンと煩い音だけが響く――それは紛れもない自分の心音。	PRINTFORMW 只有烦琐的声音在回响——那是毫无疑问的自己的心音。
PRINTFORML 「あんたぁ大丈夫かぁ？」	PRINTFORML 「你没事吧？」
PRINTFORML 不意に声が掛けられ、%CALLNAME:MASTER%はその場に尻餅をついた。	PRINTFORML 突然有人跟我打招呼，%CALLNAME:MASTER%就在那里摔了个屁股蹲。
PRINTFORMW 心配をしてくれた通行人に大丈夫だと告げて起き上がる。	PRINTFORMW 告诉担心我的行人不要紧，然后站起来。。
PRINTFORML ボタボタと汗が地面に落ちて、自分が大量の冷や汗を流していた事実に気が付いた。	PRINTFORML 我注意到了汗珠滴滴答答地落到地上，自己流了很多冷汗的事实。
PRINTFORMW ――今日は家に帰ろう。	PRINTFORMW ——今天回家吧。
PRINTFORMW ＥＮＤ名２の本文です	PRINTFORMW END名2的正文
PRINTFORMW ＥＮＤ名３の本文です	PRINTFORMW END名3的正文
