//EVENT_K17_DAILY.ERB
PRINTFORMW 「%CNAMET(ARG,"一人称")%にもっとかまって……%CNAMET(ARG,"一人称")%をほうっておかないで……！」	PRINTFORMW 「更加在意%CNAMET(ARG,"一人称")%一些……不要不管%CNAMET(ARG,"一人称")%……！」
PRINTFORMW 「んっ……！？　んっ……んぐっ……」	PRINTFORMW 「唔……！？嗯……唔唔……」
PRINTFORMW %CALLNAME:ARG%は喉に絡んだ精液を胃に落とし込んでから、%CALLNAME:MASTER%に目を向けた	PRINTFORMW %CALLNAME:ARG%将口中的精液吞下去、然后看向了%CALLNAME:MASTER%。
PRINTFORMW 「起こしに来たんだけど……%CNAMET(ARG, "二人称")%のおちんちんが、大きくなってたから……」	PRINTFORMW 「叫醒了……%CNAMET(ARG, "二人称")%的小弟弟变大了所以……」
PRINTFORMW 「……起きた？　おはよう、%CNAMET(ARG, "二人称")%」	PRINTFORMW 「……起床了吗？早上好、%CNAMET(ARG, "二人称")%」
PRINTFORMW %CALLNAME:MASTER%が目を開いたのを察して、%CALLNAME:ARG%は口を離した	PRINTFORMW 察觉到%CALLNAME:MASTER%睁开眼睛、%CALLNAME:ARG%说道。
PRINTFORMW 「%CNAMET(ARG,"二人称","かな")%……%CNAMET(ARG, "二人称","かな","甘え")%……はやく起きてぇ……！」	PRINTFORMW 「%CNAMET(ARG,"二人称","かな")%……%CNAMET(ARG, "二人称","かな","甘え")%……快起来哦……！」
PRINTW 「ごはん、さめちゃうぅ……！」	PRINTW 「饭要凉了……！」
PRINTFORMW 「その……ね？　%CNAMET(ARG, "二人称")%のおちんちんが、すごく大きくなっていて……」	PRINTFORMW 「那个……呐？　%CNAMET(ARG, "二人称")%的小弟弟变得非常大……」
PRINTFORMW 「……ほしくなっちゃいました……ごめんなさい……」	PRINTFORMW 「……变得想要了……对不起……」
PRINTFORMW 正座をした%CALLNAME:ARG%が、深々と頭を下げた	PRINTFORMW 跪坐的%CALLNAME:ARG%深深埋下了头。
PRINTFORMW 「おはよう、%CNAMET(ARG, "二人称")%」	PRINTFORMW 「早上好、%CNAMET(ARG, "二人称")%」
PRINTFORMW %CALLNAME:ARG%の辞書に、寝起きが悪いという言葉はないようだ……	PRINTFORMW %CALLNAME:ARG%的字典里好像没有起床气这个词……
PRINTFORMW なにをしていたか訊ねると、%CALLNAME:ARG%は%TEXTR("ドヤッ……という/得意げな/疲れた")%気配をわずかに漂わせた	PRINTFORMW 当被问起在做什么的时候、%CALLNAME:ARG%的身上飘出了%TEXTR("得意……大概吧、/得意/疲惫")%的气息
PRINTFORMW 「ただいま、%CNAMET(ARG, "二人称")%」	PRINTFORMW 「我回来了、%CNAMET(ARG, "二人称")%」
PRINTFORMW %CALLNAME:ARG%は買い物袋を手に提げている	PRINTFORMW %CALLNAME:ARG%提着购物袋。
PRINTW いったい何を買ってきたのだろう……	PRINTW 买了什么东西呢……
PRINTFORMW 「お散歩、してたの」	PRINTFORMW 「去散步了」
PRINTFORMW なにをしていたか訊ねると、%CALLNAME:ARG%は%TEXTR("わずかに落ち込んだ/ほんのりうれしそうな")%様子で答えた	PRINTFORMW 问她去干什么的时候、%CALLNAME:ARG%看起来%TEXTR("有些失落/有些开心")%的样子。
PRINTFORMW 散歩の最中になにがあったのだろう……	PRINTFORMW 散步的时候发生了什么呢……
PRINTFORMW どこかから帰ってきた%CALLNAME:ARG%が、ぺこりと頭を下げた	PRINTFORMW 不知道从哪里回来的%CALLNAME:ARG%突然低下头。
PRINTFORMW 「おかえり、%CNAMET(ARG, "二人称","甘え")%……%CNAMET(ARG, "一人称")%、%CNAMET(ARG, "二人称")%にかまって……ほしいな……」	PRINTFORMW 「欢迎回来、%CNAMET(ARG, "二人称","甘え")%……%CNAMET(ARG, "一人称")%想、想要%CNAMET(ARG, "二人称")%……」
PRINTFORMW %CALLNAME:ARG%は、%CALLNAME:MASTER%にすり寄って精一杯誘惑しようとしている……	PRINTFORMW %CALLNAME:ARG%靠近%CALLNAME:MASTER%不停地诱惑着……
PRINTFORMW 「……おかえり、%CNAMET(ARG, "二人称")%」	PRINTFORMW 「……欢迎回来、%CNAMET(ARG, "二人称")%」
PRINTFORMW %CALLNAME:ARG%は%TEXTR("テレビを見て/読書をして/ぼんやりして/居眠りして")%いたようだ……	PRINTFORMW %CALLNAME:ARG%似乎在%TEXTR("看电视/读书/发呆/打瞌睡")%……
PRINTFORM 「おかえり、%CNAMET(ARG, "二人称")%……	PRINTFORM 「欢迎回来、%CNAMET(ARG, "二人称")%……
PRINT なにかしてほしいこと、ある……？	PRINT 有什么想要%CNAMET(ARG, "一人称")%做的事情吗……？
PRINTFORMW %CALLNAME:ARG%は%CALLNAME:MASTER%の帰りをずっと待っていたようだ……	PRINTFORMW %CALLNAME:ARG%似乎一直在等%CALLNAME:MASTER%回来……
PRINTW 玄関に、なにやら威圧感を放つ市松人形が置かれている……！		PRINTW 玄关口、放置着透出威压感的人偶……！
PRINTFORMW %CALLNAME:MASTER%がソレから目を離せずにいると、		PRINTFORMW %CALLNAME:MASTER%回来看到这个时、
PRINTFORMW という軽快な音ともに、%CALLNAME:ARG%の姿が現れた	PRINTFORMW 伴随着轻快的声音、%CALLNAME:ARG%的身影出现了。
PRINTFORMW 「おかえり、%CNAMET(ARG, "二人称")%」	PRINTFORMW 「欢迎回来、%CNAMET(ARG, "二人称")%」
PRINTFORMW なにも言えずに立ち尽くす%CALLNAME:MASTER%を眺めながら、%CALLNAME:ARG%は小首をかしげた	PRINTFORMW 看着一言不发站着的%CALLNAME:MASTER%、%CALLNAME:ARG%歪着小脑袋。
PRINTFORMW 「……しょうえね？」		PRINTFORMW 「……怎么了？」
PRINTFORMW すかさず人形の頭にチョップを入れると、ぽむっという音とともに%CALLNAME:ARG%の姿になった		PRINTFORMW 在触摸到人偶脑袋的时候、砰的一下变成了%CALLNAME:ARG%的样子。
PRINTFORMW 「おかえり、%CNAMET(ARG, "二人称")%……いたい」		PRINTFORMW 「欢迎回来、%CNAMET(ARG, "二人称")%……好痛」
PRINTW ……ご家庭の怪談になりそうな行いはやめなさい		PRINTW ……不要做那些会成为家庭怪谈的事。
PRINTFORMW %CALLNAME:ARG%は捨てられた仔犬のような目で%CALLNAME:MASTER%たちを見送った……	PRINTFORMW %CALLNAME:ARG%用像是被遗弃的小狗一样的眼神目送着%CALLNAME:MASTER%……
PRINTFORMW %CALLNAME:ARG%は黙然と%CALLNAME:MASTER%たちを見送った……	PRINTFORMW %CALLNAME:ARG%默默看着%CALLNAME:MASTER%离开……
PRINTFORML 「……よろしくおねがいします？」	PRINTFORML 「……请多关照？」
PRINTFORML 小首をかしげる%CALLNAME%の挨拶は、なぜか疑問形だった……	PRINTFORML %CALLNAME%歪着小脑袋、问候语不知为何成了疑问句……
PRINTFORML %CALLNAME%はむくりと起き上がると、何事もなかったように%TEXTR("読みかけの本を開いた/窓の外へ目を向けた/ぼんやりし始めた")%……	PRINTFORML %CALLNAME%像什么都没发生一样站起来、%TEXTR("打开读了一半的书/看向窗外/开始发呆")%……
PRINTFORML %CALLNAME%は、両頬を手で包みながら幸せを噛みしめている……	PRINTFORML %CALLNAME%幸福地捂住脸颊……
CALL PRINT_STR, @"「%CNAME("二人称")%と、デート……_HH_」_W_"	CALL PRINT_STR, @"「和%CNAME("二人称")%约会……_HH_」_W_"
PRINTFORML %CALLNAME%は頬を緩ませている……	PRINTFORML %CALLNAME%显得很轻松……
PRINTFORML %CALLNAME%は頬を染めながらスカートを押さえている……	PRINTFORML %CALLNAME%红着脸压住裙子……
PRINTFORML %CALLNAME%は困惑しながらスカートを押さえている……	PRINTFORML %CALLNAME%一脸困惑地压着裙子……
PRINTFORML 「%CNAME("二人称")%の、えっち……！」	PRINTFORML 「%CNAME("二人称")%的手、诶……！」
PRINTFORML ……%CALLNAME%は、本気で責めているわけではないようだ……	PRINTFORML ……%CALLNAME%似乎并不是真的在责备……
PRINTFORML %CALLNAME%は、スカートを押さえてうつむいてしまっている……	PRINTFORML %CALLNAME%低下头按着裙子……
PRINTFORML %CALLNAME%はそろそろ我が家での生活に慣れてきただろうか？	PRINTFORML %CALLNAME%是不是已经适应了我们家的生活了呢？
PRINTFORML ふと気になって%CALLNAME%を探すと……棚に上ろうとしていた	PRINTFORML 突然在意起来、去寻找%CALLNAME%……在架子上吧
PRINTFORML 「……いつも、こういう場所に置かれていたから……」	PRINTFORML 「……因为一直都放在这样的地方……」
PRINTFORML %CALLNAME%の目には、隠し切れない期待が溢れている……	PRINTFORML %CALLNAME%的眼中、充满了无法隐藏的期待……
PRINTFORML 目が合うと、%CALLNAME%が柔らかく微笑んだ	PRINTFORML 眼神交汇后、%CALLNAME%露出了柔和的微笑。
PRINTFORML どうやらずっとこちらを見つめていたようだ……	PRINTFORML 好像一直在盯着看……
PRINTFORM 時折湯呑みを傾けながら、	PRINTFORM 一边不时倾倒着茶杯、
PRINTFORML ぼんやりと%TEXTR("窓の外/こちら/室内の一点")%に目を向けている……	PRINTFORML 呆呆地看着%TEXTR("窗外/哪里/室内")%……
PRINTFORML 視ているのか視ていないのか分からない目つきで		PRINTFORML 用不知道是看着还是没看的眼神盯着电视里放的
PRINTFORM %TEXTR("バラエティ番組/音楽番組/野球の試合/サッカーの試合/ニュース番組/ドラマ")%	PRINTFORM %TEXTR("综艺节目/音乐节目/棒球比赛/足球比赛/新闻节目/连续剧")%
PRINTFORM %TEXTR("バラエティ番組/情報番組/ニュース番組/ドラマ")%	PRINTFORM %TEXTR("综艺节目/新闻节目/连续剧")%
PRINTL 新聞を読んでいる	PRINTL 正在安静地看报纸
PRINTL 本を読んでいる	PRINTL 正在安静地看书
PRINTFORML 気になって覗き込むと、%TEXTR("料理本/料理雑誌/教養書/民話集/妖怪事典/おまじないの本")%だった……	PRINTFORML 有些在意得看了一眼、好像是%TEXTR("料理书/料理杂志/教養書/民间故事集/妖怪事典/咒语书")%之类的……
PRINTFORML %CALLNAME%は静かに眠っている……	PRINTFORML %CALLNAME%静静沉睡著……
PRINT はち切れんばかりの	PRINT 要把衣服撑破的
PRINT なだらかな	PRINT 平坦的
PRINTL 胸が、ゆっくりと上下している……	PRINTL 胸部、一上一下地起伏着……
PRINTFORMW 「ふふ……%CNAME("二人称")%、いきなりどうしたの……？」	PRINTFORMW 「呼呼……%CNAME("二人称")%、突然怎么了……？」
PRINTFORMW %CALLNAME%は、子供をあやすように%CALLNAME:MASTER%の背中をさすっている……	PRINTFORMW %CALLNAME%哄孩子一样地抚摸%CALLNAME:MASTER%的背部……
PRINTFORMW 「ふあ……%CNAME("二人称")%……！？」	PRINTFORMW 「呼呀……%CNAME("二人称")%……！？」
PRINTFORMW %CALLNAME%は驚いて目を白黒させている……	PRINTFORMW %CALLNAME%吓得两眼发白……
PRINTFORMW %CALLNAME%は困惑している……	PRINTFORMW %CALLNAME%很困惑……
PRINTFORMW %CALLNAME%はされるがままだ……	PRINTFORMW %CALLNAME%被任意摆布……
PRINTFORMW %CALLNAME%は優しく抱き返してきた……	PRINTFORMW %CALLNAME%温柔地抱过来……
PRINTFORMW %CALLNAME%はおずおずと抱き返してきた……	PRINTFORMW %CALLNAME%怯生生地抱了过来……
PRINTFORMW 「%CNAME("二人称")%……んんっ……！？」	PRINTFORMW 「%CNAME("二人称")%……嗯……！？」
PRINTFORMW 「%CNAME("二人称")%ったら……いつもいきなりなんだから……」	PRINTFORMW 「%CNAME("二人称")%的……总是那么突然……」
PRINTFORMW %CALLNAME%は、しかたないなあと言いたげに苦笑した……	PRINTFORMW %CALLNAME%像是没了办法似的苦笑起来……
PRINTFORMW 「えっ……%CNAME("二人称")%……んんっっ！？」	PRINTFORMW 「唉……%CNAME("二人称")%……唔嗯！？」
PRINTFORMW 「%CNAME("二人称","どもり")%……ん……」	PRINTFORMW 「%CNAME("二人称","どもり")%……嗯……」
PRINTFORMW %CALLNAME%は戸惑いながら%CALLNAME:MASTER%のキスを受け入れている……	PRINTFORMW %CALLNAME%困惑地和%CALLNAME:MASTER%接吻……
PRINTFORMW 「ん……んん……？」	PRINTFORMW 「嗯……嗯嗯……？」
PRINTFORMW %TEXTR("ちゅ/くちゅ")%……%TEXTR("ん/んん")%……」	PRINTFORMW %TEXTR("啾/库啾")%……%TEXTR("嗯/嗯嗯")%……」
PRINTFORMW %CALLNAME%は照れくさそうに微笑んだ……	PRINTFORMW %CALLNAME%害羞地笑了……
PRINTFORMW 「%TEXTR("ん/んっ")%……%CNAME("二人称")%……」	PRINTFORMW 「%TEXTR("啾/库啾")%……%CNAME("二人称")%……」
PRINTFORMW %CALLNAME%は真っ赤になって俯いてしまった……	PRINTFORMW %CALLNAME%深低下头、脸涨得通红……
PRINTFORMW 「……%TEXTR("ん/んっ")%……」	PRINTFORMW 「……%TEXTR("啾/库啾")%……」
PRINTFORMW 「挨拶」の間、%CALLNAME%はじっと目を伏せていた……	PRINTFORMW 「打招呼」的时候、%CALLNAME%一直低着视线……
PRINTFORMW 「%TEXTR("ん/んっ")%……%TEXTR("ん/んっ/んん/んんっ")%…\@ RAND:2 == 0 ? …？ # … \@」	PRINTFORMW 「%TEXTR("嗯/嗯姆")%……%TEXTR("嗯/嗯姆/嗯嗯/嗯唔")%…\@ RAND:2 == 0 ? …？ # … \@」
PRINTFORMW 「%CNAME("二人称","どもり")%……ふあ！？」	PRINTFORMW 「%CNAME("二人称","どもり")%……呼姆！？」
PRINTFORMW 「あうっ……%CNAME("二人称")%、%CNAME("二人称")%ってば……これ本当にごあいさつ！？」	PRINTFORMW 「啊……%CNAME("二人称")%、%CNAME("二人称")%这……真的是问候吗！？」
PRINTFORMW 「えっ……%CNAME("二人称")%……なにしてるの！？」	PRINTFORMW 「哎……%CNAME("二人称")%……在干什么！？」
PRINTFORMW 「うぁ……こっ……こんなの、ごあいさつじゃないよぅ……」	PRINTFORMW 「嗯……这……不要这样、打招呼……」
PRINTFORMW 「んんっ……%CNAME("二人称","どもり")%……」	PRINTFORMW 「嗯哼……%CNAME("二人称","どもり")%……」
PRINTFORMW %CALLNAME%は身動きもできずに「挨拶」を受け入れている……	PRINTFORMW %CALLNAME%身体无法动弹、接受了「打招呼」……
PRINTFORMW 「んっ……くぅ……？」	PRINTFORMW 「嗯……唔……？」
PRINTFORMW ……この子には、ぱんつを穿くということを教えた方がいいのだろうか……	PRINTFORMW ……教导这个孩子穿胖次比较好吧……
PRINTFORMW ……この子には、はじらいというものを教えた方がいいのだろうか……	PRINTFORMW ……还是教导这个孩子什么是羞耻心比较好吧……
PRINTFORMW 「%CNAME("二人称","どもり")%、だめぇ……！」	PRINTFORMW 「%CNAME("二人称","どもり")%、不行……！」
PRINTFORMW 「せめて、お布団の上で……%TEXTR("ふあ/ひあ/あうっ/んくっ")%！？」	PRINTFORMW 「至少在床上……%TEXTR("嗯/呀/哎呀/库")%！？」
PRINTFORMW それでは挨拶にならない……	PRINTFORMW 看来不能打招呼了……
PRINTFORMW 「%CNAME("二人称","どもり")%、こんなのやめようよ……」	PRINTFORMW 「%CNAME("二人称","どもり")%、不要这样……」
PRINTFORMW 「%TEXTR("ふあ/ひあ/あうっ/んくっ")%……ご挨拶で感じるなんて、おかしいよ……！」	PRINTFORMW 「%TEXTR("嗯/呀/哎呀/库")%……这样打招呼感觉、很奇怪……！」
PRINTFORMW 「%CNAME("二人称")%……%TEXTR("あぅ/ん/あっ")%……」	PRINTFORMW 「%CNAME("二人称")%……%TEXTR("呀/嗯/啊")%……」
PRINTFORMW %CALLNAME%は困惑しながら小さな声を上げている……	PRINTFORMW %CALLNAME%一边困惑一边小声地叫着……
PRINTFORMW 「%TEXTR("ん/ぁ/ぅ")%……%TEXTR("んん/んっ/あ")%…\@ RAND:2 == 0 ? …？ # … \@」	PRINTFORMW 「%TEXTR("嗯/啊/唔")%……%TEXTR("嗯姆/嗯/啊")%…\@ RAND:2 == 0 ? …？ # … \@」
PRINTFORMW %CALLNAME%はされるがままに小さく喘いでいる……	PRINTFORMW %CALLNAME%被欺负得娇喘起来……
PRINTFORM 微笑みながら	PRINTFORM 微笑着并
PRINTFORMW そっと頭を下げた……	PRINTFORMW 悄悄地低下了头……
PRINTFORMW ぱちりと目を覚ますと、%CALLNAME%は身体を起こして居住まいを正した……	PRINTFORMW %CALLNAME%睁开眼睛后起身并整理居所……
PRINTW 「ほんとに……！？」	PRINTW 「真的吗……！？」
PRINTFORMW %CALLNAME%は、紅く染まった頬を両手で押さえて照れている……	PRINTFORMW %CALLNAME%用双手捂住因为害羞而通红的脸……
PRINTW 「……うれしい」	PRINTW 「……很开心」
PRINTFORMW %CALLNAME%はわずかに困惑している……ほめられ慣れていないようだ	PRINTFORMW %CALLNAME%有点儿困惑……似乎不习惯被赞扬。
CALL PRINT_STR, @"「%CNAME("一人称")%、しあわせ……%CNAME("二人称","甘え")%_HH_」_W"	CALL PRINT_STR, @"「%CNAME("一人称")%、很幸福……%CNAME("二人称","甘え")%_HH_」_W"
PRINTFORMW %CALLNAME%はうっとりしている……	PRINTFORMW %CALLNAME%神情陶醉……
PRINTFORMW %CALLNAME%は、%CALLNAME:MASTER%の言葉で混乱している……	PRINTFORMW %CALLNAME%因为%CALLNAME:MASTER%的言语陷入混乱……
PRINTFORMW いまの%CALLNAME%には、よく理解できなかったようだ……	PRINTFORMW 现在的%CALLNAME%还无法理解……
PRINTFORMW %CALLNAME:TARGET%との関係を変えてみるのもいいかもしれない	PRINTFORMW 改变一下与%CALLNAME:TARGET%的关系也许不错。
PRINTFORMW そう思った%CALLNAME:MASTER%は、今から自分のことを――	PRINTFORMW %CALLNAME:MASTER%希望――
PRINTFORML [0] ご主人様と思ってほしいと告げた	PRINTFORML [0] 是她的主人
PRINTFORML [1] \@ TALENT:MASTER:オトコ ? お父さん # お母さん \@と思ってほしいと告げた	PRINTFORML [1] 是她的\@ TALENT:MASTER:男性 ? 父亲 # 母亲 \@と思ってほしいと告げた
PRINTFORML [2] \@ TALENT:MASTER:オトコ ? パパ # ママ \@と思ってほしいと告げた	PRINTFORML [2] 是她的\@ TALENT:MASTER:男性 ? 爸爸 # 妈妈 \@と思ってほしいと告げた
PRINTFORML [3] \@ TALENT:MASTER:オトコ ? お兄ちゃん # お姉ちゃん \@と思ってほしいと告げた	PRINTFORML [3] 是她的\@ TALENT:MASTER:男性 ? 哥哥 # 姐姐 \@と思ってほしいと告げた
PRINTFORML [4] 初めて出逢ったときのように%CEVENTS("初期選択")%と思ってほしいと告げた	PRINTFORML [4] 变回第一次两人遇到的称呼%CEVENTS("初期選択")%
PRINTFORML [5] ……やっぱりやめる	PRINTFORML [5] ……果然还是放弃
PRINTL ※関係を変えると「お願いする」で変更した呼び名は消去されます！	PRINTL ※改变关系的话、用「拜托了(お願いする)」更改后的称呼会被删除！
CALL SET_CEVENT,"立場：ご主人様"	CALL SET_CEVENT,"立場：主人様"
PRINT 恋人で	PRINT 是恋人
PRINTFORMW %CALLNAME%は寂しそうに呟いた	PRINTFORMW %CALLNAME%寂寞地小声说道。
PRINTW なにか不満でもあるのだろうか……	PRINTW 有什么不满吗……
PRINTFORMW %CALLNAME%は新しい関係を受け入れたようだ……	PRINTFORMW %CALLNAME%接受了新的关系……
CALL SET_CEVENT,@"立場：\@ TALENT:MASTER:オトコ ? お父さん # お母さん \@"	CALL SET_CEVENT,@"立場：\@ TALENT:MASTER:男性 ? 父亲 # 母亲 \@"
CALL SET_CEVENT,@"立場：\@ TALENT:MASTER:オトコ ? パパ # ママ \@"	CALL SET_CEVENT,@"立場：\@ TALENT:MASTER:男性 ? 爸爸 # 妈妈 \@"
CALL SET_CEVENT,@"立場：\@ TALENT:MASTER:オトコ ? お兄ちゃん # お姉ちゃん \@"	CALL SET_CEVENT,@"立場：\@ TALENT:MASTER:男性 ? 欧尼酱 # 欧内酱 \@"
PRINTFORMW %CALLNAME%はぎゅっとしがみついてきた	PRINTFORMW %CALLNAME%紧紧地抱上来
PRINTFORMW %CEVENTS("初期選択")%という関係には強い思い入れがあるようだ……	PRINTFORMW 好像对一开始%CEVENTS("初期選択")%这种关系有强烈的思念……
PRINTFORMW %CALLNAME%は小首をかしげている	PRINTFORMW %CALLNAME%歪着小脑袋
PRINTFORML さて、この機会に――	PRINTFORML 那么、借此机会――
PRINTFORML [0] パンツというものを教えておこうか	PRINTFORML [0] 让我来教你什么叫胖次吧
PRINTFORML [1] 恥じらいというものを教えておこうか	PRINTFORML [1] 教导你什么是害羞的感觉吧
PRINTFORML [2] 恥じらいというものを理解させようか	PRINTFORML [2] 让我们理解所谓的羞耻感吧
PRINTFORML [100] ……なんでもない	PRINTFORML [100] ……没什么事
PRINTFORMW %CALLNAME:MASTER%はパンツの何たるかについて熱く語った	PRINTFORMW %CALLNAME:MASTER%仔细说明了胖次的事情。
PRINTFORMW 「ヒトはみんなはいていて……%CNAME("二人称")%はだいすきで……こだわりが大事？」	PRINTFORMW 「人类都是这样……%CNAME("二人称")%很喜欢……需要坚持？」
PRINTW ……教えなくていいことまで教えたかもしれない	PRINTW ……说不定连不能教导的事都教导了。
PRINTFORMW %CALLNAME%が下着を着用するようになりました	PRINTFORMW %CALLNAME%穿上内衣了。
PRINTFORMW %CALLNAME:MASTER%は恥じらいの何たるかについて熱く語った	PRINTFORMW %CALLNAME:MASTER%仔细描述了害羞的感觉。
PRINTFORMW 「ぱんつやはだかは、はずかしいもの……？ %CNAME("一人称")%がはずかしがると、%CNAME("二人称")%は興奮する……？」	PRINTFORMW 「胖次和裸体的、会害羞……？ %CNAME("一人称")%害羞的话、%CNAME("二人称")%会兴奋起来……？」
PRINTW ……いや、あくまで一般論であって、別に自分の性癖の話をしたわけでは……	PRINTW ……不、只是一般的论调、并不是说着自己的性癖……
PRINTFORMW %CALLNAME%は恥じらいという概念を学びました	PRINTFORMW %CALLNAME%学习了害羞这个概念。
PRINTFORMW %CALLNAME:MASTER%は、股間を執拗に観察された%CALLNAME%の反応について冷静に解説した	PRINTFORMW %CALLNAME:MASTER%向%CALLNAME%详细说明了在被看见下面时应有的反应。
PRINTW 「あのときの、急に頭があっつくなって……なんにも考えられなくなっちゃう感じが……？」	PRINTW 「那个时候、会突然脑袋发热……变得不能思考……？」
PRINTW 「あれが……あれが、"はずかしい"っていうこと……！？」	PRINTW 「那是……那就是“害羞”的意思……！？」
PRINTFORMW 「じゃあ……じゃあ……い、いままでの%CNAME("一人称")%って……！？」	PRINTFORMW 「那么……那么……到现在为止的%CNAME("一人称")%是……！？」
PRINTW ……身体は恥ずかしがっていたのに、頭では気がついていなかったことになる	PRINTW ……虽然身体很害羞、但是脑子里却没有意识到。
PRINTW 「……わかる……いまならわかる……！　この感じが……はずかしいっていうことなんだ……！」	PRINTW 「……我明白了……现在明白了……！　这种感觉……就是说很害羞……！」
PRINTFORMW 「%CNAME("一人称","どもり")%……はずかしいいいいぃぃぃぃ……！！」	PRINTFORMW 「%CNAME("一人称","どもり")%……好害羞啊——————……！！」
PRINTFORMW ……恥じらいに目覚めた%CALLNAME%は、自らの黒歴史を思い返してしばらくのあいだ悶絶し続けた……	PRINTFORMW ……因为害羞而觉醒的%CALLNAME%回顾了自己的黑历史、一时间晕了过去……
PRINTFORMW %CALLNAME%は[恥薄い]を失い、[清楚]を獲得しました	PRINTFORMW %CALLNAME%的[不知羞恥]失去了、获得了[清楚]
PRINTFORMW %CALLNAME%は小首をかしげている……	PRINTFORMW %CALLNAME%歪着小脑袋……
PRINTFORML %CALLNAME:MASTER%は、%CEVENTS("立場")%という立場をどう思うか%CALLNAME%に訊ねてみた	PRINTFORML %CALLNAME:MASTER%询问%CALLNAME%、关于%CEVENTS("立場")%这个关系是怎么想的。
CALL PRINT_STR, "「……だいすき_HH_」_W_"	CALL PRINT_STR, "「……非常喜欢_HH_」_W_"
PRINTFORML ……それは%CEVENTS("立場")%という立場に関する意見ではないのでは……？	PRINTFORML ……关于%CEVENTS("立場")%这个关系的意见……？
PRINTFORMW 「……えっちなことをする関係？」	PRINTFORMW 「……做过的关系？」
PRINTFORMW ……%CALLNAME%に歪んだ認識を持たせてしまった気がする……	PRINTFORMW ……感觉让%CALLNAME%有了歪曲的认知……
PRINTFORMW 「……いちゃいちゃする関係？」	PRINTFORMW 「……调情关系？」
PRINTFORMW 「……いっしょに住む関係？」	PRINTFORMW 「……同居关系？」
PRINTFORMW それだけではないが……間違ってはいないか	PRINTFORMW 不仅如此……应该没错吧。
PRINTFORMW 「%CNAME("二人称")%……%CNAME("一人称")%、学校に行きたい」	PRINTFORMW 「%CNAME("二人称")%……%CNAME("一人称")%、想去学校」
PRINTFORMW ……本格的に学校の怪談になりたいのだろうか……	PRINTFORMW ……真的想成为学校的怪谈吗……
PRINTFORMW 噛んで含めるように言い聞かせたが、%CALLNAME%は頷かなかった	PRINTFORMW 虽然劝说过要好好考虑、但是%CALLNAME%
PRINTFORMW 「……%CNAME("一人称")%はもう、%CNAME("二人称")%のものだけど……学校の備品でもあるから……	PRINTFORMW 「……%CNAME("一人称")%已经、是%CNAME("二人称")%的东西了……学校的用品……
PRINTFORMW どうしても、だめ……？」	PRINTFORMW 不是了……？」
PRINTFORMW ……学校では絶対誰にも見つからないことと、夜までには家に帰ること	PRINTFORMW ……在学校里绝对不能被任何人发现、晚上之前必须回家。如此向她交代。
PRINTFORMW 「……ありがとう、%CNAME("二人称")%……！」	PRINTFORMW 「……十分感谢、%CNAME("二人称")%……！」
PRINTFORMW 「あっ……%CNAME("二人称","かな","甘え")%……」	PRINTFORMW 「啊……%CNAME("二人称","かな","甘え")%……」
PRINTFORMW %CALLNAME%の声は早くも蕩けかかっている……	PRINTFORMW %CALLNAME%的声音荡漾……
PRINTFORMW 「%CNAME("二人称","かな")%……だめぇ……！」	PRINTFORMW 「%CNAME("二人称","かな")%……不行……！」
PRINTFORMW %CALLNAME%が、恥じらいに火照った手を重ねてくる……	PRINTFORMW %CALLNAME%因为害羞双手用力捂起来……
PRINTFORMW 「だめ……だよ、%CNAME("二人称","かな")%……」	PRINTFORMW 「不行……的吧、%CNAME("二人称","かな")%……」
PRINTFORMW 戸惑う%CALLNAME%の手が、%CALLNAME:MASTER%の腕に添えられる……	PRINTFORMW 困惑的%CALLNAME%把手放在%CALLNAME:MASTER%的怀里……
PRINTFORMW %CALLNAME%は、自分がなにをされているかよく分かっていないようだ……	PRINTFORMW %CALLNAME%似乎不太清楚自己在被做着什么……
PRINTFORMW 「……%CNAME("二人称")%の手、きもちいい……」	PRINTFORMW 「……%CNAME("二人称")%的手、很舒服……」
PRINTFORMW %CALLNAME%はうっとりとした声を漏らしながらマッサージを受け続けた……	PRINTFORMW %CALLNAME%一边按摩一边发出诱人的声音……
PRINTFORMW 「%TEXTR("あ/ふあ/ん")%……%TEXTR("くぅ/っっ/あぅ")%……」	PRINTFORMW 「%TEXTR("啊/呀/嗯")%……%TEXTR("库/唔/呜")%……」
PRINTFORMW %CALLNAME%から漏れる声が、かなりエロい気がする……	PRINTFORMW %CALLNAME%漏出来的声音、感觉相当色情……
PRINTFORMW 「これは……%TEXTR("あ/ふあ/ん")%……はずかしいことじゃ……ないよね……？」	PRINTFORMW 「这是什么……%TEXTR("啊/呀/嗯")%……感觉……有些害羞……？」
PRINTFORMW 微妙にエロい声を出しながら、%CALLNAME%はこの行為がエロくないことを確認しようとする……	PRINTFORMW 微妙地发出色情的声音同时、%CALLNAME%想确认这个行为是不是色情的事……
PRINTFORM %TEXTR("ちゅっ/くちゅっ/ちゅぱ/ちゅぷ")%……%TEXTR("ちゅっ/くちゅっ/ちゅぱ/ちゅぷ")%…	PRINTFORM %TEXTR("啾/库啾/啾姆/啾卜")%……%TEXTR("啾/库啾/啾姆/啾卜")%…
PRINTFORMW 激しさを増したキスは、もはや性交時のそれと大差ない……	PRINTFORMW 如同做爱一般激烈地接吻着……
PRINTFORMW 「%CNAME("二人称","かな")%……%TEXTR("ちゅっ/くちゅっ/ちゅぱ/ちゅぷ")%……%TEXTR("ちゅっ/くちゅっ/ちゅぱ/ちゅぷ")%……もう、ほんとにだめ……！」	PRINTFORMW 「%CNAME("二人称","かな")%……%TEXTR("啾/库啾/啾姆/啾卜")%……%TEXTR("啾/库啾/啾姆/啾卜")%……不、不要这样……！」
PRINTFORMW 湯気が出そうなほど赤面した%CALLNAME%に、とうとう押し離されてしまった……	PRINTFORMW 脸红得快要冒出热气的%CALLNAME%终于推开了%CALLNAME:MASTER%……
PRINTFORMW 「%TEXTR("ちゅ/くちゅ")%……%TEXTR("ん/んん")%……」	PRINTFORMW 「%TEXTR("啾/库啾")%……%TEXTR("嗯/嗯姆")%……」
PRINTFORMW %CALLNAME%は、眉をひそめながらキスを受け入れている……	PRINTFORMW %CALLNAME%一边皱着眉头一边接吻……
PRINTFORMW 「%TEXTR("ん/んっ")%……%TEXTR("んっ/んんっ")%……？」	PRINTFORMW 「%TEXTR("嗯/嗯姆")%……%TEXTR("嗯/嗯唔")%……？」
PRINTFORMW %CALLNAME%は、自分がなにをされているかよく分かっていないようだ	PRINTFORMW %CALLNAME%好像不太清楚自己在做什么……
PRINTFORMW 「%TEXTR("ちゅ/くちゅ")%……%TEXTR("ん/んん")%……%CNAME("二人称","かな","甘え")%」	PRINTFORMW 「%TEXTR("啾/库啾")%……%TEXTR("嗯/嗯姆")%……%CNAME("二人称","かな","甘え")%」
PRINTFORMW 唇を重ねると、%CALLNAME%はうっとりしながら舌を絡めてきた……	PRINTFORMW 嘴唇相叠、%CALLNAME%的舌头伸了进来……
PRINTFORMW 「だめだよ、%CNAME("二人称","かな")%……%TEXTR("んっ/んんっ")%……」	PRINTFORMW 「不要、%CNAME("二人称","かな")%……%TEXTR("嗯/嗯唔")%……」
PRINTFORMW %CALLNAME%の手が%CALLNAME:MASTER%の胸に添えられるが、押し離すまではできないようだ……	PRINTFORMW %CALLNAME%的手被压在%CALLNAME:MASTER%的怀里、无法用力推开……
PRINTFORMW 「あっ……%TEXTR("んっ/んんっ")%……」	PRINTFORMW 「啊……%TEXTR("嗯/嗯唔")%……」
PRINTFORMW 「ふふ……%TEXTR("やさしい/あったかい/なんだか照れちゃう")%ね、%CNAME("二人称")%……」	PRINTFORMW 「呼呼……%TEXTR("很舒适/好温暖/总觉得有些害羞")%呢、%CNAME("二人称")%……」
PRINTFORMW 膝枕をされながら、%CALLNAME%はゆったりとくつろいでいる	PRINTFORMW %CALLNAME%舒舒服服地枕在腿上。
PRINTFORMW 「……こういう気持ちが、落ち着く……っていうこと……？」	PRINTFORMW 「……心情很平静……是这样吗……？」
PRINTFORMW %CALLNAME%は、不思議そうに%CALLNAME:MASTER%の太股の感触を味わっている	PRINTFORMW %CALLNAME%不可思议地体会着%CALLNAME:MASTER%大腿的触感。
PRINTFORMW %CALLNAME%はこの状況をよく理解できていないようだ	PRINTFORMW %CALLNAME%好像不太理解这个状况。
PRINTFORMW 「……ありがとう、%CNAME("二人称")%」	PRINTFORMW 「……十分感谢、%CNAME("二人称")%」
PRINTFORM %CALLNAME%は	PRINTFORM %CALLNAME%
PRINTFORM ほのかに	PRINTFORM 隐约
PRINTFORM こくりと頭を下げて	PRINTFORM 低下头
PRINTFORMW お茶を受け取った	PRINTFORMW 接过茶
PRINTFORMW 「え……%CNAME("二人称")%……？」	PRINTFORMW 「诶……%CNAME("二人称")%……？」
PRINTFORMW %CALLNAME%は不意を打たれてきょとんとしている……	PRINTFORMW %CALLNAME%被突然袭击搞得目瞪口呆……
PRINTFORMW %CALLNAME%は、%CALLNAME:MASTER%が同時に戻ってきたのを見てきょとんとしている……	PRINTFORMW %CALLNAME%看见%CALLNAME:MASTER%也走了进来时、呆住了……
PRINTFORMW %CALLNAME%は、何事もなかったように座り直した……	PRINTFORMW %CALLNAME%像是什么都没发生过一样重新坐了下来……
PRINTFORMW 「あ……」	PRINTFORMW 「啊……」
PRINTFORMW %CALLNAME%は小さな声を漏らすと、静かに部屋を出て行った……	PRINTFORMW %CALLNAME%轻轻地走出房间……
PRINTFORMW 「ふふ……%CNAME("二人称")%って、たまにいじわるだよね……」	PRINTFORMW 「呼呼……%CNAME("二人称")%……偶尔也会恶作剧……」
PRINTFORMW %CALLNAME%にくすくす笑われてしまった……	PRINTFORMW 被%CALLNAME%嘲笑了……
PRINTFORMW 「%CNAME("二人称")%……そういうこと、訊いちゃだめなんだよ……」	PRINTFORMW 「%CNAME("二人称")%……不许问那种事……」
PRINTFORMW %CALLNAME%は恥ずかしそうにもじもじしている……	PRINTFORMW %CALLNAME%有点害羞……
PRINTFORMW %CALLNAME%は、答えていいものか困り切っている……	PRINTFORMW %CALLNAME%的沉默非常尴尬……
PRINTFORMW 「……お手洗い」	PRINTFORMW 「……厕所」
PRINTFORMW %CALLNAME%は顔色も変えずに即答した	PRINTFORMW %CALLNAME%面不改色地回答
PRINTFORMW 「%CNAME("二人称","どもり")%の、えっちっ……！」	PRINTFORMW 「%CNAME("二人称","どもり")%、呀……！」
PRINTFORMW %CALLNAME%は逃げ出してしまった……	PRINTFORMW %CALLNAME%逃走了……
PRINTFORMW 「%CNAME("二人称","どもり")%……ほんと、だめだからっ……」	PRINTFORMW 「%CNAME("二人称","どもり")%……真的、不行……」
PRINTFORMW %CALLNAME%の顔がさらに上気していく……	PRINTFORMW %CALLNAME%的脸涨起来了……
PRINTFORMW 「%CNAME("二人称")%……だめ、だよ……」	PRINTFORMW 「%CNAME("二人称")%……不行、不要……」
PRINTFORMW %CALLNAME%は教えた恥じらいを忠実に守っているようだ……	PRINTFORMW %CALLNAME%似乎遵守了教导过的害羞的感觉……
PRINTFORMW 「……い、いまは、だめっ……！」	PRINTFORMW 「……现在、现在不行……！」
PRINTFORMW %CALLNAME%は、身を縮めて裾を押さえてしまった……	PRINTFORMW %CALLNAME%缩着身子按住了下摆……
PRINTFORMW 「%CNAME("二人称","どもり")%……そういうの、だめ……」	PRINTFORMW 「%CNAME("二人称","どもり")%……这样不行……」
PRINTFORMW %CALLNAME%の顔が上気している……今までにはなかった反応だ……	PRINTFORMW %CALLNAME%的脸涨起来了……这是至今为止没有过的反应……
PRINTFORMW %CALLNAME%は、裾を両手で握って困惑している……	PRINTFORMW %CALLNAME%双手握住下摆并感到困惑……
PRINTFORMW 「%CNAME("二人称","どもり")%……はずかしい……です……」	PRINTFORMW 「%CNAME("二人称","どもり")%……好害羞……呜……」
PRINTFORMW 「なに……なに、これ……！？」	PRINTFORMW 「为什么……身体自己……！？」
PRINTFORMW %CALLNAME%の身体がふるふると震えている	PRINTFORMW %CALLNAME%的身体颤抖着。
PRINTFORMW %CALLNAME%の手は自身の鼠径部をさまよい、女性器を隠したい本心を明瞭に漏らしている……	PRINTFORMW %CALLNAME%的手在徘徊着、想要遮住下面……
PRINTFORMW ……今なら、%CALLNAME%に本当の羞恥心というものを教えられるかもしれない……	PRINTFORMW ……现在应该能教导%CALLNAME%明白羞耻心……
PRINTFORMW 股間を覗き込む%CALLNAME:MASTER%を、%CALLNAME%は困惑した表情で受け入れている……	PRINTFORMW %CALLNAME%用困惑的表情看着正在观察性器的%CALLNAME:MASTER%……
PRINTFORMW %CALLNAME%の手は自身の臀部をさまよい、隠したい本心を明瞭に漏らしている……	PRINTFORMW %CALLNAME%的手在徘徊着、想要遮住下面……
PRINTFORMW パンツを覗き込む%CALLNAME:MASTER%を、%CALLNAME%は困惑した表情で受け入れている……	PRINTFORMW %CALLNAME%用困惑的表情看着正在观察胖次的%CALLNAME:MASTER%……
PRINTFORMW %CALLNAME%は訝しげに%CALLNAME:MASTER%を見つめている……	PRINTFORMW %CALLNAME%惊讶地看着%CALLNAME:MASTER%……
PRINTFORMW 「%TEXTR("あ/んん/く")%……%TEXTR("うぅ/はぁっ/あう")%……」	PRINTFORMW 「%TEXTR("啊/嗯姆/库")%……%TEXTR("唔/哈呜/啊呜")%……」
PRINTFORMW %CALLNAME%は、艶やかな脚を震わせながら恥辱に耐えている……	PRINTFORMW %CALLNAME%秀美的双脚不停颤抖着忍受羞耻感……
PRINTFORMW %CALLNAME%の顔が、茹でられたように火照っている	PRINTFORMW %CALLNAME%的脸红得发烫。
PRINTFORMW %CALLNAME%はそんな自分の身体の反応に混乱しているようだ……	PRINTFORMW %CALLNAME%似乎为自己身体的反应感到混乱。
PRINTFORMW 「%CNAME("二人称")%……は、はずかしい……」	PRINTFORMW 「%CNAME("二人称")%……好、好害羞……」
PRINTFORMW %CALLNAME%の顔が、茹でられたように火照っている……	PRINTFORMW %CALLNAME%的脸红得发烫……
PRINTFORMW %CALLNAME%は無造作に裾をまくり上げた	PRINTFORMW %CALLNAME%随意地卷起下摆。
PRINTFORMW 「%CNAME("二人称","どもり")%……ちがうの、ちがうのっ……！」	PRINTFORMW 「%CNAME("二人称","どもり")%……不、不是这样的……！」
PRINTFORMW 故意にぱんつを穿いていないくせに、なにが違うと言うのだろうか……	PRINTFORMW 明明故意没有穿胖次、还说不是……
PRINTFORMW ちらちらさせたぱんつ……ちゃんと、見てくださいっ……」	PRINTFORMW 胖次……请好好地看吧……」
PRINTFORMW %CNAME("一人称")%のぱんつ……み、見てくださいっ……」	PRINTFORMW %CNAME("一人称")%的胖次……请、请看吧……」
PRINTFORMW 耳まで紅く染めた%CALLNAME%は、それでも言ってほしいと頼んだ台詞をなぞってくる……	PRINTFORMW 耳朵都红了的%CALLNAME%、念出即便如此也要说的台词……
PRINTFORMW %CALLNAME%の手は自身の鼠径部をさまよい、隠したい本心を明瞭に漏らしている……	PRINTFORMW %CALLNAME%手在自己的鼠径部揉搓着、藏起来的本心显露无疑……
PRINTFORMW 「%CNAME("二人称","どもり")%……ちらちらしたぱんつ……ちゃんと、見てくださいっ……」	PRINTFORMW 「%CNAME("二人称","どもり")%……胖次……请好好地看吧……」
PRINTFORMW 「%CNAME("二人称","どもり")%……い、いきなり、そんなことしちゃ……だめぇ……」	PRINTFORMW 「%CNAME("二人称","どもり")%……突、突然、这样子……不行……」
PRINTFORMW 裾を押さえる%CALLNAME%の手には、%CALLNAME:MASTER%を制止できるほどの力は入っていない……	PRINTFORMW 压着下摆的%CALLNAME%没法阻止%CALLNAME:MASTER%的力量……
PRINTFORMW %CALLNAME%は、艶やかな脚を震わせながら恥辱を耐えている……	PRINTFORMW %CALLNAME%秀美的双脚不停颤抖着忍受羞耻感……
//EVENT_K17_SHOP.ERB
PRINTFORMW 「どうしたの、%CNAME("二人称")%……？」	PRINTFORMW 「怎么了、%CNAME("二人称")%……？」
PRINTFORMW %CALLNAME%は微笑みを浮かべている……	PRINTFORMW %CALLNAME%露出微笑……
PRINTFORMW %CALLNAME:TARGET%が%CALLNAME:MASTER%の顔を覗き込んできた……	PRINTFORMW %CALLNAME:TARGET%悄悄看着%CALLNAME:MASTER%的脸……
PRINTFORMW 「%CNAME("二人称")%……ご用？」	PRINTFORMW 「%CNAME("二人称")%……有事吗？」
PRINTFORMW %CALLNAME%は%CALLNAME:MASTER%の目をじっと見つめている	PRINTFORMW %CALLNAME%目不转睛地看着%CALLNAME:MASTER%
PRINTFORMW %CALLNAME%は%CALLNAME:MASTER%が口を開くのを待っている……	PRINTFORMW %CALLNAME%等待%CALLNAME:MASTER%开口……
PRINTFORMW %CALLNAME%はぼんやりとした視線を%CALLNAME:MASTER%に向けている……	PRINTFORMW %CALLNAME%将视线转向%CALLNAME:MASTER%……
PRINTFORMW 「……なんて呼べばいいの？」	PRINTFORMW 「……叫什么好呢？」
PRINTFORMW 「%CNAME("二人称")%……で、いい？」	PRINTFORMW 「%CNAME("二人称")%……好的？」
PRINTFORMW %CALLNAME%が、%CALLNAME:MASTER%の\@ TALENT:長身 ? 胸を抱きしめてくる # 胸にしがみついてすっぽりと収まる \@……	PRINTFORMW %CALLNAME%、\@ TALENT:高大 ? 抱在 # 扑在 \@%CALLNAME:MASTER%的怀里……
PRINTFORMW 「%CNAME("一人称")%、最近ずっと思ってた……」	PRINTFORMW 「%CNAME("一人称")%、最近一直在想……」
PRINTFORMW 「ご主人様でもなくて、\@ TALENT:MASTER:オトコ ? お父さん # お母さん \@でもなくて、\@ TALENT:MASTER:オトコ ? お兄ちゃん # お姉ちゃん \@でもなくて……」	PRINTFORMW 「不是主人、\@ TALENT:MASTER:男性 ? 爸爸 # 妈妈 \@、\@ TALENT:MASTER:男性 ? 哥哥 # 姐姐 \@的关系……」
PRINTW 「もっとちがう関係になりたいって……思ってた」	PRINTW 「想成为更不同的关系……一直想着」
PRINTFORMW 「%CNAME("一人称")%……ヘン」	PRINTFORMW 「%CNAME("一人称")%……很奇怪」
PRINTFORMW 「%CNAME("二人称")%の恋人にしてもらえるのに……もっともっと、%CNAME("二人称")%の特別になりたい」	PRINTFORMW 「明明是%CNAME("二人称")%的恋人……想变成%CNAME("二人称")%更加、更加特别的人」
PRINTFORMW 「%CNAME("二人称")%に、もっともっとすきになってもらいたい」	PRINTFORMW 「希望被%CNAME("二人称")%更喜欢……」
PRINTFORMW 「だから……もっといっぱい、いろんなことを教えてね……%CNAME("二人称")%……！」	PRINTFORMW 「所以……再多教我一些东西吧……%CNAME("二人称")%……！」
PRINTFORMW 出逢ってから一番の笑顔で、%CALLNAME%は%CALLNAME:MASTER%と約束の口付けを交わした	PRINTFORMW 相遇之后用最灿烂的笑容、%CALLNAME%和%CALLNAME:MASTER%交换了约定的吻。
PRINTFORMW %CALLNAME%は[貞操無頓着][感情乏しい]を失いました	PRINTFORMW %CALLNAME%失去了[不在乎貞操][感情缺乏]
PRINTFORMW 答えることもできないまま、%CALLNAME%は一瞬で紅潮した頬を押さえて混乱している	PRINTFORMW 没有回答、%CALLNAME%一瞬间捂住红潮的脸颊混乱不堪。
PRINTFORMW 今まで見たことのない反応だ	PRINTFORMW 这是从未见过的反应。
PRINTFORMW 脈はありそうに見えるのだが……	PRINTFORMW 看样子、可能……
PRINTFORMW %CALLNAME%はこくりと頷いた	PRINTFORMW %CALLNAME%点了点头。
PRINTFORMW 「%CNAME("一人称")%も%CNAME("二人称","かな")%のこと、すき」	PRINTFORMW 「%CNAME("一人称")%也喜欢%CNAME("二人称","かな")%」
PRINTFORMW 明らかに、%CALLNAME%は恋愛感情というものを理解できていない……	PRINTFORMW 很明显、%CALLNAME%无法理解恋爱的感情……
PRINTFORMW 「む、むり……！」	PRINTFORMW 「不、不行……！」
PRINTFORMW %CALLNAME%は、顔を火照らせながらぶんぶんと首を振った	PRINTFORMW %CALLNAME%使劲摇头、脸上一片火红。
PRINTFORMW %CALLNAME%は、困惑しきってもじもじしている……	PRINTFORMW %CALLNAME%感到困惑……
PRINTFORMW %CALLNAME%は、ふるふると首を横に振った	PRINTFORMW %CALLNAME%摇了摇头。
PRINTW 「はいてない」	PRINTW 「没穿」
PRINTFORMW %CALLNAME%は自分の下腹部に視線を落とした	PRINTFORMW %CALLNAME%将视线投向自己的下腹部。
PRINTW 「…………ぱんつ？」	PRINTW 「…………胖次？」
PRINTFORMW %CALLNAME%からパンツを貰うには、まずパンツを穿かせるところから始めなければいけないようだ……	PRINTFORMW 要从%CALLNAME%那里得到胖次的话、必须要先教导她穿胖次……
PRINTFORMW %CALLNAME%からパンツを貰うには、まずパンツを穿くことを教えるところから始めなければいけないようだ……	PRINTFORMW 要从%CALLNAME%那里得到胖次的话、必须要先教导她穿胖次……
PRINTFORMW %CALLNAME%はおずおずとパンツを脱ぐと、恥ずかしそうに手渡してきた……	PRINTFORMW %CALLNAME%怯生生地脱掉胖次、有点害臊地用手递过来……
PRINTW 「……はい」	PRINTW 「……是」
PRINTFORMW %CALLNAME%はためらいがちに頷くと、パンツを脱いで手渡してきた	PRINTFORMW %CALLNAME%犹豫地点了点头、脱下胖次递了过来。
PRINTFORMW %CALLNAME%はこくりと頷くと、無造作にパンツを脱いで手渡してきた	PRINTFORMW %CALLNAME%点了点头、随手脱下胖次递了过来。
PRINTFORMW ……この子には、恥じらいというものを教えた方がいいのだろうか……	PRINTFORMW ……还是教导这个孩子什么是羞耻心比较好吧……
PRINTW 「だめ……！！」	PRINTW 「不行……！！」
PRINTFORMW %CALLNAME%は、真っ赤な顔でぶんぶんと首を振った	PRINTFORMW %CALLNAME%使劲摇头、脸上一片火红。
PRINTFORMW %CALLNAME%は、パンツを渡していいものか戸惑っているようだ……	PRINTFORMW %CALLNAME%在疑惑为什么要交出胖次……
PRINTFORMW お願いを理解した%CALLNAME%は、こくりと頷いた	PRINTFORMW %CALLNAME%理解了请求、点了点头。
PRINTW 「……おべんとうって、なに？」	PRINTW 「……便当是什么？」
PRINTW お弁当を作ってもらう以前の問題のようだ……	PRINTW 好像是做便当之前的问题……
PRINTW 「勉強してるから、まって」	PRINTW 「正在学习、稍等」
PRINTFORMW %CALLNAME%は両手で持った%TEXTR("料理雑誌/料理雑誌/料理本/料理本/キノコ図鑑/動物図鑑")%を突き出してきた	PRINTFORMW %CALLNAME%双手捧着%TEXTR("料理杂志/料理杂志/料理书/料理书/蘑菇图鉴/动物图鉴")%
PRINTW 「……作ってみる」	PRINTW 「……试一下」
PRINTW 「勉強してみたけど……自信はあんまりない」	PRINTW 「虽然试着学习了……但没什么把握」
PRINTW ……誰かに手ほどきを頼んでおいた方がいいかもしれない……	PRINTW ……最好找别人先试一下……
PRINTFORMW %CALLNAME%は耳まで紅潮させながら、おずおずと滑らかな下腹部を晒した……	PRINTFORMW 耳朵都红了的%CALLNAME%怯生生地将光滑的腹部给展示出来……
PRINTFORMW %CALLNAME%は、戸惑った表情で滑らかな下腹部を晒した……	PRINTFORMW %CALLNAME%疑惑地将腹部给展示出来……
PRINTFORMW %CALLNAME%はこくりと頷くと、服を脱ぎ捨てて下腹部を無防備にさらけ出した	PRINTFORMW %CALLNAME%点了点头、随意脱下衣服露出了腹部。
PRINTFORMW %CALLNAME%は、感触を確かめるようにシールの紋様を指でなぞっている……	PRINTFORMW %CALLNAME%为了确认触感、用手指描画着贴纸上的纹样……
PRINTFORMW %CALLNAME%は不安そうに%CALLNAME:MASTER%を見つめている	PRINTFORMW %CALLNAME%不安地看着%CALLNAME:MASTER%。
PRINTFORMW これから存在が書き換えられることを、本能的に感じ取っているのかもしれない……	PRINTFORMW 也许是本能地感觉到了一些变化……
PRINTFORMW 「%CNAME("二人称","かな")%……%CNAME("一人称")%……%CNAME("一人称")%じゃなくなっちゃう……」	PRINTFORMW 「%CNAME("二人称","かな")%……%CNAME("一人称")%……不是%CNAME("一人称")%了……」
PRINTFORMW %CALLNAME%の目に涙が浮かんだ	PRINTFORMW 眼泪涌上%CALLNAME%的眼眶。
PRINTFORMW %CALLNAME%は明らかに怯えている……	PRINTFORMW %CALLNAME%显然很害怕……
PRINTFORMW 「%CNAME("二人称","かな")%……おねがい……%CNAME("一人称")%がどうなっちゃっても……すてないで……！」	PRINTFORMW 「%CNAME("二人称","かな")%……求求你……%CNAME("一人称")%变成什么样子……都不要丢下%CNAME("一人称")%……！」
PRINTFORMW %CALLNAME%が%CALLNAME:MASTER%の手にすがりついてきた	PRINTFORMW %CALLNAME%用力抱住%CALLNAME:MASTER%的手。
PRINTFORMW 決して後戻りできないほど存在を書き換えられてしまう予感に、%CALLNAME%は激しい恐怖を抱いているようだ……	PRINTFORMW %CALLNAME%似乎对再也无法消除的淫紋抱有强烈的恐惧……
PRINTFORMW %CALLNAME%は理解できなかったようだ……	PRINTFORMW %CALLNAME%好像没能理解……
//EVENT_K17_小菊.ERB
美術準備室に置かれていた市松人形	放在美术准备室的人偶。
依り集まった魔力によって不安定な人化変身を起こして学校の怪談になりかけていたが、%NAME:MASTER%から霊力を与えられたことにより、晴れて完全な妖怪化を果たした	因为汇聚了魔力不时以人的姿态行动、而成为学校的怪谈。由于%NAME:MASTER%的灵力、得以完全妖怪化。
PRINTFORML %NAME:MASTER%から霊力を与えられたことにより、晴れて完全な妖怪化を果たした	PRINTFORML 由于%NAME:MASTER%的灵力、得以完全妖怪化。
PRINTW 「夜の学校にお化けが出る」という噂を初めて耳にしたのは、一週間ほど前のことだった	PRINTW 大概是一周前、听说了「学校夜晚会有妖怪」的传闻。
PRINTL 「ええ、いますよ。美術準備室にいる和服の子ですよね？」	PRINTL 「对对、好像是美术准备室里面那个穿着和服的人偶吧？」
PRINTFORMW 部室で雑談の話題として持ち出すと、%NAME:FINDCHARA(NO, 1)%は平然と頷いた	PRINTFORMW 在社团里闲谈时聊到这个话题、%NAME:FINDCHARA(NO, 1)%听到后随意地点了点头。
PRINTW 「でも正確には、そうですね……人形をよりどころに集まった魔力で生まれた魔法生物、と言ったところでしょうか」	PRINTW 「准确来说……应该是人偶依靠汇聚的魔力而诞生的魔法生物吧」
PRINTW 「長い年を経て霊を宿した付喪神ではありませんが、広い意味ではそのお仲間なんでしょうね」	PRINTW 「不是什么付丧神、不过总的来说算是友好的家伙」
PRINTW 「今のところは、意志らしい意志もなく学校を徘徊しているだけで、魔力が抜ければただの人形に戻るような不安定な存在ですが」	PRINTW 「如今只是漫无目地在学校里徘徊、如果魔力消散就会变回人偶的不稳定存在」
PRINTFORMW 「興味をお持ちでしたら、一度ご覧になってみてはいかがです？　もしお気に召しましたら、%CNAMET(FINDCHARA(NO, 1), "二人称")%であれば、魂を分け与えて存在を固定化できると思いますよ」	PRINTFORMW 「如果有兴趣的话、去看一次怎么样？如果中意的话、%CNAMET(FINDCHARA(NO, 1), "二人称")%可以分享灵魂来固定她的形态」
PRINTW ……仮に存在を固定化した場合、「それ」はどういう存在になるのだろう？	PRINTW ……如果将形态固定化的话、「那个」会怎么样呢？
PRINTFORMW 「どう扱うかはご自由ですが、契約上は%CNAMET(FINDCHARA(NO, 1), "二人称")%の式神、あるいは使い魔という形になるでしょうね」	PRINTFORMW 「想怎么处理都可以、契约后大概就是%CNAMET(FINDCHARA(NO, 1), "二人称")%的式神、或者是使魔的形式」
PRINTFORMW %CALLNAME:MASTER%は、ぼんやりと昨晩の出来事を思い返していた	PRINTFORMW %CALLNAME:MASTER%大致回忆了一下昨晚发生的事情。
PRINTW 静まりかえった、深夜の学校	PRINTW 夜晚的学校变得非常安静。
PRINTFORMW ほのかな月光を半身に浴びながら、学校の廊下に似つかわしくない華やかな着物姿の人影が振り返った	PRINTFORMW 当月光照在身上时、回头看见了与学校走廊不相称的华丽和服。
PRINTW 肩で切り揃えられた黒髪が、さらりと揺れる	PRINTW 齐肩的黑发在不停飘动。
PRINT 若い……いやむしろ幼い	PRINT 很年轻……不如说是幼小、
PRINT 成熟した	PRINT 看起来很成熟、
PRINT 若い	PRINT 很年轻、
PRINT 顔立ちの、	PRINT 身材
PRINT 小柄な	PRINT 瘦小的
PRINT 大柄な	PRINT 高挑的
PRINTW 月明かりに照らされて滑らかに映える肌は、高級な和人形を思わせた	PRINTW 肌肤在月光的照耀下显得异常光滑、让人联想到日本的高级人偶。
PRINTW しかし、サイズはどう見ても1/1スケール	PRINTW 只不过、不管怎么看都像是1:1的比例。
PRINTW こんな巨大な人形が、美術準備室に置いてあったのだろうか？	PRINTW 美术准备室真的有这么大的人偶吗？
PRINTFORMW 観察する%CALLNAME:MASTER%をじっと見返しているうつろな瞳からは、普通の女性がこの状況下で抱きそうな感情は全く窺えない	PRINTFORMW 一直盯着%CALLNAME:MASTER%的眼睛里面完全看不到正常女性的感情。
PRINTL 一見無害そうではあるが……	PRINTL 看起来似乎无害……
PRINTFORMW 非常識な存在に馴れ親しんでしまった%CALLNAME:MASTER%ならともかく、一般人が出会ってしまったら、おしっこちびるくらいはするかもしれない	PRINTFORMW 撇开对非正常生物有免疫力的%CALLNAME:MASTER%不谈、一般人遇到这种事情会吓尿吧。
PRINTW 名前を訊ねてみると、彼女は小首をかしげて固まってしまった	PRINTW 问了一下她的名字、她歪着脑袋愣住了。
PRINTW 言葉が通じなかったのだろうか？	PRINTW 语言不通吗？
PRINTFORMW %CALLNAME:MASTER%がそう考え始めたとき、思い出したように着物の脇から袖のあたりをごそごそと探り、木の札を差し出してきた	PRINTFORMW 在%CALLNAME:MASTER%这么思考的时候、她仿佛突然想起来一样、拿出放在和服里的木牌。
PRINTFORMW 五月人形に付属しているような、職人名などを記した札。そこには、明らかに子供の手による稚拙な字で「%NAME:ARG%」と書き足されていた	PRINTFORMW 像是人偶附赠的标牌、上面有类似儿童手写般的幼拙字迹――「%NAME:ARG%」
PRINTW 彼女は、それを自分の名前と認識しているらしい	PRINTW 她好像认为那就是自己的名字。
PRINTW 反応を見る限りでは、自我こそ希薄なものの、ある程度の知識や言語力は備えているようだ	PRINTW 仅从反应来看、虽然自我意识薄弱、但似乎具备一定程度的知识和语言能力。
PRINTFORMW それにしても、%NAME:FINDCHARA(NO, 1)%は%NAME:ARG%を好きにしていいと言っていたが、このまま放っておくと騒ぎが大きくなってしまうのではないだろうか？	PRINTFORMW 话虽如此、虽然%NAME:FINDCHARA(NO, 1)%说把%NAME:ARG%怎么样都好、但是这样放任不管的话会引起很大的骚动吧？
PRINTFORMW とりあえず連れて帰ろうと考えた%CALLNAME:MASTER%は彼女に――	PRINTFORMW %CALLNAME:MASTER%想先带她回去――
PRINTFORML [0] ご主人様になってあげると告げた	PRINTFORML [0] 告诉她你是她的主人
PRINTFORML [1] \@ TALENT:MASTER:オトコ ? お父さん # お母さん \@になってあげると告げた	PRINTFORML [1] 告诉她你是她的\@ TALENT:MASTER:男性 ? 父亲 # 母亲 \@
PRINTFORML [2] \@ TALENT:MASTER:オトコ ? パパ # ママ \@になってあげると告げた	PRINTFORML [2] 告诉她你是她的\@ TALENT:MASTER:男性 ? 爸爸 # 妈妈 \@
PRINTFORML [3] \@ TALENT:MASTER:オトコ ? お兄ちゃん # お姉ちゃん \@になってあげると告げた	PRINTFORML [3] 告诉她你是她的\@ TALENT:MASTER:男性 ? 哥哥 # 姐姐 \@
PRINTFORMW こくんと頷き、%NAME:ARG%はその関係を受け入れた	PRINTFORMW %NAME:ARG%点了点头，很快便接受了这件事。
PRINTFORML ※%CALLNAME:ARG%との関係は、日常イベント「トーク」→「雑談する」を選択した際に低確率で再選択可能です。	PRINTFORML ※与%CALLNAME:ARG%的关系在日常中的「Talk」→「雑談」里有低几率可以重新选择。
PRINTW 　また、口上中「教える」というフレーズが登場した時には「雑談する」で教えることができる場合があります。	PRINTW 　另外、口上中出现「教导(教える)」这个词语时、可以使用「雑談」来教导。
PRINTFORMW お持ち帰りされた%CALLNAME:ARG%は%CALLNAME:MASTER%宅の備品として"同棲中"となります。	PRINTFORMW 被带走的%CALLNAME:ARG%将作为%CALLNAME:MASTER%的所有物而变为"同居中"的状态。
PRINTFORMW しかし人の姿では学校関係者（？）と認められないので部室に来ることができません。	PRINTFORMW 但是因为学校领导（？）不会认可、所以不能来部室。
PRINTFORMW ベッドに座らせると、%CALLNAME%は静かに%CALLNAME:MASTER%を見上げた	PRINTFORMW %CALLNAME%坐在地上，抬头安静地看着%CALLNAME:MASTER%
PRINTW その表情からはなんの感情も読み取れない	PRINTW 从那个表情中什么感情也读不出来。
PRINTFORMW これからなにが行われるか、%CALLNAME%には知識がないのだろう……	PRINTFORMW 今后要怎么做呢、%CALLNAME%应该还什么都不懂吧……
PRINTW 「ちょっと、わかってきた気がする……」	PRINTW 「稍微、有点明白了……」
PRINTW 「……ヒトが、ヒトといっしょにいたい……気持ち」	PRINTW 「……人类、和人类在一起的……情绪」
PRINTFORMW そう呟く%CALLNAME%の目は、以前よりもはっきりした意志が宿ってきているように見えた……	PRINTFORMW 小声诉述着的%CALLNAME%的眼中、看起来有比以前更明确的意志了……
PRINTFORMW 「%CNAME("二人称")%は、これ……楽しいの……？」	PRINTFORMW 「%CNAME("二人称")%、做这个……会开心吗……？」
PRINTFORMW 「そうなんだ……%CNAME("二人称")%が楽しいのなら……いっぱいしても、いいよ？」	PRINTFORMW 「这样的话……%CNAME("二人称")%如果会开心……做更多也没关系哦」
PRINTFORMW %CALLNAME%は、%CALLNAME:MASTER%の肉欲を受け入れたようだ……	PRINTFORMW %CALLNAME%似乎接受%CALLNAME:MASTER%了。
PRINTFORMW 「……ね、%CNAME("二人称")%……もっと、いっぱい教えて……？」	PRINTFORMW 「……呐、%CNAME("二人称")%……更多、教我更多吧……？」
PRINTFORMW 「%CNAME("一人称")%も……%CNAME("二人称")%に、いろいろしてあげたい……」	PRINTFORMW 「%CNAME("一人称")%也……想要为%CNAME("二人称")%做更多的事情……」
PRINTFORMW %CALLNAME%は、訴えるように%CALLNAME:MASTER%を\@ !TALENT:MASTER:小柄 && !TALENT:長身 ? 見上げた # 見つめた \@……	PRINTFORMW %CALLNAME%一边说一边\@ !TALENT:MASTER:娇小 && !TALENT:高大 ? 抬头仰望 # 凝视着 \@%CALLNAME:MASTER%……
PRINTFORMW 「ね、%CNAME("二人称")%……%CNAME("二人称")%はいつも通り……なんだよね……？」	PRINTFORMW 「呐、%CNAME("二人称")%……%CNAME("二人称")%不太对劲……为什么……？」
PRINTFORMW 「……%CNAME("一人称")%が……ヘン、なのかな……！？」	PRINTFORMW 「……%CNAME("一人称")%……变得奇怪了……！？」
PRINTFORMW %CALLNAME:MASTER%に抱きすくめられた%CALLNAME%は、身体を火照らせながら身じろぎしている……	PRINTFORMW 被%CALLNAME:MASTER%抱住的%CALLNAME%、身体发烫还在颤抖……
PRINTFORMW 「あのね、%CNAME("二人称")%……%CNAME("二人称")%は、気がついてないよね……？」	PRINTFORMW 「那个、%CNAME("二人称")%……%CNAME("二人称")%没有注意到吧……？」
PRINTFORMW  %CALLNAME%が、ふわりと抱きしめてくる……	PRINTFORMW  %CALLNAME%轻轻地拥抱了过来……
PRINTFORMW 「%CNAME("二人称")%が、心を分けてくれるたびに……%CNAME("一人称")%の中が、どんどん優しくてあたたかくなるの……」	PRINTFORMW 「每次%CNAME("二人称")%把心分给我的时候……%CNAME("一人称")%的里面、都会越来越温暖……」
PRINTFORMW 「いまの%CNAME("一人称")%は、ぜんぶ%CNAME("二人称")%が……くれたんだよ」	PRINTFORMW 「现在的%CNAME("一人称")%、全部被%CNAME("二人称")%的心……填满了」
PRINTFORMW 「%CNAME("二人称")%が%CNAME("二人称")%になってくれて、よかった……」	PRINTFORMW 「%CNAME("二人称")%能成为%CNAME("二人称")%真是太好了……」
PRINTFORMW 「ありがとう……だいすきだよ、%CNAME("二人称","かな")%……」	PRINTFORMW 「谢谢你……最喜欢了、%CNAME("二人称","かな")%……」
PRINTFORMW 涙混じりにそう囁くと、%CALLNAME%は\@ !TALENT:MASTER:小柄 && !TALENT:長身 ? 顔を上げて # 顔を寄せて \@、熱く優しい口付けを%CALLNAME:MASTER%の頬に贈った……	PRINTFORMW 混杂着泪水的细语中、%CALLNAME%\@ !TALENT:MASTER:娇小 && !TALENT:高大 ? 抬起头 # 靠过来 \@、将热情又温柔的吻送到%CALLNAME:MASTER%的脸颊……
PRINTFORMW 「%CNAME("一人称")%で……いいんだよね」	PRINTFORMW 「%CNAME("一人称")%……可以来吗」
PRINTFORMW 穏やかな微笑みを浮かべ、%CALLNAME%はしっとりと呟いた	PRINTFORMW %CALLNAME%脸上浮现出温和的微笑、轻声说道。
PRINTFORMW 「……いっしょにいっぱいどきどきしようね……%CNAME("二人称")%」	PRINTFORMW 「……让我们的心一起跳动吧……%CNAME("二人称")%」
PRINTFORMW %CALLNAME%は、自分の心を覗き込むように両手を胸に重ねている……	PRINTFORMW %CALLNAME%像是要窥探内心一样、两手重叠在胸前……
PRINTFORMW 「今日の%CNAME("二人称")%の心はね……」	PRINTFORMW 「今天%CNAME("二人称")%的心……」
PRINTFORMW 「……ふふ……ちょっと%TEXTR("えっちな気分/甘えたい/やさしくされたい")%……かな？」	PRINTFORMW 「……呼呼……稍微%TEXTR("想征服别人/想撒娇/想被温柔对待")%……是吧？」
PRINTFORM 「%CEVENTS("立場")%と	PRINTFORM 「%CEVENTS("立場")%与
PRINT 娘	PRINT 女儿
PRINT 妹	PRINT 妹妹
PRINTFORMW なら、こういうのもいいよね……？」	PRINTFORMW 的话、这样也不错吧……？」
PRINTFORMW %CALLNAME%は%CALLNAME:MASTER%の脚の間に座ると、ひとしきり甘えてきた……	PRINTFORMW %CALLNAME%坐在%CALLNAME:MASTER%的腿上撒娇了一会……
PRINTFORMW %CALLNAME:MASTER%の手を取ると、%CALLNAME%はわずかな躊躇いの後に自分の胸へと導いた	PRINTFORMW 握起%CALLNAME:MASTER%的手、%CALLNAME%稍稍踌躇之后引到了自己的胸口。
PRINTFORMW 「%CNAME("二人称")%……ここ、触ってみて……」	PRINTFORMW 「%CNAME("二人称")%……摸摸这里……」
PRINTFORMW 「……%TEXTR("どきどき/どっくんどっくん")%してる……でしょ？　%CNAME("二人称")%……」	PRINTFORMW 「……有%TEXTR("心跳/咚咚一声")%……对吧？　%CNAME("二人称")%……」
PRINTFORMW %CALLNAME%は、挑むように%CALLNAME:MASTER%を\@ !TALENT:MASTER:小柄 && !TALENT:長身 ? 見上げ # 見つめ \@ている……	PRINTFORMW %CALLNAME%像在挑战似的\@ !TALENT:MASTER:娇小 && !TALENT:高大 ? 仰视 # 凝视 \@着%CALLNAME:MASTER%……
PRINTFORMW 「……%CNAME("二人称")%の手って、おっきいね……」	PRINTFORMW 「……%CNAME("二人称")%的手好大……」
PRINTFORMW %CALLNAME%は、揉みほぐすように%CALLNAME:MASTER%の手の感触を確かめている……	PRINTFORMW %CALLNAME%不停地揉着、确认%CALLNAME:MASTER%的手的触感……
PRINTFORMW 「ね、%CNAME("二人称")%……%CNAME("一人称")%がんばるから、頭なでて……？」	PRINTFORMW 「呐、%CNAME("二人称")%……%CNAME("一人称")%会加油的、摸头……？」
PRINTFORMW %CALLNAME%はしばらくの間、%CALLNAME:MASTER%に甘え続けた……	PRINTFORMW %CALLNAME%在一段时间内、都在向%CALLNAME:MASTER%撒娇……
PRINTFORMW %CALLNAME%は、出逢った頃なら想像もできないほどの甘え振りを見せている……	PRINTFORMW %CALLNAME%露出了曾经相遇时所不能想象的撒娇模样……
PRINTFORMW 「%CNAME("二人称")%……%TEXTR("？/あれ、するの……？")%」	PRINTFORMW 「%CNAME("二人称")%……%TEXTR("？/在、干什么……？")%」
PRINTFORMW %CALLNAME%は、静かに%CALLNAME:MASTER%を見つめている……	PRINTFORMW %CALLNAME%静静地看向%CALLNAME:MASTER%……
PRINTFORMW 「%CNAME("二人称")%……教えて？」	PRINTFORMW 「%CNAME("二人称")%……告诉我吧？」
PRINTFORMW 「%CNAME("一人称")%に、ヒトのふれあい……」	PRINTFORMW 「%CNAME("一人称")%人与人的接触……」
PRINTFORMW %CALLNAME%は、そっと%CALLNAME:MASTER%の%TEXTR("頬に触れてきた/胸に手を置いた/手を撫でてきた")%……	PRINTFORMW %CALLNAME%轻轻地%TEXTR("触摸%CALLNAME:MASTER%的脸颊/把手放在%CALLNAME:MASTER%胸前/抚摸着%CALLNAME:MASTER%的手")%……
PRINTFORMW 「……%CNAME("二人称")%の腕……%CNAME("二人称")%の肩……%CNAME("二人称")%の……顔……」	PRINTFORMW 「……%CNAME("二人称")%的手臂……%CNAME("二人称")%的肩膀……%CNAME("二人称")%的……脸……」
PRINTFORMW %CALLNAME%は、%CALLNAME:MASTER%の身体を確かめるように触ってくる……	PRINTFORMW %CALLNAME%像是要确认%CALLNAME:MASTER%的身体似的摸了过来……
PRINTFORMW 「%CNAME("二人称")%……今度は、なにをするの……？」	PRINTFORMW 「%CNAME("二人称")%……这次、要做什么呢……？」
PRINTFORMW %CALLNAME%の目には、ほのかな好奇心の光が灯っている……	PRINTFORMW %CALLNAME%的眼中、隐约散发着好奇的光芒……
PRINTFORMW 「ね……はやくヒトのこと教えて、%CNAME("二人称")%……」	PRINTFORMW 「呐……快教我人类的事情、%CNAME("二人称")%……」
PRINTFORMW %CALLNAME%は、%CALLNAME:MASTER%との営みを期待していたようだ……	PRINTFORMW %CALLNAME%很期待与%CALLNAME:MASTER%的事情……
PRINTFORMW 「今日は、%CNAME("一人称")%に……なにをしてほしい？」	PRINTFORMW 「今天、%CNAME("一人称")%想要做什么呢？」
PRINTFORMW 「%CNAME("一人称")%に……どうなってほしい……？」	PRINTFORMW 「希望%CNAME("一人称")%……变成什么样子……？」
PRINTFORMW %CALLNAME%の姿勢がわずかに前のめりになっている……気がする	PRINTFORMW 感觉%CALLNAME%的姿势越来越往前倾。
PRINTFORMW 「%CNAME("二人称","かな")%……なにもしてくれないの……？」	PRINTFORMW 「%CNAME("二人称","かな")%……什么也不做吗……？」
PRINTFORMW %CALLNAME%は寂しそうに肩を落としていた……	PRINTFORMW %CALLNAME%寂寞地垂下肩膀……
PRINTFORMW %CALLNAME%は小首をかしげていた……	PRINTFORMW %CALLNAME%歪着小脑袋……
PRINTFORMW 「ふふ……こころも、からだも……%CNAME("二人称","かな")%にもらってもらっちゃった……」	PRINTFORMW 「呼呼……心也好、身体也好……%CNAME("二人称","かな")%都收下了……」
PRINTFORMW 「人形としてだけじゃなくて……女の子としても、%CNAME("二人称","かな")%のものなんだね……」	PRINTFORMW 「不只是作为人偶……作为女孩子、也是%CNAME("二人称","かな")%的东西……」
PRINTFORMW 「だめ……！　%CNAME("一人称","かな")%、しあわせすぎちゃう……！」	PRINTFORMW 「不行……！　%CNAME("一人称","かな")%、太幸福了……！」
PRINTFORMW 弾む%CALLNAME%の声を聞きながら、%CALLNAME:MASTER%は眠りへ落ちていった……	PRINTFORMW 听着%CALLNAME%的声音、%CALLNAME:MASTER%也慢慢睡去……
PRINTFORMW 「はぁぅ……%CNAME("一人称","かな")%……しあわせすぎちゃう……」	PRINTFORMW 「啊呜……%CNAME("一人称","かな")%……太幸福了……」
PRINTFORMW 夢見心地で呟いて、%CALLNAME%はゆっくりと目を閉じた……	PRINTFORMW 如同梦呓般、%CALLNAME%慢慢闭上了眼睛……
PRINTFORMW 女性器から破瓜の血を垂らしながら、%CALLNAME%は両手で顔を覆って悶えていた……	PRINTFORMW 从下方滴落处女血的时候、%CALLNAME%双手捂住脸……
PRINTFORMW 「はぁっ……しあわせぇ……%CNAME("二人称","かな")%も、しあわせだった……？」	PRINTFORMW 「哈……幸福……%CNAME("二人称","かな")%、也很幸福……？」
PRINTFORMW %CALLNAME%が幸せになってくれたなら自分も幸せだ……と告げると、%CALLNAME%はぱちりと目を開いた	PRINTFORMW 如果%CALLNAME:MASTER%幸福的话、自己也会幸福、%CALLNAME%迅速睁开了眼睛。
PRINTFORMW 「しあわせになってくれたら、しあわせ……そう、なんだ……」	PRINTFORMW 「如果变得幸福的话、幸福……没错、为什么……」
PRINTFORM 「……%CNAME("一人称","かな")%、がんばる……%CNAME("二人称","かな")%に、もっとしあわせって思ってもらえるように……	PRINTFORM 「……%CNAME("一人称","かな")%、加油……为了能让大家觉得%CNAME("二人称","かな")%更幸福……
PRINTFORMW 意識を失う直前に見た%CALLNAME%の顔は、今までに見たことがないほどやる気に溢れていた……	PRINTFORMW 在失去意识之前看到的%CALLNAME%的脸、充满了至今为止从未见过的干劲……
PRINTFORMW 心に刻むように呟いて、%CALLNAME%はゆっくり目を閉じた……	PRINTFORMW 将话语刻在心里、%CALLNAME%慢慢闭上了眼睛……
PRINTFORMW ぐっと両手を握りしめる%CALLNAME%は、今までに見たことのないほどのやる気を溢れさせていた……	PRINTFORMW 紧握双手的%CALLNAME%充满了从未见过的干劲……
PRINTFORMW %CALLNAME%は、受動的な姿勢を改めたようだ……	PRINTFORMW %CALLNAME%似乎改变了一些东西……
PRINTFORMW %CALLNAME%は[愚か]を失いました	PRINTFORMW %CALLNAME%失去了[笨蛋]
PRINTFORMW 「無理してもらって、ごめんね……%CNAME("二人称")%」	PRINTFORMW 「让你勉强了、对不起……%CNAME("二人称")%」
PRINTFORMW 「%CNAME("一人称")%が見ててあげるから、ゆっくりやすんでね……」	PRINTFORMW 「%CNAME("一人称")%会照顾你的、所以要好好休息哦……」
PRINTFORMW 頭を撫でる%CALLNAME%の手の温かさを感じながら、%CALLNAME:MASTER%の意識はだんだん沈んでいく……	PRINTFORMW 额头感觉到%CALLNAME%手心温度的同时、%CALLNAME:MASTER%的意识渐渐沉没……
PRINTFORMW 「……ありがとう、%CNAME("二人称")%……」	PRINTFORMW 「……谢谢、%CNAME("二人称")%……」
PRINTFORMW 「%CNAME("二人称")%ががんばってくれて、%CNAME("一人称","かな")%うれしい……」	PRINTFORMW 「%CNAME("二人称")%为我加油、%CNAME("一人称","かな")%很高兴……」
PRINTFORMW 柔らかく抱きしめてくる%CALLNAME%の感触に埋もれるように、%CALLNAME:MASTER%は眠りへ落ちていった……	PRINTFORMW 感觉就像被%CALLNAME%温柔拥抱着、%CALLNAME:MASTER%陷入了睡眠中……
PRINTFORMW 「ね、%CNAME("二人称","かな")%は満足してくれた……？」	PRINTFORMW 「呐、%CNAME("二人称","かな")%满足了吗……？」
PRINTFORMW 「いっぱい%TEXTR("しあわせに/きもちよく")%なってくれたなら、うれしいな……」	PRINTFORMW 「如果能%TEXTR("幸福/舒服")%的话、会很开心……」
PRINTFORMW %CALLNAME%の弾んだ声とは裏腹に、%CALLNAME:MASTER%の意識は急速に闇へと飲み込まれていく……	PRINTFORMW 与%CALLNAME%兴奋的声音相反、%CALLNAME:MASTER%的意识迅速被黑暗吞噬……
PRINTFORMW 「……あっ！？　%CNAME("二人称","かな")%、大丈夫……！？」	PRINTFORMW 「……啊！？　%CNAME("二人称","かな")%、不要紧吗……！？」
PRINTFORMW 「ねえ%CNAME("二人称","かな")%、しっかりして、%CNAME("二人称","かな")%っ！？」	PRINTFORMW 「呐%CNAME("二人称","かな")%、振作些、%CNAME("二人称","かな")%！？」
PRINTFORMW 慌てふためいた%CALLNAME%の声を最後に、%CALLNAME:MASTER%の意識は途切れた……	PRINTFORMW 在惊慌的%CALLNAME%的声音中、%CALLNAME:MASTER%的意识中断了……
PRINTFORMW 気を失う前に見た最後の光景は、不思議そうに小首をかしげる%CALLNAME%の顔だった……	PRINTFORMW 在失去意识之前看到的最后的情景是、不可思议地歪着小脑袋的%CALLNAME%的脸……
PRINTFORMW 「ふふ……こころもからだも、いっぱいにしてもらっちゃった……」	PRINTFORMW 「呼呼……内心和身体都满满的……」
PRINTFORMW 「%CNAME("一人称","かな")%しあわせだよ……%CNAME("二人称","かな","甘え")%……」	PRINTFORMW 「%CNAME("一人称","かな")%很幸福……%CNAME("二人称","かな","甘え")%……」
PRINTFORMW ぐったりと身体を沈めた%CALLNAME%は、満足そうに微笑んでいた……	PRINTFORMW 精疲力尽的%CALLNAME%露出了满足的微笑……
PRINTFORMW 「……ごめんね、%CNAME("二人称","かな")%……」	PRINTFORMW 「……对不起、%CNAME("二人称","かな")%……」
PRINTFORMW 「もっと……いろいろしてあげたかったのに……」	PRINTFORMW 「更多……本来想为你做更多的……」
PRINTFORMW 脱力した肢体を投げ出した%CALLNAME%は、ゆっくり目を閉じて微睡みへ沈んでいく……	PRINTFORMW 肢体无力的%CALLNAME%慢慢地闭上眼睛沉入微睡中……
PRINTFORMW 「まだ……まだ、だいじょうぶ……だから……」	PRINTFORMW 「还……还没关系……所以……」
PRINTFORMW 「やめないで……%CNAME("二人称","かな","甘え")%……！」	PRINTFORMW 「不用停止……%CNAME("二人称","かな","甘え")%……！」
PRINTFORMW 限界を超えた身体を起こそうとする%CALLNAME%を、%CALLNAME:MASTER%は優しく寝かしつけた……	PRINTFORMW 看着想要超越身体极限的%CALLNAME%、%CALLNAME:MASTER%温柔地陪她入睡……
PRINTFORMW 「……%CNAME("二人称","かな")%は、きもちよくなって……くれたかな……？」	PRINTFORMW 「……我有让……%CNAME("二人称","かな")%舒服吗……？」
PRINTFORMW 「%CNAME("一人称","かな")%のこと……もっとすきに……なって、くれたかな……」	PRINTFORMW 「%CNAME("一人称","かな")%的……更加喜欢……你……」
PRINTFORMW うわごとのように呟く%CALLNAME%の頭を撫でてやると、%CALLNAME%は瞬く間に眠りへ落ちていった……	PRINTFORMW 当抚摸着像胡言乱语般嘟哝着的%CALLNAME%的头时、%CALLNAME%瞬间坠入了睡梦中……
PRINTFORMW 疲れ切った%CALLNAME%は、投げ捨てられた操り人形のようにねじれた肢体で横たわっている……	PRINTFORMW 疲惫不堪的%CALLNAME%像被扔掉的人偶一样、弯曲着肢体躺着……
PRINTFORMW 「%TEXTR("すごい/ふあぁ/わ")%……%CNAME("一人称","かな")%のなかに、%CNAME("二人称","かな")%のが……」	PRINTFORMW 「%TEXTR("好厉害/呐/啊呜")%……%CNAME("一人称","かな")%的里面、都是%CNAME("二人称","かな")%的那个……」
PRINTFORM %CALLNAME%は、股間から掬った精液を	PRINTFORM %CALLNAME%的股间涌出精液
PRINTFORM %TEXTR("ぐちゅぐちゅ/ぐちゃぐちゃ")%	PRINTFORM %TEXTR("到处都是/乱七八糟的")%
PRINTFORM %TEXTR("にちゃにちゃ/にちにち/くちくち/ちゅくちゅく")%	PRINTFORM %TEXTR("黏糊糊的/粘粘的/粘糊糊的/稠稠的")%
PRINTFORMW と弄びながら感歎の声を漏らしていた…	PRINTFORMW 一边玩弄一边发出感叹的声音…
PRINTFORMW 行為が終わった後も、%CALLNAME%は余韻を味わうように\@ ( TALENT:巨乳 && !TALENT:小尻 ) || ( TALENT:巨尻 && !TALENT:貧乳 ) ? 肉感的な身体 # 身体 \@をすりつけてくる……	PRINTFORMW 结束后、%CALLNAME%\@ ( TALENT:巨乳 && !TALENT:小尻 ) || ( TALENT:巨尻 && !TALENT:貧乳 ) ? 肉感的身体 # 的身体 \@仿佛在品味着余韵一般紧贴着……
PRINTFORMW 「%CNAME("二人称","かな","甘え")%……%TEXTR("しあわせぇ/だいすきぃ/うれしい/すきぃ")%……」	PRINTFORMW 「%CNAME("二人称","かな","甘え")%……%TEXTR("幸福/最喜欢了/高兴/喜欢")%……」
PRINTFORMW 「ふふ……%CNAME("一人称","かな")%は……%CNAME("二人称","かな")%と、%TEXTR("こうなる/いっしょになる/つながる")%ために生まれてきたんだね……」	PRINTFORMW 「呼呼……%CNAME("一人称","かな")%……是为了和%CNAME("二人称","かな")%%TEXTR("在一起/变成这样/连在一起")%而生……」
PRINTFORMW 「%CNAME("二人称","かな")%は、もういいの……？」	PRINTFORMW 「%CNAME("二人称","かな")%、足够了吗……？」
PRINTFORMW 「……%CNAME("二人称","かな")%も、%CNAME("一人称","かな")%と同じくらい%TEXTR("しあわせに/きもちよく/うれしく/心がいっぱいに")%なってくれてたら、うれしいなぁ……」	PRINTFORMW 「……%CNAME("二人称","かな")%、也和%CNAME("一人称","かな")%一样%TEXTR("幸福/舒服/高兴/被填满心")%、开心……」
PRINTFORMW %CALLNAME:MASTER%の頭を\@ TALENT:巨乳 ? 豊満な胸 # 胸 \@に抱き寄せて、%CALLNAME%は優しい鼓動を伝えてくる……	PRINTFORMW 将%CALLNAME:MASTER%的头抱在\@ TALENT:巨乳 ? 豊満的胸 # 胸 \@前、%CALLNAME%温柔的心跳传了出来……
PRINTFORMW 「ね、どうだった……？　%CNAME("二人称","かな")%も、よかった……？」	PRINTFORMW 「呐、怎么样……？　%CNAME("二人称","かな")%、舒服吗……？」
PRINTFORMW 「%CNAME("一人称","かな")%、もっともっときもちよくできるようになるから……！」	PRINTFORMW 「%CNAME("一人称","かな")%、会变得更舒服的……！」
PRINTFORMW %CALLNAME%は、早くも次回へ向けてやる気に満ちていた……	PRINTFORMW %CALLNAME%提前充满了下次的干劲……
PRINTFORMW 「%TEXTR("はぁっ/んんぅ/くぅん")%……%TEXTR("しあわせぇ/すごかったぁ/うれしい")%……」	PRINTFORMW 「%TEXTR("呼呼/嗯/唔")%……%TEXTR("好幸福/好厉害/好开心")%……」
PRINTFORMW 「ふふ……ね、%CNAME("二人称","かな")%……つぎは、いつするの？」	PRINTFORMW 「呼呼……呐、%CNAME("二人称","かな")%……什么时候继续做呢？」
PRINTFORMW %CALLNAME%は、多幸感をこらえきれないように笑い声を漏らしながら催促してきた……	PRINTFORMW %CALLNAME%抑制不住幸福感、露出笑容催促着……
PRINTFORMW 「%CNAME("二人称","かな")%、もうつかれちゃった……？」	PRINTFORMW 「%CNAME("二人称","かな")%、已经累了吗……？」
PRINTFORMW 「……いいよ、また何度でもできるもんね？」	PRINTFORMW 「……可以哦、不管多少次都可以的吧？」
PRINTFORMW %CALLNAME%は笑顔を浮かべているが、どうやら物足りなかったようだ……	PRINTFORMW %CALLNAME%脸上露出了笑容、但总觉得有些欠缺……
PRINTFORMW 「%TEXTR("ん/ふぅ/んん")%……やめちゃうの……？」	PRINTFORMW 「%TEXTR("嗯/呼/嗯嗯")%……为什么……？」
PRINTFORMW 「%CNAME("一人称","かな")%なら、まだだいじょうぶだよ……？」	PRINTFORMW 「如果是%CNAME("一人称","かな")%的话、不要紧哦……？」
PRINTFORMW %CALLNAME:MASTER%は、切なそうに身体をくねらせる%CALLNAME%をなんとかなだめた……	PRINTFORMW %CALLNAME:MASTER%总算安慰了伤心地扭转身体的%CALLNAME%……
PRINTFORMW %CALLNAME%は、終始訝しげな表情のままだった……	PRINTFORMW %CALLNAME%始终带着怀疑的表情……
PRINTFORMW 終了を告げると、%CALLNAME%はそっと%CALLNAME:MASTER%を呼んだ……	PRINTFORMW 结束后、%CALLNAME%轻轻地叫了%CALLNAME:MASTER%……
PRINTFORMW 「%CNAME("二人称","かな")%……たのしかった……？」	PRINTFORMW 「%CNAME("二人称","かな")%……很开心……？」
PRINTFORMW %CALLNAME%はうっすらと微笑んだ……	PRINTFORMW %CALLNAME%微微地笑了……
PRINTFORMW 「%CNAME("二人称","かな")%……もういいの……？」	PRINTFORMW 「%CNAME("二人称","かな")%……已经足够了吗……？」
PRINTFORMW %CALLNAME%は、物足りなそうに太股をすり合わせた……	PRINTFORMW %CALLNAME%觉得不满意地用大腿摩擦着……
PRINTFORMW 「もっとさわって……%CNAME("二人称","かな","甘え")%」	PRINTFORMW 「再碰一下……%CNAME("二人称","かな","甘え")%」
PRINTFORMW %CALLNAME%は困惑しながら目を逸らした……	PRINTFORMW %CALLNAME%困惑地移开了视线……
PRINTFORMW 「んん……？」	PRINTFORMW 「嗯嗯……？」
PRINTFORMW %CALLNAME%は%CALLNAME:PLAYER%をじっと見つめながら愛撫を受けている……	PRINTFORMW %CALLNAME%一边凝视着%CALLNAME:PLAYER%一边接受着爱抚……
PRINTFORMW 「%CNAME("二人称","かな","甘え")%……%CNAME("一人称","かな")%を、きもちよくして……？」	PRINTFORMW 「%CNAME("二人称","かな","甘え")%……%CNAME("一人称","かな")%、开心吗……？」
PRINTFORMW 「%CNAME("二人称","かな")%……ごめんなさい……%CNAME("二人称","かな","甘え")%……！」	PRINTFORMW 「%CNAME("二人称","かな")%……对不起……%CNAME("二人称","かな","甘え")%……！」
PRINTFORMW 「こんなの、はずかしいのに……どうしたらいいの、%CNAME("二人称","かな","甘え")%……！」	PRINTFORMW 「明明这么害羞……怎么办才好、%CNAME("二人称","かな","甘え")%……！」
PRINTFORMW %CALLNAME%は不思議そうに腰を揺らしている……	PRINTFORMW %CALLNAME%很不可思议地摇着腰……
PRINTFORMW %CALLNAME%は%CALLNAME:PLAYER%を呼びながら身体を震わせた	PRINTFORMW %CALLNAME%一边呼唤着%CALLNAME:PLAYER%一边颤抖着身体。
PRINTFORMW 「んっ……ぅぅ……？」	PRINTFORMW 「嗯……唔……？」
PRINTFORMW 力の抜けていた%CALLNAME%の身体がぴくりと震えた	PRINTFORMW 突然脱力的%CALLNAME%身体颤抖着。
PRINTFORM 「%TEXTR("あっ/ふあぁ/ひうっ/すきぃ")%\@ RAND:2 == 0 ? ！　 # …… \@%CNAME("二人称","かな")%\@ RAND:2 == 0 ? ！　 # …… \@	PRINTFORM 「%TEXTR("啊/呼呼/哇/好喜欢")%\@ RAND:2 == 0 ? ！　 # …… \@%CNAME("二人称","かな")%\@ RAND:2 == 0 ? ！　 # …… \@
PRINTFORMW %TEXTR("もっとぉ/もっとしてぇ/すごいよぅ/すきぃ")%\@ RAND:2 == 0 ? ！　 # …… \@」	PRINTFORMW %TEXTR("更加/用力/好厉害/好喜欢")%\@ RAND:2 == 0 ? ！　 # …… \@」
PRINTFORMW 「%CNAME("二人称","かな")%……そこは……！？」	PRINTFORMW 「%CNAME("二人称","かな")%……那里是……！？」
PRINTFORMW %CALLNAME%は一瞬びくりと身体をすくめる	PRINTFORMW %CALLNAME%一下子缩成一团。
PRINTFORMW だが、ゆっくり深呼吸をすると、身体の力をふわりと抜いた	PRINTFORMW 但是又慢慢深呼吸放松了身体。
PRINTFORMW 「……%CNAME("二人称","かな")%が、してくれること……だもんね……」	PRINTFORMW 「……是%CNAME("二人称","かな")%为我做的事情……所以……」
PRINTFORMW 「んっ……？？」	PRINTFORMW 「嗯……？？」
PRINTFORMW 初めての感覚を受けて、%CALLNAME%は戸惑うように腰を揺らしている……	PRINTFORMW 因为是第一次的原因、%CALLNAME%犹豫不决地摇动着腰……
PRINTFORMW 「あ……くぅ……」	PRINTFORMW 「啊……咕……」
PRINTFORMW 声を漏らしながら、%CALLNAME%はアナルに擦り込まれる感覚を受け入れている……	PRINTFORMW 漏出声音的同时、%CALLNAME%也接受了肛门里摩擦的感觉……
PRINTFORMW 「あ……んん……」	PRINTFORMW 「啊……嗯嗯……」
PRINTFORMW %CALLNAME%は、大人しくアナルに擦り込まれる感覚を受け入れている……	PRINTFORMW %CALLNAME%老实地接受了肛门里摩擦的感觉……
PRINTFORMW 「ん……」	PRINTFORMW 「嗯……」
PRINTFORMW %CALLNAME%は、胸を這う%CALLNAME:PLAYER%の手をじっと見つめている……	PRINTFORMW %CALLNAME%一直看着胸前%CALLNAME:PLAYER%的手……
PRINTFORMW 「%CNAME("二人称","かな","甘え")%……%CNAME("一人称","かな")%、もうがまんできない……！」	PRINTFORMW 「%CNAME("二人称","かな","甘え")%……%CNAME("一人称","かな")%、已经无法忍耐了……！」
PRINTFORMW 「%TEXTR("ちゅ/くちゅ")%……%TEXTR("ん/んん")%……！」	PRINTFORMW 「%TEXTR("啾/啾啾")%……%TEXTR("嗯/嗯嗯")%……！」
PRINTFORMW %CALLNAME%は、まるでキスに飢えていたかのように唇を重ねてくる……	PRINTFORMW %CALLNAME%饥渴地重叠嘴唇……
PRINTFORMW 「……%CNAME("二人称","かな")%……%TEXTR("ちゅ/くちゅ")%……%TEXTR("ん/んん")%……」	PRINTFORMW 「……%CNAME("二人称","かな")%……%TEXTR("啾/啾啾")%……%TEXTR("嗯/嗯嗯")%……」
PRINTFORMW 「……しちゃった……」	PRINTFORMW 「……搞砸了……」
PRINTFORMW %CALLNAME%は照れながら自分の唇を指でなぞっている……	PRINTFORMW %CALLNAME%一边害羞着一边用手指描画着自己的嘴唇……
PRINTFORMW 顔を離した%CALLNAME%は、自分がなにをしたのか理解できずに戸惑っている……	PRINTFORMW 刚刚分开嘴唇的%CALLNAME%不能理解自己做了什么、很困惑……
PRINTFORMW 「あ……%CNAME("二人称","かな","甘え")%……んん……」	PRINTFORMW 「啊……%CNAME("二人称","かな","甘え")%……嗯嗯……」
PRINTFORMW 「……はじめてのキス、%CNAME("二人称","かな")%にあげちゃった……」	PRINTFORMW 「……第一次接吻、献给了%CNAME("二人称","かな")%……」
PRINTFORMW 「ふふ……あれ？　なんか、笑っちゃう……ふふふ……なんでかな……？」	PRINTFORMW 「呼呼……咦？　总觉得、笑出来了……呼呼呼……为什么呢……？」
PRINTFORMW %CALLNAME%はくすぐったそうに笑っている……	PRINTFORMW %CALLNAME%微微地笑着……
PRINTFORMW 「あ……%CNAME("二人称","かな")%……！？　んんっ……！」	PRINTFORMW 「啊……%CNAME("二人称","かな")%……！？　嗯哼……！」
PRINTFORMW 「……はじめてのキス……だったんだからね……？」	PRINTFORMW 「……第一次接吻……所以……？」
PRINTFORMW %CALLNAME%は、拗ねたような顔で目を逸らした……	PRINTFORMW %CALLNAME%一脸闹别扭地移开了视线……
PRINTFORMW %CALLNAME%は目を開いたまま、ファーストキスを受け入れた……	PRINTFORMW %CALLNAME%睁着眼睛送出了初吻……
PRINTFORMW 「%CNAME("二人称","かな","甘え")%……%TEXTR("大好き/好き")%……んっ……」	PRINTFORMW 「%CNAME("二人称","かな","甘え")%……%TEXTR("最喜欢/喜欢")%……嗯……」
PRINTFORMW %CALLNAME%は、安心しきった顔で身体の力を抜いた……	PRINTFORMW %CALLNAME%一脸安心地放松了身体……
PRINTFORMW 「……今日も、いっぱい%TEXTR("しあわせにして/きもちよくして/しあわせを教えて")%ね……」	PRINTFORMW 「……今天也请、努力的%TEXTR("幸福/舒服/教我怎么幸福")%呢……」
PRINTFORMW 「……%CNAME("二人称","かな")%……んっ……」	PRINTFORMW 「……%CNAME("二人称","かな")%……嗯哼……」
PRINTFORMW %CALLNAME%の顔が、耳まで紅く染まっていく……	PRINTFORMW %CALLNAME%的脸、连耳朵都染红了……
PRINTFORM %TEXTR("ちゅっ/くちゅっ/ちゅぱ/ちゅぷ")%……%TEXTR("ちゅっ/くちゅっ/ちゅぱ/ちゅぷ")%……	PRINTFORM %TEXTR("啾/啾啵/啾啾/啾卜")%……%TEXTR("啾/啾啵/啾啾/啾卜")%……
PRINTFORMW %TEXTR("もっとぉ/しゅきぃ/はぁっ/きもちいい")%……」	PRINTFORMW %TEXTR("更多/继续/舒服/开心")%……」
PRINTFORMW %CALLNAME%は、ぼんやりと%CALLNAME:PLAYER%を見つめながらキスを受け入れている……	PRINTFORMW %CALLNAME%呆呆地和%CALLNAME:PLAYER%接吻……
PRINTFORMW 「%TEXTR("あっ/ふあ/ん")%……%CNAME("二人称","かな")%……」	PRINTFORMW 「%TEXTR("啊/唔/嗯")%……%CNAME("二人称","かな")%……」
PRINTFORMW %CALLNAME%は、\@ TALENT:恋慕 ? ゆったりと力を抜いて # ぴくりと震えて \@%CALLNAME:PLAYER%の手を受け入れた……	PRINTFORMW %CALLNAME%\@ TALENT:恋慕 ? 慢慢放松着身体 # 颤抖着 \接受@%CALLNAME:PLAYER%的爱抚……\@
PRINTFORMW %CALLNAME%はむずかるように腰をよじった……	PRINTFORMW %CALLNAME%扭了扭腰……
PRINTFORMW 「%CNAME("二人称","かな")%っ……%CNAME("一人称","かな")%、もうがまんできない……！」	PRINTFORMW 「%CNAME("二人称","かな")%っ……%CNAME("一人称","かな")%、已经无法忍耐了……！」
PRINTFORMW 「あっ……んんっ……あぅっ！」	PRINTFORMW 「啊……嗯……啊！」
PRINTFORMW 「いれちゃった……%CNAME("二人称","かな")%に、はじめてをあげちゃった……」	PRINTFORMW 「不……%CNAME("二人称","かな")%、我的第一次献给你了……」
PRINTFORMW 「おこらないで……ちゃんと、%CNAME("二人称","かな")%のものにしてほしかったのっ……！」	PRINTFORMW 「不要生气……想要、好好的变成%CNAME("二人称","かな")%的东西……！」
PRINTFORMW %CALLNAME%は、涙を溢れさせながらしがみついてきた……	PRINTFORMW %CALLNAME%一边流泪一边紧紧抱住%CALLNAME:PLAYER%……
PRINTFORMW 「い、いいよ……きて……%CNAME("二人称","かな")%」	PRINTFORMW 「可、可以哦……来吧……%CNAME("二人称","かな")%」
PRINTFORMW 「あっ……！　んく……はぁっ……ぜんぶ……はいった、ね……」	PRINTFORMW 「啊……！　嗯哼……哈……全部……进、来吧……」
PRINTFORMW 「うん、だいじょうぶ……思っていたより、ぜんぜんいたくないよ……」	PRINTFORMW 「嗯、没关系……一点也不像想的那样疼……」
PRINTFORMW 「%CNAME("二人称","かな")%がしてくれているから……かな？」	PRINTFORMW 「因为是%CNAME("二人称","かな")%……是吧？」
PRINTFORMW %CALLNAME:PLAYER%を受け止めている%CALLNAME%の背中が、ふるりと震えた……	PRINTFORMW %CALLNAME:PLAYER%按着%CALLNAME%在颤抖的背部……
PRINTFORMW %CALLNAME%は、上気しきった顔で微笑んでくる……	PRINTFORMW %CALLNAME%高涨着脸露出微笑……
PRINTFORMW 「ちょっと、きついけど……思ったよりは、へいき……」	PRINTFORMW 「稍微、有点紧……比想象中还要好……」
PRINTFORMW 「でも……なんか、ぴちぴちするぅ……」	PRINTFORMW 「但是……总觉得、有点紧张……」
PRINTFORMW %CALLNAME%が違和感に身体を竦めると、摩擦のきつい膣がみちりと締め付けてきた……	PRINTFORMW %CALLNAME%感到不舒服、身体缩成一团、阴道被用力地勒紧了……
PRINTFORMW 「ん……%CNAME("二人称","かな")%……？」	PRINTFORMW 「嗯……%CNAME("二人称","かな")%……？」
PRINTFORMW 「あっ……はぅっ……！？」	PRINTFORMW 「啊……啊……！？」
PRINTFORMW 「なに、これ……%CNAME("二人称","かな")%……？」	PRINTFORMW 「这个、是什么……%CNAME("二人称","かな")%……？」
PRINTFORMW 訝しげに問いかける%CALLNAME%は、何の抵抗も見せずに%CALLNAME:PLAYER%を受け入れている……	PRINTFORMW 惊讶地询问的%CALLNAME%、没有任何抵抗就接受了%CALLNAME:PLAYER%的插入……
PRINTFORMW 「ぐっ……あ゛ぅっ……！？」	PRINTFORMW 「呼……啊……！？」
PRINTFORMW 「%CNAME("二人称","かな")%っ……なんか、ぎちぎちして……はぐっ！」	PRINTFORMW 「%CNAME("二人称","かな")%……总觉得、有点难受……唔！」
PRINTFORMW 濡れていない処女膣に突き込まれた%CALLNAME%は、肺の空気を押し出されるような声を上げている……	PRINTFORMW 强行插入%CALLNAME%未湿润的穴内、发出了类似压到肺部而发出的声音……
PRINTFORMW 「%CNAME("二人称","かな")%に、%CNAME("一人称","かな")%のはじめてをあげたかったな……」	PRINTFORMW 「%CNAME("一人称","かな")%的、第一次想献给%CNAME("二人称","かな")%……」
PRINTFORMW 「……でも、はじめてのつもりでがんばるから……きて？」	PRINTFORMW 「……但是……？」
PRINTFORMW 「ん……ふあ……！　%CNAME("二人称","かな")%と……つながった、ね……？」	PRINTFORMW 「嗯……哼……！　和%CNAME("二人称","かな")%……做了、是吧……？」
PRINTFORMW %CALLNAME:PLAYER%を初めて受け入れた%CALLNAME%は、涙を浮かべて微笑んでいた……	PRINTFORMW 第一次和%CALLNAME:PLAYER%交合的%CALLNAME%、含泪微笑着……
PRINTFORM 既に処女を散らされた膣は、	PRINTFORM 已经失去了处女的阴道、
PRINTFORM 濡れに乏しいながらも	PRINTFORM 尽管缺乏湿润
PRINTFORMW しっかりと%CALLNAME:PLAYER%を受け入れている……	PRINTFORMW 还是好好地接受了%CALLNAME:PLAYER%的插入……
PRINTFORMW 「%TEXTR("んん/んく/あぅ/くぅ")%っ……！　%CNAME("二人称","かな")%の、おっきい……！」	PRINTFORMW 「%TEXTR("嗯/嗯库/呜/库")%っ……！　%CNAME("二人称","かな")%的、好大……！」
PRINTFORMW 「でも、%CNAME("一人称","かな")%……ちゃんとぴったりになるから……いっぱい%TEXTR("、して/にして/、ちょうだい/、きて")%……！」	PRINTFORMW 「但是、%CNAME("一人称","かな")%……就是为此而生的……%TEXTR("继续做吧/不用停下/让我感受更多/填满我吧")%……！」
PRINTFORMW 「%TEXTR("あ/ふあ/んん")%\@ RAND:2 == 0 ? っ！　 # …… \@%TEXTR("はう/あう/くぅん/くぅ")%\@ RAND:2 == 0 ? っ……！ # …… \@」	PRINTFORMW 「%TEXTR("啊/呀/嗯")%\@ RAND:2 == 0 ? ！　 # …… \@%TEXTR("哈/啊/库姆/库")%\@ RAND:2 == 0 ? っ……！ # …… \@」
PRINTFORMW 「ふふ……はいっちゃった」	PRINTFORMW 「呼呼……糟糕」
PRINTFORMW 「ね、%CNAME("二人称","かな")%……今日は動きたい？　動いてほしい……？」	PRINTFORMW 「呐、%CNAME("二人称","かな")%……今天想自己动吗？　还是想让我动……？」
PRINTFORMW 「ふふ……な、なんだか……顔がちかくて、%TEXTR("照れちゃう/どきどきしちゃう/はずかしい/緊張しちゃう")%……ね？」	PRINTFORMW 「呼呼……总、总觉得……脸上很热、%TEXTR("害羞/心跳不已/难为情/好紧张")%……是吗？」
PRINTFORMW 「%CNAME("二人称","かな","甘え")%……いっしょに、%TEXTR("きもちよくなろう/うれしくなっちゃおう/もっとどきどきしよう")%ね……」	PRINTFORMW 「%CNAME("二人称","かな","甘え")%……一起、%TEXTR("变得舒服/变得高兴/心跳加速")%吧……」
PRINTFORMW 「%CNAME("二人称","かな")%から……ま、まるみえ……だよ……」	PRINTFORMW 「%CNAME("二人称","かな")%从……这、这里……这样……」
PRINTFORMW 「は、はずかしいよ、%CNAME("二人称","かな","甘え")%……！」	PRINTFORMW 「好、好羞耻、%CNAME("二人称","かな","甘え")%……！」
PRINTFORM 「%TEXTR("あ/ふあ/んん/くぅん")%\@ RAND:2 == 0 ? っ！　 # …… \@%CNAME("二人称","かな","どもり")%の	PRINTFORM 「%TEXTR("啊/呀/嗯/库姆")%\@ RAND:2 == 0 ? ！　 # …… \@%CNAME("二人称","かな","どもり")%の
PRINTFORMW がはいって……！」	PRINTFORMW 那个……！」
PRINTFORMW %TEXTR("でいっぱい/が奥まで/がはいって")%っ……！」	PRINTFORMW %TEXTR("填满了/好深/那个")%……！」
PRINTFORMW 「%TEXTR("ん/んっ/あ/あっ/ふあ")%……%CNAME("二人称","かな","甘え")%……」	PRINTFORMW 「%TEXTR("嗯/嗯呐/啊/啊嗯/呀")%……%CNAME("二人称","かな","甘え")%……」
PRINTFORMW 「%CNAME("二人称","かな")%の……%TEXTR("うれしい/きもちいい/すごいね")%……」	PRINTFORMW 「%CNAME("二人称","かな")%……%TEXTR("很高兴/很舒服/好厉害")%……」
PRINTFORMW 「%CNAME("二人称","かな")%……はずかしい……%TEXTR("あっ/んっ/くぅ")%……」	PRINTFORMW 「%CNAME("二人称","かな")%……不好意思……%TEXTR("啊/嗯哼/库")%……」
PRINTFORMW 「%CNAME("二人称","かな")%のが……%TEXTR("あっ/んっ/くぅ")%……」	PRINTFORMW 「%CNAME("二人称","かな")%的那个……%TEXTR("啊/嗯哼/库")%……」
PRINTFORMW 「%TEXTR("はっ/あっ/んっ")%……%TEXTR("あっ/んっ/くぅ")%…\@ RAND:2 == 0 ? … # …？ \@」	PRINTFORMW 「%TEXTR("哈/啊/嗯")%……%TEXTR("啊/嗯哼/库")%…\@ RAND:2 == 0 ? … # …？ \@」
PRINTFORMW 一突きごとに、%CALLNAME%の肺から空気が押し出されている……	PRINTFORMW 每次突进、就会发出从%CALLNAME%肺部挤出的声音……
PRINTFORM %TEXTR("だめぇっ/すきぃっ/これすきぃっ/えっちぃっ/うそっ")%\@ RAND:2 == 0 ? ！　 # …… \@	PRINTFORM %TEXTR("舒服/喜欢/喜欢这个/呀/不行了")%\@ RAND:2 == 0 ? ！　 # …… \@
PRINTFORM %TEXTR("こんこんしてるぅ/奥だめぇ/すごいよぅ/おかしくなっちゃう/ヘンになっちゃう/おまんここわれちゃう/こわれちゃう/それだめぇ")%	PRINTFORM %TEXTR("咕噜咕噜地混在一起/好深/好厉害/要变得奇怪了/要奇怪了/要被弄坏了/要坏掉了/要不行了")%
PRINTFORM %TEXTR("そこ/そこは/それだめぇ")%	PRINTFORM %TEXTR("那个位置/那里是/不行了")%
PRINTFORM %TEXTR("くぅん/すきぃ/きもちいい/かんじちゃう/いっちゃう")%	PRINTFORM %TEXTR("嗯嗯/喜欢/好舒服/感觉要/去了")%
PRINTFORM 「%TEXTR("あっ/んっ/ふあ")%\@ RAND:2 ? ！　 # …… \@%TEXTR("やっ/んくっ/んっ/くぅ/あっ")%	PRINTFORM 「%TEXTR("啊/嗯/呀")%\@ RAND:2 ? ！　 # …… \@%TEXTR("呀/嗯库/嗯哼/库/啊")%
PRINTFORM \@ RAND:2 ? ！　 # …… \@%CNAME("二人称","かな","甘え")%っ	PRINTFORM \@ RAND:2 ? ！　 # …… \@%CNAME("二人称","かな","甘え")%
PRINTFORM \@ RAND:2 ? ！ # ……！ \@　%TEXTR("あ/あう/ああ/くぅん/これヘン")%	PRINTFORM \@ RAND:2 ? ！ # ……！ \@　%TEXTR("啊/啊嗯/啊姆/库姆/好奇怪")%
PRINTFORMW 「ふふ……なんだか、%CNAME("二人称","かな")%に守ってもらってるみたい……」	PRINTFORMW 「呼呼……总觉得、好像被%CNAME("二人称","かな")%守护着……」
PRINTFORMW 「あっ、はう……%CNAME("二人称","かな")%のが、はいってっ……！」	PRINTFORMW 「啊……哈……%CNAME("二人称","かな")%的……！」
PRINTFORMW 「あ……はう……%CNAME("二人称","かな")%のが、はいって……！」	PRINTFORMW 「啊……哈……%CNAME("二人称","かな")%的……！」
PRINTFORMW 「やぁっ……%CNAME("二人称","かな","甘え")%、見ないで……きっと、ヘンな顔になってるから……！」	PRINTFORMW 「呀……%CNAME("二人称","かな","甘え")%、不要看……一定、变成了奇怪的表情……！」
PRINTFORMW 「あ……んんっ……」	PRINTFORMW 「啊……嗯……」
PRINTFORMW %CALLNAME%は、目をつむって%CALLNAME:PLAYER%を受け入れている……	PRINTFORMW %CALLNAME%闭上眼被%CALLNAME:PLAYER%插入……
PRINTFORMW 「%TEXTR("あ/あっ/ん/んっ/ふあ")%、%TEXTR("ん/んん/んく/んくっ/あ/あっ")%……%CNAME("二人称","かな")%……ちょっと、いい……？」	PRINTFORMW 「%TEXTR("啊/啊姆/嗯/嗯姆/呀")%、%TEXTR("嗯/嗯嗯/嗯木/嗯库/啊/啊姆")%……%CNAME("二人称","かな")%……稍微、等一下……？」
PRINTFORMW %CALLNAME:PLAYER%をやんわりと制止すると、%CALLNAME%は%TEXTR("そっと抱きしめてきた/そっと頬に口付けしてきた/そっと胸に手を当ててきた")%……	PRINTFORMW 轻声制止%CALLNAME:PLAYER%后、%CALLNAME%は%TEXTR("悄悄抱上来/悄悄亲了一下脸/悄悄用手抚摸着胸")%……
PRINTFORMW 「えへへ……もういいよ、%CNAME("二人称","かな")%……いっぱい、きて……？」	PRINTFORMW 「唉嘿嘿……可以了、%CNAME("二人称","かな")%……继续、填满吧……？」
PRINTFORMW 「%CNAME("二人称","かな","甘え")%……見えなくて、ちょっとこわいよ……」	PRINTFORMW 「%CNAME("二人称","かな","甘え")%……看不见、有点害怕……」
PRINTFORMW 「んんっ……！　%CNAME("二人称","かな")%、これっ、なんか、すごく……はぅっ！？」	PRINTFORMW 「嗯……！　%CNAME("二人称","かな")%、这个、感觉、好厉害……啊！？」
PRINTFORMW 「%CNAME("二人称","かな")%っ、%CNAME("二人称","かな","甘え")%……これ、だめ……！」	PRINTFORMW 「%CNAME("二人称","かな")%、%CNAME("二人称","かな","甘え")%……这个、不行……！」
PRINTFORMW 「ぜんぶ見えちゃ……やぁっ、見ないで%CNAME("二人称","かな","甘え")%！　は、んんっっ……！」	PRINTFORMW 「全部都被看见了……不要看、%CNAME("二人称","かな","甘え")%！　啊、嗯……！」
PRINTFORMW 「ん……くぅ……」	PRINTFORMW 「嗯……呜……」
PRINTFORMW 従順に尻を捧げて、%CALLNAME%は%CALLNAME:PLAYER%を受け入れている……	PRINTFORMW %CALLNAME%顺从地撅起屁股、接受%CALLNAME:PLAYER%的插入……
PRINTFORMW 「%TEXTR("あ/あっ/ん/んっ/ふあ")%……%CNAME("二人称","かな")%、なんかヘンなところに当たって……%TEXTR("ん/んん/んく/あ/あう")%っ！」	PRINTFORMW 「%TEXTR("啊/啊姆/嗯/嗯呼/呀")%……%CNAME("二人称","かな")%、碰到奇怪的地方了……%TEXTR("嗯/嗯嗯/嗯库/啊/啊姆")%っ！」
PRINTFORMW 「%TEXTR("やっ/はうっ/んくっ/あっ/ふあっ")%……%TEXTR("ぱんぱんしちゃだめぇ/腰うごいちゃう/押しつけちゃだめぇ/ぐるぐるだめぇ")%\@ RAND:2 == 0 ? っ！　 # …… \@%CNAME("二人称","かな","甘え")%\@ RAND:2 == 0 ? っ！ # ……！ \@」	PRINTFORMW 「%TEXTR("呀/哈啊/嗯库/啊/呼姆")%……%TEXTR("不要再动了/腰在动/不要用力了/停下来")%\@ RAND:2 == 0 ? ！　 # …… \@%CNAME("二人称","かな","甘え")%\@ RAND:2 == 0 ? っ！ # ……！ \@」
PRINTFORMW 不良在庫の山を前に、%CALLNAME:MASTER%と%CALLNAME:TARGET%は頭を抱えた…	PRINTFORMW 在堆成山的不良库存前、%CALLNAME:MASTER%和%CALLNAME:TARGET%抱住了脑袋…
