//EVENT_K18_DAILY.ERB


CALL PRINT_STR, "「――ちゅぽんっ。ふふっ……おはよう_H_　朝からスッキリ出来て、いい気分だろう」_W_"	CALL PRINT_STR, "「――嗯……早上好~~從清早就開始H、感覺很好呢」_W_"
PRINTFORMW 「ほらほら、朝のサービスは終わりだ。さっさと起きて、そのだらしなくゆるんだ顔を洗ってこい」	PRINTFORMW 「早上的服務已經結束啦。趕快起床、把你那舒服的不像樣的臉洗一洗呦~~」
PRINTFORMW 「――ちゅぽんっ。おはよう……びっくりしたか？」	PRINTFORMW 「――早上好呦~嚇了一跳麼？」
PRINTFORMW 「起こそうと思ったら、大きくなったコレが目に入って、つい……な」	PRINTFORMW 「本来只是想叫你起床的、但是看到这么雄伟的……嗯~让人难耐啊」
PRINTFORML %CALLNAME:ARG%はそう言いながら、いまだ鎮まる気配のない剛直の先端へ	PRINTFORML %CALLNAME:ARG%在交談的同時、下面堅挺的帳篷仍舊沒有平靜
CALL PRINT_STR, "「ちゅっ_H_　ちゅっ_H_」と愛しげにキスの雨を降らせた……_W_"	CALL PRINT_STR, "「嗯~_H_嗯~~~_H_」情愛的吻像雨水一樣密集落下……_W_"
PRINTFORMW 「……おっと、もうこんな時間か。残念だが、続きはまたあとで……だな」	PRINTFORMW 「……哎呀呀、都這麼晚了呢。真可惜啊、我們之後再·繼·續·呦~……嗯哼哼~~~」
PRINTFORMW 「……さて。朝の一番搾りも頂いたことだし、%CNAMET(ARG, "一人称")%はシャワーでも浴びてくるか」	PRINTFORMW 「……那麼、早上那一份的種汁榨出來了呢~、%CNAMET(ARG, "一人称")%要不要洗個澡呢？」
PRINTFORMW 「ほら。%CNAMET(ARG, "二人称")%もさっさと起きて、そのだらしなくゆるんだ顔を洗ってこい」	PRINTFORMW 「那麼、%CNAMET(ARG, "二人称")%趕快起床、把你那舒服得不像樣的臉洗一洗呦~~」
PRINTFORMW 「ん……もうこんな時間か。悪いが、続きはまた後で……だな」	PRINTFORMW 「都這麼晚了呢。對不起呀、我們以後再繼續舒服的事好不好呀~」
CALL PRINT_STR, "「んっ、ちゅ……おはよう_H_　やっぱり、朝一番は濃いな。お腹の中、すっごくドロっとしてる……_H_」_W_"	CALL PRINT_STR, "「唔…唔~~早上好_H_、清晨最濃的種汁~唔~咕嘟、咕嘟~吞進~哈~肚子裏、黏糊糊的_H_,_W_"
CALL PRINT_STR, @"「んっ、ちゅ……おはよう_H_　まったく、朝早くから元気だなぁ%CNAMET(ARG, "二人称")%は……_H_」_W_"		CALL PRINT_STR, @"「唔、唔~早上好呦_H_真是的、一大早就很精神啊%CNAMET(ARG, "二人称")%……_H_」_W_"
PRINTFORMW 「――さ、もうすぐ朝ごはんも出来るから、%CNAMET(ARG, "二人称")%は顔でも洗ってこい」	PRINTFORMW 「早餐马上就做好了、%CNAMET(ARG, "二人称")%要记得洗脸呦~」
PRINTFORMW 「――ふぁ……あぁ……。ん……おはよう……うん……」	PRINTFORMW 「――呼~啊~嗯……早上好~嗯……」
PRINTFORMW 「……もう、こんな時間なのか……。起きなきゃいけない……のは分かってるんだが……ん～」	PRINTFORMW 「……已經這麼晚了啊、必須起床、我知道啦～」
PRINTFORML %CALLNAME:ARG%は眠たげな様子でベッドから起きかけるが、	PRINTFORML %CALLNAME:ARG%带着一副困倦的样子从床上爬起来、
PRINTFORMW 数度身じろぎした後、諦めたように再度%CALLNAME:MASTER%の頭を胸の谷間に抱え込んだ	PRINTFORMW 在数次尝试之后、就像放弃了一样、再次将%CALLNAME:MASTER%的頭埋抱在自己的雙峰之間。
PRINTFORMW 「……だめだ……抱き心地が良すぎる……これは魔性の抱き枕だ……抗えない魔力を感じる……」	PRINTFORMW 「……不行啦…抱著太舒服了……好像抱着一個魔法抱枕啊……完全抵抗不了這種魔法呢~~」
PRINTFORMW 「ということで……%CNAMET(ARG, "一人称")%は一切悪くないので……まだ寝る……おやすみ……むにゃ」	PRINTFORMW 「所以……%CNAMET(ARG, "一人称")%不要起床啦~来陪我繼續睡覺吧」
PRINTFORML よくわからない言い訳をしながら二度寝しかける%CALLNAME:ARG%を		PRINTFORML 隨便找了個藉口、又一次和%CALLNAME:ARG%睡在了一起。
PRINTFORMW %CALLNAME:MASTER%は胸の中で窒息死する前に全力で叩き起こした……	PRINTFORMW %CALLNAME:MASTER%在窒息于柔軟的雙乳之前全力掙脫了出來……
PRINTFORMW 「ん……おはよう。今日も気持ちのいい朝だな」	PRINTFORMW 「嗯…早上好。今天也是一個清爽的早晨啊」
PRINTFORMW 「そういえば、今日%CNAMET(ARG, "二人称")%のクラスは体育がある日だったな」	PRINTFORMW 「說起來、今天%CNAMET(ARG, "二人称")%的班上有體育課吧」
PRINTFORMW 「%CNAMET(ARG, "一人称")%は女子の担当だからずっとは見てやれないが……サボるんじゃないぞ？」	PRINTFORMW 「%CNAMET(ARG, "一人称")%不要因為老師是我就偷懶啊？」
PRINTFORMW 「そういえば、今日は水泳の授業がある日だったな」	PRINTFORMW 「這麼說來、今天是上游泳課的日子啊」
PRINTFORMW 「女子の水着姿に見とれて、溺れたりするんじゃないぞ。%CNAMET(ARG, "一人称")%の監督責任になるんだからな」	PRINTFORMW 「不要被泳裝女孩子迷住而溺水了哦。作为%CNAMET(ARG, "一人称")%我职责的一部分会在旁邊一直监督你的呦~」
PRINTFORMW 「――なに？　%CNAMET(ARG, "一人称")%の水着姿が楽しみ？」	PRINTFORMW 「――怎麼了？　%CNAMET(ARG, "一人称")%很期待我穿著泳裝的樣子？」
PRINTFORMW 「……馬鹿なこと言ってないで、さっさと支度をしろ。まったく……」	PRINTFORMW 「……說什麼呢……快去準備！真是的……」
PRINTFORMW 「…………ムダ毛の処理、もう少しきちんとやっとくかな」	PRINTFORMW 「…………說起來……體毛的處理、要好好地做一下了……」
PRINTFORMW 「……ん？　なんだ、%CNAMET(ARG, "一人称")%達だけか。ちょっと早く来すぎたな」	PRINTFORMW 「嗯？什么、只有%CNAMET(ARG, "一人称")%到了吗。来得稍微早了一些啊」
PRINTFORMW 「よっ！　お疲れ、若者ー。午前中、居眠りせずちゃんと真面目に勉強したか？　ん？」	PRINTFORMW 「呦！辛苦了、年轻人。午休期间不睡觉而在认真学习着呢？　嗯？」
PRINTFORMW %CALLNAME:ARG%は右腕を%CALLNAME:MASTER%の首に巻き付けるように回し、抱きついてきた	PRINTFORMW %CALLNAME:ARG%用右手挽住%CALLNAME:MASTER%的头、就这样抱着。
PRINTFORMW ……彼女の弾力に富んだ大きな膨らみが、%CALLNAME:MASTER%の頬にグニグニと押し付けられる……	PRINTFORMW ……她那富有弹性、硕大膨胀的胸部、就这么强行贴在%CALLNAME:MASTER%的脸颊上。
PRINTFORMW 「悪い、思いの外帰るのが遅くなってしまった。待ってろ、いま夕飯の準備を――」	PRINTFORMW 「对不起、没想到回来晚了。稍等一下啊、现在就准备晚饭――」
PRINTFORMW 「――って、そうか。%CALLNAME:FINDCHARA(NO, 1)%がいたんだったな……なんかまだこの生活に慣れないな」	PRINTFORMW 「――是这样吗。%CALLNAME:FINDCHARA(NO, 1)%有些累了吗……看来还没习惯这种生活啊」
PRINTFORMW 「ただいま。はぁ～……今日もよく働いた働いた」	PRINTFORMW 「我回来了。哈~今天工作也很顺利」
PRINTFORMW 「ふぅ……ただいま。職員会議が長引いてな、少し遅くなってしまった」	PRINTFORMW 「呼、我回来了。职工会议拖得太久、有点晚了」
PRINTFORMW 「おぉーう、おっかえりぃ～。今日も一日ごくろーさ～ん」	PRINTFORMW 「你好、回来了吗～今天一整天也要过去了啊～」
PRINTFORMW ……%CALLNAME:ARG%はビール缶を片手に、リビングのソファでだらけきっていた……	PRINTFORMW ……%CALLNAME:ARG%一手拿着啤酒罐、微醺躺在客厅的沙发上……
PRINTFORMW 「今日の家事当番は%CALLNAME:FINDCHARA(NO, 1)%なんで、ちょっとくつろがせてもらってるぞぉ。んふふ～」	PRINTFORMW 「今天的家务活轮到%CALLNAME:FINDCHARA(NO, 1)%了呢、稍稍放松了些哦。呵呵~」
PRINTFORMW 「……ングッ、ングッ……ぷはぁ～！　いやー、仕事終わりに家で飲むビールがこんなに美味かったとは」	PRINTFORMW 「……咕嘟、咕嘟……哈～！下班后在家喝啤酒~最棒了！」
PRINTFORMW 「旦那がいる時は、絶対こんなことできなかったからな。まったく、メイドのいる生活は最高だな！」	PRINTFORMW 「我老公在的时候、可绝对不会做这种事。真是的、有女仆的生活真是太棒了！」
PRINTFORMW ……奥のキッチンで夕飯の支度をしていた%CALLNAME:FINDCHARA(NO, 1)%が、若干困ったような表情を浮かべていた	PRINTFORMW ……正在后面厨房准备晚餐的%CALLNAME:FINDCHARA(NO, 1)%、有一点点尴尬的样子。
PRINTFORML 忠臣なる我がメイドに心の中で労いの言葉を送ると、	PRINTFORML 我向忠诚的女仆致以感谢的目光。
PRINTFORMW %CALLNAME:MASTER%は%CALLNAME:ARG%からビールを取り上げるべく、のしのしと近づいていった……	PRINTFORMW %CALLNAME:MASTER%从%CALLNAME:ARG%一旁拿起啤酒、慢吞吞地走近了。
PRINTFORMW 「おぅ、おかえり。もうすぐ夕飯できるからな、手を洗って待っててくれ」	PRINTFORMW 「欢迎回家。很快就能吃晚饭了、洗洗手等待一下」
PRINTFORMW エプロン姿の%CALLNAME:ARG%が、キッチンで手際よく夕食の準備をしていた	PRINTFORMW 穿着围裙形象%CALLNAME:ARG%、在厨房里以精妙的手法准备着晚饭。
PRINTFORMW 「何もかも%CALLNAME:FINDCHARA(NO, 1)%に任せきりにしてると、家事の腕が落ちそうなんでな。これくらいはさせてくれ」	PRINTFORMW 「什么都让%CALLNAME:FINDCHARA(NO, 1)%做的话、我家务活的本事要荒废了呢。让我也来帮忙吧」
PRINTFORMW 「おぉ、おかえり。なんだ、随分遅かったじゃないか」	PRINTFORMW 「欢迎回家。回来得相当晚啊」
PRINTFORMW ……明らかに風呂上がりと思われる、下着姿の%CALLNAME:ARG%と廊下で鉢合わせた……	PRINTFORMW ……明显是刚刚洗过澡、只穿着内衣的%CALLNAME:ARG%站在走廊里……
PRINTFORMW 軽く上気した健康的な小麦肌が、なんとも艶めかしい……	PRINTFORMW 还在轻微冒着蒸汽的小麦色肌肤、以及难以描述的美艳身姿……
PRINTFORMW 「ん？　……あぁ、先に風呂入らせてもらったぞ」	PRINTFORMW 「嗯？……啊、我先把澡洗了」
PRINTFORMW 「今は誰も使ってないはずだから、%CNAMET(ARG, "二人称")%も入ってくるといい。サッパリするぞ」	PRINTFORMW 「现在没有人使用浴室、%CNAMET(ARG, "二人称")%干脆也进去把澡洗了吧」
PRINTFORMW そう言って%CALLNAME:ARG%は、プラに包まれた豊かな双丘をプルンプルンと弾ませながら、リビングに戻っていった……	PRINTFORMW %CALLNAME:ARG%这么说着走回了客厅、在走路的时候被内衣包裹的丰满山丘上下跃动着……
PRINTFORMW 「ん……おかえり」	PRINTFORMW 「嗯……你回来了」
PRINTFORMW %CALLNAME:ARG%はダイニングで、真面目な表情でノートパソコンに立ち向かっていた	PRINTFORMW %CALLNAME:ARG%坐在餐厅、一脸认真地面对着笔记本电脑。
PRINTFORMW ……普段は着けていないメガネもかけていて、いつもより凛々しい印象が感じられた	PRINTFORMW ……戴着平时不戴的眼镜、给人一种比平时更严肃的印象。
PRINTFORMW 「……あぁ、すまない。仕事がちょっと残ってしまってな。もう少しで終わるから……」	PRINTFORMW 「……啊、对不起。工作只剩下一点、马上就要结束了……」
PRINTFORMW そう言って%CALLNAME:ARG%は無言となり、暫くの間黙々と作業を続けた……	PRINTFORMW 说完之后%CALLNAME:ARG%又沉默了、继续工作着……
PRINTFORMW 「――ふぅ。よし、終わり！　んぅ～～～疲れたぁ……」	PRINTFORMW 「——呼。好、终于结束了！嗯~~~好累啊……”」
PRINTFORMW 一段落がついたらしい%CALLNAME:ARG%が、チェアの背もたれを軸に思いきり背中を反らした	PRINTFORMW 好像暂时告一段落了、%CALLNAME:ARG%把背靠在椅子上、用力向后舒展着身体。
PRINTFORMW ……彼女の豊かなバストが、はちきれんばかりに衣服を押し上げ、その美しい曲線がはっきりと浮かび上がる……	PRINTFORMW ……她丰满的胸部、像要撑开衣服似的挺起、美丽的曲线尽显无疑……
PRINTFORMW 「……んぁ？　なんだ、ずっとそこにいたのか。なにか%CNAMET(ARG, "一人称")%に用だったか？」	PRINTFORMW 「……嗯？怎么了、还站在那里啊。%CNAMET(ARG, "一人称")%有什么事吗？」
PRINTFORMW 「よう、お疲れさん。先にお邪魔させてもらってるぞ」	PRINTFORMW 「哦、辛苦了。打扰你了」
PRINTFORMW %CALLNAME:MASTER%を出迎えた%CALLNAME:ARG%は、当然のように水着姿だった……	PRINTFORMW 在%CALLNAME:MASTER%对面的%CALLNAME:ARG%、理所当然是泳装的姿态……
PRINTFORML うつ伏せでソファに寝転ぶ%CALLNAME:ARG%の、競泳水着に包まれた	PRINTFORML 穿着竞赛泳衣的%CALLNAME:ARG%趴倒在沙发上。
PRINTFORMW 形の良いお尻が、つんと天井に向かって突き出されている……	PRINTFORMW 完美的臀部曲线、就那么向上展露着……
PRINTFORML 仰向けでソファに寝転ぶ%CALLNAME:ARG%の、競泳水着に包まれた	PRINTFORML PRINTFORML 穿着竞赛泳衣的%CALLNAME:ARG%躺倒在沙发上。
PRINTFORMW 豊満なバストが、形を崩すことなく見事な頂を作り上げている……	PRINTFORMW 丰满的山丘、丝毫没有下垂地挺立着……
PRINTFORML 競泳水着のするどい切れ込みから伸びた、すらりとしていながらも	PRINTFORML 竞赛泳衣非常地合身、显得很苗条。
PRINTFORMW 程よく肉づいた琥珀色の美脚が惜しげもなくさらけ出されている……	PRINTFORMW 琥珀色的美腿恰到好处地展露出来……
PRINTFORMW ……そう言って部室のソファでくつろぐ%CALLNAME:ARG%は、なぜか水着姿だった……	PRINTFORMW ……这样说着、在部室的沙发上放松的%CALLNAME:ARG%、不知为何是穿着泳衣……
PRINTFORMW 「どうした、そんなところに突っ立って……ん？　この格好か？」	PRINTFORMW 「怎么了、突然站在那里……嗯？这身打扮吗？」
PRINTFORMW 「水泳の日は水着のまま顔を出すのがこの部室のルールだと言われたんだが……違うのか？」	PRINTFORMW 「上游泳课的日子穿泳衣是这个部室的规则……不对吗？」
PRINTFORML 競泳水着のするどい切れ込みから生える、すらりとしていながらも程よく肉づいた	PRINTFORML 竞赛泳衣非常地合身、显得苗条而且恰到好处地展示了肉体。
PRINTFORMW 美脚を優雅に交差させて寝転ぶ姿は、あまりにも悩殺的で眩しい光景だった……	PRINTFORMW 优雅地交叉美腿躺下的身姿、真是让人“烦恼”的耀眼光景啊……
PRINTFORML 忠臣なる我がメイドに心の中で最大限の称賛の言葉を送ると、	PRINTFORML 在心中向我忠诚的女仆送出最大程度的称赞、
PRINTFORMW %CALLNAME:MASTER%は%CALLNAME:ARG%に向かって力強く親指を立てた	PRINTFORMW %CALLNAME:MASTER%向%CALLNAME:ARG%强有力地竖起大拇指。
PRINTFORMW 「よっ、きたな。先にお邪魔させてもらってるぞ」	PRINTFORMW 「哦、辛苦了。打扰你了」	
PRINTFORMW 「あー……すまん。邪魔してしまった、な」	PRINTFORMW 「啊……对不起。打扰了、呐」
PRINTFORMW %CALLNAME:ARG%は口説いてる最中の%CALLNAME:MASTER%を見て、申し訳なさそうに頭を掻いた。	PRINTFORMW %CALLNAME:ARG%看到正在说话的%CALLNAME:MASTER%、不好意思地挠了挠头。
PRINTFORMW 「よう。邪魔す、る……ぞ――」	PRINTFORMW 「好吧。打扰……了……哦——」
PRINTFORMW 「……あー、その、なんだ。邪魔をしてしまった、みたい、だな」	PRINTFORMW 「……啊、那个、什么啊。好像打扰你了」
PRINTFORMW 「……すまん。出直してくる」	PRINTFORMW 「……对不起。我这就走」
PRINTFORMW %CALLNAME:MASTER%は踵を返そうとする%CALLNAME:ARG%を苦笑いで引き止め、入室を促した……	PRINTFORMW %CALLNAME:MASTER%苦笑地挽留住%CALLNAME:ARG%、催促她进入了房间……
PRINTFORMW 「はぁー……まったく。学校内で女を侍らせて、いいご身分だな%CNAMET(ARG, "二人称")%は」	PRINTFORMW 「哈哈……真是的。在学校内让女人这么服侍你、%CNAMET(ARG, "二人称")%是什么身份呐」
PRINTFORMW %CALLNAME:ARG%は呆れた表情でため息をついた……	PRINTFORMW %CALLNAME:ARG%露出惊讶的表情叹了一口气……	
PRINTFORMW 「よう、お疲れさん。お邪魔させてもらうぞ」	PRINTFORMW 「哦、辛苦了。打扰你了哦」
PRINTFORMW %CALLNAME:ARG%は部室に入ってくると、当然のように水着姿に着替えた……	PRINTFORMW %CALLNAME:ARG%一进部室就理所当然地换上了泳装……
PRINTFORML ……そう言って%CALLNAME:ARG%は入室すると、部屋の隅でいきなり服を脱ぎ出しはじめ、	PRINTFORML ……说着话的%CALLNAME:ARG%进入房间后、突然在房间的角落里开始脱衣服、
PRINTFORMW あっという間に水泳の授業で着ていた水着姿となった……	PRINTFORMW 一眨眼间、就成了游泳课上穿着泳衣的样子……
PRINTFORMW 「ふぅ、これでよし……ん、なにをボケっとした顔で見てるんだ」	PRINTFORMW 「呼、这样就好了……嗯、你用呆呆的表情看着什么啊？」
PRINTFORMW 「水泳の日は水着のままでいるのがこの部室のルールだ言われたんだが……違うのか？」	PRINTFORMW 「听说游泳的日子就要在这个房间换泳衣的……不对吗？」
PRINTFORML ……忠臣なる我がメイドに心の中で最大限の称賛の言葉を送ると、	PRINTFORML 在心中向我忠诚的女仆送出最大程度的称赞、
PRINTFORMW 「なんだ、今日は用無しか？　……あー、うん、気にするな気にするな」	PRINTFORMW 「什么嘛、今天没事了吗？　……啊、没什么、不要在意不要在意」
PRINTFORMW 「こっちはこっちでくつろがせてもらうから、そっちも気にせず楽しんでくればいい」	PRINTFORMW 「我就自己在这里随便放松一下、你也没必要在意我、自己去干自己想做的事就行了」
PRINTFORMW 「ん？　今日はもうお開きか。まぁ、別にかまわんけどな……」	PRINTFORMW 「嗯？　今天就到这里吗。嘛、倒也没什么问题就是了……」
PRINTFORMW 「ほら……約束のお弁当、作ってきたぞ」	PRINTFORMW 「看……按照约定我做了便当了」
PRINTFORMW 「旦那に気付かれないように一人分増やすの、結構大変だったんだからな」	PRINTFORMW 「在不被丈夫发现的情况下多做一人份的便当、相当辛苦啊」
PRINTFORML 渡されたお弁当の蓋を開いてみると、彩り鮮やかで種類豊富なおかずが	PRINTFORML 打开盒饭的盖子一看、里面的菜色鲜艳、种类丰富。
PRINTFORMW 丁寧に敷き詰められていて、非常に食欲がそそられる……	PRINTFORMW 摆放精致的便当、非常能引起人的食欲……
PRINTFORMW 「……なんだ、その意外そうな目は。これでも料理は得意な方なんだぞ」	PRINTFORMW 「什么啊、那意外的眼神。别看我这样、料理还是很拿手的啊」
PRINTFORMW 「ほらほら、呆けてないでさっさと食え。昼休みも%CNAMET(ARG, "一人称")%は忙しいんだからな」	PRINTFORMW 「别发呆啦、快点吃吧。%CNAMET(ARG, "一人称")%的午休时间也是很短暂的啊」
PRINTFORMW %CALLNAME:ARG%に急かされるようにして、%CALLNAME:MASTER%はお弁当を食べ始める		PRINTFORMW 在%CALLNAME:ARG%的催促下、%CALLNAME:MASTER%开始吃便当了。
PRINTFORMW ……見た目どおりの美味しさに、%CALLNAME:MASTER%は大変満足した……	PRINTFORMW ……便当有着不逊色于亮丽外观的美味、%CALLNAME:MASTER%非常满足……
PRINTFORMW 「……あっ。そのおかず、初めて挑戦してみたんだ。どうだ……味、変じゃないか？」	PRINTFORMW 「啊！这道菜我第一次挑战。怎么样……味道怎么样啊？」
PRINTFORMW ……美味しい。%CALLNAME:MASTER%は満足げに%CALLNAME:ARG%へ頷いた。	PRINTFORMW ……美味啊。%CALLNAME:MASTER%满足地向%CALLNAME:ARG%点了点头。
PRINTFORMW 「そ、そうか……。ふふっ、よかった……」	PRINTFORMW 「PRINTFORMW 「哇……呵呵、太好了……」
PRINTFORMW 「……実はそれ、旦那の弁当には入れてない、%CNAMET(ARG, "二人称")%用に作ったんだ」	PRINTFORMW 「其实那个、是用了丈夫的便当没有放的材料、专门给%CNAMET(ARG, "二人称")%做的哦」
PRINTFORMW 「旦那は好き嫌いが多くて、いつも決まったおかずしか食べてくれなくてな……」	PRINTFORMW 「因为我老公很挑食、我们总是只吃固定几样菜……」
PRINTFORMW 「反面、%CNAMET(ARG, "二人称")%は何でも喜んで食べてくれるからな。ちょっと色々と挑戦してみたくなって……」	PRINTFORMW 「相反、%CNAMET(ARG, "二人称")%什么都会高兴地吃啊。想挑战一下各种各样的新菜呢……」
PRINTFORMW 「おかげで最近、お弁当づくりが楽しくなってしまった……その責任はとってもらうぞ、ふふふっ」	PRINTFORMW 「托您的福、最近制作便当变得很开心……你要负起这个责任哦、呵呵」
PRINTFORMW 男子のツボを抑えたおかずの数々に、%CALLNAME:MASTER%の箸は止まらない……！	PRINTFORMW 菜肴完全命中了个人的喜好、%CALLNAME:MASTER%的筷子完全停不下来……！
PRINTFORMW 「おいおい。そんなに急いで食べなくても、誰もとりゃしないって」	PRINTFORMW 「喂喂。不用吃得那么急、又没人和你抢~」
PRINTFORMW 「……でもまぁ、自分の料理を美味しそうに食べてくれるのは、やっぱり嬉しいものだな……ふふふっ」	PRINTFORMW 「……不过嘛、能吃到美味的料理、果然还是会很开心吧……呵呵呵」
PRINTFORMW 「どうだ、美味いか？　遠慮なく食べていいからな」	PRINTFORMW 「怎么样、好吃吗？不用客气、尽情享用吧」
PRINTFORMW 「……っと、口にご飯粒ついてるぞ……ああ、そっちじゃない」	PRINTFORMW 「……哇、嘴边还沾着饭粒呢……啊、不是那边啦」
PRINTFORMW 「もう……ほら、とってやるからこっちむけ」	PRINTFORMW 「已经……你看、我来吧、在这边啊」
PRINTFORMW %CALLNAME:ARG%は%CALLNAME:MASTER%の口元についた米粒を指で摘み上げると、	PRINTFORMW %CALLNAME:ARG%用手擦去%CALLNAME:MASTER%嘴边的米粒。
PRINTFORMW そのまま自分の口へもっていき、舌で舐め取った……	PRINTFORMW 就这样把米粒放进自己的嘴里、用舌头舔着……
PRINTFORMW 「ん、ちゅっ……これでよし。……ん？　どうした――って、ああ」	PRINTFORMW 「唔……嗯、这样就好了。……嗯？怎么了――、啊啊」
PRINTFORMW 「すまんすまん。つい旦那と同じようにしてしまった。嫌だったか？」	PRINTFORMW 「对不起、不知不觉就和在老公身边一样了。惹你讨厌了吗？」
PRINTFORMW 「……%CNAMET(ARG, "二人称")%は何を作ってきても美味しそうに食べてくれるよな」	PRINTFORMW 「……无论%CNAMET(ARG, "二人称")%做什么、都能吃得很香呢」
PRINTFORMW 実際、%CALLNAME:ARG%のお弁当はいつも美味しい	PRINTFORMW 实际上、%CALLNAME:ARG%做的便当总是很好吃。
PRINTFORMW %CALLNAME:MASTER%は素直にそのことを伝えた	PRINTFORMW %CALLNAME:MASTER%坦率地说出了这句话。
PRINTFORMW 「……ホント、%CNAMET(ARG, "二人称")%はいい子だなぁ。んふふ……♪」	PRINTFORMW 「……真的、%CNAMET(ARG, "二人称")%是个好孩子啊。哼哼哼……♪」
PRINTFORML %CALLNAME:MASTER%はニンマリと頬を緩めた%CALLNAME:ARG%に抱き寄せられると、	PRINTFORML %CALLNAME:MASTER%被带着放松表情的%CALLNAME:ARG%紧紧抱住、
PRINTFORMW その豊満な胸の谷間に顔を包まれながら、頭を撫でくりまわされた……	PRINTFORMW 把你的脸埋进她丰满的谷间、轻轻地抚摸着你的头。
PRINTFORML 「……まさか、学校の一室がヤリ部屋にされていたとはな……」	PRINTFORML 「……没想到、竟然要寄宿在这样的一间的房里啊」
PRINTFORML 「まぁ、今日からは%CNAME("一人称")%も同じ穴の狢か……ほどほどによろしく頼むよ」	PRINTFORML 「嘛、从今天开始、要和%CNAME("一人称")%住在一起咯？……请多关照」
PRINTFORML 「ふぅ～……。体育のあとは、やっぱり暑いな……」	PRINTFORML 「呼～……运动之后、非常地热啊……」
PRINTFORML %CALLNAME:TARGET%がＴシャツの胸元をパタパタと引っ張ると、	PRINTFORML %CALLNAME:TARGET%啪嗒一声拉开T恤的领口。
PRINTFORML 汗が浮ぶ深い谷間がチラチラと見え隠れした……	PRINTFORML 浮现着汗水的深谷若隐若现……
PRINTFORML 「ふぁ……あぁ……。んぅー、よく寝た」	PRINTFORML 「哼……哈……嗯~睡得好香」
PRINTFORML 目覚めた%CALLNAME:TARGET%は大きく伸びをすると、豊満なバストで衣服がはちきれんばかりに押し上げられた……	PRINTFORML 睡醒了的%CALLNAME:TARGET%伸了一个大大的懒腰、丰满的双乳好像都要把前胸的衣服撑破了……
PRINTFORML 「……まさかもう一部屋あったとは。まったく、いったい学校をなんだと……」	PRINTFORML 「没想到还有一间屋子。真是的、学校怎么这个样子……」
PRINTFORML %CALLNAME:TARGET%は用意されていた部屋を見て、ブツブツと文句を垂れ流している……	PRINTFORML %CALLNAME:TARGET%看着准备好的房间、咕嘟咕嘟地发着牢骚……
PRINTFORML 「こんなところに連れてきて何を――ま、まさか……ここでするつもりか？」	PRINTFORML 「带我到这种地方来干什么——不、不会吧……打算在这里做吗？」
PRINTFORML 「ば、馬鹿ッ！　万が一バレたら、どうするつもりなんだッ」	PRINTFORML 「笨蛋、笨蛋！万一被人看到了、你打算怎么办啊？」
PRINTFORML 「な、なぁ……やっぱ、ウチに戻らないか？」	PRINTFORML 「呐、呐……果然、要不然还是回家吧？」
PRINTFORML 「こういうところに来ると、なんかこう……浮気してる感が、すごい、して……」	PRINTFORML 「到这种地方来的话、总觉得会……很有出轨的感觉的说」
PRINTFORML %CALLNAME:TARGET%は落ち着かない様子で体をモジモジとさせている……	PRINTFORML %CALLNAME:TARGET%一副难耐的样子、扭捏着身体……
PRINTFORML 「ん？　この肌は日焼けなのか、って？　いや、これは元々なんだ」	PRINTFORML 「嗯？你问我这皮肤是晒黑的吗？不、这本来就是如此」
PRINTFORML 「遺伝でな、ウチの家系はみんな肌がこうなんだよ。昔はコンプレックスだったが……」	PRINTFORML 「是遗传、我们家族的皮肤都是这样的。以前我总是因为这个很自卑……」
PRINTFORML 「今はもう気にしてないな。それに、誰かさんもこの肌を気に入ってくれてるようだし、な……ふふっ」	PRINTFORML 「现在已经不在意了。而且、好像有人也喜欢这种颜色的肌肤呢……呼呼」
PRINTFORML 「色が濃いからって別段差別されることもなかったしな。今はちゃんと受け入れられてるよ」	PRINTFORML 「虽然肤色很深、但其实也不会被歧视。现在已经被能够接受了」
PRINTFORML 「いつから精霊を宿すようになったのかって？　うーん……ほぼ、生まれたときから、だな」	PRINTFORML 「什么时候开始被精灵附身了呢？嗯……大概是、从出生开始吧」
PRINTFORML 「ウチは先祖代々、火の精霊を祀る神子の家系でな。生後まもなく儀式でその身に精霊を宿すんだ」	PRINTFORML 「我们家祖辈辈都是祭祀火之精灵的祭祀家族。出生后不久、就通过仪式让精灵寄宿在孩子身上」
PRINTFORML 「今は姉が実家の当主をしている……はずだ。もう何年も里帰りしてないんでな……詳しくはわからん」	PRINTFORML 「现在姐姐应该是当代的家主吧……应该吧。毕竟已经好几年没回老家了……我也不知道详细情况」
PRINTFORML %CALLNAME:TARGET%は落ち着かない様子でチラチラとこちらを伺っている……	PRINTFORML %CALLNAME:TARGET%一副不安的样子、向这边看过来……
PRINTFORML 「……もぐもぐもぐ……」	PRINTFORML 「……奇怪啊……」
PRINTFORML %CALLNAME:TARGET%は一人なにかを食べている……	PRINTFORML %CALLNAME:TARGET%一个人在吃什么呢……
PRINTFORML 「ふぁ～～っ……。うん……暇だ」	PRINTFORML 「哼~~~嗯……好悠闲啊」
PRINTFORML %CALLNAME:TARGET%は椅子に腰掛け、眠たげにしている……	PRINTFORML %CALLNAME:TARGET%坐在椅子上、睡意朦胧的样子……
PRINTFORML %CALLNAME:TARGET%は手持ちの資料をパラパラとめくっている……	PRINTFORML %CALLNAME:TARGET%哗啦哗啦地整理着手头的资料……
PRINTFORML 「すぅ……すぅ……」	PRINTFORML 「嘶……嘶……」
PRINTFORML 「……んん～……ふぅ……」	PRINTFORML 「……嗯……呼……」
PRINTFORML 「……ん、んぅ……」	PRINTFORML 「……嗯、嗯……」
PRINTFORMW 「……時間がない。さっさとすませるぞ」	PRINTFORMW 「……时间不多。我们要快一点」
PRINTFORML %CALLNAME:TARGET%は%CALLNAME:MASTER%の正面に立つと、ファスナーを下ろして	PRINTFORML %CALLNAME:TARGET%站在%CALLNAME:MASTER%的对面拉开了拉链。
PRINTFORMW 既にビンビンに勃起したペニスをスボンの中から開放した……	PRINTFORMW 早已经在裤子里勃起的肉棒从那里跳了出来……
PRINTFORMW 「……っ……！　すごい、こんな……熱く、固くなって……」	PRINTFORMW 「……啊~~！好厉害啊、这么……热、硬邦邦的……」
PRINTFORML %CALLNAME:TARGET%は熱に浮かされたような表情で剛直を握ると、	PRINTFORML %CALLNAME:TARGET%脸通红地紧握住了那坚硬挺拔的东西。
PRINTFORMW その硬さと熱を確かめるように、しこしこと軽く上下にしごく……	PRINTFORMW 为了确认那里的硬度和热度、轻轻地上下套弄着……
PRINTFORMW 「さっき言ったように時間がないからな。ちょっと激しくいくぞ……」	PRINTFORMW 「像刚才说的那样、时间不多。稍微激烈一点吧……」
PRINTFORML %CALLNAME:TARGET%は%CALLNAME:MASTER%に体を密着させると、	PRINTFORML %CALLNAME:TARGET%将身体紧紧地贴住%CALLNAME:MASTER%、
PRINTFORMW いきり立った陰茎を激しく上下にしごきはじめた……	PRINTFORMW 被激烈套弄的肉棒开始上下颤动…………
PRINTFORML その強烈な責め立てに、肉棒の先端からは先走りが湧き水のように溢れ出し、	PRINTFORML 在强烈的责备下、先走汁从肉棒的前端开始像泉水一样溢出、
PRINTFORMW %CALLNAME:TARGET%の手が行き交うたび、 ぬちゅぬちゅといやらしい水音が室内に響き渡った……	PRINTFORMW 当%CALLNAME:TARGET%的手来回套弄时、滋滋的的水声就在室内响起……
PRINTFORMW 「んっ……もうそろそろ、か？。　いいぞ……このまま、出して……」	PRINTFORMW 「嗯……已经差不多了~吗？好啊……就这样、射出来……」
PRINTFORML 至近距離でこちらを見つめながら、妖艶に奉仕する%CALLNAME:TARGET%の姿を見て	PRINTFORML 一边从很近的距离盯着你、一边仍对你进行着服务的%CALLNAME:TARGET%的妖艳姿态尽收眼底
PRINTFORMW %CALLNAME:TARGET%の美しい手を穢したい衝動が、体の奥底から一気にこみ上げてくる……！	PRINTFORMW 想要彻底玷污%CALLNAME:TARGET%美丽双手的冲动、一下子就从身体深处涌了上来……！
PRINTFORMW 「じゃあ、するぞ……んっ、ぁむっ……」	PRINTFORMW 「那么、我决定了……哼、呜呜……」
PRINTFORML %CALLNAME:TARGET%は抱きつくように%CALLNAME:MASTER%の腰に腕を回すと、	PRINTFORML %CALLNAME:TARGET%用手臂环抱着%CALLNAME:MASTER%的腰、
PRINTFORMW その柔らかな唇で肉棒の先端を含み、そのままゆっくりと根本まで咥えこんでいった	PRINTFORMW 先用柔软的嘴唇含住了肉棒尖端、接着慢慢地将肉棒吞咽到根部。
PRINTFORML 喉の奥まで受け入れると、最初に亀頭を舌で愛撫するように丁寧に舐め回し、	PRINTFORML 最初用舌头像爱抚一样地谨慎地舔舐着龟头、然后将肉棒直接接纳在喉咙的深处。
PRINTFORMW 自身の唾液を肉棒へ十分に馴染ませた後、頭を激しく前後させ、じゅぶじゅぶと豪快にしごきたてた……	PRINTFORMW 用自己的唾液将肉棒充分浸透后、头部开始前后摆动、幅度变得越来越大……
PRINTFORMW 「じゅるっ、じゅぶっ、ぐぷっ……！　このまま、らひて、ひいからな……んっ、じゅっ、じゅずっ……！」	PRINTFORMW 「唔嗯~唔嗯~咕噜咕噜……！就这样、嗯哈……啊呜、嗯嗯~……！」
PRINTFORML 蕩けた瞳でこちらを見つめながら、献身的に肉棒へ奉仕する%CALLNAME:TARGET%の姿に	PRINTFORML する%CALLNAME:TARGET%在为肉棒服务的同时、还用荡漾的眼神瞟向这边。
PRINTFORMW その喉奥に精を解き放ちたい衝動が、一気にこみ上げてくる……！	PRINTFORMW 想在喉咙里释放的冲动、就这么一口气涌上来……！
PRINTFORMW 「じゃあ、挟むぞ……んっ、しょ……」	PRINTFORMW 「那么、用这里夹住吧……哼~哼~……」
PRINTFORML %CALLNAME:TARGET%はひざまずいて自身の上着をはだけさせると、	PRINTFORML %CALLNAME:TARGET%跪下来半褪下自己的上衣。
PRINTFORMW 天に向かってそそり立つ肉棒を、その豊満な乳房で柔らかく包み込んだ……	PRINTFORMW 将向天直立的肉棒用丰满的乳房温柔地包裹起来……
PRINTFORML 口に溜めていた唾液を潤滑剤として谷間にたらぁ…と流し込むと、	PRINTFORML 将口中积存的唾液滴下、作为润滑剂流落进山谷间……
PRINTFORMW 両手でぎゅっと乳圧を強め、にちゅにちゅと音を立ててしごき始めた……	PRINTFORMW 用双手紧紧地压住乳房、发出咯吱咯吱的声音开始运动。
PRINTFORMW 「んっ、ふっ、ぅん……！　このまま、おっぱいの中で、射精していいからな……」	PRINTFORMW 「嗯、哼哼~……就这样、在胸部里射出来也没关系呦……」
PRINTFORML 上目遣いでこちらを見やりながら、献身的に肉棒へ奉仕する%CALLNAME:TARGET%の姿に	PRINTFORML 看着一边朝上仰视、一边献身为肉棒服务的%CALLNAME:TARGET%的身姿
PRINTFORMW このまま母性の象徴に包まれたまま、白濁を漏らしたい衝動が一気にこみ上げてくる……！	PRINTFORMW 就这样被母性的象征包裹着、想射出白浊的冲动一下子涌上来……！
PRINTFORMW %CALLNAME:MASTER%は%CALLNAME:TARGET%に壁に手をついて尻をこちらへ向けるよう命じた。	PRINTFORMW %CALLNAME:MASTER%命令%CALLNAME:TARGET%把手贴在墙上然后将屁股朝这边。
PRINTFORMW 「……っ……！　こ、これで、いいか……？」	PRINTFORMW 「……啊……！这、这样可以吗……？」
PRINTFORML %CALLNAME:MASTER%は、指示に従い突き出された%CALLNAME:TARGET%の形の良い尻を何度か撫でた後、	PRINTFORML %CALLNAME:TARGET%根据指示翘起了诱人形状的屁股、%CALLNAME:MASTER%反复地抚摸几下之后、
PRINTFORMW 彼女のジャージの下をショーツごと一気に下ろし、隠されていた秘裂を露出させた	PRINTFORMW 将她的运动裤连同下面的三角短裤一口气褪下、露出了隐藏的秘裂。
PRINTFORML ……こうなることを期待していたのだろうか。	PRINTFORML ……不知道是不是一直期待着这样的事情呢？
PRINTFORMW %CALLNAME:TARGET%の膣口はすでに湿り気を帯びていた	PRINTFORMW %CALLNAME:TARGET%蜜穴的洞口已经带有明显的湿气了。
PRINTFORMW %CALLNAME:MASTER%は肉棒の先端で、彼女の濡れそぼった陰唇をぐちゅぐちゅとかき混ぜた……	PRINTFORMW %CALLNAME:MASTER%先是用肉棒的前端、轻轻地搅拌着她湿润的阴唇……
PRINTFORMW 「んっ……！　はぁっ……やっ……あぁっ……！」	PRINTFORMW 「嗯……！哈~哎……呀~呀~……！」
CALL PRINT_STR, "「こ、こらっ……！　時間ないって、んっ_H_　言った、だろっ！　早く、すませてっ……！」_W"	CALL PRINT_STR, "「别、别闹了……！说过了时间不多、嗯_H_！快点呀……」_W"
PRINTFORMW まだコンドームを装着していないが、そのまま生で挿れていいのだろうか？	PRINTFORMW 还没有戴安全套、可以直接插入吗？
CALL PRINT_STR, "「もう、なんでもいいからっ！　はやく……ぁんっ！　あっ、あっ、いっ、あんっ_H_」_W"	CALL PRINT_STR, "「已经、怎样都无所谓了！快点呀……呜呜！啊~啊~哈啊、嗯~啊_H_」_W"
PRINTFORMW 「こ、こらっ……！　ちゃんと、んっ、ゴムは、しろっ……！」	PRINTFORMW 「喂、喂……！给我……好好地、嗯、套套！」
PRINTFORMW %CALLNAME:MASTER%は%CALLNAME:TARGET%からコンドームを渡されると、渋々従ってそれをペニスに取り付けた……	PRINTFORMW %CALLNAME:MASTER%把避孕套交给%CALLNAME:TARGET%、不情愿地被戴上了……
PRINTFORMW 「……よし。もう時間がないから、さっさとすませろよ……んんっ！　んっ、んっ、ふぅっ、ぅんっ……！」	PRINTFORMW 「很好。已经没有时间了、赶快结束吧……嗯哼~哼嗯~哼~哼……」
PRINTFORML %CALLNAME:MASTER%は%CALLNAME:TARGET%のくびれた腰を両手でつかみ、	PRINTFORML %CALLNAME:MASTER%用两只手抓住%CALLNAME:TARGET%纤细的腰、
PRINTFORMW いきり立った剛直で濡れそぼった肉壷を思うがままに犯した……	PRINTFORMW 随心所欲地用干劲十足的刚直肉棒侵犯那湿透的肉壶……
PRINTFORMW %CALLNAME:MASTER%は%CALLNAME:TARGET%の手に包まれたまま、ドクドクと精を漏らした……		PRINTFORMW %CALLNAME:MASTER%被%CALLNAME:TARGET%的手温柔地包裹着那里、噗呲一声泄出了精液……
PRINTFORMW 「んっ、熱い……。ほら……もっと出さないと、すっきり出来ないぞ？」	PRINTFORMW 「呀、好烫啊……看……全部发泄出来了吗、还可以再来的吧~？」
PRINTFORML %CALLNAME:TARGET%は%CALLNAME:MASTER%の体に脚を絡ませさらに密着しながら、	PRINTFORML %CALLNAME:TARGET%将自己的身体从头到脚和%CALLNAME:MASTER%缠绕得更加紧密的同时、
PRINTFORMW 手の動きを緩めることなく、射精中のペニスを容赦なく責め立ててくる……！	PRINTFORMW 手部的运动仍旧没有停止、毫不留情地责备着射精中的阴茎……
PRINTFORML 上半身に感じる柔らかな感触と、下半身に与えられる激しい刺激に、	PRINTFORML 上半身感觉到的柔软触感和下半身被给予的激烈刺激交织在一起、
PRINTFORMW %CALLNAME:MASTER%は%CALLNAME:TARGET%の手の中にドクドクと白濁を漏らし続けることしか出来ない……	PRINTFORMW %CALLNAME:MASTER%只能在%CALLNAME:TARGET%手中不断地吐出透明和白浊……
PRINTFORMW 「……ん、これで打ち止めだな。後片付けは先生がやっておくから、%CNAME("二人称")%は先に教室へ戻ってろ」	PRINTFORMW 「嗯、就到这里吧。收拾工作由老师来做、%CNAME("二人称")%就先回教室吧」
PRINTFORMW %CALLNAME:TARGET%にせっつかれた%CALLNAME:MASTER%は余韻に浸る暇もなく、ふらつきながら身支度を整えはじめた……	PRINTFORMW 沉浸在快乐的余韵中的%CALLNAME:MASTER%听从%CALLNAME:TARGET%、摇摇晃晃地开始整理打扮……
PRINTFORMW %CALLNAME:MASTER%は%CALLNAME:TARGET%に咥えられたまま、ドクドクと精を漏らした……	PRINTFORMW %CALLNAME:MASTER%的那里被%CALLNAME:TARGET%含在口中、咕嘟咕嘟地漏出了精液……
PRINTFORMW 「んんッ！！　んっ……ふぅっ……。ぢゅっ、じゅうぅぅ……ぢゅうぅぅ……」	PRINTFORMW 「嗯唔！！！嗯……嗯……呼~。那么……那么……」
PRINTFORML %CALLNAME:TARGET%は喉を叩く精の勢いに一瞬驚くもすぐに平静を取り戻し、	PRINTFORML %CALLNAME:TARGET%在一瞬间被气势汹汹冲击喉咙的精液吓到了、不过马上又恢复了平静。
PRINTFORMW 先端を吸い上げながら根元部分を手でしごきあげて、射精中のペニスを容赦なく責め立てる……！	PRINTFORMW 一边吸着尖端、一边用手玩弄着根部、毫不留情地责备着射精中的阴茎……！
PRINTFORML %CALLNAME:MASTER%は尿道に残る精液まで一滴残らず吸い上げられ、	PRINTFORML %CALLNAME:MASTER%尿道里残留的精液被一滴不剩地吸干净了。
PRINTFORMW ようやく口腔から開放された時には、自身の陰茎に精液汚れは少しもなく、完全に芯を失ってくったりとしていた……	PRINTFORMW 好不容易从口腔中被释放出来的时候、阴茎上不仅没有任何精液污垢、也完全失去了精神……
PRINTFORMW 「……んっ、これですっきりしたな？　後片付けは先生がやっておくから、%CNAME("二人称")%は先に教室へ戻ってろ」	PRINTFORMW 「嗯、这样就清爽了吧？收拾工作由老师来做、%CNAME("二人称")%先回教室去吧」
PRINTFORMW %CALLNAME:MASTER%は%CALLNAME:TARGET%の乳房に包まれたまま、ドクドクと精を漏らした……	PRINTFORMW %CALLNAME:MASTER%的阴茎被%CALLNAME:TARGET%的乳房包裹着、咕嘟咕嘟地泄出了精液……
PRINTFORMW 「んっ、出たな……。ほら……全部出して、すっきりしろ」	PRINTFORMW 「嗯、出来了……看……全部痛快地射出来了哦」
PRINTFORML %CALLNAME:MASTER%の肉棒は%CALLNAME:TARGET%の双丘の強い圧迫の中でしごかれ、	PRINTFORML %CALLNAME:MASTER%的肉棒在%CALLNAME:TARGET%双丘的强烈压迫下持续被责备着、
PRINTFORMW びゅくびゅくと最後の一滴まで徹底的に搾り取られる……っ！	PRINTFORMW 直到被战战兢兢地榨取到一滴……也不剩。
PRINTFORML ……しばらくして、その柔らかな牢獄がゆっくりと持ち上げられると、	PRINTFORML 过了好一会儿、那柔软的牢狱才缓缓地打开。
PRINTFORMW 芯を失ってくったりとした陰茎が、ポロンと弱々しく現れた……	PRINTFORMW 放出了被榨取后无精打采的弱气肉棒……
PRINTFORMW 「よし、これでいいな。後片付けは先生がやっておくから、%CNAME("二人称")%は先に教室へ戻ってろ」	PRINTFORMW 「嗯、这样就好了。收拾工作由老师来做、%CNAME("二人称")%先回教室去吧」
PRINTFORML %CALLNAME:MASTER%は%CALLNAME:TARGET%の臀部にびたんと下腹部を密着させると、	PRINTFORML %CALLNAME:MASTER%的下腹和%CALLNAME:TARGET%的臀部紧密地贴合着、
PRINTFORMW 剛直の先端を子宮口に密着させてドクドクと精を漏らした……	PRINTFORMW 用刚直的前端顶住子宫口、咕咚咕咚地灌入了精液……
CALL PRINT_STR, "「あっ、やっ……_H_　精子……出てる……_H_　お腹の中……あっつい……んっ_H_」_W"	CALL PRINT_STR, "「啊、果然……_H_精子......满出来……_H_在肚子里……哈啊~……嗯~_H_」_W"
PRINTFORML %CALLNAME:TARGET%の膣壁は奥へ奥へと飲み込むような卑猥な動きで伸縮を繰り返し、	PRINTFORML %CALLNAME:TARGET%里面的膣壁像吞咽一样反复猥亵地运动收缩着、
PRINTFORMW %CALLNAME:MASTER%の肉槍はその動きに従って、ビュッビュッと精液を搾り取られる……	PRINTFORMW %CALLNAME:MASTER%的肉枪被蜜穴蠕动着榨取精液……
PRINTFORML 欲望をすべて出しきった%CALLNAME:MASTER%は腰を引いて、すっかり芯を失った陰茎を抜き取ると	PRINTFORML 将欲望全部释放出来%CALLNAME:MASTER%运起腰、把已经失去精神的阴茎抽了出来。
PRINTFORMW 白濁を滴らせる%CALLNAME:TARGET%の秘裂を拭うこともせず、そのままショーツとズボンを履かせた……	PRINTFORMW %CALLNAME:TARGET%并没有擦拭还在滴落白浊的秘裂、就那样穿上内裤和裤子……
CALL PRINT_STR, "「……この状態で、授業に出ろ……と？　こ、の……変態め……_H_」_W"	CALL PRINT_STR, "「……就用这种状态去上课吧……嗯？嗯哼~……变态……_H_」_W"
PRINTFORMW %CALLNAME:TARGET%は口では悪態をつきながらも、顔は完全に雌の表情で蕩けさせていた……	PRINTFORMW %CALLNAME:TARGET%虽然嘴上还开着玩笑、但脸上完全是一副雌性的表情了……
PRINTFORMW 「あ、すごい……んっ……脈打って……。射精、してるん、だな……？」	PRINTFORMW 「啊、好厉害啊……嗯……脉动着……你、要射了……是吧……？」
PRINTFORML %CALLNAME:TARGET%は膣内での脈動に気づくと、搾り取るように膣壁を起用に伸縮させ、	PRINTFORML %CALLNAME:TARGET%注意到在体内的脉动、榨取似地收缩着膣穴、
PRINTFORMW %CALLNAME:MASTER%はそれに従って、肉棒の先端からビュッビュッとゴムの中に白濁を吐き出した……	PRINTFORMW 紧接着、%CALLNAME:MASTER%从肉棒前端的不断地向套套里射出白浊……
PRINTFORML 欲望をすべて出しきった%CALLNAME:MASTER%が腰を引くと、芯を失った陰茎だけがずるりと抜け落ち、	PRINTFORML 已经将欲望全部释放出来的%CALLNAME:MASTER%拔出了已经饱受摧残的小兄弟、
PRINTFORMW 白濁が滴るゴムの口だけが%CALLNAME:TARGET%の陰唇から顔を出したままという、卑猥な光景が出来上がった……	PRINTFORMW 滴落着白浊的避孕套夹在%CALLNAME:TARGET%的阴唇之间、下流的光景就这么呈现在面前……
PRINTFORMW 「……これで、すっきり、したな？　後は先生が、やっておくから……先に、行け」	PRINTFORMW 「…………这样很爽吧？好啦、之后老师会做好善后的……你先走吧！」
PRINTFORMW %CALLNAME:MASTER%は、腰を引くつかせながら余韻にひたる%CALLNAME:TARGET%を残して、その場を後にした……	PRINTFORMW %CALLNAME:MASTER%留下还沉浸在动着腰的余韵之中的%CALLNAME:TARGET%、离开了这里……	
PRINTFORMW 「わっ……なんだ、いきなり。ちょっと、今汗かいてるんだから、離れろって……」	PRINTFORMW 「哇……什么呀、突然在这儿。我现在一身是汗、快走吧……」
PRINTFORMW 「は？　いい匂いだって？　何馬鹿なこと言って――あ、ちょ、胸に顔をうずめるな……嗅ぐな！　馬鹿ッ！！」	PRINTFORMW 「什么？味道好？说什么傻话——啊、喂、不要把脸贴在胸口啊……不要闻啊！笨蛋！！」
PRINTFORMW 「わっ……なんだ、いきなり。びっくりするじゃないか」	PRINTFORMW 「哇……什么呀、突然。吓了我一跳啊？」
PRINTFORMW 「おっと……。はは、まさかこう返されると思わなかったな」	PRINTFORMW 「哦……哈哈、没想到会被这么打招呼呢」
PRINTFORMW 「……って、おい。なんか硬いものが、お腹に当たってるんだが……？」	PRINTFORMW 「……哎、喂。总觉得有什么硬硬的东西碰到肚子了……」
PRINTFORMW 精力溢れる%CALLNAME:MASTER%のペニスは、衣服越しでもわかるほどに勃起していた……	PRINTFORMW %CALLNAME:MASTER%精力充沛到溢出的阴茎、隔着衣服越发地勃起了……
PRINTFORMW 「%CNAME("二人称")%は甘えん坊だな、まったく……ほら、これでいいんだろう？」	PRINTFORMW 「%CNAME("二人称")%真是个爱撒娇的孩子呢、真是的……你看、这样可以吗？」
PRINTFORMW %CALLNAME:TARGET%は呆れながらも口元を緩ませて、%CALLNAME:MASTER%を抱きしめ返してくれた……	PRINTFORMW %CALLNAME:TARGET%虽然很惊讶、但却禁不住嘴角上扬、紧紧抱住了%CALLNAME:MASTER%……
PRINTFORMW 「みんなに見られてるというのに……まったく、仕方ないやつだな」	PRINTFORMW 「明明大家都看着……真是个没办法的家伙」
PRINTFORMW そう言いながらも%CALLNAME:TARGET%は%CALLNAME:MASTER%の背中に腕を回して抱きしめ返してくれた……	PRINTFORMW 虽然这么说、但%CALLNAME:TARGET%抱着%CALLNAME:MASTER%的手臂却越收越紧了……
PRINTFORMW 「んんっ……！？　い、いきなり何を――は？　挨拶……？」	PRINTFORMW 「嗯……！？突然想干什么——？打招呼吗……？」
PRINTFORMW 「……まったく、お前という奴は……見境がないというかなんというか……」	PRINTFORMW 「……真是的、你这家伙……没头没脑的……」
PRINTFORMW %CALLNAME:TARGET%は呆れながらも、%CALLNAME:MASTER%の挨拶を受け入れてくれたようだった。	PRINTFORMW %CALLNAME:TARGET%虽然很吃惊、但还是和%CALLNAME:MASTER%寒暄了起来。
PRINTFORMW 「んっ……！　ちゅっ…くっ…ぅんっ……」	PRINTFORMW 「嗯……！哈…呃……嗯……」
PRINTFORMW %CALLNAME:TARGET%は一瞬驚きの表情を浮かべたが、すぐに顔を蕩けさせ、体を密着させて舌を絡めてくる……	PRINTFORMW %CALLNAME:TARGET%脸上浮现出短暂的惊讶、但神情马上就软化了、紧贴着身体、将舌头缠绕起来……
PRINTFORMW しばらくして%CALLNAME:MASTER%が口を離すと、銀色の糸が互いの唇を繋ぐように引かれた……	PRINTFORMW 暂时和%CALLNAME:MASTER%的嘴唇分开时、两人的嘴唇之间拉起了银色的丝线……
PRINTFORMW 「…………もっと……」	PRINTFORMW 「………还要……」
PRINTFORMW %CALLNAME:MASTER%は%CALLNAME:TARGET%に腕を首に回され、挨拶の域を超えてキスを求められた……	PRINTFORMW %CALLNAME:MASTER%被%CALLNAME:TARGET%用手臂环抱住脖子、不顾一切地继续要求着接吻……
PRINTFORMW 「……んっ……」	PRINTFORMW 「……嗯……」
PRINTFORMW 「――その、なんだ。挨拶のキスなんて、旦那にもあんまりしないから、ちょっと恥ずかしいな……」	PRINTFORMW 「——那个、什么。打招呼接吻什么的、和老公也没有做过、有点不好意思呢……」
PRINTFORMW %CALLNAME:TARGET%は照れくさそうにしながらも、%CALLNAME:MASTER%のキスを受け入れてくれた……	PRINTFORMW %CALLNAME:TARGET%虽然有些害羞、但还是接受了%CALLNAME:MASTER%的吻……
PRINTFORMW 「ああ、%GREETING%」	PRINTFORMW 「啊！%GREETING%」
PRINTFORMW %CALLNAME:TARGET%は凛々しく整った顔に柔らかな笑みを浮かべて、挨拶を返してきた。	PRINTFORMW %CALLNAME:TARGET%凛然地整理了柔软的笑脸、结束了寒暄。
PRINTFORMW 「ふふっ、ちゃんと返事してくれたな。よしよし……えらいぞ」	PRINTFORMW 「呵呵、有好好地回应我啊。好吧……真不错呢」
PRINTFORMW %CALLNAME:TARGET%は満足げな笑みを浮かべると、%CALLNAME:MASTER%の頭をぐしぐしと撫でてきた……	PRINTFORMW %CALLNAME:TARGET%脸上浮现出满足的笑容、用力地抚摸着%CALLNAME:MASTER%的脑袋……
PRINTFORMW 「んぁ……すまない、ちょっと眠ってしまった……」	PRINTFORMW 「嗯……对不起、我一不小心睡着了……」
PRINTFORML 起きがけの%CALLNAME:TARGET%が「んぅ～～」と艶のある息を漏らしながら体を反らすと	PRINTFORML “嗯~~”、刚醒来的%CALLNAME:TARGET%舒展着身体、透出艳丽的气息。
PRINTFORMW 彼女の豊かなバストが、はちきれんばかりに衣服を押し上げ、その美しい曲線をはっきりと浮かび上がらせた……	PRINTFORMW 她丰满的胸部、将衣服鼓鼓地撑了起来、使其美丽的曲线清晰地浮现出来……
PRINTFORMW 「な、なんだ急に……そんな手放しに褒めてくるなんて」	PRINTFORMW 「什么、怎么突然……突然会这么称赞我」
PRINTFORMW 「だが、まぁ……うん。悪い気はしない……かな」	PRINTFORMW 「但是、嘛……嗯。我倒不是觉得反感啦……」
PRINTFORMW %CALLNAME:TARGET%は目をそらしながらも、口元を緩ませて嬉しそうにしている……	PRINTFORMW %CALLNAME:TARGET%躲开了视线、但嘴角却不自觉地放松了、看起来很开心……
PRINTFORMW 「……なんだ。何か悪いことでもしたのか？　先生怒らないから、正直に話してみろ、ん？」	PRINTFORMW 「……什么？你做了什么不好的事吗？老师不会生气的、老实地告诉我、好吗？」
PRINTFORMW ……%CALLNAME:MASTER%の言葉に裏があると思ったのか、%CALLNAME:TARGET%はジト目でこちらを睨みつけてきた……	PRINTFORMW ……觉得%CALLNAME:MASTER%话里有话的%CALLNAME:TARGET%一直盯着这边看……
PRINTFORMW 「……なんだ、その。あんまり褒められ慣れてないから、その……なんだ」	PRINTFORMW 「……什么、那个。因为不太习惯被称赞呢、那个……怎么了？」
PRINTFORMW 「…………照れる…………」	PRINTFORMW 「…………真难为情…………」
PRINTFORMW 「ん……ありがとう」	PRINTFORMW 「嗯……多谢」
PRINTFORMW 「……よしよし」	PRINTFORMW 「……好的」
PRINTFORMW ……撫でられてしまった。	PRINTFORMW ……被抚摸了。
PRINTFORMW 「……うん。知ってる……」	PRINTFORMW 「……嗯。我知道了……」
PRINTFORMW %CALLNAME:TARGET%は瞳を潤ませながら、%CALLNAME:MASTER%の肩に体を預けてきた……	PRINTFORMW %CALLNAME:TARGET%用湿润的眼神看着你的同时、那身体依偎在%CALLNAME:MASTER%的肩膀上。
PRINTFORMW 「……あ、う……その、えっと、だな……」	PRINTFORMW 「……啊、呜……那个、那个……嗯……」
PRINTFORML %CALLNAME:TARGET%は頬を朱に染めて、キョロキョロとあっちこっちへ視線を向けた後、	PRINTFORML %CALLNAME:TARGET%脸颊整个红透了、眼神东躲西藏地游离着、
PRINTFORMW 熱を帯びた瞳で%CALLNAME:MASTER%を見つめながら、口を開いた	PRINTFORMW 用炙热的眼睛凝视着%CALLNAME:MASTER%的同时、嘴巴微微地张开
PRINTFORMW 「わ、%CNAME("一人称")%も――いや、やっぱり……なんでもない……」	PRINTFORMW 「嗯、%CNAME("一人称")%也——不、果然……没什么……」
PRINTFORMW 「……ッッッ～～～！！！」	PRINTFORMW 「……滋滋滋～～～！！！」	
PRINTFORML %CALLNAME:TARGET%は「ぼんっ！」と効果音が聞こえそうな勢いで顔を真っ赤にした後、	PRINTFORML 似乎能听到“砰！”的声音、%CALLNAME:TARGET%的脸颊整个红透了
PRINTFORMW %CALLNAME:MASTER%の胸板に顔を押し付けて、しばらく体をぷるぷると震わせていた……	PRINTFORMW 把脸埋进%CALLNAME:MASTER%的胸膛中、身体颤抖了好一会儿……
PRINTFORMW 「……まったく。どこでそういう言葉を覚えてくるんだ？」	PRINTFORMW 「……真是的。你在哪里能学会这些话啊？」
PRINTFORMW %CALLNAME:TARGET%は平静を保とうとしているが、どことなく頬が緩んでいる……	PRINTFORMW %CALLNAME:TARGET%虽然想要保持平静、但总觉得表情放松了下来……
PRINTFORMW 「はいはい、どうもどうも。%CNAME("一人称")%も愛してるよー」	PRINTFORMW 「好的、谢谢。我也喜欢%CNAME("一人称")%呦」
PRINTFORMW ……どうやら、本気と受け取ってくれなかったようだ……	PRINTFORMW ……看来、她还是没有完全地接受……
PRINTFORMW 「なに？　今どんなパンツを履いてるか……だと？　おっさんか、%CNAME("二人称")%は」	PRINTFORMW 「什么？现在穿着什么内裤……？%CNAME("二人称")%怎么像个猥琐大叔一样啊」
PRINTFORMW 「馬鹿なことばかり言ってないで、少しは真面目に自習でもしたらどうだ？」	PRINTFORMW 「别老说些傻话、稍微认真地自习一下怎么样？」
PRINTFORMW 「授業でわからないこととか、あったりしないか？」	PRINTFORMW 「上课时有没有什么不明白的地方？」
PRINTFORMW 「体育以外の教科でも、少しぐらいなら教えてやれるぞ」	PRINTFORMW 「体育以外的课程、我也可以稍微地教一下的」
PRINTFORMW 「いい天気だなぁ。こう、気持ちのいい日だと……あれだな」	PRINTFORMW 「天气真好啊。让人心情舒畅呢……是吧」
PRINTFORMW 「冷たいビールが飲みたくなる」	PRINTFORMW 「想喝冰镇啤酒呢」
PRINTFORMW ……残念な体育教師が、なんか残念なことを口走っている……	PRINTFORMW ……残念的体育教师、说着什么残念的事……
PRINTFORMW 「……もぐもぐもぐ……。ん？　何を食べているのかって？」	PRINTFORMW 「……咀嚼咀嚼……。嗯？问我在吃什么？」」
PRINTFORMW 「メロンパンだ。小腹が空いたから、さっき購買で買ってきた」	PRINTFORMW 「是菠萝包。肚子有点饿、刚才买回来了」
PRINTFORMW 「%CNAME("一人称")%は好きなんだが、放課後になっても売れ残ってるんだよな。こんなに美味しいのに……」	PRINTFORMW 「%CNAME("一人称")%喜欢吗、虽然是放学后卖剩下的就是了。明明这么好吃……」
PRINTFORMW 「まっ、おかげで%CNAME("一人称")%は半額でコレを買えるわけだから、文句はないがな♪」	PRINTFORMW 「呐、托你的福~%CNAME("一人称")%半价就能买到这个、也没什么可抱怨的♪」
PRINTFORMW 「なぁ……暇してるなら、マッサージでもしてくれないか？」	PRINTFORMW 「呐……你有空的话、可以给我做个按摩吗？」
PRINTFORMW 「教師という仕事もなかなかハードでな。もう肩が凝って肩が凝って……」	PRINTFORMW 「教师这个工作也挺辛苦的。肩膀已经好累了啊、好酸……」
PRINTFORML そう言いながら%CALLNAME:TARGET%が自ら拳で肩を叩くと、	PRINTFORML 一边说着、%CALLNAME:TARGET%一边自己用拳头拍打着肩膀、
PRINTFORM 競泳水着に包まれた	PRINTFORM 被泳衣包裹着的
PRINTFORM ジャージ越しでも存在感のある	PRINTFORM 即使透过运动衫也相当有存在感的
PRINTFORMW 豊満なバストがそれに合わせてプルンプルンと振動する……	PRINTFORMW 丰满的胸围配合着按摩运动着……
PRINTFORMW ……肩の凝りは、決して労働だけが原因ではないだろう……	PRINTFORMW ……肩膀的酸痛绝不仅仅是因为劳作吧……
PRINTFORMW 「拭いてくれるのか？　それはありがたいが……なんだか恥ずかしいな」	PRINTFORMW 「能帮我擦一下吗？那太好了……总觉得有点害羞呢」
PRINTFORMW 「すまないな。仕事上、よく汗を掻くから……助かるよ」	PRINTFORMW 「麻烦你了啊。因为工作时候经常出汗……啊~得救了」
PRINTFORMW %CALLNAME:TARGET%は服をはだけさせると、%CALLNAME:MASTER%の奉仕に身を委ねた……	PRINTFORMW %CALLNAME:TARGET%脱掉了衣服、委身于%CALLNAME:MASTER%的奉仕之中……
PRINTFORMW 「んっ……ふっ……。あぁ、冷たい濡れタオルが気持ちいいな……」	PRINTFORMW 「嗯……哼……啊~湿湿凉凉的毛巾真舒服啊……」
PRINTFORMW 「――なぁ。ブラジャーの中も、結構蒸れてるんだが……拭いてくれるか？」	PRINTFORMW 「——呐。胸罩里面的地方也很闷得慌……能帮我擦一下吗？」
PRINTFORML %CALLNAME:TARGET%は艷やかな笑みを浮かべながら、身につけている	PRINTFORML %CALLNAME:TARGET%浮现出妖艳的笑容、展示着美丽的身姿。
PRINTFORMW %PANTIES(TARGET)%を引っ張って深い谷間をちらつかせながら、こちらを誘ってきた……	PRINTFORMW 拉开的%PANTIES(TARGET)%的里面性感的深谷若隐若现、发出诱人的邀请……
PRINTFORMW 「……冗談だ。もうその辺でいいよ。だいぶさっぱりした、ありがとう」	PRINTFORMW 「……开个玩笑~。就这样吧。很清爽呢、谢谢你啦」
PRINTFORMW %CALLNAME:TARGET%は先程の色気を瞬時に引っ込めると、服を着直し、元の席に戻っていった	PRINTFORMW %CALLNAME:TARGET%瞬间收回刚才的魅惑姿态、穿好了衣服、回到原来的位置。
PRINTFORMW ……どうやら、からかわれたようだ	PRINTFORMW ……感觉好像被戏弄了
PRINTFORMW 「……あっ……んっ……」	PRINTFORMW 「……啊……嗯……」
PRINTFORML %CALLNAME:MASTER%が背後から%CALLNAME:TARGET%の体に	PRINTFORML %CALLNAME:MASTER%通过后背感受着%CALLNAME:TARGET%的身体。
PRINTFORMW 濡れタオルを這わせるたび、彼女の唇から甘い吐息が漏れ出てくる……	PRINTFORMW 每当湿毛巾擦拭时、她的嘴唇就会流出甜蜜的呼吸……
PRINTFORMW %CALLNAME:MASTER%は人妻の色気にドキドキしながらも、懸命に奉仕に努めた……	PRINTFORMW %CALLNAME:MASTER%虽然因为人妻的魅力而心跳不已、但还是努力为其服务着……
PRINTFORMW 「……なぁ。さっきから硬いものが、お尻に当たってるんだが……？」	PRINTFORMW 「……呐。从刚才开始就有什么硬硬的东西顶着我的屁股呢……？」
PRINTFORMW ……それは不可抗力ということで、許していただきたい……	PRINTFORMW ……这是不可抗力、请原谅……
PRINTFORMW 「まったく……隙あらばそうやって……本当におっぱいが好きだな、%CNAME("二人称")%は」	PRINTFORMW 「真是的……趁隙这么做……真的是好喜欢胸部呢、%CNAME("二人称")%」
PRINTFORMW 「だがまぁ……悔しいがホントに楽だな、これ。あぁ～……肩が軽い……」	PRINTFORMW 「但是……虽然很不甘心、但真的很舒服。啊……肩膀变轻了……」
PRINTFORMW 衣服越しでもわかる、このハリ、この柔らかさ、この形の良さ……	PRINTFORMW 透过衣服也能明白、这个弹力、这个柔软、这个形状的美妙……
PRINTFORMW 何よりこの、両の手のひらで支えてもなお有り余るボリュームと重量……	PRINTFORMW 比什么都……用双手支撑着也觉得沉甸甸的重量……
PRINTFORML この完璧なおっぱい……もとい“おっぱい様”を支えさせていただけている自分は、	PRINTFORML 这完美的胸部……一直托着“胸部大人”的我、
PRINTFORMW 今この瞬間、世界で誰よりも幸福な存在であると、心の底から自信をもって宣言できる……	PRINTFORMW 现在这个瞬间、能够从心底充满自信地宣布、自己是这个世界上最幸福的人……
PRINTFORMW 「きっと%CNAME("二人称")%は、自分がいかにアホなことをしているのか、分かってないんだろうな」	PRINTFORMW 「%CNAME("二人称")%一定想不到、自己现在到底在做一件多么愚蠢的事情」
PRINTFORMW 「……なぁ」	PRINTFORMW 「……呐」
PRINTFORMW 「ずっとそうやって、おっぱい支えてるだけで楽しいのか？」	PRINTFORMW 「一直这样、只是支撑着胸部就很开心吗？」
PRINTFORMW 「おーい、聞こえてるかー？」	PRINTFORMW 「喂、听到了吗？」
PRINTFORMW 「……はぁ。もういいや……気の済むまでやってくれ」	PRINTFORMW 「……哈哈。算了……随便你吧~」
PRINTFORMW ゆっさ、ゆっさ、ゆっさ、ゆっさ。	PRINTFORMW 摇晃、摇晃、摇晃、摇晃。	
PRINTFORMW たゆん、たゆん、たゆん、たゆん。	PRINTFORMW 丰满、丰满、丰满、丰满。
PRINTFORMW もょん、もょん、もょん、もょん。	PRINTFORMW 晃动、晃动、晃动、晃动。
PRINTFORMW たっぽん、たっぽん、たっぽん、たっぽ――	PRINTFORMW 柔软、柔软、柔软、柔软――
PRINTFORMW 「……えぇいッ！！　人の胸で、いつまで遊んでるつもりだッ！？」	PRINTFORMW 「……哎呀！你打算玩弄人家的胸到什么时候！？」
PRINTFORMW 怒られてしまった……	PRINTFORMW 生气了……
PRINTFORMW 「……本当に、マッサージするだけ……だろうな……？」	PRINTFORMW 「……真的、只是按摩而已……吗……？」
PRINTFORMW 「マッサージ、か……。わかった……よろしく、頼む」	PRINTFORMW 「按摩…吗……知道了……请多关照」
PRINTFORMW %CALLNAME:TARGET%は火照った体をぎゅっと自ら抱きしめると、覚悟を決めた顔で%NAMES("ベッド")%に横たわった	PRINTFORMW %CALLNAME:TARGET%紧紧地抱住了自己炙热的肉体、好像有所觉悟的样子躺在%NAMES("床")%上
PRINTFORMW 「お、いいのか？　じゃあ、お言葉に甘えて……」	PRINTFORMW 「哦、可以吗？那么就恭敬不如从命了……」
PRINTFORMW 「なかなか気が利くじゃないか。んじゃ、よろしく頼むよ」	PRINTFORMW 「你很会察言观色啊~。那就拜托你了」
PRINTFORMW さて……どうする？	PRINTFORMW 那么……怎么办呢？
PRINTFORMW %CALLNAME:MASTER%は%CALLNAME:TARGET%の肩周りを%TEXTR("優しく/丁寧に")%揉みほぐした……	PRINTFORMW %CALLNAME:MASTER%%TEXTR("温柔/仔细")%地揉着%CALLNAME:TARGET%的肩膀周围……	
PRINTFORMW %CALLNAME:MASTER%は%CALLNAME:TARGET%の引き締まった細い腰を%TEXTR("優しく/丁寧に")%揉みほぐした……	PRINTFORMW %CALLNAME:MASTER%%TEXTR("温柔/仔细")%地揉着%CALLNAME:TARGET%紧致的细腰……
PRINTFORMW %CALLNAME:MASTER%は%CALLNAME:TARGET%のすらりとした足を%TEXTR("優しく/丁寧に")%揉みほぐした……	PRINTFORMW %CALLNAME:MASTER%%TEXTR("温柔/仔细")%地揉着%CALLNAME:TARGET%修长的双足……
PRINTFORMW 「んっ……あっ……。な、なぁ、もっと――いや、なんでも、ない……」	PRINTFORMW 「嗯……啊……。呐、呐、再来——不、没什么……」
PRINTFORMW 「ふぁっ……ぅんっ……。や、そこじゃな――い、いや、すまん……続けてくれ」	PRINTFORMW 「哼……嗯……。不、不是那里——不是、不、啊~啊~……请继续」
PRINTFORMW %CALLNAME:TARGET%は%CALLNAME:MASTER%のマッサージに身を任せるも、どこか物足りなさげに身を震わせていた	PRINTFORMW 虽然%CALLNAME:TARGET%已经任凭%CALLNAME:MASTER%摆布了、但总觉得有些不够舒服的样子、身体微微颤抖着。
PRINTFORMW 「あ～そこそこ……。なかなか、んっ、上手いじゃないか」	PRINTFORMW 「啊～那里……舒服、嗯、这不是挺擅长嘛」
PRINTFORMW 「んっ……んっ……。気持ちいいな……このまま、眠ってしまいそうだ……」	PRINTFORMW 「嗯……嗯……好舒服啊……就这样、舒服到快要睡着了……」
PRINTFORMW %CALLNAME:TARGET%は体をリラックスさせて、%CALLNAME:MASTER%のマッサージに身を委ねた……	PRINTFORMW %CALLNAME:TARGET%放松了身体、委身于%CALLNAME:MASTER%的服务……
PRINTFORML %CALLNAME:MASTER%は%CALLNAME:TARGET%の豊かに膨らんだ乳房の周りを、	PRINTFORML %CALLNAME:MASTER%按摩着%CALLNAME:TARGET%丰满的乳房周边。
PRINTFORMW 決して本体には触れることなく、その美しい輪郭だけをなぞるようにして揉みほぐした……		PRINTFORMW PRINTFORMW 却绝不触及乳房本体、只描画出胸部美丽的轮廓、按摩着……
PRINTFORMW %CALLNAME:MASTER%は%CALLNAME:TARGET%を仰向けにして、恥骨周辺をじっくりと揉みほぐした……	PRINTFORMW %CALLNAME:TARGET%仰面躺着、%CALLNAME:MASTER%按摩着她耻骨的周边……	
PRINTFORML %CALLNAME:MASTER%は%CALLNAME:TARGET%をうつ伏せにして、そのすらりとした足の付け根部分を	PRINTFORMW %CALLNAME:TARGET%仰面躺着、%CALLNAME:MASTER%按摩着她脚跟的周边……	
PRINTFORMW 柔らかくも張りのある臀部とともに、じっくりと揉みほぐした……	PRINTFORMW 按摩着柔软而有张力的臀部……
CALL PRINT_STR, "「ふぁっ……ぅんっ……_H_　や、これ……マッサージじゃな……あっ！　やっ、はぁんっ……_H_」_W"	CALL PRINT_STR, "「哼……嗯……_ H_哎、这个……不是按摩……啊！啊、哈……_H_H_」_W"
CALL PRINT_STR, "「あっ……やぁっ……_H_　こ、こら……手つきが、やらし……んあっ！　あっいっ、んんぅっ……_H_」_W"	CALL PRINT_STR, "「啊……哎呀……_H_喂……动作、动作大一点……啊！啊、嗯……_H_」_W"
PRINTFORMW 「あっ……やっ……！　お、おい……これは、マッサージなのか……あっ、はぁっ……！」	PRINTFORMW 「啊……哎呀……！喂、喂……这是按摩吗……啊、哈……！」
PRINTFORMW 「ふぅっ……ぅんっ……！　た、たしかに気持ちいいが、ちょっとやり過ぎな……んんぅっ……！」	PRINTFORMW 「呼……呼……嗯……！确实很舒服、但是有点做过头了……嗯……！」
PRINTFORMW その瑞々しい柔肌に%CALLNAME:MASTER%の指が沈むたび、%CALLNAME:TARGET%は悩ましげな声を漏らした……	PRINTFORMW 每当%CALLNAME:MASTER%的手指没入那娇嫩柔嫩的肌肤时、%CALLNAME:TARGET%就发出苦恼的声音……
PRINTFORMW 「――ちゅ、んっ……。いつまで続けるつもりなんだ、まったく……んっ」	PRINTFORMW 「——嗯、哈……。打算持续到什么时候、真是的……嗯」
PRINTFORMW %CALLNAME:TARGET%はぶつくさ言いながらも、%CALLNAME:MASTER%の唇へキスを返した……	PRINTFORMW %CALLNAME:TARGET%嘟囔着、却还是吻着%CALLNAME:MASTER%的嘴唇……
PRINTFORMW 「ちょ、こら。くすぐったいじゃないか……」	PRINTFORMW 「喂、喂。这不是……」
PRINTFORMW %CALLNAME:MASTER%は%CALLNAME:TARGET%の唇や頬に、啄むような軽いキスを何度も捧げた……	PRINTFORMW %CALLNAME:MASTER%贴近%CALLNAME:TARGET%的嘴唇和脸颊、不断地献上啄食般轻柔的吻……
PRINTFORMW 「いいのか？　じゃあ、遠慮なく……」	PRINTFORMW 「可以吗？真的可以吗？那么、别客气……」
PRINTFORMW 「……ふぅむ。可もなく不可もなく、ってところかな……」	PRINTFORMW 「……唔。不好也不坏、感觉非常地普通……」
PRINTFORMW 「ん？　おお……悪いな。いただこう」	PRINTFORMW 「嗯？哦……不好意思啊。我不客气了」
PRINTFORMW %CALLNAME:TARGET%は%CALLNAME:MASTER%が淹れたお茶をズズッと一口すする	PRINTFORMW %CALLNAME:TARGET%噗哧一口喝干了%CALLNAME:MASTER%泡的茶。
PRINTFORMW 「……ん、美味い。ありがとうな」	PRINTFORMW 「……嗯、很好喝。谢谢你」
PRINTFORMW 「……あむっ……んもんも……んむっ、んむっ……」	PRINTFORMW 「……啊……嗯哈……嗯、嗯……」
PRINTFORMW %CALLNAME:TARGET%は机の下に隠れながら、ファスナーから飛び出たパンツ越しのペニスを口で咥えてきた	PRINTFORMW %CALLNAME:TARGET%躲在桌子下面、嘴里叼着从拉链里伸出来的肉棒。
PRINTFORMW 舌を這わせ、唇をすぼめてしごかれるたび、熱を帯びた唾液がじんわりと布地に染み込んでくる……	PRINTFORMW 每当舌头舔弄时、嘴唇就会收缩、带着热量的唾液就会慢慢从口中渗出到裤子上……	
PRINTFORMW %CALLNAME:TARGET%は周りに気取られないよう、%CALLNAME:MASTER%のズボンの中に手を差し込んでくる	PRINTFORMW 为了不让周围的人注意到、%CALLNAME:TARGET%把手伸进了%CALLNAME:MASTER%的裤子里面。
PRINTFORMW そのままパンツごと%CALLNAME:MASTER%のペニスを握りしめると、シコシコとズボンの中でしごきはじめた……	PRINTFORMW 就这样紧握裤子里%CALLNAME:MASTER%的肉棒、开始在裤子里套弄了起来……
PRINTFORMW 「……声は出すなよ。みんなにバレてしまうからな……♪」	PRINTFORMW 「……不要发出声音。否则会被大家发现的呦……♪」
PRINTFORMW 「なぁ……まだしないのか……？」	PRINTFORMW 「呐……还不开始吗……？」
PRINTFORMW 「%CNAME("一人称")%のココは、早く気持ちよくなりたいーって言ってるぞ？　ほらほら……ふふふっ♪」	PRINTFORMW 「%CNAME("一人称")%的那里、好像想要早点一吐为快呢？你看……呵呵♪」
PRINTFORMW 「ふふっ……隙だらけだったぞ」	PRINTFORMW 「呼呼……满是破绽呢」
PRINTFORMW 「ほら……こうされるの、好きだろ？」	PRINTFORMW 「看……喜欢这样吗？」
PRINTFORMW 「なぁ……まだ、しないのか？」	PRINTFORMW 「呐……还不开始吗」
PRINTFORMW 「このおっぱい、%CNAME("二人称")%の好きにしていいんだぞ。だから……な？」	PRINTFORMW 「这个胸部、%CNAME("二人称")%可以随便玩弄呦。所以……啊~？」
PRINTFORMW 「ふふふ……♪」	PRINTFORMW 「呵呵……♪」
PRINTFORMW 豊満なバストが%CALLNAME:MASTER%の体にグニグニと押し付けられる……	PRINTFORMW 丰满的胸围被%CALLNAME:MASTER%的身体紧紧地压住了……
PRINTFORMW 「はぁっ……んっ……。なぁ……まだ、しないのか……？」	PRINTFORMW 「啊~哈……嗯……。呐……还不做吗……？」
PRINTFORMW クイクイと擦りつけられる股間から、しっとりとした湿り気が布越しに感じられる……	PRINTFORMW 从被轻轻摩擦着的股间、隔着布料感到了湿润的气息……
PRINTFORMW 「なんだか眠そうだな？　ほら、%CNAME("一人称")%の膝、使っていいぞ」	PRINTFORMW 「好像很困吧？看、可以使用%CNAME("一人称")%的膝盖呦」
PRINTFORMW 「目が重たそうだな……少し横になるか？　%CNAME("一人称")%の膝、貸してやるから」	PRINTFORMW 「眼皮好像很沉重啊……要躺一会儿吗？%CNAME("一人称")%的膝盖可以借给你呦」
PRINTFORMW 「ちょっと飲みたくなってな、淹れてみたんだ。ほれ、%CNAME("二人称")%もどうだ？」	PRINTFORMW 「我有点想喝茶了、就泡了一杯。来%CNAME("二人称")%、怎么样？」
PRINTFORMW 「うわっ！！　な、なんだ！？　ちょ、こら！　%OUTER(TARGET, "略")%から手を離せ！！」	PRINTFORMW 「哇！！什、什么！？喂、喂！　%OUTER(TARGET, "略")%放开手啊！！！」
PRINTFORMW 「――ったく、なんなんだもう……って、は？　パンツが見たかった……？」	PRINTFORMW 「——真是的、怎么了……啊、你？想看内裤……？」
PRINTFORMW 「……さっき下半身に視線を感じてたのはそれか。まったく、呆れを通り越して感心するよ、ホント……」	PRINTFORMW 「……刚才就稍微感觉到的对下半身的视线原来是这么回事啊。真是的、呆过头了真是让人不知道说什么好、真是……」
PRINTFORMW 「……それならそうと言え。今さら見せるくらい拒んだりしないから……まったく」	PRINTFORMW 「……那就按你说的做吧。事到如今我不会拒绝你了……完完全全~」
PRINTFORM ぴっちりした競泳水着によってはっきりわかる、	PRINTFORM 透过贴身的泳衣可以清楚地了解到、
PRINTFORM ジャージ越しでもはっきりわかる、	PRINTFORM 透过运动衫可以清楚地了解到、
PRINTFORMW きゅっと引き締まったウェストの美しいくびれ	PRINTFORMW 那被紧束着的纤细腰肢是如此美丽。
PRINTFORMW そこから下に拡がるは、成熟した女性特有の、丸みを帯びた安産型のヒップ	PRINTFORMW 从那里向下、则是成熟的女性特有的、安产型的圆润臀部。
PRINTFORMW 男の欲情を掻き立てるそのグラマラスなボディに、%CALLNAME:MASTER%は思わず生唾を飲んだ	PRINTFORMW 对着这激发男人欲望的丰满肉体、%CALLNAME:MASTER%禁不住流出了口水。
PRINTFORMW 「……おい。なんだ、さっきからチラチラと。なんか体に付いてるのか？」	PRINTFORMW 「……喂。怎么了、刚才就一直眼神发光。我身上有什么东西吗？」
PRINTFORMW %CALLNAME:TARGET%は身を翻して身だしなみを確認するが、おかしなところなどはない	PRINTFORMW %CALLNAME:TARGET%前后确认着、但并没有什么奇怪的地方。
PRINTFORMW どうやら彼女は自分の体が男の目にどう映るのか、あまり自覚がないようだ……	PRINTFORMW 看来她对自己的身体在男人眼里是怎么样的、几乎没有什么认知……
PRINTFORMW 変わらずメリハリのいい極上な肢体をしており、どれほど眺めても飽きることはない……	PRINTFORMW 一如既往地凹凸分明的极致肉体、无论怎么看也不会觉得厌倦……
PRINTFORMW 「……なんだ？　%CNAME("一人称")%のお尻になにか付いてるのか？」	PRINTFORMW 「……啊？%CNAME("一人称")%的屁股上有什么东西吗？」
PRINTFORMW 「なんだ、また視線を感じるな……」	PRINTFORMW 「什么嘛、感觉被盯着呢……」
PRINTFORMW 「別に怒ったりしないから、見るならちゃんとこっち向け。逆に気になるだろうが」	PRINTFORMW 「不是在生气啦、一边看着一边向这边过来。反过来肯定会更在意的吧」	
PRINTFORMW 「またか……。そうチラチラ見られると、落ち着かないんだが」	PRINTFORMW 「又来了……被那样的眼神看着、我无法平静下来啊」
PRINTFORMW %CALLNAME:MASTER%は%CALLNAME:TARGET%が視線に無頓着なことをいいことに、じっくりと視姦した……	PRINTFORMW %CALLNAME:MASTER%发现%CALLNAME:TARGET%并没有察觉到自己的视线、于是慢慢地视奸起来……	
PRINTFORMW 「さすがにそう、至近距離で眺められると……恥ずかしいんだが……」	PRINTFORMW 「果然这么近距离被盯着的话……会不好意思……」
PRINTFORMW 「……そんなところ、眺めてて楽しいのか？」	PRINTFORMW 「……在那里看着、就这么开心吗？」
PRINTFORMW 「……そんな顔を近づけられると、息が……んっ、くすぐったい……」	PRINTFORMW 「……脸靠得这么近、气息就……嗯、好痒……」

//EVENT_K18_SHOP.ERB


PRINTFORMW 「……あー、その、なんだ。好意をもってくれるのは、嬉しいんだが……」	PRINTFORMW 「……啊、那个、很高兴你对我有好感……」
PRINTFORMW 「%CNAME("一人称")%が既婚者だということ、忘れたわけじゃないよな？」	PRINTFORMW 「但是%CNAME("一人称")%已经结婚了、你应该不会忘了吧？」
PRINTFORMW 「すまないが……その気持ちには答えてあげられないな」	PRINTFORMW 「不好意思……我真的不能给你答复」
PRINTFORMW 「……何度告白されても、答えは変わらんぞ」	PRINTFORMW 「……无论被告白多少次、答案都不会改变的」
PRINTFORMW 「%CNAME("一人称")%は%CNAME("二人称")%にとってただの……そう、ただの性処理相手に過ぎないのだからな」	PRINTFORMW 「对于%CNAME("一人称")%和%CNAME("二人称")%来说只是……没错、只不过是肉体关系而已」
PRINTFORMW 「……なにかと思えば、%CNAME("二人称")%という奴は……まったく」	PRINTFORMW 「……到底在想什么、%CNAME("第二人称")%这个家伙……完全」
PRINTFORMW %CALLNAME:TARGET%は呆れた表情で額を抑え、ため息をついた……	PRINTFORMW %CALLNAME:TARGET%露出惊讶的表情扶住额头、叹了一口气……
PRINTFORMW 「……ちょっと後ろ向いてろ」	PRINTFORMW 「…………稍微背过去一下」
PRINTFORMW %CALLNAME:MASTER%は言われたとおり後ろを向くと、背後でゴソゴソと布が擦れる音が聞こえはじめた……	PRINTFORMW 听从%CALLNAME:MASTER%所说转过身去、听到背后有稀稀疏疏的布料摩擦声……
PRINTFORMW 「……もういいぞ、こっち向け」	PRINTFORMW 「……好了、可以朝这边看了」
PRINTFORMW %CALLNAME:MASTER%が振り返ると、%CALLNAME:TARGET%が若干頬を染めながら布切れをこちらに差し出していた	PRINTFORMW %CALLNAME:MASTER%回头一看、%CALLNAME:TARGET%脸颊略微染上颜色、向这边递过来……
PRINTFORMW 「……色気のない下着だろう？　こんなもの貰ったところで、%CNAME("二人称")%だって嬉しくなんか――」	PRINTFORMW 「……没有魅力的内衣吧？即使收到了这样的东西、%CNAME("二人称")%也会感到高兴吗――」
PRINTFORMW 「――めちゃくちゃ目が輝いてるな。はぁ……よくわからん」	PRINTFORMW 「——眼睛竟然在闪闪发光呢。哈……让人难懂」
PRINTFORMW 「……またか。まったく、%CNAME("一人称")%の下着なんかで、なにがいいんだか……」	PRINTFORMW 「……又来了。真是的、%CNAME("一人称")%的内衣、该说你什么好呢……」
PRINTFORMW %CALLNAME:TARGET%は文句を言いながらも、%CALLNAME:MASTER%の死角でゴソゴソと下着を脱ぎはじめた……	PRINTFORMW %CALLNAME:TARGET%一边抱怨、一边走到%CALLNAME:MASTER%视野的死角开始脱掉内衣……
PRINTFORMW 「……はぁ。何を馬鹿なことを言ってるんだ、%CNAME("二人称")%は……」	PRINTFORMW 「……哈哈。你在说什么蠢话、%CNAME("二人称")%你……」
PRINTFORMW 「……は？　同棲だと？」	PRINTFORMW 「……什么？同居？」
PRINTFORMW 「そんなこと出来るわけないだろう。家庭があるんだぞ、%CNAME("一人称")%は」	PRINTFORMW 「那种事情不可能做到吧。我是有家室的哦、%CNAME("一人称")%！」
PRINTFORMW 「あ、いや……別に%CNAME("二人称")%と一緒にいたくない、と言ってるわけじゃないんだぞ？」	PRINTFORMW 「啊、不……并不是说不想和%CNAME("二人称")%在一起」
PRINTFORMW 「でも、同棲なんて……旦那がいるのにそんなこと、出来るわけ――」	PRINTFORMW 「但是、同居什么的……明明有老公了、怎么可能做那种事？」
PRINTFORMW ……ピロロロロン♪　ピロロロロン♪	PRINTFORMW ……叮铃铃♪　叮铃铃♪
PRINTFORMW 「……すまん、電話だ。……もしもし？　あ、うん。どうしたの、こんな時間に」	PRINTFORMW 「……对不起、电话来了……喂？啊、嗯。这么晚了、怎么了」
PRINTFORMW 「……え？　そんな……急な話だね。うん、うん……わかった。準備は大丈夫なの？」	PRINTFORMW 「……诶？那种……真是突然啊。嗯、嗯……知道了。已经准备好了吗？」
PRINTFORMW 「そう……わかった。ううん、こっちのことは気にしないで。……うん、ありがとう。気をつけて行ってきてね。じゃあ――」	PRINTFORMW 「是的……知道了。不、不要在意这边。……嗯、谢谢。路上小心，那么——」
PRINTFORMW ……ピッ。	PRINTFORMW ……哔。	
PRINTFORMW 「……旦那が、急に長期出張になった。すぐに出発で、当分戻ってこない、と……」	PRINTFORMW 「老公突然长期出差。马上就要出发了、暂时不会回来……」
PRINTFORMW 「――ああぁぁッ、もう！　わかったわかった！　旦那が帰ってくるまでだからな！？」	PRINTFORMW 「——啊啊啊啊、已经！知道了知道了知道了！直到老公回来为止啊！？」
PRINTFORMW 「ま、また？　いや、この前はたまたま旦那の出張が重なったからで、そう何度も――」	PRINTFORMW 「嘛、又来了？不、上次是因为老公出差、所以就——」
PRINTFORMW 「……旦那が、もどってくるまで、だからな……」	PRINTFORMW 「……直到老公回来为止、所以啊……」
PRINTFORMW 「%CNAME("二人称")%にはメイドがいるんじゃないのか？　彼女に作ってもらえばいいじゃないか」	PRINTFORMW 「%CNAME("二人称")%不是有女仆吗？让她来做就行了」
PRINTFORMW 「ん、また作ってほしいのか？　%CNAME("二人称")%のでよければ、お安い御用だが」	PRINTFORMW 「嗯、还想再做吗？　%CNAME("二人称")%愿意的话、没问题的」
PRINTFORMW 「お弁当？　%CNAME("一人称")%が……%CNAME("二人称")%に？」	PRINTFORMW 「便当？%CNAME("一人称")%为……%CNAME("二人称")%？」
PRINTFORMW 「……まぁ、普段旦那に作ってたし、腕を鈍らせないためにはちょうどいいか」	PRINTFORMW 「……嘛、平时是给老公做的、为了不让手艺退步、不是正好吗？」
PRINTFORMW 「いいだろう、作ってあげるよ」	PRINTFORMW 「好吧、我给你做吧」
PRINTFORMW 「……んー、まぁ毎日旦那に作ってるし、一人分増えたところで問題ないか」	PRINTFORMW 「……嗯、嘛、每天给老公做、增加一人份也没问题的」
PRINTFORMW 「……あのな。こんなこと%CNAME("二人称")%に言うのもアレだが、%CNAME("一人称")%は普通に夫とも営みをしてるんだ」	PRINTFORMW 「……那个。虽然这么对%CNAME("二人称")%说有点那个、但%CNAME("一人称")%本来是过着普通的夫妻生活的」	
PRINTFORMW 「特に理由もないのに生理が止まったら、怪しまれるだろう？」	PRINTFORMW 「没什么特别的理由但是生理期停了、会很奇怪吧？」
PRINTFORMW 「個人的に本番は諦めてもらいたいんだが……まぁ、避妊具があるなら、多少は目を瞑ってやろう」	PRINTFORMW 「我个人其实是不想直接做爱的……如果有避孕用品的话、还算可以接受……」
PRINTFORMW 「……何度頼まれても、駄目なものは駄目だ」	PRINTFORMW 「……不管请求多少次、不行就是不行」
PRINTFORMW 「どうしてもシたいって言うのであれば、ちゃんと避妊具を用意してくれ」	PRINTFORMW 「如果你无论如何都想做的话、就给我准备避孕用品吧」
PRINTFORMW 「節度は守れと言ったろう？　流石にそこまでは許容できないな」	PRINTFORMW 「不是说过要遵守分寸吗？不能容忍到这种程度」
PRINTFORMW 「……っ……！　わ、かった……」	PRINTFORMW 「……唔……！明、明白了……」
PRINTFORMW 「……っ……！　授業の合間にも、相手しろ、っていうのか……？」	PRINTFORMW 「……啊……！上课的间隙、也叫对方来做吧……？」
PRINTFORMW 「……駄目だと言っても、無駄……なんだろうな」	PRINTFORMW 「……即使说不行、也没用……是呢」
PRINTFORMW 「……絶対、バレないように、気をつけてくれよ……」	PRINTFORMW 「……一定要注意不要被人发现啊………」
PRINTFORMW 「……もう、いいのか……？」	PRINTFORMW 「……已经、好了吗……？」		



//EVENT_K18_ホムラ.ERB


火の精霊“サラマンダー”の力をその身に宿した女体育教師	拥有火之精灵“沙罗曼达”力量的女性体育教师。
 一見クールな印象だが、心の奥底に燃え上がるような情熱を秘めている	乍一看给人很冰冷的印象、心底却隐藏着在燃烧般的热情。
生活指導も担当しており、「地獄の焔（ほむら）」の異名で畏れられているが、 普段付き合いは気さくで優しく、頼れる先生として生徒から慕われている	也担任着生活指导、有着「地狱的火焰」的别名而被人畏惧,不过……其实平时来往时是个坦率、温和、可靠的老师、受到学生的爱戴。
天然の艷やかな小麦肌に、引き締まっていながらも肉感的な男好きする肢体で	天生光洁美丽的小麦色肌肤、受男人喜欢、紧致而有肉感的躯体。
周囲の男性の目を自然と惹きつけるが、本人はあまりその自覚がなく	自然地吸引周围男性的视线，不过、本人却对此没什么自觉。
ガサツで色気がない女だと思い込んでいる	自认为是个粗枝大叶、没有魅力的女人。
数年前に一般男性と結婚したが、自身の素性は秘密にしている	几年前和普通的男性结婚、但隐瞒了自己的来历。
夫婦仲は良好とのことだが――	虽然夫妻关系很好——
PRINTFORMW 「……まさか、ウチの生徒に%CNAME("一人称")%の事情を知られるとはな」	PRINTFORMW 「……没想到、我的学生竟然知道%CNAME("一人称")%的情况」
PRINTFORMW 「その不思議な魂の輝き……再生する魂、というのは間違いではなさそうだな」	PRINTFORMW 「那不可思议的灵魂的光辉……这就是可以再生的灵魂、应该不会错吧」
PRINTFORMW 「……で。その精魂を分け与えてくれる代償として、いったい%CNAME("二人称")%は%CNAME("一人称")%に何を望む？」	PRINTFORMW 「……那、作为分享那个精魂的代价、%CNAME("二人称")%对%CNAME("一人称")%有什么要求呢？」
PRINTFORMW 「――は？　性欲、処理……だと……？」	PRINTFORMW 「――啊？性欲、处理……那……」
PRINTFORMW 「……ぷっ。くくっ……あっはっはっはっはっ！！！」	PRINTFORMW 「……哼。唔……啊哈哈哈哈！！！」
PRINTFORMW 「――はぁー……まったく、何を要求されるかと思えば……思春期の男の子らしいといえばらしいか」	PRINTFORMW 「哈……真是的、一想到会被要求做什么就……真的是青春期的男孩子吧」
PRINTFORMW 「まぁ、いいだろう。こんな無骨な女でよければ、性の捌け口にでもなんでも、好きに使ってくれ」	PRINTFORMW 「嘛、好吧。如果你喜欢这么没骨气的女人、在有需要的时候也可以随心所欲地使用」
PRINTFORMW 「ただし！　本来%CNAME("一人称")%たちは教師と生徒の関係であり、これでも%CNAME("一人称")%は既婚の身だ」	PRINTFORMW 「但是！本来%CNAME("一人称")%就和你是教师和学生的关系、%CNAME("一人称")%也已经结婚了」
PRINTFORMW 「しっかりと節度は守ってくれよ？　もし守れなかったら……分かってるな？」	PRINTFORMW 「一定不能越界哦？如果不能遵守的话……你懂了吗？」
PRINTFORML このキャラは既婚者……いわゆる人妻です。	PRINTFORML 这个角色是已婚者……也就是所谓的人妻。
PRINTFORML コンセプト上、寝取り要素がふんだんに含まれております。	PRINTFORML 概念上、大量地包含着寝取要素。
PRINTFORML また、この口上は加筆調整中につきデフォルトのキャラステータスを前提としています。	PRINTFORML 同时、这个角色的口上是针对默认角色编写的。
PRINTFORML 素質を変更すると口上に矛盾が生じる場合があります。	PRINTFORML 素质变更的话口上可能会产生矛盾。
PRINTFORMW 以上の点を了承いただいた上で、お楽しみ下さい。	PRINTFORMW 了解以上的点之后、请尽情享受。
PRINTFORMW 「んっ……。別に、%CNAME("一人称")%を気持ちよくする必要は、ないんだぞ？」	PRINTFORMW 「嗯……。那个、没有必要那么在意%CNAME("一人称")%的感受」
PRINTFORMW 「まぁ、%CNAME("二人称")%がそうしたいっていうのであれば、構わないんだが……」	PRINTFORMW 「嘛、如果%CNAME("二人称")%这么想做的话、那也没关系……」
PRINTFORMW %CALLNAME:TARGET%は抵抗することなく、%CALLNAME:PLAYER%の愛撫を受け入れた……	PRINTFORMW %CALLNAME:TARGET%没有抵抗、接受了%CALLNAME:PLAYER%的爱抚……
CALL PRINT_STR, "「やだ、まってっ、あぁっ！！　イッた、ばっかで、あっあっ_HH_　いきが、できなっ_HH_　はぁぁんっ！！」_W_"	CALL PRINT_STR, "「不要、等一下、啊！！啊哈、才刚刚去_HH_　不行、不可以……_HH_　啊啊啊啊！！」_W_"
CALL PRINT_STR, "「あっ、そこっ、あぁんっ！！　やだ、もう、指だけで、きもちいっ_HH_　ふぁっ、あああっ！！」_W_"		CALL PRINT_STR, "「啊、那里、啊！！讨厌、已经、只用手指~就好舒服_HH_　嗯啊啊~！！」_W_"
CALL PRINT_STR, "「あぁっ、はぁっ、んぅっ！！　やっ、だめっ_HH_　ぜんぶ、敏感にっ、なってる、からぁっ_HH_　ああぁっ！！」_W_"	CALL PRINT_STR, "「啊、哈、嗯！！！啊、不行_HH_全都变得敏感了、所以啊_HH_　哈啊啊！！」_W_"
PRINTFORMW %CALLNAME:TARGET%は完全に出来上がった体を更に責められ、快楽に溺れるように嬌声を上げている……	PRINTFORMW %CALLNAME:TARGET%被完全开发的身体又受到更多责备、发出沉溺在快乐中的甘甜声音……
PRINTFORMW 「あぁっ、はぁんっ……！　こんな、教え子に、いいように、されて……あっんっ！」	PRINTFORMW 「啊、哈……！像这样、被自己的学生这么说……啊！」
PRINTFORMW 「やっ……そこ、すごいっ……きもちい……あぁんっ！」	PRINTFORMW 「哎呀……那里、好厉害……好舒服……啊啊啊！」
PRINTFORMW 「あっいっ、んぅっ……！　やだ、こんな……からだ、切なくなって……はぁっ、あぁっ！」	PRINTFORMW 「啊、嗯……！讨厌、这种……身体变得好奇怪……啊、啊！」
PRINTFORMW %CALLNAME:TARGET%は甘い声を上げながら、その成熟した肢体を激しくくねらせている……	PRINTFORMW %CALLNAME:TARGET%在发出甜美声音的同时、激烈地扭动着成熟的肢体……
PRINTFORMW 「ふぅっ、んっ……！　そ、そんなにしなくても、いいから……あっ、あっ……！」	PRINTFORMW 「哼、哼~……！不、不要那么做啊、别……好、好吧……啊、啊哈……！」
PRINTFORMW 「やっ……そこ、だめっ……ぁんっ……！」	PRINTFORMW 「哎呀……那里、不可以~……啊……！」
PRINTFORMW 「はぁっ……あっ……！　手つきが、やらし……んぅっ」	PRINTFORMW 「哈哈……啊……！手的动作、那里……嗯~」
PRINTFORMW %CALLNAME:TARGET%は敏感な部分を撫でられるたび、ピクンピクンと体を震わせた……	PRINTFORMW %CALLNAME:TARGET%每次被爱抚敏感的部分、身体都会激烈地颤抖……
PRINTFORMW 「……随分熱心だが、%CNAME("一人称")%の体なんて触ってて、楽しいのか？」	PRINTFORMW 「……相当热心呢，不过、抚摸%CNAME("一人称")%的身体、很开心吗？」
PRINTFORMW 「んっ……。結構、丁寧に触るんだな……」	PRINTFORMW 「嗯……很好、要温柔地抚摸啊……」
PRINTFORMW 「ふふっ……ちょっとくすぐったいな」	PRINTFORMW 「呵呵……稍微有点痒呢」
PRINTFORMW %CALLNAME:TARGET%はされるがままに%CALLNAME:PLAYER%の愛撫を受け入れているが、顔色が変わる気配はない……	PRINTFORMW %CALLNAME:TARGET%就这样接受了%CALLNAME:PLAYER%的爱抚、但看起来依旧面不改色……
PRINTFORMW 「こういうのは、どうだろうか？　興奮してくれると嬉しいんだが……」	PRINTFORMW 「这样如何？能让你兴奋我就很开心了……」
PRINTFORMW 「重かったり苦しかったりしたら言ってくれよ。すぐに退くから」	PRINTFORMW 「如果你觉得太重了不舒服、要告诉我啊。我会停止的」
PRINTFORMW %CALLNAME:TARGET%は遠慮がちに、股間を%CALLNAME:PLAYER%の顔に押し付けている……	PRINTFORMW %CALLNAME:TARGET%不再客气、把股间跨坐在%CALLNAME:PLAYER%的脸上……
PRINTFORMW 「ひゃっ！　ち、躊躇なくきたな……流石というかなんというか」	PRINTFORMW 「哎呀！怎么了、这么急冲冲的……到底是怎么回事？」
PRINTFORMW 「ただまぁ、基本は%CNAME("二人称")%の性処理なんだから、こういうのはほどほどに……んっ、ふっ……」	PRINTFORMW 「不过呢、因为是%CNAME("二人称")%的性处理、所以这种情况还是适可而止……哼、哼嗯~……」
PRINTFORMW %CALLNAME:TARGET%は愛撫されることに若干抵抗を感じながらも、脚を開いて%CALLNAME:PLAYER%に身を委ねた……	PRINTFORMW %CALLNAME:TARGET%虽然对于被爱抚感到有些抵触、但还是张开双腿、委身于%CALLNAME:PLAYER%的爱抚中……
PRINTFORMW 「はっ、あっ、んっ……！　ふふっ、どうした？　さっきからチンポがビクビク震えてるぞ？」	PRINTFORMW 「啊~哈啊~嗯……！呵呵、怎么了？刚才小鸡鸡就开始颤抖了？」
PRINTFORMW 「顔におまんこ押し付けられて、んっ、興奮してるのか？　この、変態めっ……♪」	PRINTFORMW 「脸被那里压着、嗯、很兴奋吗？你这个变态啊啊……♪」
PRINTFORMW 「ほら……もっと舌伸ばして……あっそこ、いいっ！　ふふっ……よしよし、いい子だぞ……」	PRINTFORMW 「啊~……伸长舌头……那里、嗯啊！呵呵……真听话、是个好孩子呢~……」
PRINTFORMW 「上手に出来たら、たぁっぷりご褒美してるやるからな……ほら、かんばれかんばれ……♪」	PRINTFORMW 「如果做得好的话、我会好好奖励你的……来啊、加油……♪」
PRINTFORMW 「あっ、いっ、んっ……！　ふふっ、先生のおまんこジュース……美味しいか？」	PRINTFORMW 「啊、哈啊~……！呵呵、老师的蜜汁……好吃吗~」
PRINTFORMW 「こんなやらしい体にしたのは%CNAME("二人称")%なんだからな……責任はとってもらうぞ……♪」	PRINTFORMW 「身体变得这样下流、都是%CNAME("二人称")%的错呢……你要负起责任来哦……♪」
PRINTFORMW %CALLNAME:TARGET%は妖艶な笑みを浮かべながら、嗜虐的な快楽に打ち震えている……	PRINTFORMW %CALLNAME:TARGET%露出妖艳的笑容、因为嗜虐性的快乐而颤抖……
PRINTFORMW 「んっ、ふっ……！　あぁっ、これ……癖になりそうだ……はぁっ、ぁんっ……！」	PRINTFORMW 「嗯、哼……！啊、这个……快成瘾了……哈、嗯……！」
PRINTFORMW 「あっ、はぁっ……！　教え子の顔に、跨がって、こんな……あっ、やっ……！」	PRINTFORMW 「啊、哈……！跨坐在学生的脸上、这样……啊、果然……！」
PRINTFORMW %CALLNAME:TARGET%は切なげな声を上げながら、腰を前後に振って快感を求めている……	PRINTFORMW %CALLNAME:TARGET%一边发出急切的声音、一边摇着腰寻求快感……
PRINTFORMW 「旦那もたまにこれをせがんでくるんだが……本当にこんなのが良いのか？」	PRINTFORMW 「我老公偶尔也会抱怨这个……这样真的好吗？」
PRINTFORMW 「人の顔に跨がって押し付けるなんて、ちょっと……んっ、変な気分になるな」	PRINTFORMW 「跨坐在人的脸上、有点……嗯、感觉好奇怪啊」
PRINTFORMW 「なに？　もっとお尻を押し付ける感じで？　……こうか？」	PRINTFORMW 「什么？想要更紧贴屁股的感觉？……这样吗？」
PRINTFORMW %CALLNAME:TARGET%は不慣れな様子で%CALLNAME:PLAYER%の顔に%TEXTR("柔らかな恥丘をくにくにと/むっちりとした尻肉をムニムニと")%押し付けてくる……		PRINTFORMW %CALLNAME:TARGET%有些不适应地把%CALLNAME:PLAYER%的脸向%TEXTR("柔软的恥丘里/柔软的臀肉里")%摁了下去……	
CALL PRINT_STR, "「やだ、まってっ、あぁっ！！　だめだめだめっ_HH_　またクる、きちゃうっ_HH_　あっ、ああぁぁっ！！」_W_"	CALL PRINT_STR, "「不要、等一下、啊！！不行~不行~~不行~~~_HH_又要泄了、要泄了_HH_啊~啊啊啊！！」_W_"
CALL PRINT_STR, "「あっ、いっ、はあぁんっ！！　おまんこ、すわれて、きもちいっ_HH_　ふぁっ、あああっ！！」_W_"	CALL PRINT_STR, "「啊、啊、啊！！你、等等~、好舒服_HH_呼、啊啊！！」_W_"
CALL PRINT_STR, "「あぁっ、はぁっ、んぅっ！！　やっ、だめっ_HH_　おまんこペロペロしちゃ、だめぇっ_HH_　あんっ、ああぁっ！！」_W_"	CALL PRINT_STR, "「啊、哈、嗯！！！哎呀、不行_HH_你这个笨蛋、不行啊_HH_啊、啊啊！！」_W_"
PRINTFORMW %CALLNAME:TARGET%は%TEXTS("太股：描写")%太股で%CALLNAME:PLAYER%の頭を挟み込み、快楽に溺れるように嬌声を上げている……	PRINTFORMW %CALLNAME:TARGET%用结实健美的美腿夹住%CALLNAME:PLAYER%的头、发出沉溺在快乐的甘甜尖叫……
PRINTFORMW 「やっ、だめっ……！　パンツの上からじゃ、せつなくて……ふぅ、ぅんっ……！」	PRINTFORMW 「哎呀、不行……！裤子、好难过……哼、哼……！」
PRINTFORMW 「やっ、あっ、それっ……舌の動き、すごいっ……あぁんっ！」	PRINTFORMW 「啊、啊、那个……舌头的动作、好厉害……啊啊啊！」
PRINTFORMW 「はっ、あぁっ、んぅっ……！　そんなっ、やらしい音、たてるなぁっ……んぁっ、はあぁんっ！」	PRINTFORMW 「啊、啊、嗯……！那种、下流的声音、真让人兴奋啊……嗯、啊啊啊！」
PRINTFORMW %CALLNAME:TARGET%は%CALLNAME:PLAYER%の頭に両手を置き、擦りつけるように腰を大きくくねらせている……	PRINTFORMW %CALLNAME:TARGET%把双手放在%CALLNAME:PLAYER%的头部两侧、像受了伤一样大幅度弯着腰……
PRINTFORMW 「あっ、んっ……！　パンツ越しなのに、こんな……あっ、あっ……！」	PRINTFORMW 「啊、嗯……！明明是超短裤的、居然这样……啊、啊……！」
PRINTFORMW 「んっ……ふぅ……ぅんっ……！」	PRINTFORMW 「嗯……呼……嗯……！」
PRINTFORMW 「んっ……くぅっ……！　舌の感触が……はぁっ、あっ……！」	PRINTFORMW 「嗯……唔……！舌头的触感……啊、啊哈~……」
PRINTFORMW %CALLNAME:TARGET%は時折甘い声を漏らしながら、ビクビクと腰を悶えさせている……	PRINTFORMW %CALLNAME:TARGET%时不时漏出甜蜜的声音、舒服得腰都直不起来了……
PRINTFORMW 「あっ、こら……！　そんなにしたら、パンツが染みになるじゃないか」	PRINTFORMW 「啊、哎呀……！那样的话、裤子会不会被弄脏呢？」
PRINTFORMW 「んっ……。人に股間を舐めてもらうというのは、なんかこう……クるものがあるな」	PRINTFORMW 「“嗯……。让别人舔你的那里、怎么说呢……真变态啊」
PRINTFORMW 「くふ、んふふっ……こら、息がくすぐったいじゃないか」	PRINTFORMW 「呼呼~呼呼~……哎呀、你的呼吸好痒~」
PRINTFORMW %CALLNAME:TARGET%はむずがゆそうにはしているが、まだ快楽にはいたっていないようだ……	PRINTFORMW %CALLNAME:TARGET%看起来很痒、但好像还没感受到快乐…………
PRINTFORMW 「ん……。どうだ……って感想を聞くものなのかどうか分からないが……」	PRINTFORMW 「嗯……怎么说呢……虽然不知道是不是想听到这样的想法……」
PRINTFORMW 「……熱心に揉み続けているところを見るに、とりあえず悪くはないみたいだな」	PRINTFORMW 「……看到他热心地持续揉搓的样子、感觉并不坏呢」
CALL PRINT_STR, "「やだ、まってっ、あぁっ！！　イクっイクっ_HH_　おっぱいだけで、またイクっ_HH_　あっ、ああぁぁっ！！」_W_"	CALL PRINT_STR, "「不要、等一下、啊！！喂_HH_HH_又是胸部、又欺负胸部了~_HH_啊、啊啊！！」_W_"
CALL PRINT_STR, "「あっ、あっ、んあぁっ！！　やっだめっ_HH_　おっぱい、かんじすぎてっ_HH_　あんっ、はああぁんっ！！」_W_"	CALL PRINT_STR, "「啊、啊、啊啊！！果然不行_HH_胸部、感觉好胀了_HH_啊、啊啊啊！！」_W_"
CALL PRINT_STRW, "「ふあぁぁっ！！　だめっ、だってっ_HH_　それ以上は、乳首、とれちゃうっ_HH_　ああっ、んああああっ！！」"	CALL PRINT_STRW, "「啊啊啊！！！不行、因为_ HH_那里~、乳头、要坏掉了_ HH_啊啊~、啊啊啊啊！！」"
CALL PRINT_STR, @"「やっ、それっ、いっ！！　いいよっ、さわってっ_HH_　%CNAME("一人称")%のおっぱい、すきなように、してっ_HH_　あっいっ、ああぁんっ！！」_W_"	CALL PRINT_STR, @"「啊、那个、什么！好啊、摸一下吧_HH_　%CNAME("一人称")%的乳房、喜欢吗~_HH_啊、啊啊啊！！_W_」_W_"
PRINTFORMW 「んぁっ……！　い、いきなりそこ、か……はぁっ、んっ……！」	PRINTFORMW 「嗯……！突然、突然、那里……啊、嗯……！」
PRINTFORMW 「こ、の……おっぱい、星人、めっ……あっ、だめっ！　はっ、あんっ……！」	PRINTFORMW 「你这个……啊~……胸部、星人、……啊、不行！啊、啊哈……」
PRINTFORMW 「も、もうちょっと、んっ、優しく……！　誰かさんのせいでっ、すごい敏感に……あっ、だめっ！　はっ、あんっ……！」	PRINTFORMW 「也、再稍微、嗯、温柔一点……！因为那里、非常地敏感……啊、不行！不行~不行啊、嗯啊啊啊……！」
PRINTFORMW 「はぁっ、あっ、んぅ……！　やっ、だめっ……おっぱいだけで、%CNAME("一人称")%っ……んっ、くうぅぅんっ！」	PRINTFORMW 「“啊、啊、嗯……！哎呀、不行……只有胸部、%CNAME("一人称")%的胸部……唔~唔唔~！」
PRINTFORMW 「やっ、あっ、それっ……おっぱい、きもちいっ……あぁんっ！」	PRINTFORMW 「啊、啊、那个……胸部、好舒服……啊啊啊！」
PRINTFORMW 「ふあぁぁっ！　や、だ……乳首、吸われてっ……もうっ……あっ、はあぁぁっ！！」	PRINTFORMW 「啊啊啊啊！不、那里是……乳头、被吸住……已经……啊~啊！！」
PRINTFORMW 「あっ、はっ、やんっ……！　おっぱい、グニグニっ、揉まれてっ……あっいっ、んぁんっ！」	PRINTFORMW 「啊、哈、哎……！奶、被咕噜咕噜、被揉了……啊、嗯嗯嗯！」
PRINTFORMW 「んぅっ……！　い、いきなりそこ、か……」	PRINTFORMW 「嗯……！突然、突然、那里……」
PRINTFORMW 「%CNAME("二人称")%は本当にっ、んっ、おっぱいが好き、だな……はっ、あんっ……！」	PRINTFORMW 「%CNAME("二人称")%真的、嗯、好喜欢胸部啊……啊、啊……！」
PRINTFORMW 「最近ちょっと、んっ……！　感じやすい、から……少し、優しくっ、な……はっ、あんっ……！」	PRINTFORMW 「最近有点……！容易有感觉……稍微、温柔点、呐……啊、啊……！」
PRINTFORMW 「はぁっ……ぁんっ……！　も、もうちょっと、優しく……ふぅっ、ぅんっ……！」	PRINTFORMW 「哈哈……嗯……！也、再温柔一点……呼、哼……！」
PRINTFORMW 「んっ……くっ……ふぅんっ……！」	PRINTFORMW 「嗯……呃……哼哼……！」
PRINTFORMW 「ふぁっ……ぁんっ……！　そんな、夢中で、吸っちゃ……あっ、だめっ……ぃっ……！」	PRINTFORMW 「哼……嗯……！这样啊、在梦中吸着……啊、不行……啊……！」
PRINTFORMW 「あっ……はんっ……！　触り方が、やらしっ……あっ、だめっ……んっ……！」	PRINTFORMW 「啊……哈……！这个摸法……啊、不行……哼嗯……！」
PRINTFORMW 本当におっぱいが好きだなぁ、%CNAME("二人称")%は」	PRINTFORMW 「真的好喜欢乳房啊、%CNAME("二人称")%」
PRINTFORMW %CNAME("二人称")%、そんなにおっぱい好きだったのか？」	PRINTFORMW %CNAME("二人称")%、有那么喜欢乳房吗？」
PRINTFORMW 「男の子がおっぱいに夢中になってるのって、んっ、ふふっ……ちょっと可愛いな」	PRINTFORMW 「男孩子这么着迷乳房、嗯、呵呵……有点可爱呢」
PRINTFORMW 「普段も男子生徒の視線を感じたりするんだが……やっぱ大きい胸って気になるのか？」	PRINTFORMW 「平时也感受到男生的视线……果然还是很在意丰满的胸部吗？」
PRINTFORMW 「んっ……夢中になって吸って、まるで赤ん坊だな……ふふっ」	PRINTFORMW 「嗯……这么入迷地吸、简直就像婴儿一样……呵呵」
PRINTFORMW 「ふふっ、触り方がやらしいなぁ……あっ……んっ……」	PRINTFORMW 「呵呵、抚摸的方法不太舒服啊……啊……嗯……」
PRINTFORMW %CALLNAME:TARGET%はなすがままに胸を\@ CHECK_COM("乳首舐め") ? 吸われて # 揉まれて \@いるが、快感を感じている気配はない……	PRINTFORMW %CALLNAME:TARGET%暴露在外的胸部被\@ CHECK_COM("乳首舐め") ? 吸着 # 揉着 \@、好像没怎么感受到快感的样子……
PRINTFORMW 「ほら……触りたいんだろ？　そんな露骨にチラチラ見られれば、%CNAME("一人称")%だってさすがに気づく」	PRINTFORMW 「呐……想摸吧？被那样露骨地看着、%CNAME("一人称")%早就注意到了」
PRINTFORMW %CALLNAME:TARGET%はその存在感のある乳房を、ツンとこちらへ突き出してきた……	PRINTFORMW %CALLNAME:TARGET%将有强烈存在感的乳房向这边挺起……
PRINTFORMW 「まぁ、無駄に大きさだけはあるし、気になるよな。こんなのでよければ、好きに触ってくれ」	PRINTFORMW 「嘛、这么在意那没什么用的胸部大小么、如果你喜欢的话、请随意触摸~」
PRINTFORMW 「……このチンポ……ホントに旦那と全然違う形で……んっ……」	PRINTFORMW 「……这个肉棒……和老公的形状完全不一样……嗯……」
PRINTFORMW 「……ちょっとだけなら……でも相手は生徒で、旦那にも……ああ、でもっ……」	PRINTFORMW 「……如果只是一点点的话……但是对方是自己的学生、自己也是有丈夫的……啊、但是……」
PRINTFORMW 身動きのとれない%CALLNAME:MASTER%のいきり立った剛直を手でしごきなら、%CALLNAME:TARGET%は甘い吐息を荒げていく……	PRINTFORMW 用手抚摸着身体无法动弹的%CALLNAME:MASTER%的刚直、%CALLNAME:TARGET%发出了甜蜜的吐息……
CALL PRINT_STR, "「……ゴムすれば、一回くらいなら……そう、これ一回だけ、だから……_HH_」_W_"	CALL PRINT_STR, "「……如果戴套……一次左右的话……对、就这一次、所以……_HH_」_W_"
PRINTFORMW %CALLNAME:TARGET%はどこからともなくコンドームを取り出すと、手早く%CALLNAME:MASTER%の肉棒に取り付けた……	PRINTFORMW %CALLNAME:TARGET%不知从哪里取出避孕套、很快就戴在%CALLNAME:MASTER%的肉棒上……
CALL PRINT_STR, @"「%CNAME("二人称")%も、いいよな……？　先生のおまんこで、気持ちよくなりたいよな？　な……_HH_」_W_"	CALL PRINT_STR, @"「%CNAME("二人称")%也想要的吧…？想在老师的小穴里、变得舒服起来的吧？……_HH_」_W_"
CALL PRINT_STR, "「……本当は駄目なのに、こんな、やらしいチンポ見せられたら……っ_HH_」_W_"	CALL PRINT_STR, "「……明明真的不行、如果让我看到这样下流的小鸡鸡的话……_HH_」_W_"
CALL PRINT_STR, "「まだ、シたりないだろう？　先生ももっと、ほしいんだ……_HH_」_W_"	CALL PRINT_STR, "「还不够吧？老师也想要更多的……_HH_」_W_"
CALL PRINT_STR, "「まだチンポ苦しそうだな……_HH_　今、楽にしてやる……_HH_」_W_"	CALL PRINT_STR, "「小鸡鸡看起来挺痛苦的……_ HH_现在、我会让你放·松·下·来·的~……_HH_」_W_"
CALL PRINT_STR, "「こんなにガチガチにさせて……_HH_　そんなに先生に犯してほしいのか、ん？」_W_"	CALL PRINT_STR, "「这样硬邦邦的……_HH_就这么想侵犯老师吗、嗯？」_W_"
PRINTFORML %CALLNAME:TARGET%は反り返るほどに勃起した%CALLNAME:MASTER%のペニスを一瞥すると、	PRINTFORML %CALLNAME:TARGET%瞥了一眼%CALLNAME:MASTER%勃起的阴茎、
PRINTFORMW 横たわった%CALLNAME:MASTER%に上から覆いかぶさった……	PRINTFORMW 从横躺着的%CALLNAME:MASTER%上面压了上去……
CALL PRINT_STR, "「……犯すぞ？　教え子チンポ、先生のおまんこで、犯しちゃうからなっ……_HH_」_W_"	CALL PRINT_STR, "「……要侵犯了吗？学生的小鸡鸡、在老师的这里、要侵犯了~……_HH_」_W_"
PRINTFORMW 「ん、ゴムつけるのか？　生でしてもいいのは、今日だけだぞ？」	PRINTFORMW 「嗯、要戴套吗？只有今天可以无套插入小穴哦？」
CALL PRINT_SELECT, "やっぱりゴムを外す/ゴムをつけたままする"	CALL PRINT_SELECT, "还是去掉避孕套/戴着避孕套"
PRINTFORMW %CALLNAME:MASTER%は考えをあらため、装着していたコンドームを取り外した	PRINTFORMW %CALLNAME:MASTER%重新考虑了下、取下了戴着的避孕套
PRINTFORMW 「ふふふ、わかりやすい奴め……。ほら、こい。何度でも受け止めてやる……♪」	PRINTFORMW 「呵呵呵、真是个好懂的家伙呢……好了~好了~，不管多少次我都会全部接受的……♪」
PRINTFORMW 「……そうか。まぁ、%CNAME("二人称")%がいいのなら構わないが」	PRINTFORMW 「……这样啊。嘛、%CNAME("二人称")%愿意的话也没关系」
PRINTFORMW 「おいおい……約束、覚えてないのか？」	PRINTFORMW 「喂喂……约定、你不记得了吗？」
PRINTFORMW 「今日は安全日だから、約束どおり生でしてもいいんだぞ？」	PRINTFORMW 「今天是安全日、按照约定直接做也可以吧？」
CALL PRINT_SELECT, "忘れてました！　生で童貞捨てさせて下さい！/いや、やっぱり避妊って大事ですし……"	CALL PRINT_SELECT, "忘了那个约定吧！不带套的直接丢掉童贞！/不、果然避孕还是很重要的……"
PRINTFORMW %CALLNAME:MASTER%は鼻息を荒くして、装着していたコンドームを勢いよく取り外した！	PRINTFORMW %CALLNAME:MASTER%鼻息急促、气势汹汹地取下了戴上的避孕套！
PRINTFORMW 「ははっ、素直な奴だなぁ♪　でも、先生そういうところ……嫌いじゃないぞ？」	PRINTFORMW 「哈哈、真是个坦率的家伙啊~♪那么、老师的那种地方……不讨厌吧？」
CALL PRINT_STR, "「それじゃあ……ご褒美の生セックス、先生としちゃおうな……_HH_」_W_"	CALL PRINT_STR, "「那么、作为老师……奖励的性行为呦……_HH_」_W_"
PRINTFORMW 「生でさせてやるなんてそうそうないから、あとで後悔するなよ？」	PRINTFORMW 「不能直接插入来脱处、不会后悔吗？」
PRINTFORMW 「今日は安全日じゃないから生ではさせてやれないぞ。それでもいいのか？」	PRINTFORMW 「今天不是安全日、我不能让你直接插入。这样也可以吗？」
CALL PRINT_SELECT, "忘れてました。我慢します……/ヒャア、我慢できねぇ！　セックスだぁ！"	CALL PRINT_SELECT, "忘记了。忍耐一下……/啊、我受不了！做爱啊！"
PRINTFORMW 「うんうん。ちゃんと我慢できてえらいぞ。よしよし……」	PRINTFORMW 「嗯、能好好忍耐真了不起。真是个好孩子~……」
PRINTFORMW %CALLNAME:MASTER%は%CALLNAME:TARGET%に頭を撫でられた……	PRINTFORMW %CALLNAME:MASTER%温柔地摸着%CALLNAME:TARGET%的头……
PRINTFORMW 「……夫がいる身だから、出来れば本番は控えてほしかったんだが……」	PRINTFORMW 「……因为有丈夫、所以如果可以的话、希望不要用小穴做爱……」
PRINTFORMW 「その様子じゃ、駄目と言っても聞かなそうだな……」	PRINTFORMW 「那个样子、就算说不行也听不到啊……」
PRINTFORMW 「……仕方ない。ちゃんとゴムはしてくれるようだし……ほら、好きにしろ」	PRINTFORMW 「……没办法、随你的便吧。但是好好地给我戴上套套啊」
PRINTFORMW 「……うん？　なんだ、ゴムしてするのか？　そうか、つけるのか……」	PRINTFORMW 「“……嗯？什么呀、在戴套吗？是吗、要戴吗……」
PRINTFORMW 「あ、いや。なんでもない。ちゃんと避妊するのはいいことだ、うん」	PRINTFORMW 「啊、不。没什么。好好避孕是件好事、嗯」
PRINTFORMW 「……別に生でしたかったわけではないからな……本当だぞ？」	PRINTFORMW 「……因为并不想生下来……真的吗？」
PRINTFORMW 「……ゴムするのか……。まぁ、当然だよな……うん……」	PRINTFORMW 「……要戴套吗……当然了……嗯……」
PRINTFORMW 「……ゴム、つけるのか。ふーん、そうか……」	PRINTFORMW 「……避孕套……戴上了吗？哼、是吗……」
PRINTFORMW 「……なんだその目は。別に残念がってなどいないぞ」	PRINTFORMW 「…………那是什么眼神啊。有什么可遗憾的」
PRINTFORMW 「ふふっ、いいぞ……今日だけは何度でも受け止めてやる」	PRINTFORMW 「呼呼、啊~……今天已经来了好几次了」
PRINTFORMW 「まだヤリたりないのか？　まったく、童貞の性欲は凄まじいな……♪」	PRINTFORMW 「还不够吗？真是的、处男的性欲太厉害了……」
CALL PRINT_STR, "「はぁーっ_HH_　はぁーっ_HH_　だ、だめだ……初体験の約束、しただろ……っ？」_W_"	CALL PRINT_STR, "「哈—_HH_哈—_HH_不行……就算是初体验……约定好了……对吧？」_W_"
PRINTFORMW 「今日は、大丈夫な日じゃ、ないから……ちゃんと約束は、守るから……な？」	PRINTFORMW 「就算今天是安全日……也会遵守约定的……是吗？」
PRINTFORMW %CALLNAME:TARGET%は度重なる絶頂の連続で、抵抗する力が弱くなっている……	PRINTFORMW %CALLNAME:TARGET%在反复的绝顶下、抵抗的力量变弱了……
CALL PRINT_STR, "「はぁーっ_HH_　はぁーっ_HH_　だ、だめだ……ゴム、つけなきゃ……っ」_W_"	CALL PRINT_STR, "「哈~_HH_哈~_HH_不行呀~……避孕套、必须戴上……」_W_"
PRINTFORMW 「ま、待て……またゴム、してないだろっ！？　そんな、何度もしたら……%CNAME("一人称")%……っ！」	PRINTFORMW 「“等、等等……又没有戴避孕套吧！？那样的……%CNAME("一人称")%做了好几次……！」
PRINTFORMW 「ま、また生で……！？　だ、だめだ……そんな、何度も……っ！」	PRINTFORMW 「又、又直接插入……！？不行、不行的……那种、不可以……啊！」
CALL PRINT_STR, "「お願いだから、それだけは……あっ、うそっ、ホントに生で、あっ、あぁっ……_HH_」_W_"	CALL PRINT_STR, "「就算你求我、只有那个……啊、骗人、真的没有戴套、啊、啊~……_HH_」_W_"
CALL PRINT_STR, "「こらっ、ホントに、だめ……やっ、入って、あっ、んんぅっ……_HH_」_W_"	CALL PRINT_STR, "「“喂、真的、不行……啊、插进来了……啊、嗯…………_HH_」_W_"
CALL PRINT_STR, "「ちょ、こら、待ちなさ……あっ！　やだ、かた……あっ、あっ、あっ……_HH_」_W_"	CALL PRINT_STR, "「“喂、喂、等一下……啊！讨厌、讨厌……啊、啊~啊……_HH_」_W_"
PRINTFORMW 「ふふっ……覚えているよ。約束したものな？　生で初体験させてやる、って……」	PRINTFORMW 「呵呵……我记得。约定好了吧？第一次的体验…………」
CALL PRINT_STR, "「いい子で我慢できたご褒美の、初エッチ生おまんこ……しっかりと味わえよ……_HH_」_W_"	CALL PRINT_STR, "「给能忍得住好孩子的奖励呦、第一次做爱的无套生插小穴……好好品尝吧……_HH_」_W_"
PRINTFORMW 「今日は安全日じゃないから生ではさせてやれないぞ。約束のエッチはまだおあずけだ」		PRINTFORMW 「今天不是安全日、我不能让你直接插进来。要遵守约定啊」
CALL PRINT_SELECT, "安全日まで我慢、する……ッ！/ゴムありでいいから今やる！"	CALL PRINT_SELECT, "忍耐到安全日为止……啊！/戴套就好了、现在就做"
PRINTFORMW %CALLNAME:MASTER%は断腸の思いで本番を諦めた……	PRINTFORMW %CALLNAME:MASTER%伤心地放弃了直接做爱的打算……
PRINTFORMW 「……なんで泣きそうな顔してるんだ。なんか悪いことをしている気分になるじゃないか」	PRINTFORMW 「怎么一副要哭出来的样子嘛，总觉得我做了坏事啊……」
PRINTFORMW 「生でさせてやるなんてそうそうないから、あとで後悔はするなよ？」	PRINTFORMW 「不能直接插入来脱处、不会后悔吗？」
PRINTFORMW にべもなく拒絶されてしまった……	PRINTFORMW 被轻易地拒绝了…………
PRINTFORMW 「その様子じゃ、駄目と言っても聞かなそうだな……はぁ、仕方ない」	PRINTFORMW 「那个样子、就算说不行也听不到啊……唉、没办法」
PRINTFORMW 「ただし！　きちんとゴムはしてもらうぞ。万が一妊娠でもしたら、困るのはお互い様だろう？」	PRINTFORMW 「只是！请好好地带着套做。万一怀孕了、双方都会为难吧？」
PRINTFORMW 「……って、ゴムを用意してないのか。じゃあ、エッチはおあずけだ。また今度な」	PRINTFORMW 「……没有准备套套吗？那么、就这样吧。下次要记得呦」
CALL PRINT_SELECT, "初めてなんで、生でさせてください！/今日は諦める……"	CALL PRINT_SELECT, "第一次、请让我生插入吧！/今天放弃……"
CALL PRINT_SELECT, "初めてなんで、生でさせてください！/言うとおりにゴムをつける"	CALL PRINT_SELECT, "第一次、请让我生插入吧！“按照约定、戴上避孕套"
PRINTFORMW 「は、はぁ？　いや、初めてだからいいとか、そういうことでは……」	PRINTFORMW 「哈、哈？不、因为是第一次所以没关系、这种事……」
PRINTFORMW 「……いやしかし、男の子にとって初体験は大事なものとも聞くし……うーん」	PRINTFORMW 「但是、听说对于男孩子来说初次体验很重要……嗯……」
PRINTFORMW 「……仕方ない。今日は大丈夫な日だし……今回だけ、特別だぞ？」	PRINTFORMW 「没办法。今天是安全日……只有这一次、是特别的啊？」
PRINTFORMW 「……わかった、じゃあこうしよう」	PRINTFORMW 「……知道了、那么就这样吧」
PRINTFORMW 「今日は大丈夫な日じゃないからさせてやれないが、安全日になったら生でさせてやる」	PRINTFORMW 「今天不是安全日啊、我不能让你做、不过到了安全日我会让你直接插入哦」
PRINTFORMW 「だから、今日のところは我慢するんだぞ、いいな？」	PRINTFORMW 「所以、今天就忍一忍、好吗？」
PRINTFORMW %CALLNAME:MASTER%は%CALLNAME:TARGET%と生初体験の約束をした！	PRINTFORMW %CALLNAME:MASTER%与%CALLNAME:TARGET%做了首次体验的约定！
PRINTFORMW 「今日は大丈夫な日じゃないからさせてやれないが、安全日になったら生でさせてやる……どうだ？」	PRINTFORMW 「今天不是安全日啊、我不能让你做、不过到了安全日我会让你无套插入的……怎么样？」
CALL PRINT_SELECT, "分かりました、我慢、します……っ！/やっぱゴムありでいいから今やる"	CALL PRINT_SELECT, "明白了、我忍一忍！/戴上避孕套现在就做"
PRINTFORMW 「そ、そうか……そこまでして生でしたいのか……」	PRINTFORMW 「是、是吗……你想要直接插进来吗……」
PRINTFORMW 「じゃあまぁ……そういうわけで、その日が来るまで我慢するんだぞ、いいな？」	PRINTFORMW 「那么……、在那一天到来之前忍一忍、好吗？」
PRINTFORMW %CALLNAME:MASTER%は渋々、本番を諦めた……	PRINTFORMW %CALLNAME:MASTER%不情愿地放弃了无套插入……
PRINTFORMW 「……うん？　なんだ、コンドーム用意してなかったのか？」	PRINTFORMW 「……嗯？怎么了、没有准备避孕套吗？」
PRINTFORMW 「なんだ、もうコンドームがないのか」	PRINTFORMW 「什么嘛、已经没有避孕套了吗？」
PRINTFORMW 「なら仕方ないな。残念だろうが、エッチはおあずけだ……うん？　今日は安全日じゃないかって？」	PRINTFORMW 「那就没办法了。虽然很可惜、但H就没办法了啊……唔？今天应该是安全日吧？」
PRINTFORMW 「……%CNAME("二人称")%がなぜ%CNAME("一人称")%の安全日を把握しているのかは甚だ疑問だが……こういう関係でも、ちゃんと節度は守るべきだろう」	PRINTFORMW 「……%CNAME("二人称")%为什么掌握了%CNAME("一人称")%的安全日这点非常值得怀疑……但是无论如何、也应该遵守约定吧」
PRINTFORMW 「これでも体育教師だ。生徒には正しい保健の知識を教えないとな」	PRINTFORMW 「就算是个体育教师、也要教学生正确的保健知识啊」
PRINTFORMW 「なら仕方ないな。残念だろうが、エッチはおあずけだ。また今度な」	PRINTFORMW 「那就没办法了。很遗憾、H可不行。下次再说吧」
PRINTFORMW 「こら。だめだぞ、ちゃんとゴムはつけなさい」	PRINTFORMW 「喂。不行啊、好好地戴上避孕套吧」
PRINTFORMW 「先生がつけてあげるから……ほら、貸して……んっ、あむ――」	PRINTFORMW 「老师会帮你戴上的……来吧、交给我~……嗯、啊啊——」
PRINTFORMW %CALLNAME:TARGET%は取り上げたコンドームを唇に含むと、そのまま%CALLNAME:MASTER%のペニスを根本まで咥え込み、器用に取り付けた……	PRINTFORMW %CALLNAME:TARGET%把安全套含在嘴唇里、就那样到直接把%CALLNAME:MASTER%的阴茎含到根部、戴上了避孕套……
PRINTFORMW %CALLNAME:TARGET%はそのまま口からペニスを離さず、唾液でコーティングするようにねっとりとしゃぶってきた……	PRINTFORMW %CALLNAME:TARGET%就这样从嘴巴里吐出了阴茎、黏糊糊的唾液像涂层一样滴落在肉棒上……
PRINTFORMW %CALLNAME:TARGET%の巧みな口奉仕に、%CALLNAME:MASTER%の射精欲がみるみる増していく……！	PRINTFORMW 在%CALLNAME:TARGET%巧妙的口交服侍下、%CALLNAME:MASTER%的射精感越来越强了！
PRINTFORMW 「――ぷはっ。ふふっ……どうした？　そんな切なげな顔をして……」	PRINTFORMW 「——呵呵~……怎么了？露出那样不像样的表情~」
PRINTFORMW %CALLNAME:TARGET%はすんでのところで口を離すと、ニヤニヤと笑みを浮かべながらこちらを見つめてきた……	PRINTFORMW %CALLNAME:TARGET%在快要爆发的紧要关头停下了、微笑着看着这边……
PRINTFORMW 「ほらほら……このたくましいチンポで、いったいナニを、どうしたいんだ？　ん？」	PRINTFORMW 「你看……这个胀大到不行的小鸡鸡、到底想干什么呀~？嗯？」
PRINTFORMW 「――ぷはっ……ん、これでよし。ほら、もういいぞ」	PRINTFORMW 「——噗哈……嗯、这样就行了吧。好啦」
PRINTFORMW 「――ちゅぽんっ……ふふっ、準備できたな……じゃ、やろうか」	PRINTFORMW 「――噗噜噗噜……呵呵、准备好了……那么、开始吧~」
PRINTFORMW 「先生がつけてやるから……ほら、こっちに貸せ」	PRINTFORMW 「老师会帮你戴的……来、交给我」
PRINTFORMW %CALLNAME:TARGET%はコンドームを取り上げると、%CALLNAME:MASTER%のペニスに器用に取り付けていく……	PRINTFORMW %CALLNAME:TARGET%拿起了避孕套、帮%CALLNAME:MASTER%的阴茎戴上了……
PRINTFORMW 「まったく……体だけの関係とはいえ、きちんと線引は必要だ。ちゃんと分かっているのか、ん？」	PRINTFORMW 「真是的……只是肉体上的关系、不要越界是有必要的。你明白吗？嗯？」
PRINTFORMW %CALLNAME:TARGET%はそのままペニスから手を離さず、ゴム越しに上下に強くしごきあげてきた……	PRINTFORMW %CALLNAME:TARGET%嘴上说着手却没停下来、隔着套套上下用力地搓弄起来……
PRINTFORMW 容赦ない強引な責めたてに、%CALLNAME:MASTER%の射精欲がみるみる増していく……！	PRINTFORMW 被毫不留情地强行责备、眼看着%CALLNAME:MASTER%到了爆发的边缘……！
PRINTFORMW 「……おっ、と。このままイかせてしまうところだった……ふふふっ」	PRINTFORMW 「……哦、呵呵~。差点儿就这么射了呢……呵呵~」
PRINTFORMW %CALLNAME:TARGET%はすんでのところで、ビクビクと脈打つ肉棒からパッと手を離した……	PRINTFORMW %CALLNAME:TARGET%在最后一刻、手突然从不停脉动的肉棒上松开了……
PRINTFORMW 「つい意地悪が過ぎてしまった。お詫びに、ほら……先生のこと、好きにしていいぞ」	PRINTFORMW 「不知不觉就想欺负你呢~。为了表示歉意、你看……老师、随·你·使·用·呦」
PRINTFORMW 「……ん、これでよし。ほら、もういいぞ」	PRINTFORMW 「……嗯、这样就行了。好了」
PRINTFORMW 「ふふっ、準備できたな……じゃ、やろうか」	PRINTFORMW 「呵呵、准备好了……那么、开始吧~」
PRINTFORMW 「……。……ちゃんと、ゴム……して……」	PRINTFORMW 「……好好地、避孕套……」
PRINTFORMW %CALLNAME:TARGET%は言葉では拒絶しているが、普段の毅然とした力強さはなく	PRINTFORMW %CALLNAME:TARGET%在语言上拒绝了，但却没了平时坚定的样子。
PRINTFORMW %CALLNAME:MASTER%がじっと見つめても頬を染めて顔を逸らすだけで、抵抗の意志は感じられない……	PRINTFORMW 被%CALLNAME:MASTER%目不转睛地凝视着脸颊、只是害羞地转过脸去、感受不到有抵抗的想法……
PRINTFORMW 「……っ……」	PRINTFORMW 「……啊……」
PRINTFORMW %CALLNAME:TARGET%は避妊する気のない%CALLNAME:MASTER%を無言で睨みつけるてくるが	PRINTFORMW %CALLNAME:TARGET%无言地瞪着没有避孕打算的%CALLNAME:MASTER%。
PRINTFORMW 同時になにかを期待しているかのような熱っぽさが、その瞳から感じられた……	PRINTFORMW 但却能从她的眼神深处感受到了某种炙热的期待……
PRINTFORMW 「あっ……。……だめ、だ、これ以上は……」	PRINTFORMW 「啊……不行、不行、只有这个……」
PRINTFORMW %CALLNAME:TARGET%は詰め寄ってくる%CALLNAME:MASTER%を手で押しのけようとするが	PRINTFORMW %CALLNAME:TARGET%想要用手推开逼近的%CALLNAME:MASTER%。
PRINTFORMW 明らかに力が入っておらず、本気の拒絶さは感じられない……	PRINTFORMW 但是明显没有用力、感觉不是在真正的拒绝……
CALL PRINT_STR, "「あっ……生チンポ、入って……_HH_　はっ、あぁっ……んっ……_HH_」_W_"	CALL PRINT_STR, "「……啊……无套肉棒、插进来了……_HH_哈~啊啊……嗯_HH_」_W_"
CALL PRINT_STR, "「……やだ、おっき……_HH_　あっ、はぁっ……_HH_」_W_"	CALL PRINT_STR, "「……讨厌、整个都……_HH_啊、哈…………_HH_」_W_"
CALL PRINT_STR, "「……やっ、きてる……_HH_　んっ……ふぅっ……_HH_」_W_"	CALL PRINT_STR, "「……“……啊、来了……_HH_嗯……呼…………_HH_」_W_"
PRINTFORML %CALLNAME:TARGET%は%CALLNAME:MASTER%がコンドームを着けるのを見届けると、	PRINTFORML %CALLNAME:TARGET%看到%CALLNAME:MASTER%戴着安全套。
PRINTFORML を仰向けに押し倒すと、その%TEXTS("太股：描写")%足をＭ字に開かせ、	PRINTFORML 仰面推倒、%TEXTS("太股：描写")%呈M字打开、
PRINTFORML をうつ伏せに押し倒すと、その%TEXTS("お尻：視覚")%を鷲掴みにし、	PRINTFORML 面朝下推倒、%TEXTS("お尻：視覚")%被直接捉住了、
PRINTFORM を押し倒すと、上から覆いかぶさって	PRINTFORM 将其推倒、从上面压住了
PRINTFORML を強引に抱き寄せると、その%TEXTS("お尻：感触")%を持ち上げて、	PRINTFORML 强行抱住、托着%TEXTS("お尻：感触")%、
PRINTFORML を後ろから抱き上げると、その%TEXTS("お尻：感触")%を掴み上げ、	PRINTFORML 从后面抱住、抓住了%TEXTS("お尻：感触")%	
PRINTFORMW 剛直の先端を秘裂にあてがった……	PRINTFORMW 用刚直的前端侵入了秘裂……
PRINTFORMW 自ら足をＭ字に開き、%CALLNAME:PLAYER%を誘った……	PRINTFORMW 把腿打开成M字、诱惑着%CALLNAME:PLAYER%。
PRINTFORMW 自ら四つん這いになって、%TEXTS("お尻：視覚")%をこちらへ差し出した……	PRINTFORMW 自己趴了下去、把%TEXTS("お尻：視覚")%撅向了这边……
PRINTFORMW ベッドに横たわって身を差し出した……	PRINTFORMW 躺在床上展开了身体……
PRINTFORMW %CALLNAME:MASTER%の膝上に腰をおろした…	PRINTFORMW 坐在了%CALLNAME:MASTER%的膝盖上…
PRINTFORMW 柔らかな尻肉を%CALLNAME:MASTER%のペニスに押し付けながら、%CALLNAME:MASTER%にもたれ掛かった……	PRINTFORMW 将柔软的臀部坐在%CALLNAME:MASTER%肉棒上的同时、依偎在%CALLNAME:MASTER%身边……
PRINTFORMW 横たわった%CALLNAME:MASTER%に四つん這いでにじり寄った……	PRINTFORMW 横躺着的%CALLNAME:MASTER%四脚着地地靠近……



