//19-H
選ばれし身体を持ってるのに、まったく活かせないでくすぶっている淫魔	明明拥有被选中的身体，却完全不能活用这个身体的淫魔
精をむしって殺してしまうことを恐れ、破瓜の痛みを恐れている。	害怕剥取别人的精气而将其杀害，也害怕破瓜的疼痛。
そんな中、いくら精をむしって、魂すら奪ってしまっても死なない%CALLNAME:MASTER%に出会う。	在那样的情况下，遇到无论怎么被榨精，即使被夺去了灵魂也不会死的%CALLNAME:MASTER%。
淫魔落第で人間世界に追放されていた%NAME:TARGET%は、\@ TALENT:MASTER:オトコ ? 彼 # 彼女 \@に復権の望みを託すことに。	因淫魔落榜而被放逐到人间世界的%NAME:TARGET%、把复归的希望寄托在了\@ TALENT:MASTER:男性 ? 他 # 她 \@的身上。
PRINTFORMW %CALLNAME:MASTER%は道中に、普通の人にしてはいろいろとできすぎた子が、ぼんやりと空を眺めてる様子を見かけた。	PRINTFORMW %CALLNAME:MASTER%在路上，看到作为普通人来说太过耀眼的孩子，迷茫地望着天空的样子。
PRINTFORMW 掌で目の前を煽ってもしばらく反応しなかったため、その莫大な質量の胸部を掌で包み込んでやったら……	PRINTFORMW 因为用手掌遮在眼前暂时没有反应，那个一只手都包不住的巨大的胸部……
PRINTFORMW 思いっきり頬を平手打ちされた。痛い。	PRINTFORMW 被狠狠地打了下脸颊。好痛。
PRINTFORMW だが、その出会いはひとりの落第淫魔を救う、小さくも大きな一歩だった。	PRINTFORMW 但是，那次邂逅拯救了一个落榜淫魔，是一切故事的开始……
PRINTFORMW %NAME:ARG%は絶望のどん底にあった。	PRINTFORMW %NAME:ARG%处于绝望的深渊。
PRINTFORMW そもそもの種族らしさにない躊躇いと優しさと、狩猟対象を求めるのにためらう内気が、もともとの居場所を失わせるきっかけになった。	PRINTFORMW 和种族特色完全不同的温柔，以及因为内向而在寻求狩猎对象时踌躇不决，使之失去了原来的居所。
PRINTFORMW いるべき場所にいることを許されず、長くいてはならない場所に放置される。	PRINTFORMW 被放逐到人间，不允许呆在原来的地方。
PRINTFORMW 知る人が見れば明らかに危険であることはわかりきったことなのだが……その\@ TALENT:MASTER:オトコ ? 青年 # 少女 \@は、彼女の身の上など知ったことではなく。	PRINTFORMW 在认识的人看来，明显很危险的……\@ TALENT:MASTER:男性 ? 青年 # 少女 \@却并不知道其身份。
PRINTFORMW ただその得難き豊満を手に収めたがため、なんとしてでもその感触を手元に置きたくなっていた。		PRINTFORMW 只是为了把那个难得的丰满的肉体据为己有，无论如何也想把那个甜蜜的触感留在身边。
PRINTFORMW 悪魔に知らされた己の力は、自身の性への渇望を自在に満たし、その欲望をまっすぐにかなえてくれる。	PRINTFORMW 因恶魔知道了自己的力量，为了满足自己对性的渴望，满足那个一直无法平息的欲望。
PRINTFORMW 例え相手が魔の手のもので、精も魂も抜き取られようとも、後から無限にわき続けるのだ。恐れる要素は何もない。	PRINTFORMW 即使对手是恶魔，精灵和其他的什么。灵魂被夺取之后也会无限地继续再生。没有任何害怕的理由。
PRINTFORMW 「な、なん、ですか……？」	PRINTFORMW 「为，为什么……？」
PRINTFORMW 先ほど乳房をわしづかみにした痴漢\@ TALENT:MASTER:オトコ ? 男 # 女 \@という認識で、こちらをにらみつける彼女。	PRINTFORMW 是刚才袭胸的色狼\@ TALENT:MASTER:男性 ? 男 # 女 \@认识到这一点的她，瞪着你。
PRINTFORMW だがすぐに。	PRINTFORMW 但是马上。
PRINTFORMW 「あら、いいんですか？　あなた、揉んでもらってこその淫魔ですよね？」	PRINTFORMW 「哎呀，这样吗？亲爱的，你揉的正是被放逐之后的淫魔吧？」
PRINTFORMW \@ TALENT:MASTER:オトコ ? 青年 # 少女 \@のそばに立つ、魔の者に正体を見破られた。	PRINTFORMW \@ TALENT:MASTER:オトコ ? 青年 # 少女 \@の被站在旁边的恶魔看穿了原形。
PRINTFORMW 「だ、だから、なんだっていうんですか。わ、私は、私をだめだめのくずサキュバスとでもいうんでs」	PRINTFORMW 「你，你说什么啊？我可不是什么被放逐的菜鸟淫魔……」
PRINTFORMW 「そうですね、あなたがそういうなら、そういうことなんでしょうね」	PRINTFORMW 「好吧，如果你不喜欢被那么称呼的话，就不那么叫吧~」
PRINTFORMW 「……っ！？」	PRINTFORMW 「……啊！？」
PRINTFORMW メイド悪魔の肯定に、淫魔は言葉を失った。	PRINTFORMW 被女仆恶魔完全看穿，淫魔沉默了。
PRINTFORMW 「じゃ、じゃあ、どうすれば、いいっていうんです？」	PRINTFORMW 「那种事，我又有什么办法啊？」
PRINTFORMW 「この方の言う通りにしてみたらどうです？　きっとあなたらしくなれると思いますよ」	PRINTFORMW 「按主人公说的去做怎么样？一定能变得更像淫魔哦」
PRINTFORMW 「そんな！！」	PRINTFORMW 「怎么会！！」
PRINTFORMW 「じゃああなたは屑よ、屑の中の屑。最低の」	PRINTFORMW 「你就是垃圾男，屑中之屑。最差劲的那种！」
PRINTFORMW 「っ！！　さ、最低なのは……最低なのはそっち……」	PRINTFORMW 「啊！！！那么，最差劲的……最差劲最差劲的那……」
PRINTFORMW 口喧嘩させるわけにもいかずふたりのやり取りを制して、\@ TALENT:MASTER:オトコ ? 青年 # 少女 \@は手を差し伸べる。	PRINTFORMW 为了停止两人的争吵、\@ TALENT:MASTER:男性 ? 青年 # 少女 \@伸出手来。
PRINTFORMW 助けが欲しいんだろう？　と。	PRINTFORMW 你是想要被帮助的吧？啊？
PRINTFORMW 淫魔は、その手の意味をすぐに理解できずに戸惑ったが、そのふたりを見比べて、はっと何かを察する。	PRINTFORMW 淫魔小姐，不能理解那个手的意义而踌躇了，不过，比起之前二人，察觉到了什么。
PRINTFORMW \@ TALENT:MASTER:オトコ ? 彼 # 主らしいほうの彼女 \@は「特別」なのだと。	PRINTFORMW \@ TALENT:MASTER:男性 ? 彼 # 主らしいほうの彼女 \@是「特別」的。
PRINTFORMW 「……ま、マノン」	PRINTFORMW 「……嗯、万音」
PRINTFORMW 「ままのん？」	PRINTFORMW 「就这样吧？」
PRINTFORMW 「%CALLNAME:ARG%！　わ、私の名前です！」	PRINTFORMW 「%CALLNAME:ARG%！　嗯，是我的名字！」
PRINTFORMW メイドの小悪魔な冗談を一蹴し、淫魔は、\@ TALENT:MASTER:オトコ ? 青年 # 少女 \@の差し伸べた手に応じた。	PRINTFORMW 没有理会恶魔女仆的玩笑，淫魔向、\@ TALENT:MASTER:男性 ? 青年 # 少女 \@伸出了手。
PRINTFORMW %NAME:ARG%は居候として "同棲中" となります。	PRINTFORMW %NAME:ARG%作为寄居地，变成了"同居中"。
PRINTFORMW しかし入学手続きはしていないので部室には来ることが出来ません。	PRINTFORMW 但是因为没有办理入学手续，所以不能来到教室
PRINTFORMW そもそも入学を必要とする年齢かどうかが気になる見た目ですが……	PRINTFORMW 原本就很在意年龄上是不是需要入学……
PRINTFORMW 「あ、あ、あの、よろしくお願い、します……」	PRINTFORMW 「啊，那个，请多关照，拜托了……」
PRINTFORMW %CALLNAME:TARGET%は緊張にがちがちに固くなっている様子だった。	PRINTFORMW %CALLNAME:TARGET%看起来非常容易紧张。
PRINTFORMW %CALLNAME:MASTER%が%CALLNAME:TARGET%をそっと抱きしめると、瞬間驚きにびくついた。	PRINTFORMW %CALLNAME:MASTER%轻轻地抱住了%CALLNAME:TARGET%的瞬间、显然是被吓了一跳。
PRINTFORMW 静かに背中をさすり、頭を撫でてやっていると、%CALLNAME:TARGET%はだんだんと落ち着きを取り戻す。	PRINTFORMW 静静地搂着背，轻摸着脑袋、%CALLNAME:TARGET%渐渐地恢复了平静。
PRINTFORMW 「あ、あ、あの、もう、だいじょぶ、です……」	PRINTFORMW 「啊，啊，那个，已经不要紧了……」
PRINTFORMW 「えっち、ですよね……私、淫魔なので本当は、したくてたまらないんです」	PRINTFORMW 「诶，那个……我，因为是淫魔真的，可能会忍不住」
PRINTFORMW 「た、ただ、ただ、お願いですから……本番は、お、おまんこをおちんぽで貫くことは、しないでください……」	PRINTFORMW 「所以，所以，拜托了……做的时候，请不要用插入我的……那里……」
PRINTFORMW 「かわいそ、サキュバスのくせに。%CNAMET(ASSI, "二人称")%の本番禁止なんてかわいそうすぎ」	PRINTFORMW 「真可怜，明明面对着这样的美少女。%CNAMET(ASSI, "二人称")%却被本番禁止真是太可怜了」
PRINTFORMW 「ううううるさい、ですメイド」	PRINTFORMW 「烦死了、你个女仆」
PRINTFORMW %CALLNAME:MASTER%はどちらもたしなめ、%CALLNAME:TARGET%に無理を強いないことを約束した。	PRINTFORMW %CALLNAME:MASTER%和%CALLNAME:TARGET%达成了不会无理强迫的约定。
//PRINTFORML - システムメッセージ -	PRINTFORML - 系统信息 -
PRINTFORML マノンは極端に性交行為を嫌がっています。	PRINTFORML 万音讨厌极端的性行为。
PRINTFORML ただ、元来が淫魔なので本気な頑なさではないはずです……	PRINTFORML 不过，因为本来就是淫魔，应该不是真心顽固的抗拒……
PRINTFORML 精子と精液の味をしっかり覚えさせ、しっかり屈服させるか、あるいは伴侶として認められればあるいはと思いますが……強引に迫っても意外と大丈夫かもしれません。	PRINTFORML 如果让她好好地记住精液的味道，或是好好地使之屈服，或者作为伴侣被认可或者……强行逼迫说不定意外也可行
PRINTFORMW ご武運を！	PRINTFORMW 祝你好运咯！
PRINTFORMW 「あ、あの……あの」	PRINTFORMW 「啊，那个……那个」
PRINTFORMW 普段と違う、マノンの戸惑いが感じられる……今日はこらえが効かない。	PRINTFORMW 能感到与平时万音有所不同……今天有些按奈不住的样子
PRINTFORMW 「私……その……んっっ」	PRINTFORMW 「我……那个……嗯……」
PRINTFORMW 唇をふさいで、圧倒的な乳房を手に携えるように揉みしだく。	PRINTFORMW 封住她的嘴唇，像要揉碎一样压倒性地蹂躏她的胸部。
PRINTFORMW 「んぁぁ……そ、そんなに揉まれたらすぐ……」	PRINTFORMW 「嗯……啊……那、那样被揉的话马上……」
PRINTFORMW マノンが嫌がるのは、すこし触られただけで達するくらい、他人に胸を触られることに弱いからだと知った。	PRINTFORMW 万音之所以讨厌被别人碰触胸部，是因为她害怕被人发现胸部是弱点，只是被摸了一下就……
PRINTFORMW いつも、いつも潔癖に性的なことを突っぱねようとするくせに、その実どこまでも、誰よりも性行為に貪欲な、淫魔らしい淫魔なのが彼女だ。	PRINTFORMW 平时，总是洁癖似地排斥性事，但实际上，比任何人都渴望着，好象淫魔一样……其实她就是淫魔……
PRINTFORMW 「や、やぁ……そんな、淫乱じゃないよ……」	PRINTFORMW 「呀，哎呀……那么淫乱……」
PRINTFORMW 「わ、わたし、落第するくらい、なんだよ」	PRINTFORMW 「可是……我……居然落第了。」
PRINTFORMW そんなかわいい彼女に、いつから……惚れこんでいたんだろう。	PRINTFORMW 不知道从什么时候开始，她变得那么可爱而让人迷恋……
PRINTFORMW 「で、でも……でも、わたしもう、我慢できないよ」	PRINTFORMW 「但，但是……但是，人家已经受不了了」
PRINTFORMW どうしようもないくらいに膨れ上がった劣情を、お互いに抱き合った中にあふれさせながら、ベッドに倒れ込んだ。	PRINTFORMW 毫无办法地膨胀起来的情愫，在互相的拥抱中溢了出来，美好的肉体轻轻地倒在床上。
PRINTFORMW 「わ、わた、わたし、あの……」	PRINTFORMW 「我、我、那个……」
PRINTFORMW いつものように抱こうとするとマノンはためらいをあらわにするのだが……	PRINTFORMW 像往常一样抱着的万音露出了犹豫的神情……
PRINTFORMW 「今日は、その……ほんば、本番しても怒らないから……」	PRINTFORMW 「那个……如果是……如果是今天的话，就算是本番也不会生气的……」
PRINTFORMW どういう風の吹き回しか。	PRINTFORMW 不知道吹的什么风。
PRINTFORMW あれほど嫌がっていたというのに。	PRINTFORMW 明明是那么排斥的。
PRINTFORMW 「だ、だって、だって……こんなの、初めてで、こんな気持ち、初めてで……」	PRINTFORMW 「因为，因为……这样的，这样的心情，第一次，还是第一次……」
PRINTFORMW 淫魔らしくもないのに淫魔にない感情に目覚めたと。	PRINTFORMW 看来某个落第淫魔因为感情而觉醒了。
PRINTFORMW 「ら、ら、らしくないなんて、いいい言わないで。私、落第だから……」	PRINTFORMW 「别……别那么说。只是因为我没考上……」
PRINTFORMW そんな風に都合良く落第を使い分けるマノンのことを躾けるような行為をしてやろうともくろんだ。	PRINTFORMW 看来得好好教育一下这个为了自己方便而随便使用落第这个词的淫魔了。
PRINTFORMW 「！？　え……え……や、やぁ、やっぱ、そんな風ならだめぇっ」	PRINTFORMW 「！？哎……哎……哎呀，哎呀，果然，这样的话不行啊」
PRINTFORMW 「えっと、今日は%CALLNAME:MASTER%に教えておきたいことがあるの」	PRINTFORMW 「那个，今天有件事想告诉%CALLNAME:MASTER%」
PRINTFORMW 「実は、今日は私の意志に反して、子宮で直接ごっくんすると……確実に宿しそうな日」	PRINTFORMW 「其实，今天是身体不听话的日子呦，如果今天在子宫里直接发噗噗的注射的话……一定会有小宝宝的」
PRINTFORMW 「あははは、そんなに驚かなくても。というか信じられないのかな？」	PRINTFORMW 「啊哈哈，是吃惊呢。还是无法相信呢？」
PRINTFORMW 「とにかく……今日はできたら、よく考えて精液を下のお口で飲ませてくれると助かるんだけど……」	PRINTFORMW 「总之……如果今天可以的话，好好考虑一下把精液射在嘴里的话就帮大忙了……」
PRINTFORMW 「ちなみに私は……%CALLNAME:MASTER%との子ども、授かってもいいよ？」	PRINTFORMW 「顺便……生下来%CALLNAME:MASTER%的孩子的话？可以吗」
PRINTFORMW 「そうなんだよ……だから、精液を下のお口に飲ませてくれるとき、少し考えてもらえると助かるなぁ」	PRINTFORMW 「是啊……所以，如果用嘴巴喝下精液就好了，那个时候稍微考虑一下？」
PRINTFORMW 普段からつまらないことで突っかかり合うあのメイドへの対抗心から、%CALLNAME:TARGET%はどうしても子どもを授かりたくなった。	PRINTFORMW 不同于平素因为各种无聊的事互相碰撞对抗心、现在的%CALLNAME:TARGET%无论如何想授予孩子。
PRINTFORMW %CALLNAME:TARGET%は、自身の胎で受精卵を受け止めるための準備を万端にした！	PRINTFORMW %CALLNAME:TARGET%做好了用自己的卵子接受精子的准备！！
PRINTFORMW %CALLNAME:TARGET%は仲の良い%CALLNAME:LCOUNT%の妊娠を知って、自分もどうしても授かりたくなった。	PRINTFORMW %CALLNAME:TARGET%知道了和自己关系好的%CALLNAME:LCOUNT%妊娠、自己也非常渴望被赐予孩子。
PRINTFORMW %CALLNAME:TARGET%は、あの%CALLNAME:LCOUNT%への対抗心に、自分もどうしても授かりたくなっていた。	PRINTFORMW %CALLNAME:TARGET%因为和%CALLNAME:LCOUNT%的敌对心理、自己也非常渴望被赐予孩子。
PRINTFORMW 「あ、あ、あの、%CALLNAME:MASTER%……ここのところもうずっと、このあたりから下が、その……」	PRINTFORMW 「啊，啊~那个%CALLNAME:MASTER%……这里已经，还有这里的下面……那个……」
PRINTFORMW %NAME:TARGET%は下腹部の付近から秘める部位までをなぞって、さすってみせながら、うるむ瞳で消え入りそうな声で続けようとし、	PRINTFORMW %NAME:TARGET%从下腹部到隐藏的部位被轻轻抚摸着，眼睛已经湿润了，声音却快要消失了似的，
そのたびに強いためらいで言葉に詰まりつづけていた。	非常地踌躇不决，一直无法说出口。
PRINTFORMW その様子についいたずら心で唇を奪いその圧巻の質量を両の手にわしづかみに蹂躙した。	PRINTFORMW 这种情况下抱着恶作剧的心态吻了上去，双手则狠狠地蹂躏了质量惊人的胸部。
PRINTFORMW 「ひっ、むぅぅぅ！！」	PRINTFORMW 「呜，呜呜！！」
PRINTFORMW それだけで快楽を登り詰めて、口づけを離して絶叫した。	PRINTFORMW 仅此就登上了快乐的巅峰，松开了嘴唇开始大声娇喘。
PRINTFORMW 面白くてついやりかけるが、彼女の体を最初に味わった日のように、そっと抱きしめた。	PRINTFORMW 虽然恶作剧很有趣，但还是像第一次开发她的身体的那天一样，轻轻地抱住了她。
PRINTFORMW だがその抱きしめはあの時とは違う。	PRINTFORMW 但这个拥抱不同于那时。
PRINTFORMW ぐっと硬く持ち上がった下腹部を、彼女の疼きに押し付けてやる。	PRINTFORMW 用硬硬地举起的肉棒，顶在她的疼痛上。
PRINTFORMW 「ぁ……ふぁぁ……せっく、す……%CALLNAME:MASTER%、私、せっくすしたい……おまんこに、おちんぽ、抜き差ししてもらって、お腹の奥で	PRINTFORMW 「啊……啊……好难过……%CALLNAME:MASTER%我、我、好想要……想让你顶进来，
たくさん、精液と精子を飲みたいの……おねがい、しますっ！」	最深处好想要饮下好多好多的精液……拜托了！」
PRINTFORMW 「もう、それ以外、望まないからぁ、もう、普段えっちなこと、されても、怒らないからぁ……ぱんつ、いくらでもあげるからぁ……して、せっくすして、ずっこずこしてっ……いっぱい、いっぱい膣内射精(なかだし)、してっ……子宮にびゅーびゅーして……ぇっ」	PRINTFORMW 「除此以外，我没有其他的奢望了，就算平时被说些小气话，我也不会生气……说什么都听你的……啊，好难过，深处都在发疼了……满满地，满满地射在里面~(膣内射精)、直接注入到子宫里来~」
PRINTFORMW 淫魔らしい淫魔に堕ちた%CALLNAME:TARGET%の姿は、なによりつややかに美しく、扇情的で。	PRINTFORMW 堕落为淫魔的%CALLNAME:TARGET%的身姿，比什么都诱人，更煽情。
PRINTFORMW すべての欲望という欲望を注ぎ込まずにいられず、彼女に覆いかぶさった。	PRINTFORMW 想要把全部的欲望都注入进去、想要用欲望覆盖她的全身……
PRINTFORMW ※本番行為を許可されました。	PRINTFORMW ※本番行為被许可了。
PRINTFORMW ※%CALLNAME:TARGET%がセックスに完全におぼれました。	PRINTFORMW ※%CALLNAME:TARGET%完全沉溺于性爱的快乐了。
PRINTFORML ※%CALLNAME:TARGET%が淫魔として覚醒しました。	PRINTFORML ※%CALLNAME:TARGET%作为淫魔觉醒了。
PRINTFORMW 自分らしい自分をはっきり理解し受け入れたため、性格面で大きな自信がついたようです。	PRINTFORMW 因为直面并接受了真正的自己，在性格方面好像自信了起来。
PRINTFORMW 「っ！　ひあぁ……な、なに、あ、あああの、えっとっ、ふぁぁ」	PRINTFORMW 「啊！啊……什、什么、啊、啊那个、诶！啊啊！」
PRINTFORMW セクハラではない、明確な行為として初めて受け入れる性的な触れあいに、%CALLNAME:TARGET%は戸惑いながらも甘い声を隠せないでいた。	PRINTFORMW 对于已经不是性骚扰、而是明确的性行为接触的行动、%CALLNAME:TARGET%一边踌躇着一边不禁发出了甜腻的声音。
PRINTFORMW %COND("好きな体位中") ? "お気に入り体位で入れられながらの胸愛撫に" # "入れられながらの胸愛撫に"%%CALLNAME:TARGET%は声にならない声で悦んでいる……	PRINTFORMW %COND("好きな体位中") ? "一边用喜欢的体位做爱一边爱抚着胸部" # "一边进入一边胸愛撫"%%CALLNAME:TARGET%用不成声音的声音展示着喜悦……
PRINTFORMW 「見てみたいんだ、この奥……」	PRINTFORMW 「想看吗，我的里面……」
PRINTFORMW 「いいよ、とてもあなたを欲しがってる私の奥の奥、じっくり見て……」	PRINTFORMW 「好啊，好想要主人公看看我的里面，仔细地……」
PRINTFORMW 「……っ！！　な、な、っ、う……ううん、だめじゃないよ……」	PRINTFORMW 「……啊！什、什、什么！……不，也不是不行……」
PRINTFORMW 「やだ……そんなに、そんなに見るの……っ」	PRINTFORMW 「讨厌……你怎么还在看……啊！」
PRINTFORMW 抗議する割には、言った通りに応じてくれている。	PRINTFORMW 虽然提出了抗议，但还是按照我说的去做。
PRINTFORMW 「す、するんだ……え、えと、うん、いいよ」	PRINTFORMW 「做、做吗？……嗯，嗯，好啊」
PRINTFORMW 「お腹の奥、もうたまらない……大好きな人のを受け入れたくて受け入れたくているの」	PRINTFORMW 「里面已经想要的受不了了……想接受最喜欢的人的灌溉啊」
PRINTFORMW 「いままで拒絶してごめんなさい……今まで禁止しててごめんなさい……いま、まで、っぁ」	PRINTFORMW 「之前一直拒绝，对不起……现在完全解禁了，对不起……现在、完全~啊」
PRINTFORMW いろいろ我慢できない先端をマノンの入り口に押し付けた。	PRINTFORMW 将让其难以忍受的前端顶在到万音的入口处
PRINTFORMW 「っく、うん、いいよ、いいの、きて、ほしい、たくましいの欲しい、がつがつ最奥突き上げてほしい……」	PRINTFORMW 「好啊~好啊~来吧，好想要，想要硬硬的，希望您能在最深处……」
PRINTFORMW 「おね、おねが……あっっ！！」	PRINTFORMW 「您啊~您啊……啊！！」
PRINTFORMW マノンの言葉より早く、こらえの効かない茎を柔らかさに押し込んだ。	PRINTFORMW 比万音的央求更早，将无法忍受的肉棒温柔地插了进去。
PRINTFORMW やや強めの抵抗は彼女の潤沢な愛液の中に飲まれるとすぐに消え、かわりに根元から先端を一瞬で白濁がつなぎきるほどの精感が襲う。	PRINTFORMW 再她的爱液的润滑下几乎没有体会到抵抗感觉，取而代之的是一瞬间袭来的流遍全身射出白浊的冲动。
PRINTFORMW 「っ、ぅ……」	PRINTFORMW 「嗯……哈……」
PRINTFORMW 「はぁ、はいった、はいったよぉ、うれし、こ、こんなに、うれしいの、はじめて……あ、あの……あの……」	PRINTFORMW 「啊，进来了~进来了~好高兴，这，这么高兴，还是第一次……啊，那个……那个……」
PRINTFORMW 「いちばん、奥で、びゅぅぅって、して……」	PRINTFORMW 「最里面、最里面、最里面……」
PRINTFORMW 「わ、わたし、あなたと、お腹の奥でも結ばれたいよ……」	PRINTFORMW 「嗯~想和你，最深处也能连接在一起……」
PRINTFORMW マノンの悦びを叶えるべく、じっくりと暴れかけるのを抑えながら、腰を深く密着させた。	PRINTFORMW 为了实现万音的喜悦，不再慢慢吞吞的动作地闹腾，把下腹紧密地贴紧合在一起。
PRINTFORMW 「き、たぁ……っ！！」	PRINTFORMW 「一直以来，啊！！」
PRINTFORMW 待ちわびた瞬間が、破瓜の痛みなど一瞬で押し流すかのように、%CALLNAME:TARGET%との結合部から溜まった愛液が押し出されて溢れた。	PRINTFORMW 焦急的瞬间，像是破瓜的疼痛被冲走了一样，从%CALLNAME:TARGET%的结合处大量的积存的爱液被挤地溢了出来。
PRINTFORMW 「っく……痛い、けど、それがいいの、やっと、やっとセックスできたんだものぉ……はぁ、はぁぁ、っぁあ！！」	PRINTFORMW 「呃……虽然很痛，不过好开心，好不容易才能真正地结合在一起……哈~哈~啊」
PRINTFORMW より深く、より強く、より激しくつながりたそうに、%CALLNAME:TARGET%はきつく締めあげる初めての膣内の、まだ浅くほぐれきれてない奥の奥へ招き入れようと腰を揺さぶって、より結合を密着させようとしていた。	PRINTFORMW 被更深，更强，更激烈地侵犯着、%CALLNAME:TARGET%第一次被侵入的膣内紧紧地收缩，还为了寻求更多快感摇起了腰，想要让里面更紧密的贴合在一起。
PRINTFORMW 「もっとぉ、もっとぉ……」	PRINTFORMW 「更加、更加……」
PRINTFORMW 「ねぇ、私が初めてだから、少し休んでるの……？　優しいなぁ……はぁ、でも、今の、今の私に心遣いをするなら……もっと、動いて、もっと、激しくして……」	PRINTFORMW 「嗯？因为我是第一次，稍微休息一下……？好温柔啊……哈~，但是，如果现在你关心我的话……万音舔了舔嘴唇~那就再深一点，再激烈一点……」
PRINTFORMW 「せーし、せいえき、どぷどぷしてください……中の、奥の、おくで、びゅーびゅーください……」	PRINTFORMW 「肉棒先生，请噗嗤噗嗤吧~……里面的、里面的、里面的、里面的~」
PRINTFORMW 求めの言葉をありのままにするかのように、%CALLNAME:TARGET%の中が不慣れさを感じさせないように、%CALLNAME:MASTER%を柔らかく包み込みはじめる。	PRINTFORMW 像是为了应和万音渴求的言语、%CALLNAME:TARGET%的里面像是有了自己的意识一样、温柔的纠缠和催促着%CALLNAME:MASTER%。
PRINTFORMW %CALLNAME:MASTER%は、%CALLNAME:TARGET%が望むがままのセックスを叶えるように、強く腰を密着させた。	PRINTFORMW %CALLNAME:MASTER%为了满足%CALLNAME:TARGET%的渴望，用力地贴紧了腰部。
PRINTFORML 「だ、だめ、だめです！　おちんぽ押し付けてるのだめっ！」	PRINTFORML 「不行，不行！不行！不要压上来！」
PRINTFORML [1] 入れたいとささやく	PRINTFORML [1] 低声的说想要插入
PRINTFORML [2] 入れるのを我慢する。	PRINTFORML [2] 忍着不放进去
PRINTFORMW 「だ、だめですっ！　さ、最初にお願いしましたよっ！」	PRINTFORMW 「不行，不行！我们最开始说好了的！」
PRINTFORML [1] 覚えてない	PRINTFORML [1] 不记得了
PRINTFORML [2] やむをえないので我慢する	PRINTFORML [2] 没办法只好忍耐
PRINTFORMW 「ひっ、ひどいですっ！　そういいながら先を押し込まないでくださいっ！」	PRINTFORMW 「哎呀，太过分了！一边这么说着，请不要再进来了！」
PRINTFORML [1] ものすごく入れたい	PRINTFORML [1] 非常想插入
PRINTFORML [2] かわいそうなので我慢する	PRINTFORML [2] 因为可怜她而忍耐
PRINTFORMW 「そ、そんなに、そんなに入れたいんですか……っ。お、お口でも、おっぱいでも射精していいですから、か、おまんこはぁっ」	PRINTFORMW 「那，那么想插进去吗……啊。嘴巴、胸部都可以的，只有那里！只有那里！」
PRINTFORML [1] もう無理、入れる！	PRINTFORML [1] 木大木大木大木大！插进去！
PRINTFORML [2] ちゃんと奉仕しろと念を押して我慢する	PRINTFORML [2] 叮嘱要好好侍奉，暂时忍耐
PRINTFORMW 「ひっ、ぎ、あっ、は、やぁ、痛い、痛い痛い入りかけてます、しょ、処女膜がぁ！　やめて、もうやめて！」	PRINTFORMW 「啊！嘶——，啊！好疼，好疼，好疼，好疼，别再进入了，那里是处女膜！住手，别干了！」
PRINTFORML [1] 止められない、最奥まで突き入れたい！	PRINTFORML [1] 不可阻挡！想要冲进最深处！
PRINTFORML [2] 痛ましいので我慢する	PRINTFORML [2] 因为对方的痛苦而忍耐
PRINTFORMW 「い、いやあああああ！！　いっ、ぎ、ああああ！！！」	PRINTFORMW 「哎呀，哎呀啊啊啊啊！！哇，嘶，啊啊啊！！」
PRINTFORMW %CALLNAME:TARGET%の、破瓜の激痛の絶叫を押しのけるように、最奥を突き上げた。	PRINTFORMW 在%CALLNAME:TARGET%的破瓜的剧痛的尖叫中，插进了最深处。
PRINTFORMW 「あっ、はぁっ、はぁっ、っく、っっ」	PRINTFORMW 「啊——哈——哈——啊、啊、嘶——呜呜」
PRINTFORM 息も絶え絶えにこらえる%CALLNAME:TARGET%の中は、	PRINTFORM 感受着痛的奄奄一息的%CALLNAME:TARGET%的里面、
PRINTFORMW 一瞬で根本から精子が遡るほどの、狭さと感触と、ぬめりと温かさで、%CALLNAME:MASTER%を包み込んでいた。	PRINTFORMW 像是要从从根本处索求精子那样，狭窄、润滑而温暖的触觉感，包裹住了%CALLNAME:MASTER%的分身。
PRINTFORMW 今までに感じたことのない強烈な刺激のあるざらつきと、ぬめりと、きつさで、%CALLNAME:MASTER%を迎えた。	PRINTFORMW 至今为止从未感受过的强烈刺激，那摩擦感、润滑而严厉，迎接了%CALLNAME:MASTER%的插入。
PRINTFORMW 「だめぇ、抜いて、ぬいてぇ……っ」	PRINTFORMW 「不行，拔出去，拔出去……啊」
PRINTFORMW 「や、やぁ、ひ、ヒニンしてない……っぁあ！！」	PRINTFORMW 「哎呀，哎呀，哎呀，怎么没有……啊……啊！！」
PRINTFORMW 「おねが、いぃ、きょ、今日はほん、ほんとにだめ、なのぉ！！」	PRINTFORMW 「拜托，喂，喂，今天，真的不行啊！！」
PRINTFORMW 「おねが、いぃ、きょ、今日、あぶなっ、いの！！」	PRINTFORMW 「拜托、喂、喂！今天是危险日、喂！！」
PRINTFORMW %CALLNAME:TARGET%の悲鳴のような主張を押しつぶすように、膨大に膨れ上がる欲望を叩きつけるように腰を押した。	PRINTFORMW 在%CALLNAME:TARGET%的悲鸣声中，抑制住了膨胀的欲望抽出了腰。
PRINTFORMW それこそ、彼女の望む通り、「膣内で」抜くために。	PRINTFORMW 正如她所期望的那样，从「膣内」拔了出去。
PRINTFORMW 経験の薄い%CALLNAME:TARGET%にも、%CALLNAME:MASTER%の動きの変化が射精の近さを予測させた。	PRINTFORMW 就算是经验稀少的%CALLNAME:TARGET%、也从%CALLNAME:MASTER%动作的变化中预测到了射精的临近。
PRINTFORMW 「あ、あの、まさか、まさか……」	PRINTFORMW 「啊，那个，不会吧……」
PRINTFORMW 今膣奥に密着する鈴口にはなんの障りもない。	PRINTFORMW 现在在阴道深处的紧贴的铃口和子宫口之间没有任何障碍。
PRINTFORMW 「だ、だめっ！　射精するなら抜いて！　外に出してっ！　中は、なかはぁ」	PRINTFORMW 「不行，不行！射精的话就拔出去！出去！里面是、里面是……」
PRINTFORMW %CALLNAME:TARGET%もがくように腰を揺さぶるが、狭さに深く挿しこまれた結合を悦ばせるだけだった。	PRINTFORMW %CALLNAME:TARGET%像挣扎一样地摇动腰,不过，只是使得深深地被插入了的结合处更加快乐了而已。
PRINTFORMW 「う、ううん……い、いいから、そ、そのままでも、いいから、早く……終わらせて……」	PRINTFORMW 「“嗯，不……不，没关系，就那样，没关系，快点……结束吧……」
PRINTFORMW とにかく早く終わらせたがるそぶりを見せた。	PRINTFORMW 显出了无论如何都想早点结束的样子。
PRINTFORMW 淫魔として最も波長のかみ合う日に、子宮へ直接精液を注がれたマノンの体は、子を宿すために精子を受け入れよう備している！	PRINTFORMW 作为淫魔身体最能接受的日子，被子宫直接注入了精液的万音，接受了精子而妊娠了！
PRINTFORMW 「むー」	PRINTFORMW 「唔—」
PRINTFORMW %CALLNAME:TARGET%はとても不満そうな顔で、コンドームが装着される様子をにらんでいた。	PRINTFORMW %CALLNAME:TARGET%用非常不满的表情，凝视着戴着的安全套。
PRINTFORMW 特別止める様子はないので、何も言わず装着を完了したが……	PRINTFORMW 因为没有什么特别的情况，什么都不说就……这样不仅少了很多刮蹭的快感，更不能平息子宫深处渴望的疼痛……
PRINTFORMW 「あ……え、えと、あ、ありがとう……」	PRINTFORMW 「啊……嗯，那个，啊，谢谢……」
PRINTFORMW 「……その、す、するんです、よね」	PRINTFORMW 「……那个、那个、要做、是吧」
PRINTFORMW 「べ、別に……私、淫魔だから……」	PRINTFORMW 「还是别了……因为我是淫魔……」
PRINTFORMW いろいろ思うところありそうだが、彼女の下の口は言葉よりも正直だった。	PRINTFORMW 虽然她这么说着，但她下面的小嘴却比主人更加诚实。
PRINTFORMW 「あら……コンドーム持ってないの？　ふふ、%CNAME("一人称")%との間にヒニンはもう必要ないから？」	PRINTFORMW 「哎呀……你没有带避孕套吗？呵呵%CNAME("一人称")%之间已经不需要了吧？」
PRINTFORMW 「%TEXTR("それだと他の子で困らないかしらね……/もちろん私は、ナマで一番奥で、いっぱい出してほしいけど……？/今日もナマでする気満々だった……？/私はもちろん、ナマしか考えられない……/もしかしたらできちゃうかもしれないのに？")%」	PRINTFORMW 「%TEXTR("这样的话就不会对其他人造成困扰了呢……/当然了、我个人是想无套着在最最里面、一口气大量的射出来的……？/今日也是干劲满满地想要无套中出……？/我当然也是一样、没有想过无套中出之外的选择项……/明明说不定一不小心会怀上？")%」
PRINTFORMW 「それはともかく……いいわ、今日もたくさん楽しみましょ。ね……私もう、お腹の奥がうずいてたまらないの」	PRINTFORMW 「先不说那个……那个，今天也好好享受吧。嗯……我肚子里想要的发疼了~」
PRINTFORMW 「ま、まって、い、入れるなら、せめて、ゴム、つけて……？」		PRINTFORMW 「嘛，等一下，喂，要放进去的话，至少，戴一下避孕套……？」
PRINTFORMW 「……あの、ゴム……」	PRINTFORMW 「……那个、避孕套……」
PRINTFORMW 「やっ、だ、だめ、なんでしてくれないの！？」		PRINTFORMW 「哎呀，不行，不可以的啊！？」
PRINTFORMW 「まさか、もって、……だ、だめ、いれちゃ、っ、あっぁっ！！」	PRINTFORMW 「难道……不行，不行，不行，啊，啊！！」
PRINTFORMW 「今日は好きなだけ出していいから、たくさんくださいね」	PRINTFORMW 「今天可以随心所欲有，想要多吃一点啊~」
PRINTFORMW 「ね、お願い。精子と精液、下のお口に飲ませて。子宮にごくごくさせてほしいの……」	PRINTFORMW 「喂，拜托了。浓浓的精液，想用下面好好品尝一下呢。想让你在子宫里好好地……」
PRINTFORMW %CALLNAME:TARGET%は、潤沢に愛液を湛えた入り口を指先で指し示し、その瞬間を待ちわびていた。	PRINTFORMW %CALLNAME:TARGET%被指尖爱抚着充满了爱液的入口，焦急地等待着那个瞬间。
PRINTFORMW 「ま、まさか……ううん、別に、今日は、できない日だし」	PRINTFORMW 「不会吧……不，没什么，今天不是不行的日子」
PRINTFORMW 「ゴムしたくないなら、そのまましていいよ」	PRINTFORMW 「如果不想避孕套的话，那就这样好了」
PRINTFORMW %CALLNAME:TARGET%は口の割に、うるんだ瞳と内股にすり合わせる下腹部を隠せていなかった。	PRINTFORMW %CALLNAME:TARGET%虽然遮住了嘴巴，但隐藏不住湿润的眼睛和内弯着的不停摩擦着的大腿。
PRINTFORMW 「もちろんだと思うけれど……ゴムなんて野暮はしないよね？」	PRINTFORMW 「怎么会这么想……避孕套什么的已经不需要了吧？」
PRINTFORMW 「でしょ。ふふ、%CNAME("一人称")%との間にはもうヒニンは必要ないもの」	PRINTFORMW 「对吧。呼呼、%CNAME("一人称")%之间已经不需要了」
PRINTFORMW 「%TEXTR("ね、今日もたくさんしてくれるよね……？/もちろん私は、ナマで一番奥で、いっぱい出してほしいけど……？/もしかして、ナマでする気満々だった……？　はぁ……うれしいなぁ/私はもちろん、ナマしか考えられない……/あーでも、もしかしたらできちゃうかもしれないよ？　なんてね……")%」	PRINTFORMW 「%TEXTR("呐、今天也要在里面射很多对吧……？/当然了、我个人是想无套着在最最里面、一口气大量的射出来的……？/今日也是干劲满满地想要无套中出……？　哈啊……真开心呢/我当然也是一样、没有想过无套中出之外的选择项……/啊真是的、明明说不定一不小心会怀上？　——开玩笑的……")%」
PRINTFORMW 「よかった……もう我慢できないの。ね、ずぶって入れたいな……」	PRINTFORMW 「太好了……已经忍不住了啊。喂，要吃进去了啊~……」
PRINTFORMW 「密着するくらい深々と突き上げて、一番奥に欲しいな……」	PRINTFORMW 「充满着欲望的将最深处紧贴住了……」
PRINTFORMW 「あら……ふふ、%CNAME("一人称")%との間にはもうヒニンは必要ないよね」	PRINTFORMW 「哎呀……呼呼、%CNAME("一人称")%之间已经不需要那个了吧」
PRINTFORMW 「今日もたくさん楽しみましょ。ね……私もう、お腹の奥がうずいてたまらないの」	PRINTFORMW 「今天也好好享受吧。呐……人家的肚子里已经在发疼了~」
PRINTFORMW 「ね、お願いだから……だ、だめ、いれちゃ、っ、あっぁっ！！」	PRINTFORMW 「啊，拜托了……不行，不行，不行，啊！！」
PRINTFORM 「あはぁぁ……寝る前なのに、ごめんなさ、っあ、疲れてるよね、でも、	PRINTFORM 「啊哈啊……还没睡，对不起啊，虽然要睡觉了，但是……
PRINTFORM あんなに、してもらったのに、たくさん、もらったのに……私、全然足りないの……もっと、もっと欲しくて	PRINTFORM 明明得到了那么多，得到了很多……但是完全不够啊……我还要~我还想要啊~
PRINTFORM %CNAME("一人称")%は、淫魔なんだからね……もっと、もっとしてほしいの……だから	PRINTFORM %CNAME("一人称")%是淫魔呀……还想再多来点什么……所以，所以~
PRINTFORMW ……ちょっとだけ、ちょっとだけ私のわがままに……付き合って……ぁぁぁ……」 	PRINTFORMW ……稍微，稍微有点任性……交合吧~……啊啊……
//19-DAILY
PRINTFORMW 「んふ……　\@　CALLNAME:MASTER != "あなた" ? 、 %CALLNAME:MASTER% # \@。 %TEXTR("おはよう……/おはよ、びっくりした……？/おはよう、こういう起こされ方もたまにはいいでしょ？/ん、ふ……ちゅ、んんっ/おはよ、ぅ……んちゅ")%」	PRINTFORMW 「嗯呐……　\@　CALLNAME:MASTER != "主人公" ? 、 %CALLNAME:MASTER% # \@。 %TEXTR("早上好……/早上好，吓了一跳……？/早上好，偶尔被这样叫醒也不错吧？/嗯，哼……嗯，嗯/早上好，嗯……")%」
PRINTFORMW 「\@　CALLNAME:MASTER != "あなた" ? 、 %CALLNAME:MASTER%、 # \@ あの、%TEXTR("べ、べつにせーしなんて……んむっ/んっ、ちゅ、ちゅば/こ、こうしなきゃ、辛そうだから/はぁ、んむっ、ちゅ")%」	PRINTFORMW 「\@　CALLNAME:MASTER != "主人公" ? 、 %CALLNAME:MASTER%、 # \@ あの、%TEXTR("啊，没什么……嗯/嗯，嗯哈、嗯啊/嗯，不这样做的话会很辛苦吧/嗯，嗯，嗯，嗯哈")%」
PRINTFORMW 素直さのない悪態に聞こえるが、だいぶ熱心な口淫を続けていた。	PRINTFORMW 听起来像个不诚实的坏话，但还是相当热心地持续着口交。
PRINTFORMW 「ただいまもどりました～　\@　CALLNAME:MASTER != "あなた" ? 、 %CALLNAME:MASTER% # \@。 %TEXTR("今日もお疲れ様/いつもお疲れ様/少し、待ち遠しかった/待ってた……よ？/ね、今日も……する？")%」	PRINTFORMW 「我回来了～　\@　CALLNAME:MASTER != "主人公" ? 、 %CALLNAME:MASTER% # \@。 %TEXTR("今天也辛苦了/总是很辛苦/有点久等了/等了很久吗？")%」
PRINTFORMW 「た、た、ただいま\@　CALLNAME:MASTER != "あなた" ? 、 %CALLNAME:MASTER% # \@。 あの、%TEXTR("おつかれ、じゃないです？/えと、その、うぅ……(言葉に詰まる)！/お、おつかれさまです！/え、えと……その、します？　あ、あの、もちろん入れちゃ嫌ですよっ！")%」		PRINTFORMW 「嗯、我回来了\@　CALLNAME:MASTER != "主人公" ? 、 %CALLNAME:MASTER% # \@。 あの、%TEXTR("辛苦了，不是吗？呃，那个，唔……（说不出话来）/辛苦了！诶，呃.。那个，你要吗？那，那个/啊，那个，那个……不是啦……")%」
PRINTFORMW 「おかえりなさい、%TEXTR("今日もお疲れ様/いつもお疲れ様/少し、待ち遠しかった/待ってた……よ？/ね、今日も……する？")%」	PRINTFORMW 「欢迎回来、%TEXTR("今天也辛苦了/总是很辛苦呢/有点，久等了……/。哟？那……今天也是要……做吗？")%」
PRINTFORMW 「あの、お、お、%TEXTR("おかえりなさい！/お、おかえりなさい！/おかえりください！　って、ああ何言ってるのっ/お待ちして……ってそんなえっちじゃないからっ！/お、お、おおぉぉ……あれ？")%」	PRINTFORMW 「那个、嗯、嗯、%TEXTR("欢迎回来！/你回来啦！/欢迎回来！啊，你在说什么啊/等一下……像个色狼一样！/嗯、嗯、嗯……咦？")%」
PRINTFORMW 「先に来てたよ、%TEXTR("これからするのよね……ね？/今日私の番だといいなぁ/うん……したいしたいしたいしたい/あー、もう、うずうずするっ/ね、今日も……する？")%」	PRINTFORMW 「我先来了、%TEXTR("从现在开始做吧……可以吗？/今天轮到我就好了/嗯……想做想做的事/啊，已经……好郁闷啊/呐，今天也……做吗?")%」
PRINTFORMW 「あの、あの、%TEXTR("今日は早くて……え、そんなにしたいかって？　ち、ち、ちがっ/えと、今日は、今日は……き、期待なんてしてな……っ！/おかえりください！　って、ああ何言ってるのっ/お待ちして……ってそんなえっちじゃないからっ！/お、お、おおぉぉ……あれ？")%」	PRINTFORMW 「那个、那个、%TEXTR("今天快点……诶，你那么想要吗？/今天……好期待啊……啊！/欢迎回来！啊，你在说什么啊……/等一下……因为不是那样的！/哦、哦、哦……咦？？")%」
PRINTFORMW 「こんにちは～%CALLNAME:ARG%到着ぅ。 %TEXTR("お仕事お疲れ様のキスしたいなぁ/なんかおっぱいの注文ばっかり来るのよねぇ……揉ませてあげたかって？　ふふ～ひみつ♪/ああー、今日は私の番だよね、ね？/ううう、うずうずするぅ？/ね、今日も……する？")%」	PRINTFORMW 「你好～%CALLNAME:ARG%来了呦。 %TEXTR("辛苦工作后的亲吻~/总觉得好重来着……想揉一揉吗？呵呵~♪/啊，今天轮到我了吧，对吧？/呜呜，呜呜呜？/呐，今天也……做吗？")%」
PRINTFORMW 「や、やっと終わりましたぁ。 あ、あの、%TEXTR("ごめんなさ、おつかれ、なのは一緒だよね……/えと、その、うぅ……(言葉に詰まる)！/な、なんで来たって、そ、そんなの、わた、私も部員だから/え、えと……その、します？　あ、あの、もちろん入れちゃ嫌ですよっ！/き、期待してなんてっ、ち、ちがうよ！(どきどき)")%」	PRINTFORMW 「啊，终于结束了。那，那个、%TEXTR("对不起，辛苦了，那个也一起吧……/呃，那个，唔……（说不出话）/为，为什么来，那，那个，我又不是社员……/呃，呃……那个，要吗？那，那个，我当然不想！/期待什么，不是的！(心跳)")%」
PRINTFORMW 「あ、そうそう。\@ TEXTS("曜日") == "土" ? あさってから # 明日から\@私も学校行くことになったの」	PRINTFORMW 「啊，对了。\@ TEXTS("曜日") == "土" ? 后天开始 # 明天开始\@我也要去学校了」
PRINTFORMW 「どうしてかって？　それはやっぱり……昼間もシタいし」	PRINTFORMW 「为什么？那果然是……白天也想要在一起」
PRINTFORMW 挑発的な潤み目が心臓に悪い。	PRINTFORMW 让人心头一颤的有点挑衅意味的湿润眼神。
PRINTFORMW 「というのは建前で、本当はただ飯食らいのままじゃよくないでしょう？　だから、何かお金稼げないかって思ったら……ちょうど学食のお仕事があったの。それで、明日が初日というわけ」	PRINTFORMW 「啊哈哈……不能总是只寄居着吃饭呀？所以，我想能不能赚到什么钱，正好有个食堂工作。那么，明天就是第一天了。」
PRINTFORMW 「これからは平日もデキるなんて夢みたいだわ……うん、そういうことなので、よろしくお願いしますね」	PRINTFORMW 「从今往后平日也能见面了，简直就像做梦一样……嗯，就是这么回事，所以请多多关照。」
PRINTFORMW なんだかややこしいことになったと思う、%CALLNAME:MASTER%であったが、%CALLNAME:ARG%が持つその類い稀なる絶対的なふたつの質量が話題を呼び、それが学食の名物になることをこの後知ることになる……	PRINTFORMW %CALLNAME:MASTER%没想到的是，%CALLNAME:ARG%的工作所具有的罕见的质量引发了话题。成为了学校食堂的名产。不过这是后话了……
PRINTFORMW 「そういえば」	PRINTFORMW 「这么说来」
PRINTFORMW 「えっちする部活動してるんだっけ？　私ももちろん参加するからね」	PRINTFORMW 「参加社团活动吗？我当然会参加」
PRINTFORMW 「あ、あ、え、えと、きょ、きょおは、お知らせしないといけないことがあって、その」	PRINTFORMW 「啊，呃，啊，有必须告诉你的事，那个……」
PRINTFORMW 「いい、いつまでもただでご飯食べさせてもらうわけにいかないから、働くことにして」	PRINTFORMW 「啊，我不能一直白白吃饭，所以要工作！」
PRINTFORMW 「その、勤め先が学校の学食に決まって、\@ TEXTS("曜日") == "土" ? あさってから # 明日から\@、なんだけれど……」	PRINTFORMW 「那个，工作单位是学校的食堂、\@ TEXTS("曜日") == "土" ? 后天开始 # 明日开始\@、虽然如此……」
PRINTFORMW 「い、家じゃなにもできないしせめて……と思ったから」	PRINTFORMW 「至少在家里什么也做不了……」
PRINTFORMW 「と、突然でごめんなさい、でも、こ、これからもよろしくお願いします」	PRINTFORMW 「突然这样很抱歉，但是，今后也请多多关照」
PRINTFORMW %CALLNAME:ARG%は深々と頭を下げたが、その頬に帯びている赤みは、きっと学校でも抱いてほしそうな欲の現れなのだろうと、%CALLNAME:MASTER%は勝手に解釈した。	PRINTFORMW %CALLNAME:ARG%深深地低下了头,不过，那个脸颊带的红，一定是学校也想在一起的欲望的表现吧，%CALLNAME:MASTER%随意地理解到。
PRINTFORMW もっとも、%CALLNAME:ARG%が持つその類い稀なる絶対的なふたつの質量が話題を呼び、学食の名物になることをこの後知ることになる……のだが、吃音交じりにおどおどとしている様子がかわいいとも評判になるのだった。	PRINTFORMW 之后、%CALLNAME:ARG%所拥有的绝对的两种质量引起了话题，这之后知道了它将成为学校食堂的名产……但是，由于混杂着口吃而战战兢兢的样子，也因其可爱而受到好评。
PRINTFORMW なお、彼女は部活動に強制参加である。	PRINTFORMW 另外，她是强制参加社团活动的
PRINTFORMW 同じ学校の学食に勤めてまで追ってきたのだから当然の処遇といえるだろう。	PRINTFORMW 在同一个学校的食堂里工作，一直追着他，可以说是理所当然的吧。
PRINTFORMW %CALLNAME:ARG%が「学食のお姉さん」として就職しました。それに伴い、日中も学校で%CALLNAME:ARG%に出会うことがきるようになりました。	PRINTFORMW %CALLNAME:ARG%作为“学校食堂的姐姐”就职。与此同时，白天在学校也能遇到%CALLNAME:ARG%了。
PRINTFORML 「あ、あ、ありがとうございます……私、家事とかでｋ……そういえば、メイドが……むぅ」	PRINTFORML 「啊，谢谢……我，做家务什么的……这么说来……女仆、不是」
PRINTFORML 気づくと押し黙ってしまった。		PRINTFORML 一发现就沉默了。
PRINTFORML 「ふぅ……」	PRINTFORML 「呼呼……」
PRINTFORML いつになく汗まみれの様子に、今日は特別ハードだったことがうかがえる。	PRINTFORML 与往常不同，汗流浃背的样子，可以看出今天是特别辛苦的。
PRINTFORML 「っ……！　嫌だって、嫌だっていったのに……どうして……どうして……だめって言っても、止めてくれなくて、なんだか私、おかしく……」	PRINTFORML 「啊……！讨厌，明明很讨厌的……为什么……为什么……虽说不行，但还是没有阻止他，总觉得有点奇怪……」
PRINTFORML 怒り心頭なはずの抗議の言葉に、言うほどの憎悪を感じないのが不思議だった。	PRINTFORML 理应愤怒的抗议的话语里，却感觉不到说出的那种憎恶，真是不可思议啊……
PRINTFORML 「あんなに、あんなにだめって言ったのに……どうして、どうして……やだ、私何か、変、嫌なのに、嫌、なのに……」	PRINTFORML 「明明说了那么，那么不行的……为什么，为什么.……哎呀，我有点不对劲，明明讨厌，却……」
PRINTFORML %CALLNAME:TARGET%はこの世の破滅のような表情でうつむいているそぶりでつぶやくが、言うほど崩壊していないように見えるのが不思議だった。	PRINTFORML %CALLNAME:TARGET%用世界毁灭一样的表情低语着，但是看起来并没有像所说的那样崩溃，真是不可思议。
PRINTFORML %CALLNAME:TARGET%は%TEXTR(@"じっとあなたを熱っぽいまなざしで見つめている/その手にあふれんばかりの乳房の位置を直している/指先で唇をゆっくりなぞっている/しっとりとした唇を指さして流し目を送っている\@ CHECK_SHIRT("ブラウス") ? /ボタンのはじけたブラウスに透ける先端を見せつけた # \@")%	PRINTFORML %CALLNAME:TARGET%%TEXTR(@"一动不动地用热乎乎的目光注视着你/正在揉搓着手中满溢的乳房/用指尖慢慢地涂抹嘴有/指着滑溜溜的嘴唇眼神流动着\@ CHECK_SHIRT("女式襯衫") ? /解开扣子的的衬衫露出了透明的尖端 # \@")%
PRINTFORML %CALLNAME:TARGET%は%TEXTR(@"じっとあなたを警戒するまなざしで見つめている/その手にあふれんばかりの乳房の位置を直している/\@ FIND_COND("フェリシエル", "現在存在") ? あなたとメイドのやり取りを見つめている # あなたのことをじっと見つめている \@/内またの居座りを直している\@ CHECK_SHIRT("ブラウス") ? /サイズの合わないブラウスの、はじけたボタンの位置を締めようとしている # \@")% 	PRINTFORML %CALLNAME:TARGET%%TEXTR(@"一动不动地用警戒的眼光注视着你/用手挡在丰满的胸前/\@ FIND_COND("弗理希艾尔", "現在存在") ? 注视着你和女仆的对话看了过来 # 一直盯着主人公 \@/正在改正内八的坐姿\@ CHECK_SHIRT("女式襯衫") ? /正要扣上大小不符的衬衫的弹开的纽扣# \@")%
PRINTFORML %CALLNAME:TARGET%はこの世の破滅のような表情でうつむいている	PRINTFORML %CALLNAME:TARGET%用世界毁灭一样的表情低语着。
PRINTFORML %CALLNAME:TARGET%は%TEXTR(@"じっとあなたを熱っぽいまなざしで見つめている/その手にあふれんばかりの乳房の位置を直している/指先で唇をゆっくりなぞっている/しっとりとした唇を指さして流し目を送っている\@ CHECK_SHIRT("ブラウス") ? /ブラウスに透ける先端を見せつけてきた # \@")%	PRINTFORML %CALLNAME:TARGET%%TEXTR(@"一动不动地用热乎乎的目光注视着你/正在揉搓着手中满溢的乳房/用指尖慢慢地涂抹嘴有/指着滑溜溜的嘴唇眼神流动着\@ CHECK_SHIRT("女式襯衫") ? /解开扣子的的衬衫露出了透明的尖端 # \@")%
PRINTFORML %CALLNAME:TARGET%は%TEXTR(@"じっとあなたを警戒するまなざしで見つめている/その手にあふれんばかりの乳房の位置を直している/\@ FIND_COND("フェリシエル", "現在存在") ? あなたとメイドのやり取りを見つめている # あなたのことをじっと見つめている \@/内またの居座りを直している\@ CHECK_SHIRT("ブラウス") ? /今にもはちきれそうなブラウスのボタンを気にしている # \@")%	PRINTFORML %CALLNAME:TARGET%%TEXTR(@"一动不动地用警戒的眼光注视着你/用手挡在丰满的胸前/\@ FIND_COND("弗理希艾尔", "現在存在") ? 注视着你和女仆的对话看了过来 # 一直盯着主人公 \@/正在改正内八的坐姿\@ CHECK_SHIRT("女式襯衫") ? /很在意穿着的衬衫的扣子# \@")%
PRINTFORMW 「%TEXTR("もう、穴までほめるって言うの本当にしちゃうんだね……/そんなに褒めるなら揉んでく……？（たゆん/わかってるね……うん、うれしいなぁ/そりゃもう、サキュバスだもの。ね、その名器で、今日もたくさん気持ちよくなろうね/あー、えっと、うん、なんかこう……改めて言われると、ちょっと照れるね")%」	PRINTFORMW 「%TEXTR("真是的，洞口被称赞了呢……那么赞扬的话，就开始吧？/你明白啊.。嗯，真高兴/那里已经湿漉漉的了。呐，用这个名器，今天也会变的舒服起来的吧/啊，呃，嗯，总之是这样。这样被说，有点害羞……")%」
PRINTFORMW 「あ、あの……%CALLNAME:MASTER%。あの」	PRINTFORMW 「哦，那个……%CALLNAME:MASTER%。那个」
PRINTFORMW 思った以上に喜んでいるようだ。	PRINTFORMW 似乎比想象的还要高兴。
PRINTFORMW 「もう……そんなに私のお腹の奥を熱くしたいの……？」	PRINTFORMW 「已经……你那么想在我的肚子里边……？」
PRINTFORMW 「いろいろわかってるじゃないの……うん、はぁ……」	PRINTFORMW 「你不是很清楚吗……嗯，那里……」
PRINTFORMW 「もう……そうじゃないでしょう」	PRINTFORMW 「已经……不是那样的吧」
PRINTFORMW 「もっとこう、%TEXTR("がつーんとお腹の奥を熱くするような/じゅんんって内またがぬめるような/心の底から欲しくなるような")%一言じゃなくちゃ」	PRINTFORMW 「再这样的话、%TEXTR("就好像让肚子里头热起来一样/顺着内心又湿润了一样/好像从心底想要得到一样")%了呢」
PRINTFORMW 「……！！　あ、えと、あ、う、うぅ……」	PRINTFORMW 「……！！啊、嗯、啊、呜……」
PRINTFORMW 驚いているようだがいろいろ反応は正直である。		PRINTFORMW 受惊了的样子发出了正直的反应。
PRINTFORMW 「な、な、なに、何言ってんの、そんな、むぅ」	PRINTFORMW 「什、什、什么、你在说什么、那种、唔」
PRINTFORMW 驚いているというよりは、いぶかしんでいるようだ。	PRINTFORMW 与其说惊讶，倒不如说是在怀疑。
PRINTFORMW 「つわりは気持ち悪いけど、孕んだって実感があって、余計にそそるの……普段より性欲強くなってるんだから、できるだけ、相手をしてほしいな」	PRINTFORMW 「虽然怀孕很不舒服，但是实际上，反而会更有感觉。比平时性欲更强烈了，所以我希望你尽可能地陪伴我」
PRINTFORMW 「生徒さんに『妊娠してます』って言ったら、誰の子かすごく気にしてたなぁ」	PRINTFORMW 「对学生说”怀孕了“的时候，大家非常在意是谁的孩子呢……」
PRINTFORMW 「もちろん秘密にしてたけどね？」	PRINTFORMW 「当然是保密的呢？」
PRINTFORMW 「誰の子かって実感ない？　あんなに熱烈に子宮をおちんぽで愛しておいてそれはないんじゃないかなぁ」	PRINTFORMW 「谁的孩子不知道吗？那么热烈地疼爱着子宫，应该不会没自觉吧……」
PRINTFORMW 「せーしをたくさんしきゅーにびゅっびゅってしてくれたからだよ……ふふ」	PRINTFORMW 「因为你中出了很多次……呵呵」
PRINTFORMW 新しい命を宿したお腹をなでながら幸せそうに微笑んでいる。	PRINTFORMW 抚摸着孕育着新生命的肚子，幸福的微笑着。
PRINTFORMW 「他にも特別なこがいっぱいいるから、私の相手はできる範囲で……って言いたいけど、我慢するほどお腹の奥がじわじわするの。なるべく、私として……ね？　お願い……」	PRINTFORMW 「因为还有很多其他的很有特色的女孩子、所以把我作为对象的话能做的也很有限……说是这么说、但是如果忍耐的话腹部深处就会疼的难受。所以可能的话、和我……呐？　求你了……」


//PRINTFORMW 「おっぱいひとつなんて注文されたっけ。魂一つ分って言ったら冗談だと思われてた。割と本気なんだけどなぁ……まあ、あのメイドとは違うから魂ごと根こそぎ絞ったりは……たぶんしない」
//PRINTFORMW 「今日は誰のせーしがおいしそうかなって物色するの楽しみなの……もちろん、%CALLNAME:MASTER%が満たしてくれるならそれが一番なのよ？　ね、このままシテ……？」
//PRINTFORMW 「純正の淫魔だけど、別に人間を淫魔化するだけが種を増やす方法じゃないよ？　その……%CALLNAME:MASTER%なら……って、そういうのはまた今度ね」
//PRINTFORMW 「あなたのそばにいるメイド……魂を狩る悪魔だっけ？　知らないわけじゃないけど……住む世界が違うっていうか、種そのものが違うっていうか……あー、思い出せない」
//PRINTFORMW 「せーしとせーえきってどっちがえっちな呼び方だろうね……？　私的にはちゃんと種を残せるほうだと思うけど……」
//PRINTFORMW 「……あかちゃん、でき、できちゃって……うう」
//PRINTFORMW つわりの記憶を思い出しているようで顔が真っ青になっている。
//PRINTFORMW 「ど、どう、しよ、まだ早いと、思うのに、でも……」
//PRINTFORMW 腹部をさすりながら、ぼんやりと頬を染めている。
//PRINTFORMW 膣内射精自体は否定どころか没入していそうな雰囲気である。
//PRINTFORMW 「ごめんね……育てきれなかったら……ごめんね……」
//PRINTFORMW 母親の自覚が芽生えつつあるが、それ以上に膣内射精に嵌る自分を責めているようにも見える。
//PRINTFORMW 「お、お、おっぱいなんて注文されたって困るのに……何度も、何度も」
//PRINTFORMW 今注文してやろうかと言ったら、%CALLNAME:TARGET%は真っ赤になって俯いて、「男のひとってみんな……うう」とつぶやいていた。
//PRINTFORMW 「な、な、なんか、終わったらでーと、って誘われた……時間あわなくてことわったけど、その、やっぱりそういうこと」
//PRINTFORMW 「ぶ、部活、なんでもするので、がんばります……な、なんでもって、本番するのは、嫌なんだけど……な、なんでもじゃないって、はぅぅ」
//PRINTFORMW あれだけ膣奥を突き上げられて感じまくってるのに？　と問うと、ジト目でにらんできた。
//PRINTFORMW 「わ、私、その」
//PRINTFORMW 「その、私……すごく嫌ってわけじゃないから」
//PRINTFORMW 「え、えと、なんでもするので、がんばります……」
//PRINTFORMW 「あら……%TEXTR("んふ……とても楽。やっぱりこんな大きさだし……/はふっ！？　え、いえっくすぐったくてっ/うひゃぁ、これいいわ……/はぁん……持ち上げるだけじゃなくて、ね/ふぁぁ……ね、もっとしっかり包み込んでほしい……/あはぁ、なんかいいんだけど……もっとこう、先の方に絞ってみて……/んふ……/持ち上げるだけでいいの？　ね、もっとこう、がっしと鷲掴むように/はぁぁ……")%」
//PRINTFORMW %CALLNAME:TARGET%は%CALLNAME:MASTER%の掌の感触を愉しんでいるようだ。
//PRINTFORMW 「あの、お、お、%TEXTR("おおっ！　な、何してるんですかっ！！/お、おっぱい触るのだめぇ！/っ、そういうのいきなり禁止！/おぉ、それおっぱいですよっ！/お、お、おおぉぉ……いやぁああああ！！")%」
//PRINTFORMW %CALLNAME:TARGET%は今にもビンタするような勢いでこちらをにらみつけてきた。
//PRINTFORMW ベッドではあれだけ触らせてくれるというのに……TPOの問題だろうか。
//PRINTFORMW 「あら……%TEXTR("んふ……とても具合い。やっぱりこんな大きさだし……/ありがと/ありがとう……はぁ、楽/ねぇ、肩だけで終わらないよね？/あー、もっと下のほう……そっち側じゃなくて/……/んふ……/そう、脇のあたりからすすっと、前に……/はぁぁ……")%」
//PRINTFORMW %CALLNAME:TARGET%は%CALLNAME:MASTER%のマッサージを気に入っているようだが、どこか物足りなさそうだ。
//PRINTFORMW 「あの、あ、あ、%TEXTR("ありが、と……/あ、ありがと、こんなだから、肩がつらくて/あ、あの、肩だけだよね？/あ、えと、えと……うん、おっぱいまで触るのだめだからね/あっ、は……具合いい、ありがとう")%」
PRINTFORMW %CALLNAME:TARGET%は下心のないマッサージに浸っている。	PRINTFORMW %CALLNAME:TARGET%沉浸在并不是很用心的按摩中。
//PRINTFORMW 「ふぁぁっ！？　んふ、やぁ、しっぽは敏感だから、優しく触ってね？」	PRINTFORMW 「呜哇啊啊！？　嗯、呀啊、尾巴很敏感的啦、能温柔一点摸吗？」
//PRINTFORMW %CALLNAME:TARGET%はぱたぱたと根本と掴まれた部位の間を跳ねさせて、感じた度合いを伝えてきていた。
//PRINTFORMW 「ひゃぁっ！？　あ、あ、あ、あの、しっぽ、しっぽだめ、びくびくするからっ！！」
//PRINTFORMW %CALLNAME:TARGET%は背中をさすっていった悪寒をぶつけるかのようににらみつけてきた。
//PRINTFORMW 「うん、そんな、そんな、かんじ……んはぁ……はぁぁ」
//PRINTFORMW %CALLNAME:TARGET%の言うとおりにしてやると頬がより紅潮し、今にも達したりするんじゃないかと思わせるほど感じ入っていた。
//PRINTFORMW 「やあああ！！　も、もうだめ！　もうやめて！！」
//PRINTFORMW %CALLNAME:TARGET%は思いっきり平手でぶってきた。痛い。	PRINTFORMW %CALLNAME:TARGET%使劲打了一巴掌。好痛。
//PRINTFORMW 「んはっ！？　はぁ、びっくりした……んふ、いいよ、優しくさすってね？」
//PRINTFORMW %CALLNAME:TARGET%は潤んだ目で、尻尾をつかむ%CALLNAME:MASTER%に上目遣いで訴えた。
//PRINTFORMW 「ひゃぁっ！？　あ、あ、あ、あの、しっぽ、しっぽだめ、やああ！！」
//PRINTFORMW %CALLNAME:TARGET%はぞくぞくと背中を震わせる悪寒をぶつけるかのようににらみつけてきた。
//PRINTFORMW 「いいのぉ、尻尾感じちゃう……んふぁ、はぁぁ……ね、さすられてたら、我慢できなくなりそう……」
//PRINTFORMW %CALLNAME:TARGET%の目に目覚めさせてはいけなさそうな情念をともしたように見えるが、気のせいだと信じたい。
