//ERB\EVENT_K\20 カリスタ\EVENT_K20_SHOP.ERB
PRINTFORML 「では、ご用向きをお伺いいたします。」	PRINTFORML 「那么、请问您有什么事。」
PRINTFORML 「%CNAME("一人称")%のできうる限りにおいてお助けいたします。」	PRINTFORML 「%CNAME("一人称")%会尽我所能的帮助你。」
PRINTFORML 「%CNAME("一人称")%はいついかなるときも、正しき人の味方なるゆえ…」	PRINTFORML 「%CNAME("一人称")%无论什么时候、都会是站在正派的一方、…」
PRINTFORML 「あんまり極端なお願いは聞けませんが…。」	PRINTFORML 「我不会听从太极端的要求、……」
PRINTFORMW 「便当ですね？承知いたしました。」	PRINTFORMW 「便当是吧？知道了。
PRINTFORMW 「便当を作ってきてほしいのですか？」	PRINTFORMW 「想要我做便当吗？」
PRINTFORMW 「承知いたしました。学園で一緒に食べましょうね。」	PRINTFORMW 「知道了。我们在学校一起吃吧。
CALL PRINT_STRW, "「承知いたしました。お任せください。……_／／／_」"	CALL PRINT_STRW, "「知道了。交给我吧。……_/_／／／_」"
PRINTFORMW すこし恥ずかしいようだ。	PRINTFORMW 好像有点害羞呢。
PRINTFORMW 「くっ　たましいがたりない！」	PRINTFORMW 「可恶的不得了！」
PRINTFORMW 「あの、申し訳ございません。」	PRINTFORMW 「不好意思。」
PRINTFORMW 「あの、非常抱歉。」	「非常抱歉。」
PRINTFORMW 「魂が全部抜けてしまいますので　だめですー」	PRINTFORMW 「因为灵魂全都丢了所以还不行—」
PRINTFORMW 「メタ的に言うと魂が1.00以下では取引出来ません故、」	PRINTFORMW 「话说灵魂在1.00以下无法进行交易、」
PRINTFORMW 「魂が回復してから再度お願い致します…。」	PRINTFORMW 「请在灵魂恢复之后再来拜托……」
PRINTFORMW 「身体能力の向上ですね。」	PRINTFORMW 「是身体能力的提高呢。」
PRINTFORMW 「生半可な人体改造では体が追い付かないので、今日から训练しましょう。」	PRINTFORMW 「而不彻底的人体改造已经跟不上你的身体、所以从今天开始锻炼吧。」
PRINTFORMW 「鍛錬せず力持ちになるのは何かズルい感じがしますし……。」	;PRINTFORMW 「不锻炼就成为有力气的人、总觉得有些狡猾……」
PRINTFORMW 「『淫紋』の術の習得ですね？」	PRINTFORMW 「‘淫纹’术的学习对吧？」
PRINTFORMW 「天界でも類似した術が研究されていますが、使用には注意が必要です。」	PRINTFORMW 「虽然在天界也研究过类似的术语、但是使用时需要注意。」
PRINTFORMW 「最初は同様の効果を持つシールから始めましょう。」	PRINTFORMW 「最初从具有相同效果的贴纸开始吧。」
PRINTFORMW 「………悪い事には使わないでくださいね、%CNAME("二人称")%。」	PRINTFORMW 「……」请%CNAME("二人称")%不要用在坏事上。
PRINTFORMW 「『具現』の術の習得ですね？」	PRINTFORMW 「‘具现术’的学习对吧？」
PRINTFORMW 「今の%CNAME("二人称")%には必要なさそうですが、どうしても必要というのであれば。」	PRINTFORMW 「现在的%CNAME("二人称")%似乎没有必要、但无论如何都需要的话。」
PRINTFORMW 「女性同士で愛し合うには必要ないと思いますが、どうしても必要というのであれば。」	PRINTFORMW 「我认为女性之间相爱是不必要的、但如果无论如何都需要的话。」
PRINTFORMW 「何度も言いますが、悪い事には使わないでくださいね。」	PRINTFORMW 「虽然已经说了好几次、但是请不要用在坏事上。」
PRINTFORMW 「え゛っ、もっと大きくしてほしいのでしょうか。」	PRINTFORMW 「咦、您希望再大一点吗？」
PRINTFORMW 「これだと%CNAME("一人称","かな")%のには入りきれないと思いますが……。」	PRINTFORMW 「我想这样的话是进不了%CNAME("一人称","かな")%里面的……」
PRINTFORMW 「………後悔しませんね？」	PRINTFORMW 「……」不会后悔吧？
PRINTFORMW 「大き過ぎて困っていたのですね、承知いたしました。」	PRINTFORMW 「太大了很为难啊、嗯、知道了。」
PRINTFORMW 「妥当な判断と思います。過ぎたるはなお及ばざるが如し…。」	PRINTFORMW 「我认为这是妥当的判断。过犹不及呢……。
PRINTFORMW 「%CNAME("二人称")%、その申し出は%CNAME("一人称")%の手には余るようです…。」	PRINTFORMW 「%CNAME("二人称")%、这个提议似乎无法说服%CNAME("一人称")%……」
PRINTFORMW 「%CNAME("二人称")%、承知いたしました。」	PRINTFORMW %CNAME("二人称")%、知道了。」
PRINTFORML 「%CNAME("二人称")%、お買い物ですか？」	PRINTFORML 「%CNAME("二人称")%、要买东西吗？」
PRINTFORMW 「承知致しました。一緒に行きましょう。」	PRINTFORMW 「知道了。一起去吧。」
PRINTFORMW 「(買いすぎないように見張るためにも)」	PRINTFORMW 「（为了防止买太多）」
PRINTFORMW 「少々お待ちください。服の準備ができ次第出発しましょう。」	PRINTFORMW 「请稍等。衣服准备好就出发吧。」
PRINTFORMW 「ちょうど消耗品が不足しているようですし。」	PRINTFORMW 「正好好像消耗品不足了。」
PRINTFORMW %TEXTR("「欲しい商品は決まりましたか？」/「見て下さいこれ、カラーが256種類もありますよ。」/（あ、これ順番ずれてますね）/（うわぁ、痛そう……。）")%	PRINTFORMW %TEXTR("「想要的商品决定了吗？」/「你看、这有256种颜色。」/（啊、这个顺序错了。）/（哇、好痛啊……。）")%
PRINTFORMW %CALLNAME:TARGET%は商品%TEXTR("を手に取り眺めながら/を興味深そうに観察して/の順番を正しいものに並べつつ/の説明書を読みながら")%品定めしている……	PRINTFORMW %CALLNAME:TARGET%决定了商品、%TEXTR("手握着手、眺望着、/兴致勃勃地观察着/查找着正确的顺序的/の説明書认真地读着的")%商品……
PRINTFORMW 「今日は何も買わなくてよろしかったのですか？」	PRINTFORMW 「今天什么都不用买吗？」
//ERB\EVENT_K\20 カリスタ\EVENT_K20_DAILY.ERB
CALL PRINT_STR, @"「ぉはょぅござぃます、%CNAMET(ARG, "二人称","かな")%……_H_」_W"	CALL PRINT_STR, @"「早上好、%CNAMET(ARG, "二人称","かな")%……_H」_W"
PRINTFORMW 「ぉはょぅござぃます、%CNAMET(ARG, "二人称","かな")%……。」	PRINTFORMW 「早上好、%CNAMET(ARG, "二人称","かな")%……」
CALL PRINT_STR, @"「んっ、んきゅ……_H_―――ぷぁっ。」_W"	CALL PRINT_STR, @"「……_H_―――噗。」_W"
PRINTFORMW 「ぉはょぅござぃます、%CNAMET(ARG, "二人称","かな")%。」	PRINTFORMW 「是这样的、%CNAMET(ARG, "二人称","かな")%。」
PRINTFORMW 「おはようございます、%CNAMET(ARG, "二人称")%。」	PRINTFORMW 「是%CNAMET(ARG, "二人称")%啊、早上好啊、。」
PRINTFORMW 「今日は体育の授業がありますね。」	PRINTFORMW 「今天有体育课。」
PRINTFORMW 「体操服とタオル、水筒の準備は出来ていますか？」	PRINTFORMW 「体操服和毛巾、水壶都准备好了吗？」
PRINTFORMW 「準備運動をサボってはいけませんよ？」	PRINTFORMW 「不可以偷懒不做准备运动哦？」
PRINTFORMW 「おっと、だれもいませんね。」	PRINTFORMW 「哎呀、谁也不在啊。」
PRINTFORMW 「%CNAMET(ARG, "一人称")%たちが一番乗りのようですね。」	PRINTFORMW 「%CNAMET(ARG, "一人称")%好像是最先来的呢。」
PRINTFORMW 「だから何というわけでもありませんけれども。」	PRINTFORMW 「所以也没什么特别的。」
PRINTFORMW 「おや、%CNAMET(ARG, "二人称")%でしたか。」	PRINTFORMW 「啊、原来是%CNAMET(ARG, "二人称")%啊。」
PRINTFORMW 「%CNAMET(ARG, "二人称")%、ただいまお戻りいたしました。」	PRINTFORMW 「%CNAMET(ARG, "二人称")%、我回来了。」
PRINTFORMW 「%TEXTR("おかえりなさい/おつかれさまです/きょうもいちにちごくろうさまです")%、%CNAMET(ARG, "二人称")%。」	PRINTFORMW 「%TEXTR("(欢迎回来/您辛苦了/在外面辛苦了)")%、%CNAMET(ARG, "二人称")%。」
PRINTFORMW 「おかえりなさい、%CNAMET(ARG, "二人称")%。」	PRINTFORMW 「你回来了、%CNAMET(ARG, "二人称")%。」
PRINTFORMW 「しつｒ…」	PRINTFORMW 「唔r……」
PRINTFORMW 「」（絶句している。）	PRINTFORMW 「（无言以对。）
PRINTFORMW 「しつれいしま…ってちょっと、なにやってるんですか…？」	PRINTFORMW 「失礼了……」话说回来、你在干什么呢…？」
PRINTFORMW 「し、しつれいします……あれ？」	PRINTFORMW 「嗯、失礼了……咦？」
PRINTFORMW 「いえ、どうぞ、%CNAMET(ARG, "一人称","かな")%のことなぞ気にせずに…」	PRINTFORMW 「不、请、不要在意%CNAMET(ARG, "一人称","かな")%……」
PRINTFORMW 「すみません、おくれました……っと、お取込み中ですね。」	PRINTFORMW 「对不起、我迟到了……嗯、现在正在接待客人呢。
PRINTFORMW 「これは一旦、出直してきたほうがいいのでしょうか……？」	PRINTFORMW 「这个暂时重新来一次比较好吧……？」
PRINTFORMW 「お邪魔します、みなさん集まっていらっしゃいますね」	PRINTFORMW 「打扰了、大家都到齐了啊」
PRINTFORMW 「こんにちは。今日も部活動を頑張りましょうね。」	PRINTFORMW 「你好。今天也努力参加社团活动吧！」
CALL PRINT_STR, @"『%CNAMET(ARG, "二人称")%、今お暇でしょうか……？』_L"	CALL PRINT_STR, @"『%CNAMET(ARG, "二人称")%、现在有空吗……？』_L"
;PRINTFORMW 居間だけに。	;PRINTFORMW 只在起居室里。
PRINTFORMW %CALLNAME:ARG%は%CALLNAME:MASTER%に構ってもらいたそうだ……。	PRINTFORMW 听说%CALLNAME:ARG%被%CALLNAME:MASTER%照顾了……。
PRINTFORMW 『%CNAMET(ARG, "二人称")%、何かお申し付けはございますか？』	PRINTFORMW %CNAMET(ARG, "二人称")%、您有什么吩咐吗？
PRINTFORMW 『この番組、%CNAMET(ARG, "二人称")%も観てみませんか？』	PRINTFORMW 「这个节目%CNAMET(ARG, "二人称")%不试试看吗？」
PRINTFORMW 『こんばんは、%CNAMET(ARG, "二人称")%。』	PRINTFORMW 晚上好、%CNAMET(ARG, "二人称")%
PRINTFORMW 『こんにちは、%CNAMET(ARG, "二人称")%。』	PRINTFORMW 「你好、%CNAMET(ARG, "二人称")%。」
PRINTFORMW 『お元気そうで何よりですね……』	PRINTFORMW 「你看起来很有精神、这比什么都好……」
PRINTFORMW 「%CNAMET(ARG, "二人称")%、手作りのサンドイッチをご用意いたしました。」	PRINTFORMW 「%CNAMET(ARG, "二人称")%、我为您准备了手工三明治。」
PRINTFORMW よく見ると、サンドイッチのパンの間から謎の生物がこちらを見ている……。	PRINTFORMW 仔细一看、从三明治的面包之间、神秘的生物正在看着这边……。
PRINTFORMW 思い切って食べてみたが、案外美味しかった。	PRINTFORMW 我下定决心吃了、没想到很好吃。
PRINTFORM 今日のお弁当は	PRINTFORM 今天的便当
PRINTFORMW %TEXTR("カツサンド/コーンサラダサンド")%のようだ…。	PRINTFORMW 像%TEXTR("猪排三明治/玉米沙拉三明治")%一样…。
PRINTFORMW マヨネーズソースもたっぷり入っている。	PRINTFORMW 加了很多蛋黄酱酱。
PRINTFORMW ローストビーフサンドイッチだ	PRINTFORMW 烤牛肉三明治
PRINTFORMW スゴイぞ！オニオンと卵も入ってる	PRINTFORMW 好厉害啊！里面有洋葱和鸡蛋
PRINTFORM %TEXTR("チキンカツサンド/ハムカツサンド/メンチカツサンド/ベーコンサンド/ツナサラダサンド/きたのさばサンド/きゅうりサンド/たまごサンド")%	PRINTFORM %TEXTR("鸡肉炸猪排三明治/火腿炸猪排三明治/炸猪排三明治/培根三明治/金枪鱼沙拉三明治/蘑菇三明治/黄瓜三明治/鸡蛋三明治")%
PRINTFORMW のようだ…。	PRINTFORMW 好像是这个…。
PRINTFORMW 「%CNAMET(ARG, "二人称")%、今日のお弁当をお持ちしました。」	PRINTFORMW 「%CNAMET(ARG, "二人称")%、今天的便当拿来了。」
PRINTFORM %TEXTR("味噌汁付き日の丸弁当/ポテトサラダ付きからあげ弁当/おにぎり＆卵焼き弁当/エビフライ弁当/アジフライ弁当/海苔弁当/おひたし付きハンバーグ弁当/虹弁もどき")%	PRINTFORM %TEXTR("带味噌汤的日之丸便当/带土豆沙拉的炸便当/饭团/煎鸡蛋便当/炸虾便当/炸紫菜便当/海苔便当/带凉青菜的汉堡便当/虹便当")%
PRINTFORML 「よろしくお願いします、%CNAME("二人称")%。」	PRINTFORML 「请多关照、%CNAME("二人称")%。」
PRINTFORML 「あ゛っつ゛ーぃですね…。汗拭きたい…」	PRINTFORML 「啊～哈～呼呼…。想擦汗……」
PRINTFORML 「うぅ…じとじとするぅ…。」	PRINTFORML 「呜…湿漉漉的……」
PRINTFORML 「うぅーん……。」	PRINTFORML 「嗯……」
PRINTFORML 「ぁ…あたまがくらくらするぅ……。」	PRINTFORML 「啊…头晕……」
PRINTFORML 「よいおこないをなされました。神もよろばれましょう、たぶん。」	PRINTFORML 「做得很好。哪怕神也受不了吧、大概。
PRINTFORML 「魂がいくつもある人が存在するとか、よのなかふしぎですね。」	PRINTFORML 「世上有多少灵魂存在呢、真是不可思议啊。」
PRINTFORML 「」(ふょんふょん)	PRINTFORML "(ふんふょう)"
PRINTFORML 「いえ、%CNAME("一人称","かな")%の魂が抜かれているわけではないのでご安心を。」	PRINTFORML 「不、%CNAME("一人称","かな")%的灵魂并没有被拔出、请放心。」
PRINTFORML 「%CNAME("二人称")%、%TEXTR("こんな季節に裸だなんて/風邪になっても知りませんよ/流石に寒いです")%……！」(ぷるぷる)	PRINTFORML %CNAME("二人称")%、%TEXTR("在这样的季节裸体/也不知道得感冒/真冷啊")%……！(筛选)
PRINTFORML %CALLNAME:TARGET%は%TEXTR("ドン引きして/寒そうにして/呆れて")%いるようだ…	PRINTFORML %CALLNAME:TARGET%似乎还在%TEXTR("冷得发抖/目瞪口呆")%……
PRINTFORML 「（やっぱり恥ずかしいです……。）」	PRINTFORML 「（果然很丢脸……）」
PRINTFORML 「%CNAME("二人称", "どもり")%。何のつもりでしょうか……？」	PRINTFORML 《%CNAME("二人称", "どもり")%。你打算干什么……？」
PRINTFORML 「%TEXTR("お買い物お疲れ様です/お買い物お疲れ様でした/無事に帰ってこれましたね/お疲れ様です/お疲れ様でした")%、%CNAME("二人称")%」	PRINTFORML 「%TEXTR("买东西辛苦了/平安无事地回来了/辛苦了")%、%CNAME("二人称")%」
PRINTFORML 「%TEXTR("おぉ/それにしても/こう整理してみると")%、%TEXTR("結構/色々/たくさん")%買ってきましたね…。」	PRINTFORML 「%TEXTR("哦/即使那样/试着帮忙整理")%、%TEXTR("各种/很多")%商品买来了……」
PRINTFORM %CALLNAME:TARGET%は	PRINTFORM %CALLNAME:TARGET%是
PRINTFORM %TEXTR("黙々と/要領よく/微笑みつつ/没頭した様子で")%	PRINTFORM %TEXTR("默默地/认真地/微笑着/专心致志的样子")%
PRINTFORML %TEXTR("本の整理をして/掃除をして/掃除機をかけて/食器を洗って/制服をブラシ掛けして/消耗品の残量を確認して/洗濯をして")%いる	PRINTFORML 在%TEXTR("做书本整理/打扫/用吸尘器/洗碗/刷制服/确认消耗品余量/做洗涤")%
PRINTFORML 「……………zzz」（うとうと）	PRINTFORML 「…………」zzz」（迷迷糊糊）
PRINTFORML 「（ぼっち……か。）」	PRINTFORML 「（孤零零的……」
PRINTFORML 「おや、二人きりみたいですね。」	PRINTFORML 「哎呀、好像只有两个人啊。」
PRINTFORML %CALLNAME:TARGET%と%CALLNAME:FINDCHARA(NO, 1)%は	PRINTFORML %CALLNAME:TARGET%与%CALLNAME:FINDCHARA(NO, 1)%
CALL PRINT_STR, @"%TEXTR(@"%CNAME("二人称")%のこと/メイドと執事のこと/悪魔と天使のこと")%について話している。_L"	CALL PRINT_STR, @"在谈论%TEXTR(@"%CNAME("二人称")%/女仆与执事/恶魔与天使")%的事情。_L"
PRINTFORML 「あっ、お手伝い頂きありがとうございます。」	PRINTFORML 「啊、谢谢你的帮助。」
PRINTFORML %CALLNAME:TARGET%は%CALLNAME:FINDCHARA(NO, 21)%に部室掃除を手伝ってもらっている…。	PRINTFORML %CALLNAME:TARGET%让%CALLNAME:FINDCHARA(NO, 21)%帮忙打扫房间…。
PRINTFORM %CALLNAME:TARGET%は部室の	PRINTFORM %CALLNAME:TARGET%在部室里
PRINTFORM %TEXTR("机と椅子を並べて/ゴミ袋を交換して/机を拭いて/窓を拭いて/床を箒で掃いて/黒板のチョークを交換して/花瓶の水を交換して")%	PRINTFORM %TEXTR("摆桌子和椅子/换垃圾袋/擦桌子/擦窗户/扫地板/换黑板粉笔/换花瓶水")%
PRINTFORML いる。	PRINTFORML 在做这些事。
PRINTFORML 「%TEXTR("………。/………♪/………★/………？/………！")%」	PRINTFORML 「%TEXTR("………。/………♪/………★/………？/………！")%」
PRINTFORM 『%TEXTR("メイドと執事のイメージ変遷史/マチルダは小さな大天才/ビリティスの歌/バグは人生/アダムの呪い/今更聞けないお茶の出し方/空想科学読本/やるしかＧＯ！！/銀河戦士バルロイ（小説版）/ロマンシングサガ２（漫画版）")%』	PRINTFORM 《%TEXTR("女仆和执事的印象变迁史/Muchilda是小天才/Vilities的歌/Bug人生/亚当的诅咒/事到如今不能听的茶的发出方法/空想科学读本/只有做GO！！/银河战士巴罗伊（小说版）/浪漫沙加2（漫画版）")%》
PRINTFORML と題された本を読んでいる…。	PRINTFORML 正在读一本题为这个的书
PRINTFORML 「%TEXTR("………。/（なるほどなるほど）/………★/………？")%」	PRINTFORML 「%TEXTR("………。/（原来如此）/………★/………？")%」
PRINTFORML %CALLNAME:TARGET%は新聞を読んでいる。	PRINTFORML %CALLNAME:TARGET%在看报纸。
PRINTFORM 気になって覗き込むと、	PRINTFORM 介意地窥视一下的话、
PRINTFORML %TEXTR("天気予報/iPS細胞について/4コマ漫画/法律制定について/テレビ番組/スポーツ/怪事件/社会情勢")%の項目だった……	PRINTFORML 是%TEXTR("关于天气预报/iPS细胞/4格漫画/法律制定/电视节目/体育/怪事件/社会形势")%的专题……
PRINTFORML 「めんばーかーどがあればさ……。」	PRINTFORML 「如果有面条的话……」
;PRINTFORML それ以上いけない	;PRINTFORML 不能再那样了
;PRINTFORML 「ひみつのみせにはいれるって	;PRINTFORML 「要进入秘密商店」
;PRINTFORML 　はなしだぜ	;PRINTFORML 说起来啊
;PRINTFORML 　だけど　そのみせが	;PRINTFORML 但是那个商店
;PRINTFORML 　どこにあるかは　だれも	;PRINTFORML 在何处无论是谁
;PRINTFORML 　しらねえってよ」	;PRINTFORML 不知道啊」
PRINTFORML 「ばしゃと　きれぼし………。」	PRINTFORML 「吸溜吸溜吸溜……」
PRINTFORML 「ごにんあわせて……『こわれている……」	PRINTFORML 「合您的口味吗……「坏了……」
PRINTFORML %CALLNAME:TARGET%はすやすやだ。	PRINTFORML %CALLNAME:TARGET%在休息时间。
PRINTFORML 「すやぁ………」	PRINTFORML 「哎呀……」
PRINTFORML 「…………%CNAME("二人称","かな","甘え")%……zzz」	PRINTFORML 「……%CNAME("二人称","かな","甘え")%……zzz」
PRINTFORML 「…きゅぅぅー………」	PRINTFORML 「…恭喜……」
PRINTFORML 「んぅ………」	PRINTFORML 「嗯……」
PRINTFORML 「ぉふとぅん…♪」	PRINTFORML 「被子……♪」
PRINTFORMW 「%GREETING%、%CNAME("二人称")%。」	PRINTFORMW 「%GREETING%、%CNAME("二人称")%。」
PRINTFORMW 「お、おはようございます…。」	PRINTFORMW 「早上好……」
PRINTFORMW 「今日の%CNAME("二人称","かな")%は早起きですね…。」	PRINTFORMW 「今天的%CNAME("二人称","かな")%早起了呢……」
PRINTFORMW 「んぅ……」	PRINTFORMW 「嗯……」
PRINTFORMW 「あ、ありがとうございます。」	PRINTFORMW 「啊、谢谢。」
PRINTFORMW 「なんか実感沸きませんね…。」	PRINTFORMW 「总觉得没有真实感呢……」
PRINTFORML 「……？」	PRINTFORML 「……？」
PRINTFORMW 意味が伝わっていないようだ。	PRINTFORMW 好像没有传达到意思。
PRINTFORMW (う゛ぃぃぃぃん゛)「え、今なにをおっしゃいましたか？」(う゛ぃぃぃぃん゛)	PRINTFORMW （ぃぃぃ゛）「诶、您刚才说什么了？」(呜呜~)
PRINTFORMW どうやら掃除機をかけていて気がつかなかったようだ。	PRINTFORMW 好像是在打扫时没注意到。
PRINTFORMW 「%CNAME("二人称","かな")%、カラオケでもしてみませんか？」	PRINTFORMW %CNAME("二人称","かな")%、去唱卡拉OK怎么样？
PRINTFORML %CALLNAME:TARGET%はおもむろにゲーム機を持ち出してきた。	PRINTFORML %CALLNAME:TARGET%慢慢地拿出了游戏机。
PRINTFORMW それはカラオケじゃなくてカラオケモードだ…	PRINTFORMW 这不是卡拉OK、而是卡拉OK模式……
;PRINTFORMW しかもウィンキー時代のスパロボの。	;PRINTFORMW 而且温基时代的斯帕洛沃。
PRINTFORMW 「ボードゲームですか？バトルテックとかPathfinder RPGならありますけど。」	PRINTFORMW 「是棋盘游戏吗？要是战斗的话、Pathfinder RPG倒是也有。」
PRINTFORMW それだとルール説明するだけで休み時間が終わってしまう…	PRINTFORMW 那么只是说明规则就结束了休息时间……
PRINTFORMW 「いちおう、%CNAME("一人称")%のように、女性でも執事になれるそうです。」	PRINTFORMW 「总之、像%CNAME("一人称")%一样、女性也可以当管家。」
PRINTFORMW 「とくに女性の主人には女性の執事が仕えることが多いらしいです。」	PRINTFORMW 「特别是女主管家的事好像很多。」
;PRINTFORMW 「そういえばどうして『女装ショタメイド』はいくらかいるのに、	;PRINTFORMW 「这么说来、为什么‘女装正太女仆’要多少钱、
;PRINTFORMW 　『男装ロリ執事』がなかなかいないのでしょうか。」	;PRINTFORMW 「男装萝莉执事」怎么也不存在呢？」
;PRINTFORMW 「やはり、お堅いイメージがいくらかあるからでしょうか？」	;PRINTFORMW 「果然、是因为多少有些死板的印象吧？」
;PRINTFORMW 「そういえばイスラーム圏では『天使は大概男性』ということになってるらしいです。」	;PRINTFORMW 「这么说来、在伊斯兰教圈里天使大概是男性。」
;PRINTFORMW 「しかし熱心な教徒でも天使の創造にはふつう立ち会わないので、	;PRINTFORMW 「但是、就算是热心教徒、一般也看不到天使的创造。
;PRINTFORMW 　ぶっちゃけ偏見やおもいこみというほかありません。」	;PRINTFORMW 直截了当地说只有偏见和深思熟虑。」
;PRINTFORMW 「天使が女でわるいかおまえらー」	;PRINTFORMW 「天使是女人、你们不是坏蛋吗？」
PRINTFORMW 「ところで、なぜ執事には『背が高い』というイメージが強いのでしょうか？」	PRINTFORMW 「话说回来、为什么执事给人‘个子高’的印象很强呢？」
PRINTFORMW 「%CNAME("一人称")%は背が低くても特に困ったことはありませんでしたが…。」	PRINTFORMW 「%CNAME("一人称")%就算个子矮也没什么特别困扰的……」
PRINTFORMW 「『男に見えるけど実は女かと思ったら本当に男だった』とかぜってー需要ねーから…。」	PRINTFORMW 「‘看上去像男的、其实是女的、却没想到真的是男的’之类的话根本不需要……」
PRINTFORMW %CALLNAME:TARGET%は悩ましい表情を浮かべている…。	PRINTFORMW %CALLNAME:TARGET%露出了恼人的表情…。
PRINTFORMW 「んゅ……」(のびー…)	PRINTFORMW 「嗯……」(伸懒腰……)）
PRINTFORMW 「ときどき体をほぐしておかないと、急に用事ができたときに困りますからね…。」	PRINTFORMW 「有时候不放松身体的话、有急事时会很困扰的……」
PRINTFORMW 「%CNAME("二人称")%、%TEXTR("本棚/学習机/衣装タンス/押入れ")%の整理が終わりました。」	PRINTFORMW 「%CNAME("二人称")%、%TEXTR("书架/学习机/服装柜子/壁橱")%的整理结束了。」
PRINTFORMW 「%TEXTR("ベッドの下の本/この大きな枕カバー/ぬいぐるみ")%はどこに置けばいいのでしょうか？」	PRINTFORMW 「%TEXTR("床底下的书/这个大枕头套/毛绒玩具")%应该放在哪里呢？」
PRINTFORMW 「おぉ、ありがとうございます。」	PRINTFORMW 「哦、谢谢。」
PRINTFORMW 「ただの汗でも放置すると冷えますからね…。」	PRINTFORMW 「就算只是出汗、如果放任不管的话、也会变冷……」
PRINTFORMW 「翼も拭いていただけますか？自分では届かないので…。」	PRINTFORMW 「可以帮我擦一下翅膀吗？因为自己没办法够得到……」
PRINTFORMW %CALLNAME:TARGET%は微笑みつつ汗を拭かれている…。	PRINTFORMW %CALLNAME:TARGET%一边微笑一边擦汗…。
PRINTFORML 「%TEXTR("You'll be ok～♪太陽が西から昇っても～♪/止ま～らない～♪未来を～目指して～♪/Youはshock！哀で月がぴちてくぅ～♪/やＢみザ　！（ぺーユくユシペ")%」	PRINTFORML 「%TEXTR("You'll be ok〜♪太阳从西边升起了也~♪/没有停止~♪为了未来~目标~♪/You shock !因为悲伤月亮是闪闪发光的♪！")%」
PRINTFORML 「%TEXTR("かぽーん…")%」	PRINTFORML 「%TEXTR("かぽーん…")%」
PRINTFORML ぷにぷに。	PRINTFORML 软绵绵的。
PRINTFORMW 「%CNAME("二人称")%、どうかなさいましたか……？」	PRINTFORMW %CNAME("二人称")%、怎么了……？
PRINTFORML むにょむにょ。	PRINTFORML 无奈。
CALL PRINT_STRW, "「……_／／／_。」(じとー…。)"	CALL PRINT_STRW, "「……_／／／_。」(半睁…。)"
PRINTFORMW 「……うーん…？」	PRINTFORMW 「……嗯……？」
PRINTFORML むにょ。	PRINTFORML 没关系。
PRINTFORMW 「えっ、何やってるのですか？」	PRINTFORMW 「啊、你在干什么呢？」
PRINTFORML 「……。」(ひょい。)	PRINTFORML 「……」（莫非。）
PRINTFORMW 紙一重の差でよけられた。	PRINTFORMW 只差一张纸就被捅破了。
CALL PRINT_STRW, "「うぅ……。_／／／_」"	CALL PRINT_STRW, "「嗯……。_／／／_」"
PRINTFORMW %CALLNAME:TARGET%は自身の薄い胸を全然気にしていないようだ……。	PRINTFORMW %CALLNAME:TARGET%好像完全不在意自己薄弱的胸部……。
PRINTFORML 「お゛ぉ゛ぉ゛お゛っ゛……★」	PRINTFORML 「哦~哦~哦~~~★」
PRINTFORMW %CALLNAME:TARGET%は気持ちよさそうに翼をぱたつかせている……	PRINTFORMW %CALLNAME:TARGET%心情舒畅地拍着翅膀……
PRINTFORML 「あ、ありがとうございます。」	PRINTFORML 「啊、谢谢。」
PRINTFORMW 「肩がやたら凝っていて辛かったので…。」	PRINTFORMW 「肩膀非常僵硬、很难受……」
PRINTFORMW 「歩きすぎて足が疲れているので…。」	PRINTFORMW 「走得太累了……」
PRINTFORMW %CALLNAME:TARGET%はマッサージを満喫している……	PRINTFORMW %CALLNAME:TARGET%在享受按摩……
PRINTFORML ぐりぐり…	PRINTFORML 嗯……
PRINTFORMW 「ぃ゛っ、痛いです…。」	PRINTFORMW 「啊、好痛……」
PRINTFORMW 「あっ、いけないいけない。」	PRINTFORMW 「啊、不可以。」
PRINTFORML 「おぉ、ありがとうございます。」	PRINTFORML 「哦、谢谢。」
PRINTFORML 「おや、気が利きますね。ありがとうございます。」	PRINTFORML 「哎呀、可真机灵呢。谢谢您。」
PRINTFORMW %CALLNAME:TARGET%はにこやかにお茶を受け取った。	PRINTFORMW %CALLNAME:TARGET%笑嘻嘻地接过茶。
PRINTFORMW 「んきゅ…おいしいですね。」	PRINTFORMW 「嘻嘻……很好吃啊。」
PRINTFORMW 「時にはこのようにまったりするのもいいですね……。」	PRINTFORMW 「有时候像这样悠闲地休息也不错……」
PRINTFORMW 「っちゅ……。」	PRINTFORMW 「啾……」
PRINTFORMW 「……。何かドキドキしますね…。」	PRINTFORMW 「……。总觉得心跳加速呢……」
PRINTFORMW %CALLNAME:TARGET%は平たい胸を押し付けて、人肌の温もりを楽しんでいる…。	PRINTFORMW %CALLNAME:TARGET%压着平坦的胸膛、享受着肌肤的温暖…。
PRINTFORMW 「……。」(´・ω・｀)	PRINTFORMW 「……」(´・ω・｀)
PRINTFORMW 「抱きつこうとしたのですが、どうしても胸が先に当たりますね…。」	PRINTFORMW 「我本来想抱你、但是怎么胸口都会先碰到……」
PRINTFORMW 「……？」	PRINTFORMW 「……？」
PRINTFORMW 「%CNAME("一人称")%がこういう事をするのは意外ですか…？」	PRINTFORMW 「%CNAME("一人称")%做这样的事情很意外吗…？」
PRINTFORMW 「%CNAME("二人称")%、いかがですか？」	PRINTFORMW %CNAME("二人称")%怎么样？
PRINTFORMW %TEXTR(@"なでなで/なでぇ……/ふわふわ/わしゃわしゃ/ぽふぽふ")%。	PRINTFORMW %TEXTR(@"抚摸抚摸/抚摸……/轻飘飘/软绵绵/软飘飘")%。
PRINTFORMW 「ﾅﾃﾞﾅﾃﾞｼﾃ %TEXTR(@"と言われた気がして/という鳴き声がしたので/と轟く叫びを耳にしたので")%。」	PRINTFORMW 「ﾅﾃﾞﾅﾃﾞｼﾃ %TEXTR(@"似乎被说了什么/听见了叫声/听到了轰隆的叫声")%。」
PRINTFORMW そんなこと言ってない。	PRINTFORMW 没说过那样的话。
PRINTFORMW 「よろしければ%CSTR:お茶の種類%どうぞ。」	PRINTFORMW 「如果可以的话、请用%CSTR:お茶の種類%。」
PRINTFORMW 「ところで、この口上においては低確率でネタ分岐が実装されております。」	PRINTFORMW 「话说、在这张嘴上低概率实施了材料分歧。」
PRINTFORMW 「一見ネタに見えないものからきれぼし脳まで様々。」	PRINTFORMW 「从乍一看没有什么素材到断裂的大脑、各种各样的。」
PRINTFORMW 「作者曰く、『マリーさん口上でも低確率ネタ分岐あるしいいかなー』とのことです。」	PRINTFORMW 「作者说、‘玛丽小姐在嘴上也存在低概率段子分歧啊~’。」
PRINTFORMW %CALLNAME:TARGET%は唐突にメタ発言をしている…。	PRINTFORMW %CALLNAME:TARGET%唐突发表了听不懂的元话语…。
PRINTFORMW 「…んゅ？」	PRINTFORMW 「…嗯？」
PRINTFORMW 「どうなされましたか？」	PRINTFORMW 「您怎么了？」
PRINTFORMW 「うぅ…、%CNAME("二人称")%はひどいです…。」	PRINTFORMW 「呜…%CNAME("二人称")%太过分了。
PRINTFORMW 「え、ここでですか…？」	PRINTFORMW 「啊、是这里吗……？」
PRINTFORMW 「流石にいつでもどこででもという訳には…。」	PRINTFORMW 「不愧是随时随地的理由……」
PRINTFORMW %CALLNAME:TARGET%は%CALLNAME:MASTER%の要求に呆れているようだ…。	PRINTFORMW %CALLNAME:TARGET%似乎对%CALLNAME:MASTER%的要求感到惊讶…。
CALL PRINT_STR, "「や、やっぱり恥ずかしいです…。_／／／_」_W_"	CALL PRINT_STR, "「呀、果然很害羞…。_／／／_」_W_"
PRINTFORMW 「えっ、まだ続けるのですか…？」	PRINTFORMW 「咦、还要继续吗……？」
PRINTFORMW 「%CNAME("二人称")%って本当に下着好きなんですね…。」	PRINTFORMW 「%CNAME("二人称")%真的是很喜欢内衣的呢……」
PRINTFORMW 「あまり服には似合っていないかもしれませんが…。」	PRINTFORMW 「也许是不太适合的衣服……」
PRINTFORMW 「えっ、えっと…、楽しいですか？」	PRINTFORMW 「啊、那个……开心吗？」
PRINTFORMW 「あんまり降ろしすぎると、ベルトが痛みますよ？」	PRINTFORMW 「放得太多的话、腰会疼吧？」
//ERB\EVENT_K\20 カリスタ\EVENT_K20_カリスタ(男装ロリ執事).ERB
LOCALS = わたくし_わたくし	LOCALS = 我_我
LOCALS = お嬢様_おじょうさま	LOCALS = 大小姐_大小姐
LOCALS = 奥様_おくさま	LOCALS = 母亲大人_母亲大人
%CALLNAME:MASTER%に仕える天使で執事さん。	侍奉%CALLNAME:MASTER%的天使兼管家。
PRINTFORML 中身は女の子というオチかと思ったけど残念ながらそうではなかった。	PRINTFORML 本以为内在是女孩子的心智、但很遗憾并非如此。
PRINTFORML だがふたなりだ。	PRINTFORML 可是、她现在仍然是活生生的。
PRINTFORML だが女だ。	PRINTFORML 但她毕竟是女的。
PRINTFORML 基本的に礼儀正しいが時々おかしい。（時々ゲーム関連のセリフを発するなど）	PRINTFORML 基本上很有礼貌、但有时候很奇怪。（会时不时说游戏相关的台词等）
PRINTFORMW 「%CNAMET(ARG, "一人称")%は%NAME:ARG%と申します。今後ともよろしく…」	PRINTFORMW 「%CNAMET(ARG, "一人称")%是%NAME:ARG%。今后也请多关照……」
PRINTFORMW 「だと違う意味で悪魔ですね。どういたしましょう…。」	PRINTFORMW 「有些不同意义上的恶魔呢。怎么办呢……」
PRINTFORMW 「満足していただけましたでしょうか……？」	PRINTFORMW 「能满足我吗……？」
PRINTFORMW 「あ、%CNAME("二人称", "かな")%……。」	PRINTFORMW 啊、%CNAME("二人称", "かな")%……。
PRINTFORMW 「お、おつかれさまでした……。」	PRINTFORMW 「辛苦了……」
PRINTFORMW 「%CNAME("二人称", "かな")%……？」	PRINTFORMW %CNAME("二人称", "かな")%……？
PRINTFORMW 「ぅにゅぅ……。」(ぴくぴく)	PRINTFORMW 「嗯、嘶……」(抽搐)
PRINTFORMW 「きゅぅ……。」(くてー…)	PRINTFORMW 「嗯啊……」(てー…）
PRINTFORMW 「」(くてー…)	PRINTFORMW 「」(てー……)）
PRINTFORMW 「ぅゅ、おつかれさま……★」	PRINTFORMW 「嗯、辛苦了……★」
PRINTFORMW 「おつかれさまです…。」	PRINTFORMW 「辛苦了……」
PRINTFORMW 「おつかれさまです、%CNAME("二人称", "かな")%…★」	PRINTFORMW 「%CNAME("二人称", "かな")%、辛苦了…★」
PRINTFORMW 「%CNAME("二人称")%も満足していただけましたでしょうか？」	PRINTFORMW 「%CNAME("二人称")%也满足了吗？」
PRINTFORMW 「おつかれさまです、%CNAME("二人称", "かな")%…。」	PRINTFORMW 「辛苦了、%CNAME("二人称", "かな")%……」
PRINTFORMW 「%CNAME("二人称")%は満足していただけましたでしょうか？」	PRINTFORMW 「%CNAME("二人称")%满足了吗？」
PRINTFORMW 「好きにしてかまいませんよ…。」	PRINTFORMW 「喜欢的话也没关系……」
PRINTFORMW 「んゅ…★」	PRINTFORMW 「嗯……★」
PRINTFORMW 「………。（こそばゆい…。）」	PRINTFORMW 「………。（好痒痒…。）」
PRINTFORMW 「んゅ…。」	PRINTFORMW 「嗯……。」
PRINTFORMW 「ぇ…？」	PRINTFORMW 「诶…？」
PRINTFORMW 「……（おいしいんですかね）」	PRINTFORMW 「……（好吃吗）」
PRINTFORMW 「ひぁっ！？な…何ですか？」	PRINTFORMW 「啊！？什……什么啊？」
PRINTFORMW 「えっ…？な…何ですか？」	PRINTFORMW 「诶…？什……什么？」
PRINTFORMW 「んん…？小さいですか？」	PRINTFORMW 「嗯…？小吗？
PRINTFORMW %CALLNAME:TARGET%は自身の平たい胸を全然気にしていないようだ。	PRINTFORMW %CALLNAME:TARGET%似乎完全不在意自己平坦的胸膛。
PRINTFORMW 「おむねくすぐったい…。」	PRINTFORMW 「大体上还好吧…」
PRINTFORMW %CALLNAME:TARGET%は自身の平たい胸を全く気にしていないようだ……。	PRINTFORMW %CALLNAME:TARGET%好像完全不在意自己平坦的胸膛……。
PRINTFORMW 「んぅ！？……っちゅ。」	PRINTFORMW 「恩！？……纯。
PRINTFORMW 「っ…んゅ……♪」	PRINTFORMW 「啊…嗯……♪」
PRINTFORMW 「%CNAME("二人称", "甘え")%…しゅき……。」	PRINTFORMW %CNAME("二人称", "甘え")%…手……」
PRINTFORMW 「んゅ。」	PRINTFORMW 「嗯。」
PRINTFORMW 「%CNAME("二人称", "かな")%…、お願いします…。」	PRINTFORMW %CNAME("二人称", "かな")%…、拜托了……」
PRINTFORMW 「%CNAME("一人称", "かな")%は構いませんよ…。」	PRINTFORMW 「%CNAME("一人称", "かな")%没关系的……」
PRINTFORMW 「%CNAME("二人称")%、こんなの、入りきらなっ…！」	PRINTFORMW 「%CNAME("二人称")%、这种东西、真是讨厌……！」
PRINTFORMW 「うぅっ……！」	PRINTFORMW 「呜呜……！」
PRINTFORMW %CALLNAME:TARGET%は身構えている…。	PRINTFORMW %CALLNAME:TARGET%正准备着……。
PRINTFORMW 「あっ、あまり体重かけないで下さいね…。」	PRINTFORMW 「啊、请不要太重啊……」
CALL PRINT_STRW, "「……ぁっ_H_、っは……。_／／／_」"	CALL PRINT_STRW, "「……啊_H_、是……。_／／／_」"
CALL PRINT_STRW, "「っ…_／／／_。ぉぉっ……_H_」"	CALL PRINT_STRW, "「…／u。哇……_H_」"
CALL PRINT_STRW, "「……っ_H_、むぎゅ。」"	CALL PRINT_STRW, "「……啊_H_、。」"
CALL PRINT_STRW, "「うゅっ、んっ……。_／／／_」"	CALL PRINT_STRW, "「嗯、嗯……。_／／／_」"
PRINTFORMW %CALLNAME:TARGET%の薄い胸が密着している…。	PRINTFORMW %CALLNAME:TARGET%小小的胸膛紧贴着…。
PRINTFORMW 「（この体勢、意外と楽かも……）」	PRINTFORMW 「（这个姿势、意外地很舒服……）」
PRINTFORMW 「こ、こうですか？」	PRINTFORMW 「这、这样吗？」
CALL PRINT_STRW, "「……_／／／_、ぉ゜っ…_H_ぉ゜ぉ゜っ…_H_」"	CALL PRINT_STRW, "「……_／／u、o゜_H_o゜o゜o゜…_H_」"
CALL PRINT_STRW, "「……みゅっ_H_みゅっ……_H_」"	CALL PRINT_STRW, "「……啊_H_哈……_H_」"
CALL PRINT_STRW, "「んぅっ、ぁっ……_／／／_」"	CALL PRINT_STRW, "「恩、啊……／／／_」"
CALL PRINT_STRW, "「……_H_、うぅ…。」"	CALL PRINT_STRW, "「……_u H_呜…」"
PRINTFORMW %CALLNAME:TARGET%の翼が抽送に合わせてぱたついている……	PRINTFORMW %CALLNAME:TARGET%的翅膀配合着抽送拍打着……
PRINTFORMW 「えっと、こうでしょうか…。」	PRINTFORMW 「啊、是这样吗……」
PRINTFORMW 「…もし痛かったら言って下さいね、%CNAME("二人称")%。」	PRINTFORMW 「…如果痛的话请%CNAME("二人称")%告诉我哦。
CALL PRINT_STR, @"「%CNAME("二人称")%、気持ち良いでしょうか…？ふふ…_H_」_W"	CALL PRINT_STR, @"「%CNAME("二人称")%、舒服吗…？呼呼……_H_」_W"
CALL PRINT_STR, @"「…ん、ふふ……_H_」_W"	CALL PRINT_STR, @"「…嗯、呵呵……_H_」_W"
PRINTFORMW 「%CNAME("二人称")%も動きを合わせて欲しいです……っ」	PRINTFORMW 「也希望%CNAME("二人称")%能够配合着做……啊」
CALL PRINT_STR, @"「っは……_H_」_W"	CALL PRINT_STR, @"「……__H_」_W"
PRINTFORMW 「%CNAME("二人称", "かな")%っ…、これでよろしいでしょうか…？」	PRINTFORMW 「%CNAME("二人称", "かな")%……」觉得这样可以吗…？」
PRINTFORMW %CALLNAME:TARGET%は平坦な胸を擦り付けている…	PRINTFORMW %CALLNAME:TARGET%擦着平坦的胸膛……
;PRINTFORMW ちっぱいズリいいよね…	;PRINTFORMW 小鹿乱撞很不错呢…
PRINTFORMW 「%CNAME("二人称", "かな")%、これでよろしいでしょうか？」	PRINTFORMW %CNAME("二人称", "かな")%、觉得这样可以吗？
PRINTFORMW 「何度やっても慣れませんねこれ…。」	PRINTFORMW 「做几次都还不习惯啊……」
PRINTFORMW 「(本当にきもちいいのでしょうか…。)」	PRINTFORMW 「（真的是很舒服吗……。）
PRINTFORMW 「これできもちよくなれるのなら…。」	PRINTFORMW 「如果这样就能心情变好的话……」
PRINTFORMW 「執事がメイド服を着てみるというのも、時々はいいものですね…。」	PRINTFORMW 「管家试穿一下女仆装、感觉真好啊……」
PRINTFORMW 「ビキニなんだ！」	PRINTFORMW 「是比基尼！」
PRINTFORMW 「なお、%CNAME("一人称")%の下はスタンドしませんのであしからず。」	PRINTFORMW 「另外、%CNAME("一人称")%的翅膀会收起来、请不要见怪。」
PRINTFORMW 「おや、%CNAME("二人称")%いい趣味してますね。」	PRINTFORMW 「哎呀、%CNAME("二人称")%的兴趣真好。」
PRINTFORMW 「いつ見ても露出多いですね、この水着…。」	PRINTFORMW 「这件泳衣……什么时候看都露出了很多」
PRINTFORMW 「おや、奇跡的にサイズが合ってますね。」	PRINTFORMW 「哎呀、尺寸奇迹般地合适呢。」
PRINTFORMW 「（こんなの嘘でしょ…何故なんですか…）」	PRINTFORMW 「（这是骗人的吧……为什么……」
PRINTFORMW 「ふふ、この衣装って胸のサイズに関係なく似合うみたいですね。」	PRINTFORMW 「呵呵、这件衣服好像和胸部的尺寸无关、很适合呢。」
;PRINTFORMW ※服と体型のサイズがぴったりであることが前提	;PRINTFORMW ※前提是衣服和体型很合适
PRINTFORMW 「%CNAME("二人称")%、どうでしょうか。似合っていますか？」	PRINTFORMW 「%CNAME("二人称")%、怎么样？合适吗？
PRINTFORMW 「これって大量に出ても大丈夫なんですかね。」	PRINTFORMW 「这样大量出来也没关系吗？」
PRINTFORMW 「母乳は血液から造られると言いますし……。」	PRINTFORMW 「据说母乳是由血液制造的……」
PRINTFORMW 「…ん、んぅ！？」(ごくん。)	PRINTFORMW 「…嗯、嗯！？」
PRINTFORMW 「(ぅぅ…おくちのなかねばねばする…)」	PRINTFORMW 「…嘴里发粘……）
PRINTFORMW 「……んぅ♪」(ずぞー…。)	PRINTFORMW 「……嗯♪」(嘘……。）
PRINTFORMW 「んむ……♪」(もっもっ)	PRINTFORMW 「恩……♪」(嗤嗤)
PRINTFORMW 「ん゛ー…♪」(ち゛ゅ゛る゛ーー……。)	PRINTFORMW 「嗯……♪」(加油！……。）
PRINTFORMW 「……んぅ。」(ずぞー…。)	PRINTFORMW 「……嗯。（嘘………。）
PRINTFORMW 「んむ……。」(もっもっ)	PRINTFORMW 「恩……」(嗤嗤)
PRINTFORMW 「ん゛ー…。」(ちゅるー…。)	PRINTFORMW 「嗯……」（哈……。）
PRINTFORMW 「ん゛っ…。」(もっ…もっ…。)	PRINTFORMW 「嗯……」(尤其…….も…。）
PRINTFORMW 「……っ。」(ぴくぴく)	PRINTFORMW 「……啊？(抽搐)
PRINTFORMW 「(たくさんでてる……。)」	PRINTFORMW 「（出来了很多……。）
PRINTFORMW 「ぁ……。」(ぴくぴく)	PRINTFORMW 「啊……」(抽搐)
PRINTFORMW 「むぎゅぅ…。」	PRINTFORMW 「嗯……」
PRINTFORMW 不良在庫の山を前に、%CALLNAME:MASTER%と%CALLNAME:TARGET%は頭を抱えた…	PRINTFORMW 在堆积如山的不良库存前、%CALLNAME:MASTER%和%CALLNAME:TARGET%抱着头……