

//EVENT_K25_DAILY.ERB
PRINTFORMW 「おはようございます」	PRINTFORMW 「早上好」
CALL PRINT_STRW, "「寝てるときに挿れるとどんな感触なんだろうって思ってたら、ついやっちゃいました_H_」"	CALL PRINT_STRW, "「如果在睡觉的时候插入，会是什么感觉呢，不知不觉的就做了呢_H_」"
PRINTFORMW 「あ……おはようございます」	PRINTFORMW 「啊……早上好」
PRINTFORMW 「その……朝から用事を済ませたほうが負担も少なくなるかと思って……」	PRINTFORMW 「那个……我想从早上就完成这件事，会减轻负担吧……」
PRINTFORMW 「ここからとってもエッチな%TEXTS("匂い")%出しまくってましたからうっかり来ちゃいました」	PRINTFORMW 「从这里察觉到了非常H的%TEXTS("气味")%，一不小心就过来了」
PRINTFORMW 「え！　あ……おはようございます」	PRINTFORMW 「哎！啊……早上好」
PRINTFORMW 「その……出来心といいますか……」	PRINTFORMW 「那个……一时冲动……」
PRINTFORMW 「あの……もう終わったので……」	PRINTFORMW 「那个……已经结束了……」
CALL PRINT_STRW, "「フフ……ここ触るとまだビクビクする……そんなに気持ちよかったですか……_H_」"	CALL PRINT_STRW, "「呼呼……触摸这里还是会心跳加速……那么舒服吗……_H_」"
PRINTFORMW 「\@MARK:ARG:屈服刻印 < 3 ? え！　もう……？　その…… # ようやく起きましたか。\@おはようございます」	PRINTFORMW 「\@MARK:ARG:屈服刻印 < 3 ? 欸！　已经……？　那个…… # 终于起床了。\@早上好」
PRINTFORMW 「こんな時間なのに%CNAMET(ARG, "二人称")%の\@TALENT:MASTER:オトコ ? 生意気なおちんちんが勃っていたから # はしたないおまんこがヒクヒクしてたから\@、ちゃんと鎮めてあげているんですよ？」	PRINTFORMW 「这样的时间%CNAMET(ARG, "二人称")%的\@TALENT:MASTER:オトコ ? 小鸡鸡也傲慢的勃起了 # はしたないおまんこがヒクヒクしてたから\@、好好镇定一下哟？」
PRINTFORMW 「こんな時間に生意気にもおちんちんが勃ってましたから、ちゃんと鎮めてあげているんですよ？」	PRINTFORMW 「这样的时间小鸡鸡也傲慢的勃起了、好好镇定一下哟？」
PRINTFORMW 「……こんな時間に起きた悪い子にはこうです！」	PRINTFORMW 「……这个时间起床，真是个坏孩子！」
CALL PRINT_STRW, "「……このまま朝からしちゃいましょうか_H_」"	CALL PRINT_STRW, "「……早上就这样开始做吧_H_」"
CALL PRINT_STRW, "「えっ、ここでもうしちゃうんですか……エッチ_H_」"	CALL PRINT_STRW, "「咦，是在这里做吗……真色情_H_」"
CALL PRINT_STRW, @"「%AEGI(ARG, "要", "通常")%%CNAMET(ARG, "二人称")%_H_%AEGI(ARG, "要", "Ａ異物")%おはようっ_H_ございましゅっ_H_」"	CALL PRINT_STRW, @"「%AEGI(ARG, "要", "通常")%%CNAMET(ARG, "二人称")%_H_%AEGI(ARG, "要", "Ａ異物")%早上好_H_欢迎光临_H_」"
CALL PRINT_STRW, @"「%CNAMET(ARG, "二人称")%っ_H_%CNAMET(ARG, "二人称")%っ_H_」"	CALL PRINT_STRW, @"「%CNAMET(ARG, "二人称")%_H_%CNAMET(ARG, "二人称")%_H_」"
CALL PRINT_STRW, @"「%CNAMET(ARG, "二人称")%にっ_H_%ADANA("アナル")%開発されたせいでぇっ_H_ガマンできない子になっちゃったじゃないですかぁっ_H_」"	CALL PRINT_STRW, @"「因为被%CNAMET(ARG, "二人称")%_H_开发了%ADANA("肛门")%_H_所以变成了不能忍耐的孩子_H_」"
CALL PRINT_STR, @"「責任とってっ_H_%CNAMET(ARG, "二人称")%の"	CALL PRINT_STR, @"「%CNAMET(ARG, "二人称")%要承担责任_H_"
PRINTFORM %TEXTR("赤ちゃん/かわいい")%	PRINTFORM %TEXTR("小宝宝/可爱")%
PRINTFORM %TEXTR("立派な/硬い")%	PRINTFORM %TEXTR("气派/坚硬")%
PRINTFORM %TEXTR("おっきい/極太")%	PRINTFORM %TEXTR("极大/极粗")%
PRINTFORM %TEXTR(@"馬並み/%ADANA("アナル")%いっぱいいっぱいにされちゃう")%	PRINTFORM %TEXTR(@"馬根み/%ADANA("肛門")%被弄得满满的")%
PRINTFORM %TEXTR("腕みたいに大きい/馬より大きな")%	PRINTFORM %TEXTR("象胳膊那么大/比马还大")%
PRINTFORM %TEXTR("人外/規格外の")%	PRINTFORM %TEXTR("不是人的/规格外的")%
CALL PRINT_STRW, @"「%ADANA("ペニス")%で%CNAMET(ARG, "一人称")%の%ADANA("アナル")%いじめてよぉっ_H_」"	CALL PRINT_STRW, @"「%ADANA("阴茎")%在%CNAMET(ARG, "一人称")%的%ADANA("肛门")%欺负着_H_」"
CALL PRINT_STRW, @"「ごめんなさいっ_H_ガマンっ_H_できなくてっ_H_もうちょっとだけっ_H_」"	CALL PRINT_STRW, @"「对不起_H_受不了了_H_做不到_H_只差一点点_H_」"
CALL PRINT_STRW, @"「\@MARK:ARG:屈服刻印 == 3 ? おはようございます。それと……ごちそうさまでした_H_ # あ……その……おはようございます\@」"	CALL PRINT_STRW, @"「\@MARK:ARG:屈服刻印 == 3 ? 早上好。还有……真是多谢款待_H_ # 啊……那个……早上好\@」"
PRINTFORMW 「おはようございます。もう少ししたら終わるのでちょっと待っててください」	PRINTFORMW 「早上好。再过一会儿就结束了，请稍等」
PRINTFORMW 「まったく……こんなにチンカスたっぷり貯めちゃって……」	PRINTFORMW 「真是的……居然积攒了这么多……」
CALL PRINT_STRW, @"「……こんなエッチな%TEXTS("匂い")%ばら撒きながら寝られたら我慢できないじゃないですか……_H_」"	CALL PRINT_STRW, @"「……散发着这样色情的%TEXTS("气味")%睡觉，真是让人无法忍耐……_H_」"
PRINTFORMW 「あ……す、すぐ終わらせます……でももう少し……」	PRINTFORMW 「啊……马上结束了……但是稍微再……」
PRINTFORMW 「今日は体育がありますね。目いっぱい体を動かしましょう」	PRINTFORMW 「今天有体育课。让身体动一动吧」
PRINTFORMW 「今日は水泳がありますね。目に水が入らないように気をつけてくださいね」	PRINTFORMW 「今天有游泳呢。请注意不要让眼睛进水」
PRINTFORMW 「今日も一日がんばりましょう」	PRINTFORMW 「今天一整天也要加油哦」
PRINTFORMW 「どうやら早かったみたいですね。皆さんのために先に準備でもしておきましょうか」	PRINTFORMW 「好像很早啊。为了大家先准备一下吧」
PRINTFORMW 「%CNAMET(ARG, "二人称")%、ただいま戻りました」	PRINTFORMW 「%CNAMET(ARG, "二人称")%，我回来了」
PRINTFORMW 「え？　せっかく恋人なんだからもっと軽い感じでいいって？」	PRINTFORMW 「欸？　因为是情侣所以感觉到轻松吗？」
PRINTFORMW 「ちょ、ちょっとそれは……今からそんなことしちゃったら%CNAMET(ARG,"一人称")%、嬉しいやら恥ずかしいやらで耐え切れなくなりそうで……」	PRINTFORMW 「等…等一下…如果现在%CNAMET(ARG,"一人称")%就这样做的话，真担心不知道应该是开心还是羞耻呢……」
PRINTFORMW 「た、ただいま戻りました……」	PRINTFORMW 「我、我我回来了……」
PRINTFORMW 「アハハ……%CNAMET(ARG, "二人称")%の家に帰っているっていうのがいまいち実感がわかなくて……」	PRINTFORMW 「啊哈哈……不回到%CNAMET(ARG, "二人称")%的家总觉得不踏实呢……」
PRINTFORMW 「お帰りなさい」	PRINTFORMW 「您回来了」
PRINTFORMW 「戻られましたか」	PRINTFORMW 「你回来了」
CALL PRINT_STRW, "「今日の部活も頑張りましょう_H_」"	CALL PRINT_STRW, "「今天的社团活动也要加油哦_H_」"
PRINTFORMW 「今日もしっかり監視しますからね」	PRINTFORMW 「今天也会好好监视的」
PRINTFORMW 「お待たせしました」	PRINTFORMW 「让您久等了」
PRINTFORMW 「遅れてすみません。生徒会が長引いてしまって」	PRINTFORMW 「对不起，我迟到了。在学生会耽搁了很长时间」
PRINTFORMW 『こんにちは先生』	PRINTFORMW 『老师你好』
PRINTFORMW 『今日は遅かったですね』	PRINTFORMW 『今天好晚啊』
PRINTFORMW 『こんにちは』	PRINTFORMW 『您好』
PRINTFORMW 「……ええと、その……」	PRINTFORMW 「……那么，那个……」
PRINTFORMW 「簡単なものならいくつか作ったこともあるんですが、しっかりしたお弁当は初めてで……」	PRINTFORMW 「如果是简餐的话我曾经倒是做过几次，但是这种正式的便当还是第一次……」
PRINTFORMW 「……味は問題ないと思うので、どうぞ……」	PRINTFORMW 「……我觉得味道没有问题，请尝一尝……」
PRINTFORMW 「%CNAMET(ARG, "二人称")%、今日のお弁当です」	PRINTFORMW 「%CNAMET(ARG, "二人称")%，今天的便当」
PRINTFORMW 「……前と比べると随分上手になったと思うのですが、どうでしょうか……」	PRINTFORMW 「……和之前相比，本人是不是成长了不少，怎么样……」
PRINTFORMW 「長い間%CNAMET(ARG, "二人称")%のために料理しているうちに、随分と自信がついてきました」	PRINTFORMW 「在长时间为%CNAMET(ARG, "二人称")%做料理的过程中，变得相当有自信」
PRINTFORMW 「今日は特に出来が良いのが出来たので、良かったら感想を聞かせてくださいね」	PRINTFORMW 「总觉得今天做的特别好，如果可以的话，请告诉我感想」
PRINTFORMW 「%TEXTR(@"%CNAMET(ARG, "二人称")%/はい")%、今日のお弁当です」	PRINTFORMW 「%TEXTR(@"%CNAMET(ARG, "二人称")%/是")%，今天的便当」
PRINTFORMW %CALLNAME:ARG%から弁当を渡された	PRINTFORMW 从%CALLNAME:ARG%得到了便当
PRINTFORM 今日の弁当は	PRINTFORM 今天的便当
PRINTFORM 大盛りの	PRINTFORM 好丰盛
PRINTFORM %TEXTR("栄養バランスがよさそうな/たきこみご飯がついた/色とりどりの/かわいらしくカットされた果物がついている")%	PRINTFORM %TEXTR("营养平衡似乎很好/是蘑菇饭/五颜六色的/又可爱的水果")%
PRINTFORM %TEXTR("うな重/とんかつ弁当/コロッケ弁当/幕の内弁当")%	PRINTFORM %TEXTR("鳗鱼盒饭/炸猪排便当/炸肉饼便当/幕の内便当")%
PRINTFORM %TEXTR("そぼろ丼/からあげ弁当/ハンバーグ弁当/スタミナ丼")%	PRINTFORM %TEXTR("盖浇饭/炸鸡块便当/汉堡肉便当/能量盖饭")%
PRINTFORM %TEXTR("ポテトサラダ/味噌汁/フルーツポンチ")%がついた	PRINTFORM 还有%TEXTR("土豆沙拉/味噌汤/复合果汁")%
PRINTFORM %TEXTR("サンドウィッチ/日の丸弁当")%	PRINTFORM %TEXTR("三明治/日之丸便当")%
PRINTFORMW のようだ	PRINTFORMW 什么的
PRINTFORMW %CALLNAME:ARG%の弁当からは食欲を酷く誘う匂いが漂っている	PRINTFORMW %CALLNAME:ARG%的便当中洋溢着极度诱人的味道勾引着食欲。
PRINTFORMW たとえ量がこの倍あったとしても完食できそうだ……	PRINTFORMW 纵然是平时食量的一倍，也要吃完……
PRINTFORMW %CALLNAME:ARG%の弁当からは食欲を酷く誘う匂いが漂っている……	PRINTFORMW %CALLNAME:ARG%的便当中洋溢着极度诱人的味道勾引着食欲……
PRINTFORMW %CALLNAME:ARG%の弁当は綺麗に詰められており、食欲をそそる……	PRINTFORMW %CALLNAME:ARG%的便当装扮的很漂亮、看着很有食欲…
PRINTFORMW %CALLNAME:ARG%の弁当は若干ながら綺麗に整えられている	PRINTFORMW %CALLNAME:ARG%的便当整理得很干净。
PRINTFORMW 少しずつ上達しているようだ……	PRINTFORMW 似乎一点点进步了……
PRINTFORMW %CALLNAME:ARG%の弁当の形は酷く崩れており、苦労の後が見て取れる……	PRINTFORMW %CALLNAME:ARG%的便当形状严重的崩坏着、历尽艰辛万苦才看得见里边……
PRINTFORML 「初めまして、%CALLNAME:TARGET%と申します、これからよろしくお願いします」	PRINTFORML 「初次见面、我叫%CALLNAME:TARGET%，今后请多关照」
PRINTFORML 「べとべとします……」	PRINTFORML 「粘糊糊的……」
PRINTFORML 「%ADANA("精液")%じゃないんだから気持ち悪いだけなのに……」	PRINTFORML 「又不是%ADANA("精液")%，只是让人恶心而已……」
PRINTFORML 「後{RAND:10 + 1}分だけ……」	PRINTFORML 「{RAND:10 + 1}分钟后……」
PRINTFORML 「もう朝……？」	PRINTFORML 「已经早上了……？」
PRINTFORML 「両思いかぁ……ふふっ♪」	PRINTFORML 「两情相悦……呼呼♪」
PRINTFORML 「まだまだ散らかってると思いますが……」	PRINTFORML 「应该还很乱吧……」
PRINTFORML 「失礼します」	PRINTFORML 「失礼了」
CALL PRINT_STRL, "「見られちゃった……_H_」"	CALL PRINT_STRL, "「会被看见的……_H_」"
PRINTFORML 「ち、違うんです！　これは、その……」	PRINTFORML 「不，不要！　就是这样……」
PRINTFORML 「ん……？」	PRINTFORML 「嗯……？」
PRINTFORML %CALLNAME:MASTER%に%PANTIES(TARGET, "パンツor水着")%を見られたことに気付いた%CALLNAME:TARGET%は、%CALLNAME:MASTER%に向かっていやらしい笑みを浮かべた	PRINTFORML %CALLNAME:MASTER%看见了%PANTIES(TARGET, "胖次or水着")%的说，%CALLNAME:TARGET%的脸上露出了不正经的笑容
PRINTFORML 「随分買い込みましたね……」	PRINTFORML 「买得真多啊……」
PRINTFORML 「%CNAME("二人称")%、代わりに%CNAME("一人称")%が持ちましょうか？」	PRINTFORML 「%CNAME("二人称")%、%CNAME("一人称")%帮你拿吧？」
PRINTFORML 「……あ！　%CNAME("二人称")%！　ちょうどいい所に！」	PRINTFORML 「……啊！　%CNAME("二人称")%！　现在正合适！」
PRINTFORML 「ええと……その………………」	PRINTFORML 「嗯……那个………………」
PRINTFORML 「……………………%CNAME("二人称")%！　こ、これを受け取ってください！」	PRINTFORML 「……………………%CNAME("二人称")%！　请、请收下这个！」
PRINTFORML 「……あの……チョ、チョコレート……です……」	PRINTFORML 「……那个……巧、巧克力……呢……」
PRINTFORML 「せっかくだから手作りしようと思って……作ったところまでは良かったんですが……」	PRINTFORML 「十分难得，所以想要亲手做一次……但目前为止来看做的还好……」
PRINTFORML 「……%CNAME("二人称")%に渡さないといけないって考えると途端に恥ずかしくなってしまって……」	PRINTFORML 「……一想到要亲手交给%CNAME("二人称")%就觉得很不好意思……」
PRINTFORML 「……その、良かったら味の感想とか、後で教えてくれませんか？」	PRINTFORML 「……那个、如果可以的话，味道感想之类的、等下可以告诉我吗？」
PRINTFORML 「今回のものもうまく出来たとは思うんですけど、次はもっとおいしいものを%CNAME("二人称")%に食べて貰いたいので……」	PRINTFORML 「我觉得这次也做得很好、下次想让を%CNAME("二人称")%吃到更好吃的东西……」
PRINTFORML 「あ、%CNAME("二人称")%ちょうどいい所に」	PRINTFORML 「啊、%CNAME("二人称")%现在正好」
PRINTFORML 「部活の皆さんのためにチョコレートを買いまして、そろそろ配ろうと思っていたんですよ」	PRINTFORML 「为了社团活动的各位，我买了巧克力，想着差不多该送了」
PRINTFORML 「ちょっと待ってください…………はい、%CNAME("二人称")%の分です」	PRINTFORML 「请稍等一下…………这是%CNAME("二人称")%那份」
PRINTFORML 「……ところで、昔チョコレートは媚薬として使われていたようですね」	PRINTFORML 「……顺便说一下、从前巧克力是作为媚药使用的吧」
CALL PRINT_STRL, @"「……お返し、楽しみに待っています_H_」"	CALL PRINT_STRL, @"「……很期待着回礼呢_H_」"
PRINTFORML 「……え？　そんなに苦いですか？」	PRINTFORML 「……嗯？　那么苦吗？」
PRINTFORML 「まあ、カカオ80％くらいのものにしましたが……そこまでですか？」	PRINTFORML 「嘛、大概放了80％的可可……是不是放多了？」
PRINTFORML 「おいしいと思うんですが……」	PRINTFORML 「我觉得很好吃……」
PRINTFORML 「……それでは、他の皆さんにも分けてくるので失礼します」	PRINTFORML 「……那么、因为还要分给其他诸位了，失礼了」
CALL PRINT_STRL, @"黄色_%CALLNAME:TARGET%からチョコレートを貰いました！"	CALL PRINT_STRL, @"黄色_从%CALLNAME:TARGET%那里获得了巧克力！"
CALL PRINT_STR, @"「ふふ……その使用済み\@TALENT:MASTER:オトコ || (TALENT:MASTER:ふたなり && RAND:2) ? ペニス # おマンコ\@でどういじめてくれるんですかぁ……_H_」_L"	CALL PRINT_STR, @"「呼呼……已经用完了\@TALENT:MASTER:男性 || (TALENT:MASTER:扶她 && RAND:2) ? 阴茎 # 小穴\@要怎么欺负呢……_H_」_L"
CALL PRINT_STRL, @"「今度は%CNAME("一人称")%の番ですか_H_」"	CALL PRINT_STRL, @"「这回轮到%CNAME("一人称")%了_H_」"
PRINTFORML 「あ……タイミングが悪かったみたいですね……失礼しま……え？　ここに居ろと？」	PRINTFORML 「啊……好像是时机不好呢……失礼了……嗯？　就在这里？」
PRINTFORML 「……もしかして%CNAME("一人称")%を妬かせるためにわざとやってるんですか？」	PRINTFORML 「……是为了让%CNAME("一人称")%嫉妒故意这样做的吗？」
PRINTFORML 「すみません、その……%CNAME("二人称")%の意図が読めないのですが……」	PRINTFORML 「对不起、那个……不能读出%CNAME("二人称")%的意图……」
PRINTFORML 「次の生徒会までに資料を完成させないと……」	PRINTFORML 「必须在下次学生会之前完成资料……」
PRINTFORML 「ここから見る景色って結構綺麗ですね」	PRINTFORML 「从这里看到的景色真美啊」
PRINTFORML 「ここからだと桜が綺麗に見えるんですね」	PRINTFORML 「从这里看樱花很漂亮啊」
PRINTFORML 「暑い……」	PRINTFORML 「热……」
PRINTFORML 「文化祭の準備をしないと……」	PRINTFORML 「不准备文化祭的话…………」
PRINTFORML 「もう冬ですか……月日が経つのも早いですね」	PRINTFORML 「已经冬天了吗……时间过得真快啊」
PRINTFORML 「寒い……」	PRINTFORML 「冷……」
CALL PRINT_STR, @"「%CNAME("二人称")%の%TEXTS("匂い")%がするぅ……_H_」_L"	CALL PRINT_STR, @"「有%CNAME("二人称")%的%TEXTS("气味")%……_H_」_L"
PRINTFORML 「なんだかソワソワします……」	PRINTFORML 「总觉得忐忑不安……」
PRINTFORML 「昨日は楽しかったですね」	PRINTFORML 「昨天很开心啊」
PRINTFORML 「%CNAME("二人称")%、おせちはもう食べました？」	PRINTFORML 「%CNAME("二人称")%、吃过年夜饭了吗？」
PRINTFORML 「少し早起きしたら綺麗な初日の出が見れまして、思わず撮っちゃいました」	PRINTFORML 「稍微早起的话就能看到漂亮的日出、忍不住拍了下来」
PRINTFORML 「%CNAME("二人称")%も見ます？」	PRINTFORML 「%CNAME("二人称")%想看吗？」
PRINTFORML 「あの、%CNAME("二人称")%ってチョコレートは好きですか？」	PRINTFORML 「那个、%CNAME("二人称")%喜欢这样的巧克力吗？」
PRINTFORML 「い、いえ。きょ、興味があって質問しただけです……しただけですってば！」	PRINTFORML 「不、不是的。只、只是因为感兴趣才问的……因为是亲手做的！」
PRINTFORML 「今年の義理チョコは何にしようか……」	PRINTFORML 「今年的义理巧克力用什么好呢……」
PRINTFORML 「あ、ラブレター」	PRINTFORML 「啊、情书」
PRINTFORML 「『%CNAME("一人称")%には心に決めた人がいるので、お受けできません』と……うう、心が痛むなぁ」	PRINTFORML 「『因为%CNAME("一人称")%心中已经有了决定的人、不能接受』欸……呜呜、好心痛」
PRINTFORML 「このマシュマロ、どうしたものか……」	PRINTFORML 「这个棉花糖，怎么了……」
PRINTFORML 「渡してなくても来るんだからなぁ……」	PRINTFORML 「就算没有给也会来吧……」
PRINTFORML 「考えてみれば%CNAME("二人称")%の部活って毎日ハロウィンみたいなものですよね……」	PRINTFORML 「想象一下%CNAME("二人称")%的社团活动，每天都像万圣节一样呢……」
PRINTFORML 「あ、雪が降ってる……」	PRINTFORML 「啊、下雪了……」
PRINTFORML 「……あ、この本ですか？」	PRINTFORML 「……啊、这本书吗？」
PRINTFORML 「偶然立ち寄った本屋で見つけまして……中々面白いですよ」	PRINTFORML 「偶然路过的书店发现了……很有趣哦」
PRINTFORML ……フフッ、呼んでみただけです」	PRINTFORML ……呼呼、只是试着叫一下」
PRINTFORML もしかして欲求不満だったりしませんか？」	PRINTFORML 难道是欲求不满吗？」
CALL PRINT_STRL, "「よかったら、相手してあげてもいいですよ_H_」"	CALL PRINT_STRL, "「如果可以的话，我可以陪你哦_H_」"
PRINTFORML その……い、いえ！　何でもありません！」	PRINTFORML 那个……不、不是的！　没什么事！」
PRINTFORML 「写真を撮るときは是非%CNAME("一人称")%に任せてください！」	PRINTFORML 「拍写真的时候请务必交给%CNAME("一人称")%！」
//PRINTFORML 「何か御用ですか？」	PRINTFORML 「有什么事吗?？」
PRINTFORML 「%CNAME("一人称")%の……腕だって挿れるようになっちゃったお尻失格の穴をもっといっぱいにしてぇ……」	PRINTFORML 「%CNAME("一人称")%的尻穴已经可以插入手臂了，失格的穴就要填的更满……」
PRINTFORML 「すっかりメスになっちゃった%CNAME("一人称")%のお尻マンコいっぱいズボズボしてぇ……」	PRINTFORML 「%CNAME("一人称")%的尻穴已经完全像女人的小穴一样的，做爱了呢……」
PRINTFORML 「すっかり挿れるための穴になっちゃった%CNAME("一人称")%にもっといっぱい挿れてぇ……」	PRINTFORML 「为了让这个洞完全可以插入，再多插一点%CNAME("一人称")%吧……」
PRINTFORML 「あは…%ADANA("精液")%まみれになっちゃったぁ……全身臭くて真っ白でドロドロにされちゃったぁ……」	PRINTFORML 「啊哈…%ADANA("精液")%沾满的全身呢……全身都臭臭的，变得白白的又黏糊糊的了……」
PRINTFORML 「もっとぉ……もっとズボズボさせてぇ……\@EXP:Ａ挿入経験 >= 30 && RAND:2 ? お尻なのに # \@妊娠しちゃうくらいいっぱいいっぱい出させてぇ……」	PRINTFORML 「更多……继续做爱吧……\@EXP:Ａ挿入経験 >= 30 && RAND:2 ? 明明是屁股 # \@，射出来更多，到能让我怀孕的程度吧……」
PRINTFORML 「あっ……もっとぉ……」	PRINTFORML 「啊……更多……」
PRINTFORML 「%CNAME("二人称", "甘え")%……うふふっ……」	PRINTFORML 「%CNAME("二人称", "撒娇")%……诶嘿嘿……」
PRINTFORML 「ダメェ……」	PRINTFORML 「不行……」
PRINTFORML 「スー……スー……」	PRINTFORML 「簌……簌……」
PRINTFORMW 「雨が降ってきましたね」	PRINTFORMW 「下雨了」
CALL DAILY_MESSAGE, "帰り道"	CALL DAILY_MESSAGE, "归途"
PRINTFORMW 「うわ……すごい雨ですね……」	PRINTFORMW 「哇……好大的雨啊……」
PRINTFORMW 「……え？　入れてくれるんですか？」	PRINTFORMW 「……欸？　可以进去吗？」
PRINTFORMW 「おお……これはいいかも……」	PRINTFORMW 「哦……这样很不错哦……」
PRINTFORMW 「え？　%CNAME("二人称")%、これは……？」	PRINTFORMW 「欸？　%CNAME("二人称")%、这是……？」
PRINTFORMW 「……なるほど、こんな破廉恥なものを着て\@SAVESTR:帰り道の行動 == "水着選び" ? 海で遊ぶ # 生活する\@というのも良いですね」	PRINTFORMW 「……原来如此，穿着这样无耻的东西\@SAVESTR:帰り道の行動 == "水着選び" ? 在海上玩耍 # 日常活动\@这样也不错呢」
PRINTFORMW 「こ、これはちょっと%CNAME("一人称")%には早すぎます！」	PRINTFORMW 「这、这对%CNAME("一人称")%来说太早了
PRINTFORMW 「帰る前にちょっと散歩してみませんか？」	PRINTFORMW 「回去前要不要稍微散散步？」
PRINTFORMW 「新刊出たんだ……珍しい……」	PRINTFORMW 「新书出版了……很珍贵呢……」
PRINTFORMW 「%CNAME("一人称")%の好きな漫画、いつも休載ばっかりしてるんですよ」	PRINTFORMW 「%CNAME("一人称")%喜欢的漫画、总是在休刊呢」
PRINTFORMW 「今度の新刊は一体いつになることやら……」	PRINTFORMW 「这次的新刊究竟要到什么时候啊……」
PRINTFORMW 「ここの%TEXTR("クレープ/コロッケ/ハムカツ/ケーキ/アイス/ジュース")%がおいしいんです。買いに行きませんか？」	PRINTFORMW 「这儿的%TEXTR("可丽饼/炸肉饼/火腿肉饼/蛋糕/冰淇淋/果汁")%很好吃。我们去买吧？」
PRINTFORMW 「はい。おやすみなさい」	PRINTFORMW 「好的。晚安」
PRINTFORMW 「そろそろ帰りましょうか」	PRINTFORMW 「我们该回去了吧」
PRINTFORMW 「お帰りですか」	PRINTFORMW 「要回去了吧」
GREETING = こんばんは	GREETING = 晚上好
GREETING = こんにちは	GREETING = 你好
GREETING = おはようございます	GREETING = 早上好
PRINTFORMW 「%GREETING%、遅くまで元気ですね」	PRINTFORMW 「%GREETING%、这么晚也很有精神呢」
PRINTFORMW 「%GREETING%、一緒にお昼でも食べますか？」	PRINTFORMW 「%GREETING%、一起吃午饭吗？」
PRINTFORMW 「%GREETING%、早いですね」	PRINTFORMW 「%GREETING%、很早哟」
PRINTFORMW 「%CNAME("二人称")%の汗の%TEXTS("匂い")%……いつまでも嗅いでいたくなります……」	PRINTFORMW 「%CNAME("二人称")%出汗的%TEXTS("气味")%……总是很想闻……」
PRINTFORMW 「……こんなこと言ったら引いちゃいますか？」	PRINTFORMW 「……你说这样会吸引人吗?？」
PRINTFORMW 「フフッ……%CNAME("二人称")%、暖かいです……」	PRINTFORMW 「呼呼……%CNAME("二人称")%、很温暖……」
PRINTFORMW 「……ちょっと恥ずかしいです」	PRINTFORMW 「……有点害羞」
PRINTFORMW 「今更じゃないか、ですか？」	PRINTFORMW 「事已至此了，不是吗？」
PRINTFORMW 「その……確かに今更なのですが……むしろ今更だからこそと言いますか……」	PRINTFORMW 「那个……确实事已至此……不如说是事到如今才这样说的……」
CALL PRINT_STRW, @"「%AEGI(TARGET, "要", "キス")%%GREETING%%CNAME("二人称")%_H_」"	CALL PRINT_STRW, @"「%AEGI(TARGET, "要", "接吻")%%GREETING%%CNAME("二人称")%_H_」"
PRINTFORMW 「%AEGI(TARGET, "不要", "キス")%！　い、いきなり何を……！？」	PRINTFORMW 「%AEGI(TARGET, "不要", "接吻")%！　突，突然想干什么……！？」
CALL PRINT_STRW, @"「あ、%CNAME("二人称")%、%SUBSTRING(GREETING, 0, 6)%……ヒャッ_H_」"	CALL PRINT_STRW, @"「啊、%CNAME("二人称")%、%SUBSTRING(GREETING, 0, 6)%……嘿呀_H_」"
PRINTFORMW 「……%CNAME("二人称")%って時々突拍子も無いことを始めますよね」	PRINTFORMW 「……%CNAME("二人称")%呀，总会搞一些突然袭击的事情」
PRINTFORM 「こ、こんなタイミングで	PRINTFORM 「在，在这个时候
PRINTFORM 「こ、こんな場所で	PRINTFORM 「在，在这个地方
CALL PRINT_STRW, @"そんなことするのは……%MIX_AEGI(3, TARGET, "要")%」"	CALL PRINT_STRW, @"做这种事情……%MIX_AEGI(3, TARGET, "要")%」"
CALL PRINT_STRW, @"「%CNAME("二人称", "どもり")%、何でそんな……%MIX_AEGI(1, TARGET, "要")%」"	CALL PRINT_STRW, @"「%CNAME("二人称", "どもり")%、为什么这样……%MIX_AEGI(1, TARGET, "要")%」"
PRINTFORMW 「……むぁ？」	PRINTFORMW 「……呜哇？」
PRINTFORMW 「あ、ありがとうございます……」	PRINTFORMW 「啊，谢谢……」
PRINTFORMW 「……こういうのって分かってても慣れないモノなんだなぁ……」	PRINTFORMW 「……虽然知道是这样，但还是不习惯啊……」
PRINTFORMW 「い、いえ……%CNAME("二人称")%に褒められたんだなって思うと嬉しくて……」	PRINTFORMW 「不、不是的……一想到被%CNAME("二人称")%表扬就很开心……」
PRINTFORMW 「……そ、その。%CNAME("一人称")%も%CNAME("二人称")%のこと素敵だと思ってます！」	PRINTFORMW 「……那、那个。%CNAME("一人称")%觉得%CNAME("二人称")%你也棒！」
PRINTFORMW 「そ、そうですか？　……そう言われると少し照れます」	PRINTFORMW 「是、是这样吗？　……这么一说,有点难为情」
PRINTFORMW 「わ、分かってます！　分かってますから！」	PRINTFORMW 「哇，我知道！我知道啦！」
PRINTFORMW 「もう早く止めてください！　恥ずかしいんです！」	PRINTFORMW 「请快点停下来！真是害羞！」
PRINTFORMW 「……%CNAME("二人称")%は%CNAME("一人称")%を喜ばせるのがうまいんですから」	PRINTFORMW 「……因为%CNAME("二人称")%喜欢，让%CNAME("一人称")%感觉好开心」
PRINTFORMW 「そんな浮ついた言葉より前に%CNAME("一人称")%は%CNAME("二人称")%に気持ちよくしてほしいです」	PRINTFORMW 「比起那些花言巧语%CNAME("一人称")%更希望%CNAME("二人称")%心情舒畅」
PRINTFORMW 「……あ、ごめんなさい。聞いてませんでした」	PRINTFORMW 「……啊，对不起。没有听到」
PRINTFORMW 「え、あのときのことですか？」	PRINTFORMW 「欸、是那时候的事吗？」
PRINTFORMW 「あー……あれはその……色々と溜まっていた物が爆発した結果といいますか……」	PRINTFORMW 「啊……就是这样……可以说是积攒了很多东西然后突然爆炸的结果……」
PRINTFORMW 「でも……全部本心からなので……つまりですね……」	PRINTFORMW 「但是…就是说…这些都是出于真心…………」
CALL PRINT_STR, "「……よろしくお願いします_H_」_W"	CALL PRINT_STR, "「……请多关照_H_」_W"
PRINTFORMW 「この部活の監視についてですか？」	PRINTFORMW 「关于这个社团活动的监视吗？？」
PRINTFORMW 「そこらへんは適当にごまかしているので大丈夫ですよ」	PRINTFORMW 「那边可以随意的蒙混过关没关系哦」
CALL PRINT_STRW, @"「……それに、ダメだったら%CNAME("二人称")%のテクニックでメロメロにしちゃえばいいじゃないですか_H_」"	CALL PRINT_STRW, @"「……因此、如果不行的话，是时候展示%CNAME("二人称")%真的技术了_H_」"
PRINTFORMW 「このカメラですか？」	PRINTFORMW 「是这个照相机吗？」
PRINTFORMW 「生徒会のアルバムを作るために写真係になってくれ、と言われまして、そのために持ってきているんですよ」	PRINTFORMW 「说是为了制作学生会的相册要当摄影师，所以才拿过来的」
PRINTFORMW 「それに、元々写真を撮るのが好きなので……」	PRINTFORMW 「而且，因为本来就喜欢拍照……」
PRINTFORMW 「え、%CNAME("二人称")%も写真撮っているんですか？」	PRINTFORMW 「欸、%CNAME("二人称")%也会拍照吗？」
PRINTFORMW 「ちょっと見せてもらえますか？　%CNAME("二人称")%がどういう写真を撮るのか興味あります」	PRINTFORMW 「能稍微看一下吗？　对%CNAME("二人称")%拍什么样的照片很感兴趣」
PRINTFORMW 「あ、このスマホで撮っているんですね、どれどれ……」	PRINTFORMW 「哦，用智能手机拍的啊……」
PRINTFORMW 「おお……これもきれいに撮れてる……」	PRINTFORMW 「噢……这个也拍得很漂亮……」
PRINTFORMW 「これも……%CNAME("二人称")%上手ですねぇ……」	PRINTFORMW 「这个也是……%CNAME("二人称")%很擅长呢……」
PRINTFORMW 「%CNAME("二人称")%、また写真見せてもらっていいですか？」	PRINTFORMW 「%CNAME("二人称")%、可以再给我看看照片吗？」
PRINTFORMW 「%CNAME("二人称")%の撮る写真、結構好きなんですよ」	PRINTFORMW 「%CNAME("二人称")%拍的照片、非常喜欢这个构图」
PRINTFORMW 「……まあ、ああいう系等はちょっと反応に困りますが」	PRINTFORMW 「……嘛、这个时候有反应还是很困扰的」
PRINTFORMW 「……ああいうの以外は」	PRINTFORMW 「……除了那个以外」
PRINTFORMW 「……あれ、このフォルダ……」	PRINTFORMW 「……那个，这个文件夹……」
PRINTFORMW 「……あー」	PRINTFORMW 「……啊」
PRINTFORMW 「あのですね%CNAME("二人称")%、流石にこういうことは止めましょう」	PRINTFORMW 「就是%CNAME("二人称")%吧、别再做这种事了」
PRINTFORMW 「%CNAME("一人称")%はむしろ嬉しいくらいですが、他の方がそうとは限りませんよ」	PRINTFORMW 「%CNAME("一人称")%倒不如说是高兴呢、其他人不一定是那样」
PRINTFORMW 「言ってくだされば%CNAME("一人称")%は喜んで協力しますから」	PRINTFORMW 「如果告诉%CNAME("一人称")%，一定会乐意配合的」
PRINTFORMW 「ってこれエッチな写真じゃないですか！」	PRINTFORMW 「这不是色色的照片吗！」
PRINTFORMW 「しかもこれ、もしかしてこれとか盗撮……」	PRINTFORMW 「而且这个，难道是偷拍……」
PRINTFORMW 「え？　このことは口外するな？　いや……でもさすがに……」	PRINTFORMW 「欸？　这件事你可别说出去？　不过……但是确实……」
PRINTFORMW 「……分かりました」	PRINTFORMW 「……我知道了」
PRINTFORMW 「……あ」	PRINTFORMW 「……啊」
PRINTFORM %CALLNAME:TARGET%は再び見つけてしまったフォルダに	PRINTFORM %CALLNAME:TARGET%再次找到了文件夹
PRINTFORMW 苦笑を浮かべている……	PRINTFORMW 脸上露出苦笑……
PRINTFORMW 呆れた表情をしている……	PRINTFORMW 浮现出惊讶的神情……
PRINTFORMW 顔を引き攣らせている……	PRINTFORMW 表情十分纠结……
PRINTFORMW 「……ありがとうございます、楽しかったです」	PRINTFORMW 「……谢谢，很开心」
PRINTFORMW 「あの……次デートするとき、よかったら一緒に写真を撮りませんか？」	PRINTFORMW 「那个……下次约会时、如果可以的话，一起照张相吧？」
PRINTFORMW 「%CNAME("二人称")%の好きなことを一緒に楽しみたいんです」	PRINTFORMW 「想和%CNAME("二人称")%一起享受喜欢的东西」
PRINTFORMW 「%CNAME("二人称")%こっち向いてください」	PRINTFORMW 「请%CNAME("二人称")%朝向这边」
PRINTFORMW 「そう、そのまま……はい、チーズ」	PRINTFORMW 「没错、请保持住别动……茄子」
PRINTFORMW 「いきなりですみません。でも%CNAME("二人称")%を撮りたいなってふと思ってしまって止まれなかったんです」	PRINTFORMW 「突然打扰很抱歉。突然就想想要给%CNAME("二人称")%拍照，完全没法停下来」
PRINTFORMW 「……あ、%CNAME("二人称")%。ちょっとぼーっとしてました」	PRINTFORMW 「……啊、%CNAME("二人称")%。	是不是在发呆呢」
PRINTFORMW 「そうですね、この学園は結構桜の見所が多いですけど、ここは特に綺麗に見えるので、すっかりお気に入りの場所になっちゃいました」	PRINTFORMW 「是啊，虽然这个学园有很多看樱花的地方，但是这里看起来特别漂亮，所以就成了我最喜欢的地方」
PRINTFORMW 「……あ、%CNAME("二人称")%、ちょうどいい所に」	PRINTFORMW 「……啊、%CNAME("二人称")%、现在正好呢」
PRINTFORMW 「初等部の子達が肝試しをやるようでして、見張りの仕事がこちらに来たんですが……」	PRINTFORMW 「好像初等部的孩子们在试胆、看守到这边来了……」
PRINTFORMW 「それと一緒に学園内にちょうど良い場所はないか、と依頼されてしまったんですよ」	PRINTFORMW 「在一起的话有没有什么合适的地方、被拜托了哟」
PRINTFORMW 「とはいえ、むしろここってちょうど良い場所しかないくらいですから……何せ七不思議が50個近くありますし」	PRINTFORMW 「如果这样说的话、倒不如说这里是个好地方……总之附近还有50个不可思议的地方」
PRINTFORMW 「という訳でですね、%CNAME("二人称")%も場所探しに協力してくれませんか？」	PRINTFORMW 「就是这样吧、%CNAME("二人称")%可以帮我找个地方吗？」
PRINTFORMW 「……%CNAME("二人称")%、どうかしましたか？」	PRINTFORMW 「……%CNAME("二人称")%、怎么了？」
PRINTFORMW 「あ、この楽譜のことですか？」	PRINTFORMW 「啊，是这个乐谱吗？」
PRINTFORMW 「これはですね、今度の文化祭で一緒にバンドを組もうと友人に誘われまして、その時の曲のものですね」	PRINTFORMW 「这个嘛，这次的文化祭朋友邀请我一起组乐队，那时候要演奏的歌曲吧」
PRINTFORMW 「もう少し練習できればいいんですけど、中々練習に使える時間がないので、せめて楽譜を読んでイメージだけでも、と」	PRINTFORMW 「如果能再练习一下就好了，但是没有时间练习。至少好好的读一读乐谱」
PRINTFORMW 「……なんです？　%CNAME("一人称")%が楽譜読めるのがそんなに意外だったんですか？」	PRINTFORMW 「……什么？　%CNAME("一人称")%可以读乐谱，是这么意外的事情吗？」
PRINTFORMW 「……あ、雪が降ってきましたね」	PRINTFORMW 「……啊、下雪了呢」
PRINTFORMW 「あの、%CNAME("二人称")%、手を繋いでもいいですか？」	PRINTFORMW 「那个、%CNAME("二人称")%、可以牵手吗？」
PRINTFORMW 「……%CNAME("二人称")%、コレ、着てみませんか？」	PRINTFORMW 「……%CNAME("二人称")%、这个，试穿一下吧？」
PRINTFORMW そういうと%CALLNAME:TARGET%はどこからともなくセーラー服を取り出した……	PRINTFORMW 于是%CALLNAME:TARGET%不知道从哪里拿出来了水手服……
PRINTFORMW 「大丈夫、絶対似合いますって」	PRINTFORMW 「没问题、绝对很合适」
PRINTFORMW 「……それに、いつも可愛がられる側ですから、たまには%CNAME("一人称")%が%CNAME("二人称")%を可愛がったっていいでしょう？」	PRINTFORMW 「……而且，总是被人疼爱、偶尔也让%CNAME("一人称")%来疼爱%CNAME("二人称")%吧？」
PRINTFORMW 「羽根と輪っかが黒い理由ですか？」	PRINTFORMW 「羽毛和光环是黑色的理由吗？」
PRINTFORMW 「意外に思われるかもしれませんが、これ実はただの遺伝なんですよ」	PRINTFORMW 「也许会让人感到意外，其实这只是遗传」
PRINTFORMW 「これは父から聞いた話なのですが、天使の翼や輪っかって結構色に違いがあるようでして、白が一番多いようですが、赤や青といった翼も珍しくはないそうです」	PRINTFORMW 「这是从父亲那里听说的，天使的翅膀和光环的颜色好像有很多差异，白色是最多的，红色和蓝色的翅膀也不是什么稀罕事」
PRINTFORMW 「そして父自身は堕天する前から黒い翼と輪っかだったそうで、それがそのまま%CNAME("一人称")%に遺伝してこんな風に黒くなった……ということらしいんですよ」	PRINTFORMW 「据说父亲在堕天之前就已经和黑色的翅膀合为一体、于是就这样的遗传给了%CNAME("一人称")%，所以就变成黑色的了……据说就是这样」
PRINTFORMW 「もうすぐクリスマスですね」	PRINTFORMW 「是圣诞节前夕吧」
PRINTFORMW 「クリスマスは平気なのかですって？　そこまで宗派にこだわりはないので、問題ありません」	PRINTFORMW 「圣诞节没事吗？因为这里没有宗派纷争，没有问题」
PRINTFORM 「今日	PRINTFORM 「今天是新年吧
PRINTFORMW はお正月ですね。あけましておめでとうございます」	PRINTFORMW 祝您新年快乐！」
CALL PRINT_STRW, "「……ところで姫初めはいつごろしましょうか_H_」"	CALL PRINT_STRW, "「……话说来，新年第一次做爱要什么时候呢_H_」"
PRINTFORMW 「もう一年経つんですね……」	PRINTFORMW 「已经过了一年了啊……」
PRINTFORMW はバレンタインですね」	PRINTFORMW 是情人节吧」
PRINTFORMW （張り切ってチョコを作ってきたはいいけど……）	PRINTFORMW （虽然竭尽全力制作了巧克力……）
PRINTFORMW （いつ%CNAME("二人称")%に渡せばいいか……）	PRINTFORMW （什么时候交给%CNAME("二人称")%好呢……）
PRINTFORMW 「毎年何人か%CNAME("一人称")%にチョコレートをねだってくる人がいるんですよ」	PRINTFORMW 「每年都会有几个人向%CNAME("一人称")%讨要巧克力」
PRINTFORMW はホワイトデーですね」	PRINTFORMW 是白色情人节」
PRINTFORMW 「実は%CNAME("一人称")%、ホワイトデーで誰かにチョコレートを渡したことないんですよね……」	PRINTFORMW 「其实%CNAME("一人称")%在白色情人节，还没给过谁巧克力……」
PRINTFORMW 「渡される側ならそれなりに経験あるんですが」	PRINTFORMW 「如果交给对方的话，就会有经验」
PRINTFORMW は海の日ですね」	PRINTFORMW 是海之日呢」
PRINTFORMW はハロウィンですね」	PRINTFORMW 是万圣节呢」
PRINTFORMW 「%CNAME("二人称")%の部活って毎日ハロウィンみたいなものですからあまりお祭りといった感じがしませんね」	PRINTFORMW 「%CNAME("二人称")%的社团活动，每天都想万圣节一样，没有什么祭典的感觉。」
PRINTFORMW 「この時期になると親が妙に張り切りはじめちゃって……」	PRINTFORMW 「一到这个时候，父母就莫名地开始干劲十足……」
PRINTFORMW 「毎年家族総出で準備させられるんですよ」	PRINTFORMW 「每年都要全家出动准备哦」
PRINTFORMW はクリスマスですね」	PRINTFORMW 是圣诞节呢」
PRINTFORMW 「え？　今年のクリスマスは中止？　またご冗談を」	PRINTFORMW 「欸？　今年的圣诞节不过了？　又在开玩笑了」
PRINTFORMW 「それに……中止になってしまうと少し悲しいです」	PRINTFORMW 「所以……如果停止的话会有点伤心」
PRINTFORMW 「だってせっかくなら%CNAME("二人称")%とこういう特別な日を味わいたいじゃないですか」	PRINTFORMW 「好不容易才可以和%CNAME("二人称")%一起享受这种特别的日子不是吗」
PRINTFORMW も平和ですね」	PRINTFORMW 也很安宁呢」
PRINTFORMW 「良いことです」	PRINTFORMW 「是件好事」
PRINTFORMW 「翼と輪がついているのにどうしてバレていないのか、ですか？」	PRINTFORMW 「翅膀和光环为什么没有被发现？？」
PRINTFORMW 「地上に降りた天使は元々しかるべき人間以外には普通の人と同じようにしか見えないようになっているんです」	PRINTFORMW 「降落到地上的天使，除了不想变成人类的以外，看起来和普通人一样。」
PRINTFORMW 「堕天使の上にハーフである%CNAME("一人称")%にもその力は継承されているようで、特に問題はありません」	PRINTFORMW 「堕天使之上作为混血的%CNAME("一人称")%好像也继承了那个力量、没有特别的问题」
PRINTFORMW 「……もっとも、人ならざるものであったり%CNAME("二人称")%のような特別な人間には普通にバレてしまいますが」	PRINTFORMW 「……不过、一旦遇见像%CNAME("二人称")%这种特别的人类就会暴露了」
PRINTFORMW 「生徒会の仕事ですか？」	PRINTFORMW 「学生会的工作吗？」
PRINTFORMW 「それなりに忙しくはありますけど、別に皆さんが思ってるようなものではありませんよ」	PRINTFORMW 「虽然很忙，但并不是大家所想的那样」
PRINTFORMW 「神様についてですか？　そうですね……」	PRINTFORMW 「关于神吗？是啊。……」
PRINTFORMW 「実は%CNAME("一人称")%、神様に会ったことがないんですよ。堕天使の子ですから当然といえば当然ですが」	PRINTFORMW 「其实%CNAME("一人称")%、没见过神哟。因为是堕天使的孩子，这是当然的吧」
PRINTFORMW 「ですから認識としては皆さんとそこまで違いはいないと思います」	PRINTFORMW 「所以从认识上来说，和大家没有太大的区别」
PRINTFORMW 「好きなものですか？　バナナとカメラです」	PRINTFORMW 「喜欢的东西吗？　香蕉和照相机」
PRINTFORMW 「なぜ好きなのか。ですか？」	PRINTFORMW 「为什么喜欢。是吗？」
PRINTFORML 「…………ェ…………」	PRINTFORML 「…………额…………」
PRINTFORMW 「！　な、なんでもないです！」	PRINTFORMW 「！　没，没什么！」
PRINTFORMW 「ここの皆さんの部室……」	PRINTFORMW 「这是大家的活动房间……」
PRINTFORMW 「……つまり、ここで……」	PRINTFORMW 「……也就是说，在这里……」
PRINTFORMW 「今日は穏やかで良い日ですね」	PRINTFORMW 「今天真是个平和的好日子啊」
PRINTFORMW 「……あ、すみません」	PRINTFORMW 「……啊、对不起」
PRINTFORMW 「生徒会の仕事を色々しなくちゃいけなくて……」	PRINTFORMW 「必须做很多学生会的工作……」
PRINTFORMW 「ごめんなさい。%CNAME("二人称")%に触れられていると思うとドキドキしちゃって……」	PRINTFORMW 「对不起。。一想到被%CNAME("二人称")%触摸就心跳不已……」
PRINTFORMW 「あ、ごめんなさい。汗臭かったですか？」	PRINTFORMW 「啊、对不起。。有汗臭吗？」
PRINTFORMW 「これは……お酒、ですか？」	PRINTFORMW 「这是……酒、是吗？」
PRINTFORMW 「まあ、本当はダメですが……いいでしょう。いただきます」	PRINTFORMW 「哎呀，其实不行……好吧。那我就不客气了」
CALL PRINT_STRL, @"「あっ_H_……%CNAME("一人称")%メスにされちゃったぁ……_H_」"	CALL PRINT_STRL, @"「啊_H_……%CNAME("一人称")%变成了女孩子……_H_」"
CALL PRINT_STRL, @"「%CNAME("二人称")%のせいでお尻使わないと興奮できないメスになっちゃったぁ……_H_」"	CALL PRINT_STRL, @"「因为%CNAME("二人称")%，%CNAME("二人称")%变成了不用屁股就不能兴奋的雌性……_H_」"
CALL PRINT_STRL, "「んっ……シャワーが乳首に当たって……はぅ……_H_」"	CALL PRINT_STRL, "「嗯哼……淋浴打在乳头上……哈……_H_」"
PRINTFORML 「うぅ……全然収まらない……」	PRINTFORML 「呜……毫无收敛……」
CALL PRINT_STRL, "「ん……あっ……_H_」"	CALL PRINT_STRL, "「嗯……啊……_H_」"
PRINTFORMW 「あれ、%CNAME("二人称")%もシャワーを浴びに来たんですか？」	PRINTFORMW 「啊咧、%CNAME("二人称")%也要来淋浴吗？」
PRINTFORMW 「……ところで、下着だけで我慢しててもいいんですか♪」	PRINTFORMW 「……可是、可以忍受着穿内衣呢♪」
PRINTFORMW 「生徒会の仕事をしていると肩が凝って……助かります」	PRINTFORMW 「在学生会工作时，肩膀会酸疼……得救了」
CALL PRINT_STRW, @"「%AEGI(TARGET, "要", "キス", RAND:3 + 3)%」"	CALL PRINT_STRW, @"「%AEGI(TARGET, "要", "接吻", RAND:3 + 3)%」"
CALL PRINT_STRW, @"「フフ、%CNAME("二人称")%ったら……_H_」"	CALL PRINT_STRW, @"「呼呼、%CNAME("二人称")%糟糕……_H_」"
CALL PRINT_STRW, @"「お返しです、ちゅっ_H_」"	CALL PRINT_STRW, @"「这是回礼、啾芙_H_」"
PRINTFORMW 「そ、そんな……恥ずかしいじゃないですか……」	PRINTFORMW 「那、那种……不害羞吗？……」
PRINTFORMW 「……お言葉に甘えさせていただきます」	PRINTFORMW 「……承蒙美言,不胜感激」
PRINTFORMW 「膝枕ですか？　いいですよ」	PRINTFORMW 「枕膝吗？？　可以。」
PRINTFORMW 「え？　違う？　%CNAME("一人称")%がされる側なんですか？」	PRINTFORMW 「欸？　不对？　%CNAME("一人称")%是被抛弃的一方吗？」
PRINTFORMW 「ありがとうございます」	PRINTFORMW 「非常感谢」
PRINTFORMW 「うわっ！」	PRINTFORMW 「哇！」
PRINTFORMW 「ちょっと！　そこ結構敏感なんですから！」	PRINTFORMW 「等等！　因为那里相当敏感！」
PRINTFORMW 「……時々でお願いします」	PRINTFORMW 「……这时候拜托您了」
CALL PRINT_STRW, "「ヒヤァッ_H_」"	CALL PRINT_STRW, "「嘿呀_H_」"
PRINTFORMW 「いきなりすぎてビックリしたじゃないですか！」	PRINTFORMW 「太突然了，吓了一跳吧！」
CALL PRINT_STRW, @"「さ、さすがにこのタイミングは……%MIX_AEGI(3, TARGET, "要")%」"	CALL PRINT_STRW, @"「不，不愧是这个时机……%MIX_AEGI(3, TARGET, "要")%」"
PRINTFORMW 「つ、次はちゃんと言ってくださいよ」	PRINTFORMW 「呐、下次要说出来哦」
PRINTFORMW 「いくら%CNAME("一人称")%でも心の準備というものがあるんですから……」	PRINTFORMW 「就算是让%CNAME("一人称")%有个心理准备……」
PRINTFORMW 「な、何するんだよぉっ！」	PRINTFORMW 「喂，你在干什么啊！」
PRINTFORMW 「%TEXTR("んっ、れろ…/れろ…ぁむ…んっ/んっ…、れろ……/ちゅっ、れろっ…ちゅぷっ/んんっ……れろ…/れろ、はむ……んっ")%」	PRINTFORMW 「%TEXTR("嗯、嘞噜…/嘞噜…啊呣…嗯/嗯…、嘞噜……/啾芙、嘞噜…咀卜/嗯……嘞噜…/嘞噜、哈呣……嗯")%」
PRINTFORMW 「%TEXTR("ちゅっ、ちゅっ…/ちゅ…ちゅ……っ/ちゅっ…、ちゅ……/ちゅっ、ちゅっ…ちゅっ/ちゅぅ……ちゅっ/んちゅっ、ちゅ……っ")%」	PRINTFORMW 「%TEXTR("啾芙、啾芙…/啾…啾……/啾…、啾……/啾、啾…啾/啾……啾/嗯啾、啾……")%」
CALL PRINT_STRW, "「ちゅ……_H_」"	CALL PRINT_STRW, "「啾……_H_」"
PRINTFORMW 「あ、すみません。%CNAME("二人称")%に甘えたい気持ちが抑えきれなくなってしまいました」	PRINTFORMW 「啊，对不起。想要对%CNAME("二人称")%撒娇的心情已经无法抑制了」
CALL PRINT_STRW, @"「……もう少し、いいですか_H_」"	CALL PRINT_STRW, @"「……可以再多一点吗_H_」"
PRINTFORMW 「え……あ……そ、その……」	PRINTFORMW 「欸……啊……那、那个……」
PRINTFORMW 「！　そ、そうです！　家！　家だといつもこういうことしてるので！」	PRINTFORMW 「！是、是呀！　在家！　因为在家里总是这样做！」
PRINTFORMW 「%CNAME("二人称")%もお疲れでしょう、こちらにどうぞ」	PRINTFORMW 「%CNAME("二人称")%一定很累吧，这边请」
CALL PRINT_STR, @"「え？　何か当たっている？　……\@MARK:屈服刻印 == 3 ? わざとに決まっているじゃないですか_H_ # ぁ……その……すみません\@」_W"	CALL PRINT_STR, @"「欸？　猜对了什么？　……\@MARK:屈服刻印 == 3 ? 不是故意决定的吗？_H_ # 啊……那个……对不起\@」_W"
PRINTFORMW 「フフッ……%CNAME("二人称")%ったら子どもみたいです」	PRINTFORMW 「呼呼……%CNAME("二人称")%真像个孩子」
CALL PRINT_STRW, @"「あ……%CNAME("二人称")%の%ADANA("ペニス")%、元気ですねぇ_H_」"	CALL PRINT_STRW, @"「啊……%CNAME("二人称")%的%ADANA("阴茎")%很有精神呢_H_」"
CALL PRINT_STRW, @"「%CNAME("一人称")%がいっぱいよしよししてあげます_H_」"	CALL PRINT_STRW, @"「%CNAME("一人称")%准备了很多呢_H_」"
PRINTFORMW 「あ、つい……生徒会の皆さんがよく膝枕をしてくれとせがむもので……」	PRINTFORMW 「啊、终于……学生会的大家经常催促我枕膝……」
PRINTFORMW 「……このまま耳かきでもしましょうか？」	PRINTFORMW 「……就这样掏耳朵吧？」
PRINTFORMW 「%CNAME("一人称")%、%CSTR:お茶の種類%には自信があるんです」	PRINTFORMW 「%CNAME("一人称")%、对于%CSTR:茶の種類%很有信心」
PRINTFORMW 「何をされているんですか？」	PRINTFORMW 「在做什么呢？？」
PRINTFORMW 「お暇ですか？」	PRINTFORMW 「有空吗？」
PRINTFORMW 「少しスッキリした表情されてますけど、%CNAME("二人称")%も……」	PRINTFORMW 「虽然表情有些微妙、但是你%CNAME("二人称")%也太……」
PRINTFORMW 「……あ、そういうことですか」	PRINTFORMW 「……啊，是这样啊」
CALL PRINT_STR, "「……後で続き、しますか_H_」_W"	CALL PRINT_STR, "「……要继续吗_H_」_W"
PRINTFORMW 「少し失礼します」	PRINTFORMW 「失陪一会儿」
CALL PRINT_STR, "「それはそれはもう……_H_」_W"	CALL PRINT_STR, "「那是因为已经……_H_」_W"
PRINTFORMW 「え……あ……その……」	PRINTFORMW 「欸……啊……那个……」
PRINTFORMW 「……これ以上は勘弁してください」	PRINTFORMW 「……请饶了我吧」
PRINTFORMW 「あれ、%CNAME("二人称")%もですか？」	PRINTFORMW 「啊咧、%CNAME("二人称")%也？」
PRINTFORM 「あ\@MARK:屈服刻印 == 3 ? 、 # ……、\@%CNAME("二人称")%のって	PRINTFORM 「啊\@MARK:屈服刻印 == 3 ? 、 # ……、\@%CNAME("二人称")%的
PRINTFORMW ……大丈夫ですよ。その、%CNAME("一人称")%も同じくらいですし」	PRINTFORMW ……没关系。那个、和%CNAME("一人称")%的也差不多」
PRINTFORMW ……大きさだけが価値ではありませんから」	PRINTFORMW ……因为单纯的大小是没有价值的」
PRINTFORMW 、その……しっかりしているといいますか……」	PRINTFORMW 、那个…可以说很坚硬…」
PRINTFORMW 「%CNAME("一人称")%のが少し小さめなので……ちょっと憧れます」	PRINTFORMW 「%CNAME("一人称")%的稍微小一点……有点憧憬」
PRINTFORMW 、大きいですね……」	PRINTFORMW 、真大啊……」
PRINTFORMW 、物凄く大きいですね……」	PRINTFORMW 、好大啊……」
PRINTFORMW 「……やっぱり大変なんでしょうか？大きすぎると」	PRINTFORMW 「……果然很辛苦吧？太大的话」
PRINTFORMW 「%CNAME("一人称")%も色々苦労しているので……」	PRINTFORMW 「%CNAME("一人称")%也吃了各式各样的苦……」
PRINTFORMW 「いえ、ちょっとした出来心といいますか……今のは忘れてください」	PRINTFORMW 「不，可以说是一点小小的冲动……请忘记现在的一切」
PRINTFORMW 、大きすぎる……というかコレ人間が持ってていいサイズなんでしょうか」	PRINTFORMW 、太大了……或者说这是人类可以拥有的尺寸吗」
PRINTFORMW 「いや、%CNAME("一人称")%も人のこと言えませんけども」	PRINTFORMW 「不、%CNAME("一人称")%不能够说别人」
PRINTFORMW 「……あれ？　%CNAME("二人称")%もしかして……」	PRINTFORMW 「……啊咧？　%CNAME("二人称")%或许……」
CALL PRINT_STRW, @"「……それならここでしちゃいますか_H_」"	CALL PRINT_STRW, @"「……那么，在这儿做吗？_H_」"
PRINTFORM そう言うなり%CALLNAME:TARGET%は%CALLNAME:MASTER%を個室の中に連れ込み、	PRINTFORM 这么说着%CALLNAME:TARGET%把%CALLNAME:MASTER%带进了私人房间、
PRINTFORM 完全に性器と化した	PRINTFORM 完全变成了性器
PRINTFORM 尻に入れていたバイブをゆっくりと抜き出した	PRINTFORM 把放入屁股的振动棒慢慢地拔了出来
PRINTFORM そしてまだ閉じきっていない	PRINTFORM 而且还没有关闭
PRINTFORM 期待にヒクつく	PRINTFORM 不安的期待着
PRINTFORMW %TEXTR("アナル/菊穴/不浄の穴/背徳の穴")%で%CALLNAME:MASTER%のペニス%TEXTR("に跨った/を飲み込んだ")%……	PRINTFORMW %TEXTR("肛門/菊穴/不浄之穴/背徳之穴")%把%CALLNAME:MASTER%的阴茎%TEXTR("骑乘着/吞食着")%……
PRINTFORMW 性交さえ可能なほどに拡張された尿道で%CALLNAME:MASTER%のペニス%TEXTR("に跨った/を飲み込んだ")%……	PRINTFORMW 扩张后可以性交的尿道把%CALLNAME:MASTER%的阴茎%TEXTR("骑乘着/吞食着")%……
PRINTFORM 慣れた	PRINTFORM 习惯了
PRINTFORM 不慣れな	PRINTFORM 还不习惯
PRINTFORMW 様子で%CALLNAME:MASTER%のペニスに喰らい付いた……	PRINTFORMW 看样子吞食着%CALLNAME:MASTER%的阴茎……
PRINTFORMW 手つきで%CALLNAME:MASTER%のペニスをしごき始めた……	PRINTFORMW 手开始在%CALLNAME:MASTER%的阴茎上撸动……
PRINTFORMW 「それでは先に戻らせていただきますね」	PRINTFORMW 「那我先回去了」
PRINTFORMW 行為が済むと、%CALLNAME:TARGET%は己と%CALLNAME:MASTER%の服装を整え、部屋へと戻っていった	PRINTFORMW 行为结束后、%CALLNAME:TARGET%整理好自己和%CALLNAME:MASTER%的衣服、回到了房间
PRINTFORMW 「……いいかげんにしてください」	PRINTFORMW 「……请适可而止吧」
PRINTFORMW 「今はちょっと……ごめんなさい」	PRINTFORMW 「今天有些……对不起。」
PRINTFORMW 「だっ……ダメです！」	PRINTFORMW 「啊……不行！」
CALL PRINT_STR, @"「はい_H_どうですか%CNAME("二人称")%_H_」_W"	CALL PRINT_STR, @"「是呀_H_如何%CNAME("二人称")%_H_」_W"
CALL PRINT_STRW, @"「まだ見たいんですか？　まったく、%CNAME("二人称")%ったらエッチなんですから_H_」"	CALL PRINT_STRW, @"「还想看吗？　%CNAME("二人称")%真是太H了啊_H_」"
PRINTFORMW 「ま、まだ見るんですか……？」	PRINTFORMW 「还、还想要看吗……？」
PRINTFORMW 「……仕方ないですね」	PRINTFORMW 「……没办法啊」
CALL PRINT_STR, " 「もっと近くで見てもいいんですよ_H_」_W"	CALL PRINT_STR, " 「可以再靠近一点看_H_」_W"
PRINTFORMW 「うぅ……」	PRINTFORMW 「唔……」
PRINTFORMW 「………………え」	PRINTFORMW 「………………欸」
PRINTFORMW 「……いやぁ、まったく意識してませんでした。お恥ずかしい」	PRINTFORMW 「……哎呀，完全没有意识到。不好意思，好难为情」
CALL PRINT_STRW, "「これからもタイミングを見計らってやっていただいていいですからね_H_」"	CALL PRINT_STRW, "「今后也请看准时机进行哦_H_」"
PRINTFORMW 「え…………え！？　な、なんてことを……」	PRINTFORMW 「欸…………欸！？　这、这种事情……」
CALL PRINT_STR, @" 「%CNAME("二人称")%は酷いことをしますねぇ_H_」_W"	CALL PRINT_STR, @" 「%CNAME("二人称")%做了很过分的事情呢_H_」_W"
PRINTFORMW 「やめてくださいっていったじゃないですか！」	PRINTFORMW 「不是说了请停止吗！」
CALL PRINT_STRW, "「いきなりでちょっとビックリしちゃいました_H_」"	CALL PRINT_STRW, "「突然有点吃惊_H_」"
PRINTFORMW 「……%CNAME("二人称")%、いくら何でも人としてのマナーがなってませんよ」	PRINTFORMW 「……%CNAME("二人称")%、不管怎样，作为人的礼仪都没有哦」





//EVENT_K25_FUNCTION.ERB
名称 = %TEXTR("精液/スペルマ/ザーメン/おちんぽミルク/白いおしっこ/大人のおしっこ/種液")%	名称 = %TEXTR("精液/精子/精液/迷你牛奶/白色的尿/大人的尿/种液")%
名称 = %TEXTR("ペニス/おちんちん/おちんぽ/陰茎/マラ")%	名称 = %TEXTR("阴茎/欧金金/大鸡鸡/陰茎/鸡巴")%
名称 = %TEXTR("ヴァギナ/膣/おまんこ/マンコ/下の口")%	名称 = %TEXTR("小穴/阴道/淫穴/猫咪/下面的嘴")%
名称 = %TEXTR("クリトリス/クリ/クリお豆")%	名称 = %TEXTR("阴蒂/小豆豆/豆豆")%
名称 = %TEXTR("お尻/お尻まんこ/お尻の穴/アナル")%	名称 = %TEXTR("屁股/屁穴/菊门/肛門")%
名称 = %TEXTR("おしっこの穴/尿道")%	名称 = %TEXTR("尿尿的小穴/尿道")%
喘ぎ += @"%TEXTR("あ゛/お゛/あ゛あっ/お゛ほっ/あ゛へっ/はっあ゛っ/これしゅきぃ！")%"	喘ぎ += @"%TEXTR("啊゛/奥゛/啊゛啊呜/奥゛哦/啊゛嘿/哈啊゛/这个好棒！")%"
喘ぎ += @"%TEXTR("あはっ/んはぁっ/はんっ/あんっ/あっ")%"	喘ぎ += @"%TEXTR("啊哈/嗯哈/はんっ/あんっ/あっ")%"
喘ぎ += @"%TEXTR("あっ……/ヒィン/んあっ……/あんっ/ひゃぅ……/ふぁ……/はぅん……/んっ……/ひゃっ……/ふぅんっ……/っ……")%"	喘ぎ += @"%TEXTR("啊……/吸呣/嗯啊……/啊嗯/呀呜……/哈……/哈呣……/嗯……/呀……/唔嗯……/っ……")%"
喘ぎ += @"%TEXTR("ふむぅ……/んむっ……/はむぁ……/チュパ……/ペロ……/ジュル……/ん……/んっ、れろ…/れろ…ぁむ…んっ/んっ…、れろ……/ちゅっ、れろっ…ちゅぷっ/んんっ……れろ…/れろ、はむ……んっ")%"	喘ぎ += @"%TEXTR("呼呣……/嗯哼……/哈哈……/啾吧……/吸溜……/咀噜……/嗯……/嗯、吸溜…/吸溜…啊呣…嗯/嗯……吸溜……/啾芙、吸溜……啾卜/嗯嗯……吸溜…/吸溜、哈呣……嗯")%"
喘ぎ += @"%TEXTR("んっ、んぐっ…/んん…んぅ……っ/んっ…、んん……/んぐっ、んっ…んっ/んむっ……んっ/んむっ、んん…っ")%"	喘ぎ += @"%TEXTR("嗯、嗯哼…/嗯嗯…嗯啊……/嗯…、嗯嗯……/嗯哼、嗯…嗯/嗯哼……嗯/嗯哼、嗯嗯…")%"
喘ぎ += @"%TEXTR("ちゅ……/ちゅぷ……/んむっ……/ん……/ちゅっ、ちゅっ…/ちゅ…ちゅ……っ/ちゅっ…、ちゅ……/ちゅっ、ちゅっ…ちゅっ/ちゅぅ……ちゅっ/んちゅっ、ちゅ……っ")%"	喘ぎ += @"%TEXTR("啾……/啾卜……/嗯呣……/嗯……/啾、啾…/啾…啾……/啾…、啾……/啾、啾…啾/啾……啾/嗯啾、啾……")%"
喘ぎ += @"%TEXTR("おしりがぁ/んはっ/はぁんっ")%"	喘ぎ += @"%TEXTR("屁股啊/嗯哈/哈嗯")%"
喘ぎ += @"%TEXTR("おしっこの穴がぁ")%"	喘ぎ += @"%TEXTR("尿尿的孔啊")%"
喘ぎ += @"%TEXTR(@"%CNAMET(対象, "二人称")%の\@GROUPMATCH(SELECTCOM, 125, 126, 127) && RAND:2 ? アナル # ナカ\@、気持ちいいです……/オチンチンきもちいぃっ！")%"	喘ぎ += @"%TEXTR(@"%CNAMET(対象, "二人称")%的\@GROUPMATCH(SELECTCOM, 125, 126, 127) && RAND:2 ? 肛門 # 里边\@、很舒服……/欧金金很舒服哦！")%"
喘ぎ += @"%TEXTR("オナホにジュプジュプされちゃってるぅっ/あっ……ナカがトロトロしてて……")%"	喘ぎ += @"%TEXTR("在飞机杯里咀卜咀卜的做着/啊……里边黏糊糊的……")%"


//EVENT_K25_SHOP.ERB
PRINTFORMW 「何をしてほしいんですか？」	PRINTFORMW 「想要干什么？」
PRINTFORMW 「！　ほ、本当ですか！？」	PRINTFORMW 「！　真，真的吗！？」
PRINTFORMW 「その、%CNAME("一人称")%も%CNAME("二人称")%のこと好きでした！　好きです！」	PRINTFORMW 「那个，%CNAME("一人称")%非常喜欢%CNAME("二人称")%！　最喜欢了！」
PRINTFORMW 「……まるで夢みたいだ」	PRINTFORMW 「……简直像做梦一样」
PRINTFORMW 「……ええと、それじゃあ……」	PRINTFORMW 「……那个、那么……」
PRINTFORMW 「……キス、お願いします」	PRINTFORMW 「……接吻、拜托了」
PRINTFORMW 「ごめんなさい」	PRINTFORMW 「对不起」
PRINTFORMW 「%CNAME("二人称")%とのエッチは好きですけどそういうのはちょっと……」	PRINTFORMW 「很喜欢和%CNAME("二人称")%H，但是这样有些……」
PRINTFORMW 「%CNAME("一人称")%たちまだそういう関係ではありませんし……」	PRINTFORMW 「%CNAME("一人称")%和%CNAME("二人称")%还不是那样的关系……」
PRINTFORMW 「あはは、今日穿かずに来ちゃいまして」	PRINTFORMW 「啊哈哈，今天没穿就来了」
PRINTFORMW 「ダメ……と言ったらどうしますか？」	PRINTFORMW 「不行……如果说这样的话，应该怎么做呢？」
PRINTFORMW 「まあ、今日穿いてないんですけどね」	PRINTFORMW 「嘛，今天没穿呢」
PRINTFORMW 「あの……その……今日は……」	PRINTFORMW 「那个……那个……今天是……」
PRINTFORMW 「……はい、穿いてないんです」	PRINTFORMW 「……是，没穿」
PRINTFORMW 「いいですよ」	PRINTFORMW 「可以哦」
CALL PRINT_STRW, "「かわりに、後でどう使ったか教えてくださいね_H_」"	CALL PRINT_STRW, "「作为补偿，请教我今后怎么使用吧_H_」"
CALL DAILY_MESSAGE, "パンツを脱いで手渡し"	CALL DAILY_MESSAGE, "脱下胖次亲手递了过来"
PRINTFORMW 「え、」	PRINTFORMW 「嗯、」
PRINTFORMW 「あ、　　はい、　　分かりました……」	PRINTFORMW 「啊，知道了。……」
PRINTFORMW 「……あの……何に使うつもりですか？」	PRINTFORMW 「……那个……你打算用来做什么？」
PRINTFORMW 「い、いえいえ！　決して興味があるわけでは！」	PRINTFORMW 「不、不！绝对不是有兴趣！」
PRINTFORMW 「今夜のオカズにされちゃうのかなーとか決して思ってませんから！」	PRINTFORMW 「今天晚上才不会去呢，谁知道会不会被恶作剧呢！」
PRINTFORMW 「……え？　さっきの発言が……？　……………………あ」	PRINTFORMW 「……嗯？　刚才的说的话……？　……………………啊」
PRINTFORMW 「……%CNAME("二人称")%ってものすごい豪胆な人ですよね」	PRINTFORMW 「……%CNAME("二人称")%是个非常豪爽的人呢」
PRINTFORMW 「返事、ですか？　その……………………」	PRINTFORMW 「回复，是吗？那个………………………」
PRINTFORMW 「…………わ、渡します」	PRINTFORMW 「……………哇，交给你」
PRINTFORMW 「すみません、今日は流石に穿いてなかったらマズい日なので……」	PRINTFORMW 「对不起，今天要是不穿胖次的话，那就糟糕了……」
PRINTFORMW 「そ、そういうことはするべきじゃありませんよ……」	PRINTFORMW 「那个，不应该做那种事。……」
PRINTFORMW 「ええ、分かりました」	PRINTFORMW 「好的，知道了」
PRINTFORMW 「……しかし%CNAME("二人称")%って中々ステキな趣味をしていますよね」	PRINTFORMW 「……但是%CNAME("二人称")%有着一种不错的兴趣呢」
CALL PRINT_STRW, "「いいえ、別に問題はありません。むしろ同じような趣味の人がいてくれて嬉しいくらいです_H_」"	CALL PRINT_STRW, "「不，没什么问题。倒不如说有和我有相同兴趣的人让我很开心_H_」"
PRINTFORMW 「……%CNAME("二人称")%って%CNAME("一人称")%のこと頼んだら何でもしてくれるとか思っていませんか？」	PRINTFORMW 「……如果是%CNAME("二人称")%拜托给%CNAME("一人称")%的事，就一定要答应吗？」
PRINTFORMW 「……まあ、そんなに間違ってはいませんけど……」	PRINTFORMW 「……嘛，错倒是没错……」
PRINTFORMW 「魅力的な提案ではあるのですが……まだそこまでの勇気が……」	PRINTFORMW 「很有魅力的提案……迄今为止很有勇气啊……」
PRINTFORMW 「すみません、%CNAME("二人称")%」"	PRINTFORMW 「对不起了、%CNAME("二人称")%」"
PRINTFORMW 「いくら%CNAME("二人称")%の頼みと言ってもさすがにそれは……」	PRINTFORMW 「无论怎么说%CNAME("二人称")%的请求……」
PRINTFORMW 「さ、さすがにそういうのは……」	PRINTFORMW 「不愧是这种事情呢……」
PRINTFORMW 「そういう関係ではありませんし……」	PRINTFORMW 「不是那样的关系……」
CALL PRINT_STR, "「朝から晩までセックス三昧の毎日を送りましょう……_H_」_W"	CALL PRINT_STR, "「从早到晚每天都要性交哦……_H_」_W"
PRINTFORMW 「いつまで一緒に暮らすつもりなんですか？」	PRINTFORMW 「打算一起生活到什么时候？」
PRINTFORMW 「またお弁当を作って欲しいんですか？」	PRINTFORMW 「还想要做便当吗？」
PRINTFORMW 「……まあ、いいですけど」	PRINTFORMW 「……嗯，可以。」
PRINTFORMW 「……別に拗ねてるわけじゃありませんよーだ」	PRINTFORMW 「……我并没有闹别扭哦」
PRINTFORMW 「ええ、喜んで」	PRINTFORMW 「嗯，很高兴」
PRINTFORMW 「%CNAME("二人称")%に喜んでもらえるよう、誠心誠意がんばります」	PRINTFORMW 「希望%CNAME("二人称")%能够喜欢、全心全意地努力」
PRINTFORMW 「そこまで気に入っていただけたんですか？　嬉しいです」	PRINTFORMW 「您喜欢到这种程度吗？很开心」
PRINTFORMW 「な、なんてことを言い出すんですか！」	PRINTFORMW 「怎、怎么说出这样的话来！」
PRINTFORMW 「…………いいですよ」	PRINTFORMW 「…………可以哦」
PRINTFORML 「%CNAME("一人称")%が断れないって分かった上で言っているでしょう？」	PRINTFORML 「知道%CNAME("一人称")%拒绝不了才这样说的吧？」
PRINTFORMW 「ずるい人です」	PRINTFORMW 「狡猾的人呢」
PRINTFORML 「素晴らしい考えですね！」	PRINTFORML 「好主意啊！」
CALL PRINT_STR, @"「奉仕したあとに何食わぬ顔で授業を受けなければならないなんて……ゾクゾクしちゃいます……_H_」_W"	CALL PRINT_STR, @"「服务以后还得装作什么都没吃的样子去上课……有点害怕啊……_H_」_W"
PRINTFORML 「そ、そうですよ！　こんな破廉恥な関係早く止めたほうが良いに決まっています！」	PRINTFORML 「是、是呀！　这种无耻的关系，还是早点停止的好！」
PRINTFORMW 「ダメです！　絶対にダメです！」	PRINTFORMW 「不行！绝对不行！」
PRINTFORMW 「嫌です……抑えきれなくなりそうですから」	PRINTFORMW 「讨厌……无法抑制……大概是这样」
PRINTFORML 「ちょっとそういう気分ではないので」	PRINTFORML 「并没有那样的心情」
PRINTFORMW 「すみません、今の%CNAME("二人称")%の魂の量ではそのお願いを叶えてあげられません」	PRINTFORMW 「对不起、现在%CNAME("二人称")%的灵魂的数量不能够实现这个愿望」
PRINTFORMW 「%CNAME("一人称")%がうまくお教えできるかどうか自信がありませんが……」	PRINTFORMW 「%CNAME("一人称")%没有足够的信心可以很好的告诉你……」
PRINTFORMW 「……え？　こんな感じで十分ですか？」	PRINTFORMW 「……诶？这样就足够了吗？」
PRINTFORMW 「別にペニスは大きさだけじゃないとは思いますが」	PRINTFORMW 「%CNAME("一人称")%认为不仅仅是阴茎的大小」
PRINTFORMW 「とはいえ、それで%CNAME("二人称")%の気が晴れるのであれば協力します」	PRINTFORMW 「没错、只要%CNAME("二人称")%通过其他方面的办法，也会可以很舒服」
PRINTFORMW 「ああ……まあそうですよねぇ……」	PRINTFORMW 「啊……是啊是啊……」
PRINTFORMW 「……%CNAME("一人称")%も大きくしないのか、ですか？」	PRINTFORMW 「……%CNAME("一人称")%这样的尺寸不够大吗？」
PRINTFORMW 「自分のだと術が作用してくれないんです……」	PRINTFORMW 「如果是自己的话，法术就不会起作用……」
PRINTFORMW 「え……あの……その……」	PRINTFORMW 「哎……那个……那个……」
PRINTFORMW 「大きいのでアヘアヘ言わせるのは男のロマンですよねぇ」	PRINTFORMW 「因为很大呢，所以所这才是男人的浪漫」
PRINTFORMW 「%CNAME("一人称")%はアヘアヘ言わされる側も好きですけど」	PRINTFORMW 「%CNAME("一人称")%也很喜欢这种呢」
PRINTFORMW 「あ……ちょっとこういうのは恥ずかしくて……」	PRINTFORMW 「啊……这样有点害羞……」
PRINTFORMW 「これ以上大きくするんですか……？」	PRINTFORMW 「要再大点吗？……？」
PRINTFORMW 「絶対にやめたほうがいいと思いますが……」	PRINTFORMW 「我觉得还是绝对不要做比较好……」
PRINTFORMW 「色々大変だと思うんですけど……」	PRINTFORMW 「总觉得会很辛苦……」
PRINTFORMW 「……これ以上はさすがに……」	PRINTFORMW 「……不愧是这种家伙……」
PRINTFORMW 「%CNAME("一人称")%なら入るとは思いますが……」	PRINTFORMW 「%CNAME("一人称")%想应该可以进去……」
PRINTFORMW 「逆に痛いだけですよ……」	PRINTFORMW 「相反，只会觉得疼……」
PRINTFORMW 「却って痛いだけだと思います……」	PRINTFORMW 「觉得只是疼而已……」
PRINTFORMW 「……%CNAME("二人称")%って%CNAME("一人称")%以上に\@MARK:屈服刻印 == 3 ? 変態 # アレ\@だったんですね」	PRINTFORMW 「……%CNAME("二人称")%比%CNAME("一人称")%还要\@MARK:屈服刻印 == 3 ? 変態 # アレ\@呢」
PRINTFORMW 「……なかなかマニアックな趣味をお持ちのようで……」	PRINTFORMW 「……好象有着相当狂热的爱好……」
PRINTFORMW 「普通の大きさにしたいと？」	PRINTFORMW 「想要一个正常的尺寸吗？」
PRINTFORMW 「まあ、そうですよね。大きいと大きいで色々ありますし」	PRINTFORMW 「啊，是这样啊。有些东西大有大的好处」
PRINTFORMW 「またもったいないことを……」	PRINTFORMW 「又觉得很可惜……」
PRINTFORMW 「……たしかにその大きさは大変ですよねぇ……」	PRINTFORMW 「……这个大小确实有些严重……」
PRINTFORMW 「……ごめんなさい　%CNAME("二人称")%から貰った魂だけでこの大きさを人間クラスに戻すのはムリです」	PRINTFORMW 「……对不起　只是从你这得到的灵魂%CNAME("二人称")%不可能把这个大小恢复成人类的尺寸」
PRINTFORMW 「それでも大丈夫ですか？」	PRINTFORMW 「那样也没关系吗？」




//EVENT_K25_ノノ.ERB
LOCALS = ボク_ぼく	LOCALS = 我_仆
LOCALS = 先輩_せんぱい	LOCALS = 前辈_学长

STR:1 = \@TALENT:MASTER:男の娘 ? %CALLNAME:MASTER%と同じく # \@女性にしか見えない容姿で有名な男子生徒。生徒会の庶務を務めている	STR:1 = \@TALENT:MASTER:男の娘 ? 与%CALLNAME:MASTER%相同 # \@以拥有比女孩还要美丽容貌而有名的男学生。担任学生会的总务
生徒からの評判もよく、ついた二つ名が”生徒会の天使”	学生中的评价也很好，附带了的昵称「学生会的天使」
PRINTFORMW 「何故%CNAME("二人称")%がそれを？」	PRINTFORMW 「%CNAME("二人称")%这是因为什么呢？」
PRINTFORMW 「……ばれてしまっては仕方ありません」	PRINTFORMW 「……暴露了也没办法」
PRINTFORMW 「はい。確かに%CNAME("一人称")%は天使です。厳密には堕天使と人間とのハーフですから、堕天使になりますが」	PRINTFORMW 「是的。%CNAME("一人称")%确实是天使。严格来说是堕天使和人类的混血儿，是堕天使。」
PRINTFORMW 「……え？　ばらされたくなければ部に入れって？」	PRINTFORMW 「……诶？如果不想暴露的话，就加入社团吧？」
PRINTFORMW 「そ……その、ここってあのエ、エ、エエ、エッチな声が聞こえるって噂があるんですけど……」	PRINTFORMW 「那……那个、有传闻在那里可以听见色…色…色…色…色色的声音」
PRINTFORMW 「ほ、本当にやってるんですか……」	PRINTFORMW 「真的在做那个吗……」
PRINTFORMW 「……わ、分かりました。入ります」	PRINTFORMW 「……我、我知道了。我加入」
PRINTFORMW 「でも監視のためです！　エッチなことはダメですからね！　ダメですからね！」	PRINTFORMW 「但是这是为了监视！色色的事是不行！绝对不行！」
PRINTFORMW 「………………ちょっとだけなら構いませんが」	PRINTFORMW 「………………稍微有一点点的话没关系」
PRINTFORMW %NAME:ARG%は%CALLNAME:MASTER%の"%CSTR:ARG:関係%"として、(昼)の部室に顔を出してくれます。	PRINTFORMW %NAME:ARG%和%CALLNAME:MASTER%的"%CSTR:ARG:関係%"确立了、在(白天)会在活动室露面。
PRINTFORMW 「ちょ、ちょっと！　ダメだっていったじゃないですか！」	PRINTFORMW 「等，等等！不是说了不行吗！」
PRINTFORMW 部屋から出ようとする%CALLNAME:TARGET%を%CALLNAME:MASTER%が抑える	PRINTFORMW %CALLNAME:MASTER%控制住了，想要从活动室出来的%CALLNAME:TARGET%
PRINTFORMW %CALLNAME:TARGET%は%CALLNAME:MASTER%をなんとか引き離そうとするが、その力は弱々しい	PRINTFORMW %CALLNAME:TARGET%想要从%CALLNAME:MASTER%手中脱离开、但是力气似乎是太小了
PRINTFORMW 「……分かりました。付き合ってあげます」	PRINTFORMW 「……我明白了。我会陪你的」
PRINTFORMW %CALLNAME:TARGET%が%CALLNAME:MASTER%の腕から抜け出すと、ゆっくりと服を肌蹴させる	PRINTFORMW %CALLNAME:TARGET%脱离了%CALLNAME:MASTER%的手腕、开始慢慢的脱下衣服
PRINTFORM その肢体や振る舞いは紛れも無く男性でありながら、どこか女性的な雰囲気を漂わせており、%CALLNAME:MASTER%は	PRINTFORM 他的肢体和举止毫无疑问的是男性、但是与此同时，也洋溢着女性的氛围、
PRINTFORMW 同性にもかかわらず欲情してしまった	PRINTFORMW %CALLNAME:MASTER%尽管不是同性恋，但还是被激起了欲望
PRINTFORMW 股座をいきり立たせながらその姿を眺めている	PRINTFORMW 打量着这奇妙的身体，股间不由得慢慢变硬了
PRINTFORMW 同性とも異性ともとれる独特の雰囲気に陶酔している	PRINTFORMW 不禁陶醉在同性和异性的独特氛围中
PRINTFORMW 「お待たせしました……こ、これからどんなことをするんですか？」	PRINTFORMW 「让您久等了……接，接下来要做什么呢？」
PRINTFORMW 頬を赤らめた%CALLNAME:TARGET%の瞳は、期待の色に輝いていた	PRINTFORMW %CALLNAME:TARGET%脸颊泛红、眼睛中闪烁着期待的神采
CALL PRINT_STRW, "「あ……_H_」"	CALL PRINT_STRW, "「啊……_H_」"
PRINTFORMW 「ええと……その……」	PRINTFORMW 「嗯……那个………」
PRINTFORMW 「まあ……%CNAME("二人称")%とするのはきもち……じゃなくて素行が悪いわけでもないようですし」	PRINTFORMW 「嘛……和%CNAME("二人称")%在一起的感觉……似乎还算可以」
PRINTFORMW 「……ムリしなくて良いのであれば付き合ってあげます」	PRINTFORMW 「……如果不是太过分的话，我可以和你交往」
PRINTFORMW 「実は、その……」	PRINTFORMW 「其实、那个……」
PRINTFORMW ベッドの前で、%CALLNAME:TARGET%が言いにくそうに口をモゴモゴとさせる	PRINTFORMW 在床前、%CALLNAME:TARGET%好像很难开口似的
PRINTFORMW 「%CNAME("一人称")%、人に見られたり恥ずかしい目に合わされるのが好きで好きでたまらないんです」	PRINTFORMW 「%CNAME("一人称")%喜欢被人看到而感到害羞，我非常喜欢这样」
PRINTFORMW 「物心ついたときからそうで……親は堕天使の血を引いているからじゃないかって言ってました」	PRINTFORMW 「从懂事的时候起就是这样……是因为继承了父母堕天使的血吗？」
PRINTFORMW 「でも、年を経るごとにこのままじゃいけないって思い出して……」	PRINTFORMW 「但是，随着年龄的增长，我知道不能就这样下去……」
PRINTFORMW 「……だから%CNAME("二人称")%お願いです。もうこういうことをしないでください」	PRINTFORMW 「……所以拜托%CNAME("二人称")%了。请不要再这样做了」
PRINTFORMW 「%CNAME("二人称")%とご一緒にエッチなことをするのは気持ちよくて、楽しくて……やめたくなくなってしまうんです」	PRINTFORMW 「和%CNAME("二人称")%一起做色色事情感觉很好、很开心，所以不想放弃」
PRINTFORMW 「きっとこのままだと%CNAME("一人称")%は%CNAME("二人称")%にずっと気持ちよくしてほしたがる淫乱になってしまう」	PRINTFORMW 「如果是这样的话%CNAME("一人称")%会变得淫乱，但是想要%CNAME("二人称")%永远都觉得很舒服」
PRINTFORMW 「それじゃダメなんです……だからお願いです……」	PRINTFORMW 「这可不行……所以拜托了……」
PRINTFORMW 「……でも、もし我がままが許されるなら」	PRINTFORMW 「……但是，如果允许任性的话」
PRINTFORMW 「今日だけは一杯%CNAME("一人称")%としてください」	PRINTFORMW 「今天就请满满的给%CNAME("一人称")%来一杯吧」
PRINTFORMW 「もう一生こんなことしたくなくなるくらい幸せに、気持ちよくして欲しいんです」	PRINTFORMW 「希望你幸福的一辈子再也不想做这种事了，希望你可以很舒服」
PRINTFORMW 「もうムリです」	PRINTFORMW 「已经不行了」
CALL PRINT_STR, "「もう抑え切れません……_H_」_W"	CALL PRINT_STR, "「已经无法抑制了……_H_」_W"
CALL PRINT_STRW, "「いいよね_H_、ここでだけならこのままでいいですよねぇっ_H_」"	CALL PRINT_STRW, "「可以哦_H_如果是在这里的话这样就可以了_H_」"
CALL PRINT_STRW, @"「あはっ_H_、%CNAME("二人称")%が悪いんですよぉ_H_」 "	CALL PRINT_STRW, @"「啊哈_H_、%CNAME("二人称")%真坏_H_」 "
PRINTFORMW 「あれだけ%CNAME("一人称")%がダメだって何回も言ったのに、そのまま続けちゃうんですから」	PRINTFORMW 「明明说了那么多次，%CNAME("一人称")%不行的、就这样继续下去」
CALL PRINT_STRW, "「そんなの勃起しちゃうにきまっているじゃないですかぁ_H_」"	CALL PRINT_STRW, "「那种东西不是一定会勃起的吗_H_」"
CALL PRINT_STRW, @"「ねぇ_H_、一生のお願いだから_H_、代わりにセフレにでもオナペットにでも\@VAGINA(MASTER) == 1 ? 肉バイブ # 肉オナホ\@にでもなんにでもなるから_H_」"	CALL PRINT_STRW, @"「呐_H_、因为这是一生的愿望_H_、成为炮友也好，代替手淫也罢\成为\@VAGINA(MASTER) == 1 ? 肉振動棒 # 肉飞机杯\@什么的_H_」"
CALL PRINT_STRW, "「そしてたまに甘やかしてくれたらそれだけでいいから_H_」"	CALL PRINT_STRW, "「然后偶尔也娇惯一下就行了_H_」"
CALL PRINT_STRW, @"「もっと%CNAME("一人称")%の変態な所を見てくださぁい_H_」 "	CALL PRINT_STRW, @"「让你再看看%CNAME("一人称")%变态的地方吧_H_」 "
PRINTFORMW いつものように%CALLNAME:PLAYER%が%CALLNAME:TARGET%に触れると、急に顔を赤くして俯いてしまった	PRINTFORMW 想往常一样%CALLNAME:PLAYER%碰到了%CALLNAME:TARGET%，突然脸红了起来
PRINTFORMW 「ご、ごめんなさい……こういうのは初めてで……」	PRINTFORMW 「对、对不起……这样的是第一次……」
PRINTFORMW 「いえ、こういうのは初めてではないんですけど……なんて言えばいいんだろうか……」	PRINTFORMW 「不，这倒不是第一次……怎么说才好呢……」
PRINTFORMW 「……こうなるつもりなんてなかったのになぁ」	PRINTFORMW 「……本来没打算变成这样啊」
CALL PRINT_STR, @"「ウフフッ、%CNAME("二人称")%_H_」_W"	CALL PRINT_STR, @"「呼呼、%CNAME("二人称")%_H_」_W"
PRINTFORMW %CALLNAME:TARGET%は満面の笑みを浮かべて%CALLNAME:MASTER%の手を握っている	PRINTFORMW %CALLNAME:TARGET%露出满面笑容握住%CALLNAME:MASTER%的手
PRINTFORMW 「こんな体でしたから……一生一緒に居たいって思えるような人ってできないんだろうなって思ってたんです」	PRINTFORMW 「就是这样的身体……我想不会有人愿意我和一起度过余生了吧」
PRINTFORMW 「その……%CNAME("一人称")%の体ってちょっとした事情がありまして……一生一緒に居たいって思えるような人ってできないんだろうなって思ってたんです」	PRINTFORMW 「那个……%CNAME("一人称")%的身体有些微妙的情况……想有个一辈子都在一起的人是不可能了吧」
PRINTFORMW 「それに……人間と愛し合ってもきっと先立たれてしまうだろうって、恐れてもいましたから……」	PRINTFORMW 「而且……即使与人类相爱也一定会走在前面、所以很害怕……」
PRINTFORMW 「それでも、%CNAME("二人称")%とは一緒にいたい」	PRINTFORMW 「尽管如此、还是想和%CNAME("二人称")%在一起」
PRINTFORMW 「たとえ%CNAME("二人称")%の魂が普通に戻ったって関係ないんです」	PRINTFORMW 「就算%CNAME("二人称")%的灵魂恢复正常也没有关系」
PRINTFORMW 「いくら%CNAME("二人称")%相手でも、永遠に共に居てほしいなんてわがままは言いません」	PRINTFORMW 「即使对方是%CNAME("二人称")%、我也不会任性地说希望我们永远在一起」
PRINTFORMW 「でも、この瞬間だけは%CNAME("一人称")%と%CNAME("二人称")%の二人だけのものにしてほしいんです」	PRINTFORMW 「但是、只希望这个瞬间能成为%CNAME("一人称")%和%CNAME("二人称")%之间的东西」
PRINTFORMW 「%CNAME("二人称")%、あけましておめでとうございます」	PRINTFORMW 「%CNAME("二人称")%、あけまして祝贺您！」
PRINTFORMW 「これからは気持ちも新たに、いっそう学園での生活に励んでください」	PRINTFORMW 「今后也请重新振作起来，更加努力在学园生活」
PRINTFORMW 「……さて、堅苦しいことはこれくらいにしましょうか」	PRINTFORMW 「……那么、拘谨就到此为止吧」
CALL PRINT_STRW, "「このまま一緒に姫初めしちゃいましょう_H_」"	CALL PRINT_STRW, "「就这样一起开始新年的一次做爱吧_H_」"
PRINTFORMW 「確かに、%CNAME("二人称")%にはいつも気持ちよくしてもらっていますけど……」	PRINTFORMW 「确实、总是让%CNAME("二人称")%觉得很舒服……」
PRINTFORMW 「やっぱり、こういう特別な日にすると俄然興奮しませんか？」	PRINTFORMW 「但是、在这个特别的日子里，也会特别兴奋吧？」
PRINTFORMW 「なんで、と言われましても……」	PRINTFORMW 「为什么，这么说呢……」
PRINTFORMW 「だって、年初めの、それもこんな明るい時にセックスだなんて興奮しませんか？」	PRINTFORMW 「可是，在跨年即将天亮得时候性交之类，不会感到兴奋吗？」
CALL PRINT_STRW, @"「……ですから、%CNAME("一人称")%を%CNAME("二人称")%でいっぱいいっぱいになるくらいたくさん犯してくださいね_H_」"	CALL PRINT_STRW, @"「……所以、请%CNAME("二人称")%侵犯%CNAME("一人称")%到满满的程度吧_H_」"
PRINTFORMW 「ここからは無礼講ということで、%CNAME("一人称")%と一緒に……って、な、何でベッドに連れて行こうとしてるんですか！？」	PRINTFORMW 「从这里开始粗鲁的课程、和%CNAME("一人称")%一起……、呐、为什么要去床上！？」
PRINTFORMW 「……その、%CNAME("二人称")%はそんなに%CNAME("一人称")%と、その……シたいんですか？」	PRINTFORMW 「……那个、%CNAME("二人称")%就这样的和%CNAME("一人称")%、那个……想要什么？？」
PRINTFORMW 「……やさしくしてくださいよ」	PRINTFORMW 「……请温柔一点」
CALL PRINT_STR, "「今日はラブラブエッチの気分なので_H_、"	CALL PRINT_STR, "「今天色色心情超级喜欢哦_H_、"
CALL PRINT_STRW, "孕ませるつもりで犯してくださぁい_H_」"	CALL PRINT_STRW, "为了孕育而犯下罪恶吧_H_」"
CALL PRINT_STRW, "妊娠しちゃうくらい中だしさせてくださぁい_H_」"	CALL PRINT_STRW, "请中出我到怀孕的程度吧_H_」"
PRINTFORMW 「今日はいっぱい甘えていいですよね？」	PRINTFORMW 「今天可以好好地撒娇吧？」
PRINTFORMW 「……エッチ」	PRINTFORMW 「……色色的」
PRINTFORML 「今日は何をするんですか？」	PRINTFORML 「今天干什么？？」
PRINTFORMW 「べ、別に期待してる訳じゃ……」	PRINTFORMW 「啊，并不是很期待嘛……」
PRINTFORMW 「これ以上%CNAME("二人称")%にエッチなことされると抑えきれなくなりそうです……」	PRINTFORMW 「如果再被%CNAME("二人称")%做色色的事情就无法抑制了……」
PRINTFORMW 「もう勘弁してください……」	PRINTFORMW 「请原谅我……」
PRINTFORMW 「もう一回だけなら、きっと大丈夫ですよね……」	PRINTFORMW 「如果只是再来一次的话，一定没问题吧……」
CALL PRINT_STR, "「今日はどんなことをするんですか_H_」_W"	CALL PRINT_STR, "「今天做什么呢_H_」_W"
PRINTFORMW 「……こんなものですか？」	PRINTFORMW 「……就是这样的吗？？」
PRINTFORMW 「まったく、仕方ないですね」	PRINTFORMW 「真是的，没办法啊」
CALL PRINT_STR, "「……埋め合わせに次はタップリしてくださいね_H_」_W"	CALL PRINT_STR, "「……为了补偿，下次会努力的_H_」_W"
PRINTFORMW 「おざなりになられても困りますし、今日は勘弁してあげます」	PRINTFORMW 「被敷衍了也不好办，今天就饶了你」
PRINTFORMW 「……よかった」	PRINTFORMW 「…太好了。」
PRINTFORMW 「……もう少しくらいは……」	PRINTFORMW 「……再多一点点……」
PRINTFORMW 「い、いえ！　何でもありません！」	PRINTFORMW 「不、不！没什么事！」
PRINTFORMW 「ハァ……ハァ……」	PRINTFORMW 「哈……哈……」
CALL PRINT_STR, @"「しあわしぇ……_H_」_W"	CALL PRINT_STR, @"「哎呀……_H_」_W"
CALL PRINT_STR, @"「もう……最っ高……_H_」_W"	CALL PRINT_STR, @"「已经……最…高…了…_H_」_W"
CALL PRINT_STR, @"「これ以上は……ムリ……_H_」_W"	CALL PRINT_STR, @"「除此以外……不行……_H_」_W"
CALL PRINT_STR, "「あは……_H_ぐちょぐちょにされちゃったぁ……_H_」_W"	CALL PRINT_STR, "「啊啦……_H_咕啾咕啾的被打败了……_H_」_W"
CALL PRINT_STR, "「こんな……_H_ダメェ……_H_」_W"	CALL PRINT_STR, "「这样……_H_不行……_H_」_W"
CALL PRINT_STR, "「もう……お腹いっぱい……_H_」_W"	CALL PRINT_STR, "「肚子…已经…饱…了…_H_」_W"
CALL PRINT_STRW, "「…………す、すごかったです…………_H_」"	CALL PRINT_STRW, "「…………很、厉害呢…………_H_」"
CALL PRINT_STRW, "「…………ふふっ_H_」"	CALL PRINT_STRW, "「…………呼呼_H_」"
PRINTFORMW 「いえ、こうやって%CNAME("二人称")%と一緒に居れるなんて幸せだなぁって思いまして」	PRINTFORMW 「不、像这样能和%CNAME("二人称")%在一起，觉得很幸福」
PRINTFORMW 「お疲れ様でした」	PRINTFORMW 「您辛苦了」
PRINTFORMW 「え……もうですか……」	PRINTFORMW 「欸……已经……」
PRINTFORMW 「いえ、なんでもありません……それではまた」	PRINTFORMW 「不，没什么……那么再见」
PRINTFORMW 「これだけですか？　まったく……仕方ないですね」	PRINTFORMW 「就这些吗？真是……没办法啊」
PRINTFORMW 「……まあ、いつもたっぷり愛してくれてますし……」	PRINTFORMW 「……嗯，一直都那么爱我………」
PRINTFORMW 「今日はゆっくり休んでください」	PRINTFORMW 「今天好好休息吧」
CALL PRINT_STRW, "「次はたっぷりシてくださいね……_H_」"	CALL PRINT_STRW, "「下次请充分休息……_H_」"
PRINTFORMW 「んっ……そういえばこんな風に触られたことなかったですねっ……はぅ……」	PRINTFORMW 「嗯……这么说来，从来没有被这样触碰过呢……哈……」
PRINTFORMW 「ちょっと……くすぐったいです……」	PRINTFORMW 「有点……好痒……」
PRINTFORMW 「ん……%CNAME("二人称")%の手、あたたかいです……」	PRINTFORMW 「嗯……%CNAME("二人称")%手，好暖和……」
CALL PRINT_STR, @"「そんなに焦らして……%CNAME("二人称")%は%CNAME("一人称")%を興奮させるのが上手いですねぇ_H_」_W"	CALL PRINT_STR, @"「そんなに挑逗て……%CNAME("二人称")%は%CNAME("一人称")%を興奮させるのが擅长いですねぇ_H_」_W"
CALL PRINT_STRW, "「そんなに羽根がお好きですか_H_」"	CALL PRINT_STRW, "「那么喜欢羽毛吗_H_」"
PRINTFORMW 「……羽根ばっかり触らないでください……」	PRINTFORMW 「……请不要只触摸翅膀……」
PRINTFORMW 「そっ、そんなっ、ところをっ、」	PRINTFORMW 「啊，那种地方、」
PRINTFORMW 「なっ、何をするつもりなんですか！」	PRINTFORMW 「喂，你打算干什么？！」
PRINTFORMW 「え？　ここで気持ちよくなれるために？」	PRINTFORMW 「欸？　这里可以变舒服？」
PRINTFORMW 「そ、そんなことを……」	PRINTFORMW 「那、那样的事……」
CALL PRINT_STRW, @"「メスですぅ_H_、%CNAME("一人称")%は%CNAME("二人称")%\@PLAYER == MASTER ? 専属 # \@のメスになりますぅ_H_」"	CALL PRINT_STRW, @"「是雌性_H_、%CNAME("一人称")%是%CNAME("二人称")%\@PLAYER == MASTER ? 専属 # \@的雌性_H_」"
CALL PRINT_STRW, @"「%CNAME("二人称")%っ_H_もっとっ_H_%CNAME("一人称")%の%ADANA("アナル")%躾けてくださいぃっ_H_」"	CALL PRINT_STRW, @"「%CNAME("二人称")%_H_更加、更加_H_用力的教导%CNAME("一人称")%的%ADANA("肛門")%_H_」"
CALL PRINT_STRW, @"「\@(TALENT:PLAYER:オトコ && TALENT:PLAYER:男の娘) || ((TALENT:PLAYER:ふたなり || TALENT:PLAYER:男の娘) && RAND:2) ? %CNAME("二人称")%の%ADANA("ペニス")%が入るように # %CNAME("二人称")%と同じになれるように\@いっぱいイジイジしてください_H_」"	CALL PRINT_STRW, @"「\@(TALENT:PLAYER:男性 && TALENT:PLAYER:伪娘) || ((TALENT:PLAYER:扶她 || TALENT:PLAYER:伪娘) && RAND:2) ? 像%CNAME("二人称")%的%ADANA("阴茎")%进入一样 # 为了能和%CNAME("二人称")%一样\@请更多的欺负我吧_H_」"
CALL PRINT_STRW, @"「あっ_H_、%CNAME("二人称")%に見られてるぅ_H_」"	CALL PRINT_STRW, @"「啊_H_、被%CNAME("二人称")%看见了_H_」"
CALL PRINT_STRW, @"「あっ_H_、み、見ないでくださぁい_H_」"	CALL PRINT_STRW, @"「啊_H_、请别看。_H_」"
CALL PRINT_STRW, @"「%MIX_AEGI(2, TARGET, "要")%%TEXTR(@"%CNAME("二人称")%っ_H_そこっ/あはっ_H_%CNAME("二人称")%っ_H_上手っ_H_")%」"	CALL PRINT_STRW, @"「%MIX_AEGI(2, TARGET, "要")%%TEXTR(@"%CNAME("二人称")%_H_那里/啊哈_H_%CNAME("二人称")%_H_擅长_H_")%」"
CALL PRINT_STRW, @"「%MIX_AEGI(1, TARGET, "要")%%CNAME("二人称")%_H_このまま%CNAME("一人称")%の%ADANA("精液")%%TEXTR("飲んでっ/ゴクゴクってしてっ")%_H_」"	CALL PRINT_STRW, @"「%MIX_AEGI(1, TARGET, "要")%%CNAME("二人称")%_H_就这样把%CNAME("一人称")%的%ADANA("精液")%%TEXTR("喝下去了/咕噜咕噜地喝下去了")%_H_」"
CALL PRINT_STRW, @"「あっ_H_このままじゃ%CNAME("二人称")%のお口で%ADANA("精液")%出しちゃうぅ_H_」"	CALL PRINT_STRW, @"「啊_H_就这样在%CNAME("二人称")%嘴里把%ADANA("精液")%射出来了_H_」"
CALL PRINT_STRW, @"「フフッ_H_%CNAME("一人称")%のおっぱいメスにしちゃいますか_H_」"	CALL PRINT_STRW, @"「呼呼_H_%CNAME("一人称")%雌性的胸部_H_」"
CALL PRINT_STRW, @"「いいですよ_H_いっぱいいじめて%CNAME("一人称")%を乳首だけでイケるように調教してください_H_」"	CALL PRINT_STRW, @"「可以哦_H_请尽情的欺负，调教%CNAME("一人称")%的乳头吧_H_」"
PRINTFORMW 「え……！？　な、何で胸を……？」	PRINTFORMW 「欸……！？　什、什么胸……？」
CALL PRINT_STRW, @"「%CNAME("二人称")%っ_H_そんなっ_H_おっぱいばっかりいじってっ_H_」"	CALL PRINT_STRW, @"「%CNAME("二人称")%_H_那样_H_总是摆弄着胸部_H_」"
CALL PRINT_STRW, @"「%CNAME("二人称")%のいじわるっ_H_」"	CALL PRINT_STRW, @"「%CNAME("二人称")%真是坏心眼_H_」"
CALL PRINT_STRW, @"「あはっ_H_%CNAME("二人称")%もっとやってぇ_H_」"	CALL PRINT_STRW, @"「啊哈_H_%CNAME("二人称")%再这样多做点_H_」"
CALL PRINT_STRW, @"「もっと乳首\@CHECK_COM("乳首舐め") ? ナメナメ # イジイジ\@して%CNAME("一人称")%を%ADANA("ペニス")%じゃないところでイケちゃう男の子失格なメスにしてぇ_H_」"	CALL PRINT_STRW, @"「もっと乳頭\@CHECK_COM("乳頭舐め") ? ナメナメ # イジイジ\@%CNAME("一人称")%是个有%ADANA("阴茎")%的男孩子，是个失格的雌性_H_」"
CALL PRINT_STRW, "「あっ_H_乳首いじめられてるぅ_H_」"	CALL PRINT_STRW, "「啊_H_乳头被欺负了_H_」"
CALL PRINT_STRW, @"「%CNAME("一人称")%の女の子乳首%CNAME("二人称")%に容赦なく\@CHECK_COM("乳首舐め") ? しゃぶられて # いじられて\@るぅ_H_」"	CALL PRINT_STRW, @"「%CNAME("一人称")%的女孩子乳头被%CNAME("二人称")%无情的\@CHECK_COM("乳頭舐め") ? 吮吸着 # 欺负着\@嗯……嗯_H_」"
CALL PRINT_STRW, "「こんなのじゃイっちゃうよぉ_H_」"	CALL PRINT_STRW, "「这样可不行啊_H_」"
CALL PRINT_STRW, "「男の子なのに乳首だけでイケる変態だってバレちゃうよぉ_H_」"	CALL PRINT_STRW, "「明明是男孩子的乳头，真是个光凭外表就能看穿的变态啊_H_」"
PRINTFORMW 「ちょ、ちょっと……恥ずかしいです」	PRINTFORMW 「有，有点……害羞呢」
CALL PRINT_STRW, @"「もう耐えられません……%MIX_AEGI(2, TARGET, "要")%」"	CALL PRINT_STRW, @"「已经受不了了……%MIX_AEGI(2, TARGET, "要")%」"
PRINTFORMW 「ほ、本当はダメですが……」	PRINTFORMW 「真、真的不行了……」
CALL PRINT_STRW, @"「と、特別にキスしてあげます……%MIX_AEGI(2, TARGET, "要")%」"	CALL PRINT_STRW, @"「、特别的接吻……%MIX_AEGI(2, TARGET, "要")%」"
PRINTFORMW 「……以外ですけど、%CNAME("一人称")%達今までキスしたことなかったんですね」	PRINTFORMW 「……除此之外、%CNAME("一人称")%至今为止没有接吻过呢」
CALL PRINT_STRW, @"「そこまでやっていいとはいって……！……%MIX_AEGI(2, TARGET, "要")%」"	CALL PRINT_STRW, @"「说的就是那里……！……%MIX_AEGI(2, TARGET, "要")%」"
CALL PRINT_STRW, @"「%MIX_AEGI(3, TARGET, "不要")% 足りない……」"	CALL PRINT_STRW, @"「%MIX_AEGI(3, TARGET, "不要")% 还不够……」"
PRINTFORM 「フフッ……%CNAME("二人称")%……愛しています……	PRINTFORM 「呼呼……%CNAME("二人称")%……我爱你……
CALL PRINT_STRW, @"「ん……%CNAME("二人称")%って結構ムードを気にする所ありますよねぇ……_H_」"	CALL PRINT_STRW, @"「嗯……%CNAME("二人称")%有很在意情绪的地方呢……_H_」"
CALL PRINT_STR, "「そういう所、好きですよ_H_"	CALL PRINT_STR, "「那样的地方、非常喜欢_H_"
PRINTFORM 「こういうことは恋人とするものだと思うのですが……	PRINTFORM 「我想这是作为恋人才能做的事，不过……
CALL PRINT_STRW, @"「本当は%CNAME("二人称")%といつでもこうしたいのですが……%MIX_AEGI(3, TARGET, "要")%」"	CALL PRINT_STRW, @"「其实想要一直和%CNAME("二人称")%在一起……%MIX_AEGI(3, TARGET, "要")%」"
PRINTFORMW 「……%CNAME("二人称")%ったら、わざわざそんなところ舐めなくてもいいんですよ」	PRINTFORMW 「……%CNAME("二人称")%，你这家伙、不用特意去舔那样的地方哟」
CALL PRINT_STRW, @"「ちょ、ちょっと！　足でなんて……%MIX_AEGI(1, TARGET, "要")%」"	CALL PRINT_STRW, @"「啊、等等！　用脚什么……%MIX_AEGI(1, TARGET, "要")%」"
CALL PRINT_STRW, @"「%CNAME("二人称")%_H_もっともっといじってぇ_H_」"	CALL PRINT_STRW, @"「%CNAME("二人称")%_H_更多更多更多的玩弄吧_H_」"
CALL PRINT_STRW, @"「%CNAME("二人称")%っ_H_好きっ_H_だいすきっ_H_」"	CALL PRINT_STRW, @"「%CNAME("二人称")%_H_喜欢_H_最喜欢了_H_」"
CALL PRINT_STRW, @"「はい_H_」"	CALL PRINT_STRW, @"「是_H_」"
CALL PRINT_STRW, @"「%CNAME("一人称")%が%ADANA("アナル")%を他人に見せる所、ちゃんと見てくださいね_H_」"	CALL PRINT_STRW, @"「把%CNAME("一人称")%的%ADANA("肛門")%给别人看、请好好看哦_H_」"
PRINTFORMW 「わ、分かりました……」	PRINTFORMW 「我、我知道了……」
CALL PRINT_STRW, @"「は、恥ずかしいよぉ……\@ RAND:10 == 0 ? _H_ # \@」"	CALL PRINT_STRW, @"「有，有点害羞哟……\@ RAND:10 == 0 ? _H_ # \@」"
CALL PRINT_STR, @"「%CNAME("二人称")%見てください_H_"	CALL PRINT_STR, @"「%CNAME("二人称")%请看_H_"
CALL PRINT_STRW, @"%CNAME("二人称")%の%TEXTR("おかげで/せいで")%%CNAME("一人称")%の%ADANA("アナル")%、こんなにエッチになっちゃいました_H_」"	CALL PRINT_STRW, @"%TEXTR("多亏/因为")%%CNAME("二人称")%，%CNAME("一人称")%的%ADANA("肛門")%变得这么的H~ _H_」"
CALL PRINT_STRW, @"%CNAME("二人称")%のおかげで順調に%TEXTR("性器/女の子の穴")%に作りかえられちゃってますよぉ_H_」"	CALL PRINT_STRW, @"托%CNAME("二人称")%的福很顺利，已经被成功开发成了%TEXTR("性器官/女孩子的小穴")%_H_」"
CALL PRINT_STRW, @"ここからどう%CNAME("二人称")%に開発されちゃうのか、楽しみにしてますね_H_」"	CALL PRINT_STRW, @"该会如何被%CNAME("二人称")%开发、很期待呢_H_」"
PRINTFORMW 「……%CNAME("二人称")%、その、恥ずかしいです……」	PRINTFORMW 「……%CNAME("二人称")%、那个、好害羞啊……」
CALL PRINT_STRW, "「……まあ、そこが気持ちいいんですけれど_H_」"	CALL PRINT_STRW, "「……嘛、虽然那里很舒服_H_」"
PRINTFORMW 「%CNAME("二人称")%がそんなに見たいのなら……」	PRINTFORMW 「%CNAME("二人称")%如果那么想看的话……」
PRINTFORMW 「%CNAME("二人称", "どもり")%……そんなにジロジロ見てて楽しいんですか……？」	PRINTFORMW 「%CNAME("二人称", "どもり")%……那么盯着看开心吗？……？」
CALL PRINT_STRW, @"「あっ_H_すごいっ_H_」"	CALL PRINT_STRW, @"「啊_H_好厉害啊_H_」"
CALL PRINT_STRW, @"「これ以上されたらまともに生きれなくなっちゃうっ_H_」"	CALL PRINT_STRW, @"「如果再这样下去就无法好好地活下去了_H_」"
CALL PRINT_STRW, "「アナルバイブですか、いいですよ」"	CALL PRINT_STRW, "「肛用振動棒吗、可以哦」"
PRINTFORMW 「こ、これをお尻に……？」	PRINTFORMW 「把……？」
CALL PRINT_STRW, @"「%AEGI(TARGET, "要", "通常")%……%CNAME("二人称")%の%ADANA("ペニス")%でもいいのに……%MIX_AEGI(3, TARGET, "要")%」"	CALL PRINT_STRW, @"「%AEGI(TARGET, "要", "通常")%……%CNAME("二人称")%的%ADANA("阴茎")%也可以哦……%MIX_AEGI(3, TARGET, "要")%」"
CALL PRINT_STRW, @"「%MIX_AEGI(2, TARGET, "要")%確かにこれも好きですけどぉっ_H_」"	CALL PRINT_STRW, @"「%MIX_AEGI(2, TARGET, "要")%确实这个也喜欢,不过_H_」"
CALL PRINT_STRW, @"「%CNAME("二人称")%……早くぅ……_H_早くそのバイブを使って%CNAME("一人称")%の%ADANA("アナル")%をめちゃめちゃにかき回してくださいよぉ……_H_」"	CALL PRINT_STRW, @"「%CNAME("二人称")%……快点啊……_H_快点使用振动棒，把%CNAME("一人称")%的%ADANA("肛門")%乱七八糟的搅拌吧……_H_」"
CALL PRINT_STRW, @"「%MIX_AEGI(2, TARGET, "要")%あっ_H_バイブが%ADANA("アナル")%に入ってくるっ_H_」"	CALL PRINT_STRW, @"「%MIX_AEGI(2, TARGET, "要")%啊_H_振動棒插进%ADANA("肛門")%了_H_」"
CALL PRINT_STRW, @"「%CNAME("二人称")%の目の前で女の子みたいに喘いでるところ見られちゃってるっ_H_」"	CALL PRINT_STRW, @"「在%CNAME("二人称")%的面前像女孩子一样的娇喘_H_」"
CALL PRINT_STRW, @"「ちょ、ちょっと……いくらなんでもこの格好は恥ずかし……%AEGI(TARGET, "要", "通常")%」"	CALL PRINT_STRW, @"「等…等…不管怎么说这身打扮太难为情了。……%AEGI(TARGET, "要", "通常")%」"
PRINTFORMW 「……ごめんなさい。我慢の限界です」	PRINTFORMW 「……对不起。忍耐到极限了」
CALL PRINT_STRW, @"「……%CNAME("二人称")%の%ADANA("ペニス")%、おいしそうですねぇ_H_」"	CALL PRINT_STRW, @"「……%CNAME("二人称")%的%ADANA("阴茎")%、看起来很好吃呢_H_」"
PRINTFORMW 「そっ………………その………………」	PRINTFORMW 「那………………那个………………」
CALL PRINT_STRW, @"「こんなに開発しても%ADANA("ペニス")%は挿れなかったなんて、%CNAME("二人称")%ってばイイ趣味してますね_H_」"	CALL PRINT_STRW, @"「这么开发也没有插入%ADANA("阴茎")%什么的、%CNAME("二人称")%有个好爱好呢_H_」"
PRINTFORMW 「……%CNAME("二人称")%ならいつでも大歓迎ですよ？」	PRINTFORMW 「……%CNAME("二人称")%随时欢迎哦？」
PRINTFORMW 「でも……その……」	PRINTFORMW 「但是……那个……」
CALL PRINT_STRW, "「こういうこと初めてなので、できるだけ優しくしてくれたらなって……_H_」"	CALL PRINT_STRW, "「这样的事是第一次、请尽可能的温柔一点……_H_」"
CALL PRINT_STRW, @"「……あっ……%CNAME("二人称")%の%ADANA("ペニス")%が入って……\@ABL:Ａ感覚 >= 3 ? _H_ # \@」"	CALL PRINT_STRW, @"「……啊……%CNAME("二人称")%的%ADANA("阴茎")%插进来了……\@ABL:Ａ感覚 >= 3 ? _H_ # \@」"
CALL PRINT_STRW, @"「今日はこの体位でするんですね_H_」"	CALL PRINT_STRW, @"「今天用这个体位啊_H_」"
//CALL PRINT_STRW, @"「あっ！　ちょっと！　まだ濡れて……っ\@ABL:マゾっ気 >= 3 || ABL:Ａ感覚 >= 5 ? _H_ # ！\@」"	CALL PRINT_STRW, @"「啊！　等等！　还在变湿呢……っ\@ABL:受虐属性 >= 3 || ABL:Ａ感覚 >= 5 ? _H_ # ！\@」"
PRINTFORMW 「%MIX_AEGI(2, TARGET, "不要")%%CNAME("二人称")%……\@ MARK:屈服刻印 == 0 ? 流石にムリですよ # ちょっとまだ準備不足なんじゃ\@……%MIX_AEGI(1, TARGET, "不要")%」	PRINTFORMW 「%MIX_AEGI(2, TARGET, "不要")%%CNAME("二人称")%……\@ MARK:屈服刻印 == 0 ? 果然不行 # 有点准备不充足\@……%MIX_AEGI(1, TARGET, "不要")%」
CALL PRINT_STRW, @"「%MIX_AEGI(1, TARGET, "要")%%CNAME("一人称")%のっ_H_%ADANA("アナル")%がぁ_H_」"	CALL PRINT_STRW, @"「%MIX_AEGI(1, TARGET, "要")%%ADANA("肛門")% %CNAME("一人称")%的_H__H_」"
CALL PRINT_STRW, @"「%CNAME("二人称")%の%ADANA("ペニス")%でいっぱいいっぱいにされちゃってるぅ_H_」"	CALL PRINT_STRW, @"「被%CNAME("二人称")%的%ADANA("阴茎")%填的满满的_H_」"
CALL PRINT_STRW, @"「%CNAME("一人称")%の%ADANA("アナル")%で%CNAME("二人称")%の%ADANA("ペニス")%食べちゃいますね_H_」"	CALL PRINT_STRW, @"「%CNAME("一人称")%的%ADANA("肛門")%把%CNAME("二人称")%的%ADANA("阴茎")%吃进去了_H_」"
CALL PRINT_STRW, "「はい、どうぞ_H_」"	CALL PRINT_STRW, "「好的、请_H_」"
PRINTFORM 「%CNAME("一人称")%の	PRINTFORM 让「%CNAME("一人称")%的
PRINTFORM %CNAME("二人称")%専用	PRINTFORM %CNAME("二人称")%专用
PRINTFORM とろとろの	PRINTFORM 粘糊糊的
PRINTFORM 腕だって入る	PRINTFORM 能进入胳膊的
PRINTFORM はしたない	PRINTFORM 不干净的
CALL PRINT_STRW, @"%ADANA("アナル")%でいっぱい気持ちよくなってください_H_」"	CALL PRINT_STRW, @"%ADANA("肛門")%变得舒服吧_H_」"
CALL PRINT_STRW, @"「%MIX_AEGI(3, TARGET, "要")%%CNAME("二人称")%っ_H_これすごいっ_H_」"	CALL PRINT_STRW, @"「%MIX_AEGI(3, TARGET, "要")%%CNAME("二人称")%っ_H_真了不起っ_H_」"
CALL PRINT_STRW, @"「こんなことばっかりしてたら女の子になっちゃうぅっ_H_%MIX_AEGI(2, TARGET, "要")%」"	CALL PRINT_STRW, @"「如果总是做这种事的话会变成女孩子的っ_H_%MIX_AEGI(2, TARGET, "要")%」"
CALL PRINT_STRW, @"「%CNAME("二人称")%のっ_H_いじわるぅ_H_」"	CALL PRINT_STRW, @"「%CNAME("二人称")%在っ_H_欺负_H_」"
CALL PRINT_STRW, @"「こんなっ_H_きもちいいままにされたらっ_H_おかしくなるぅっ_H_」"	CALL PRINT_STRW, @"「这样_H_被随心所欲的_H_变得好奇怪啊_H_」"
CALL PRINT_STRW, @"「%MIX_AEGI(3+RAND:3, TARGET, "要")%あっ_H_いじめられてるっ_H_%CNAME("一人称")%の%ADANA("アナル")%いじめられてるっ_H_」"	CALL PRINT_STRW, @"「%MIX_AEGI(3+RAND:3, TARGET, "要")%啊_H_被欺负了_H_%CNAME("一人称")%的%ADANA("肛門")%被欺负了っ_H_」"
CALL PRINT_STRW, "「お腹の中グチョグチョにかき回されちゃってるぅっ_H_」"	CALL PRINT_STRW, "「肚子里被硬邦邦的东西来回搅合着_H_」"
PRINTFORMW 「%AEGI(TARGET, "不要", "通常", 2)%……%CNAME("二人称")%、もうちょっとゆっくりっ！！」	PRINTFORMW 「%AEGI(TARGET, "不要", "通常", 2)%……%CNAME("二人称")%、再稍微慢一点！！」
CALL PRINT_STRW, @"「%CNAME("二人称")%っ_H_%CNAME("二人称")%だいすきっ_H_」"	CALL PRINT_STRW, @"「%CNAME("二人称")%っ_H_非常喜欢%CNAME("二人称")%っ_H_」"
CALL PRINT_STRW, "「もっとぉ_H_もっとめちゃくちゃになるくらい犯してぇっ_H_」"	CALL PRINT_STRW, "「继续_H_把我侵犯的得乱七八糟吧_H_」"
CALL PRINT_STRW, "「あっ_H_これ好きっ_H_」"	CALL PRINT_STRW, "「啊っ_H_喜欢这个_H_」"
CALL PRINT_STRW, "「こんなっ_H_こんなの帰れなくなるっ_H_」"	CALL PRINT_STRW, "「这样っ_H_这样已经回不去了_H_」"
CALL PRINT_STRW, @"「こんな%ADANA("ペニス")%挿れちゃったらお尻使わないとガマンできなくなるっ_H_」"	CALL PRINT_STRW, @"「屁股插入了这样的%ADANA("阴茎")%不是用，是没办法忍耐的_H_」"
CALL PRINT_STRW, "「もっとぉ_H_もっとゴリゴリってやってぇ_H_」"	CALL PRINT_STRW, "「もっとぉ_H_再继续嘎吱嘎吱的做吧_H_」"
CALL PRINT_STRW, @"「ふごっ_H_%MIX_AEGI(3, TARGET, "要")%」"	CALL PRINT_STRW, @"「呼芙_H_%MIX_AEGI(3, TARGET, "要")%」"
CALL PRINT_STRW, @"「あっ_H_チューッ_H_チューしてぇっ_H_」"	CALL PRINT_STRW, @"「啊っ_H_啾_H_亲吻吧っ_H_」"
CALL PRINT_STRW, @"「%CNAME("一人称")%の%ADANA("アナル")%、ゴリゴリってされてるっ_H_」"	CALL PRINT_STRW, @"「%CNAME("一人称")%的%ADANA("肛門")%、嘎吱嘎吱的做吧_H_」"
CALL PRINT_STRW, @"「%CNAME("一人称")%、男の子なのにメス扱いされてっ_H_」"	CALL PRINT_STRW, @"「%CNAME("一人称")%明明是男生却被当成雌性_H_」"
CALL PRINT_STRW, @"「こんなっ_H_イケないことなのにぃっ_H_」"	CALL PRINT_STRW, @"「这样_H_这样明明不帅气_H_」"
CALL PRINT_STRW, @"「あはぁっ_H_%ADANA("アナル")%拡げられちゃってるっ_H_」"	CALL PRINT_STRW, @"「啊哈_H_%ADANA("肛門")%被扩张开了_H_」"
CALL PRINT_STRW, @"「%MIX_AEGI(1, TARGET, "要")%もっと突いてっ_H_%ADANA("アナル")%が早く性器になるように調教してっ_H_」"	CALL PRINT_STRW, @"「%MIX_AEGI(1, TARGET, "要")%继续更多的冲刺_H_把%ADANA("肛門")%尽快调教成性器官_H_」"
PRINTFORMW 「ま……まだキツい……」	PRINTFORMW 「还……还很痛苦……」
CALL PRINT_STRW, "「あっ_H_きたぁっ_H_」"	CALL PRINT_STRW, "「啊_H_要来了っ_H_」"
CALL PRINT_STRW, @"「%CNAME("一人称")%のっ_H_%CNAME("一人称")%の%CNAME("二人称")%専用%ADANA("アナル")%で_H_」"	CALL PRINT_STRW, @"「%CNAME("一人称")%的_H_%CNAME("一人称")%的%ADANA("肛門")%是%CNAME("二人称")%专用的_H_」"
CALL PRINT_STRW, @"「いっぱいいっぱい%ADANA("精液")%出してくださぁい_H_」"	CALL PRINT_STRW, @"「请满满的射出%ADANA("精液")%_H_」"
CALL PRINT_STRW, @"「あっ_H_奥まできてますっ_H_」"	CALL PRINT_STRW, @"「啊_H_到里边来了_H_」"
CALL PRINT_STRW, @"「%CNAME("一人称")%をっ_H_%CNAME("二人称")%専用%ADANA("アナル")%にしてくださぁい_H_」"	CALL PRINT_STRW, @"「%CNAME("一人称")%已经_H_变成%CNAME("二人称")%专用的%ADANA("肛門")%_H_」"
CALL PRINT_STRW, @"「%ADANA("アナル")%の中でドクドク%ADANA("精液")%出ちゃってるっ_H_」"	CALL PRINT_STRW, @"「%ADANA("肛門")%里的%ADANA("精液")%咕嘟咕嘟的出来了_H_」"
CALL PRINT_STRW, @"「こんなっ_H_%CNAME("一人称")%の%ADANA("アナル")%が%ADANA("ペニス")%に吸いついちゃってますっ_H_」"	CALL PRINT_STRW, @"「像这样_H_%CNAME("一人称")%的%ADANA("肛門")%吮吸着%ADANA("阴茎")%_H_」"
CALL PRINT_STRW, @"「%CNAME("一人称")%っ、%CNAME("一人称")%を_H_%CNAME("二人称")%専用%ADANA("アナル")%にしてくださいっ_H_」"	CALL PRINT_STRW, @"「%CNAME("一人称")%っ、%CNAME("一人称")%_H_成为%CNAME("二人称")%专用的%ADANA("肛門")%，拜托了_H_」"
CALL PRINT_STRW, @"「%MIX_AEGI(2+RAND:2, TARGET, "要")%%CNAME("二人称")%っ_H_すきっ_H_だいすきっ_H_」"	CALL PRINT_STRW, @"「%MIX_AEGI(2+RAND:2, TARGET, "要")%%CNAME("二人称")%っ_H_喜欢っ_H_好喜欢っ_H_」"
CALL PRINT_STRW, @"「もっと%CNAME("一人称")%で気持ちよくなってっ_H_」"	CALL PRINT_STRW, @"「更多，%CNAME("一人称")%变得很舒服_H_」"
CALL PRINT_STRW, @"「いっぱい%ADANA("アナル")%に%ADANA("精液")%だしてっ_H_ビューってしてぇっ_H_」"	CALL PRINT_STRW, @"「%ADANA("肛門")%里的%ADANA("精液")%满满的_H_快看看_H_」"
CALL PRINT_STRW, @"「%CNAME("二人称")%以外考えられなくなるくらい犯してぇっ_H_」"	CALL PRINT_STRW, @"「%CNAME("二人称")%的侵犯让人无法想象_H_」"
CALL PRINT_STRW, @"「あはっ_H_%CNAME("二人称")%の%ADANA("ペニス")%かたいっ_H_」"	CALL PRINT_STRW, @"「啊っ_H_%CNAME("二人称")%的%ADANA("阴茎")%好硬啊っ_H_」"
CALL PRINT_STRW, @"「もっとっ_H_もっとっ%ADANA("ペニス")%\@ABL:サドっ気 >= 3 ? 虐めてあげる # がんばる\@から%ADANA("精液")%たくさんピュッピュしてっ_H_」"	CALL PRINT_STRW, @"「更多_H_更多%ADANA("阴茎")%\@ABL:施虐属性 >= 3 ? 会虐待的 # 加油\@让%ADANA("精液")%噗噗的出来吧_H_」"
CALL PRINT_STRW, "「あっ_H_もっとっ_H_もっと欲しいっ_H_」"	CALL PRINT_STRW, "「啊_H_更多_H_还想要更多_H_」"
CALL PRINT_STRW, @"「%CNAME("二人称")%の%ADANA("ペニス")%でもっと%CNAME("アナル")%%TEXTR("気持ちよくしてぇっ_H_/ゴリゴリってしてぇっ_H_/で感じちゃうようにしてぇっ")%」"	CALL PRINT_STRW, @"「%CNAME("二人称")%的%ADANA("阴茎")%还要更多，%CNAME("肛門")%%TEXTR("很舒服_H_/嘎吱嘎吱的_H_/很有感觉")%」"
CALL PRINT_STRW, @"「あっ_H_%CNAME("二人称")%っ_H_」"	CALL PRINT_STRW, @"「啊っ_H_%CNAME("二人称")%っ_H_」"
CALL PRINT_STRW, @"「%CNAME("二人称")%専用おちんぽケースにいっぱい%ADANA("ペニス")%ズポズポされちゃってるっ_H_」"	CALL PRINT_STRW, @"「%CNAME("二人称")%专用的容器里，%ADANA("阴茎")%滋卜滋卜的动呢_H_」"
CALL PRINT_STRW, @"「%CNAME("一人称")%の%ADANA("アナル")%_H_%CNAME("二人称")%の%ADANA("ペニス")%と同じ形になっちゃったぁっ_H_」"	CALL PRINT_STRW, @"「%CNAME("一人称")%的%ADANA("肛門")%_H_已经完全变成了%CNAME("二人称")%%ADANA("阴茎")%的形状了_H_」"
CALL PRINT_STRW, @"「%CNAME("二人称")%の%ADANA("ペニス")%がっ_H_すっぽりハマる身体になっちゃったぁっ_H_%MIX_AEGI(3, TARGET, "要")%」"	CALL PRINT_STRW, @"「%CNAME("二人称")%的%ADANA("阴茎")%っ_H_身体已经完全入迷了_H_%MIX_AEGI(3, TARGET, "要")%」"
CALL PRINT_STRW, @"「%CNAME("二人称")%の%ADANA("ペニス")%にっ_H_%ADANA("ペニス")%開発されちゃってるっ_H_」"	CALL PRINT_STRW, @"「%CNAME("二人称")%的%ADANA("阴茎")%っ_H_完全被%ADANA("阴茎")%开发了_H_」"
CALL PRINT_STRW, @"「あっ_H_%CNAME("二人称")%とっ_H_%CNAME("一人称")%のっ_H_%ADANA("ペニス")%同士でキスしちゃってるぅっ_H_」"	CALL PRINT_STRW, @"「啊っ_H_%CNAME("二人称")%っ_H_%CNAME("一人称")%っ_H_%ADANA("阴茎")%们在一起接吻着_H_」"
CALL PRINT_STRW, @"「%AEGI(TARGET, "要", "通常")%%CNAME("二人称")%の%ADANA("ペニス")%がっ_H_%ADANA("尿道")%の中グリグリしてるっ_H_」"	CALL PRINT_STRW, @"「%AEGI(TARGET, "要", "通常")%%CNAME("二人称")%的%ADANA("阴茎")%_H_在%ADANA("尿道")%里面在咯吱咯吱的_H_」"
CALL PRINT_STRW, @"「%MIX_AEGI(3+RAND:2, TARGET, "要")%すごいっ_H_こんなのっ_H_%MIX_AEGI(2+RAND:5, TARGET, "要")%」"	CALL PRINT_STRW, @"「%MIX_AEGI(3+RAND:2, TARGET, "要")%好厉害っ_H_这样っ_H_%MIX_AEGI(2+RAND:5, TARGET, "要")%」"
CALL PRINT_STRW, @"「%CNAME("二人称")%の%ADANA("ペニス")%っ_H_%CNAME("一人称")%の%ADANA("ペニス")%で犯してあげますっ_H_」"	CALL PRINT_STRW, @"「%CNAME("二人称")%的%ADANA("阴茎")%っ_H_侵犯着%CNAME("一人称")%的%ADANA("阴茎")%_H_」"
CALL PRINT_STRW, @"「だからもっと\@ PREVEX("尿道内射精") ? %ADANA("精液")%出して # %ADANA("ペニス")%めちゃくちゃにして\@ぇっ_H_」"	CALL PRINT_STRW, @"「所以，更多\@ PREVEX("尿道内射精") ? %ADANA("精液")%出来了 # %ADANA("阴茎")%被弄得乱七八糟的\@啊っ_H_」"
CALL PRINT_STRW, @"「%MIX_AEGI(3, TARGET, "要")%これっ_H_すごいっ_H_」"	CALL PRINT_STRW, @"「%MIX_AEGI(3, TARGET, "要")%这个_H_好厉害啊_H_」"
CALL PRINT_STRW, @"「%MIX_AEGI(2, TARGET, "要")%こんなこと続けてたらっ_H_おしっこするたびにイッちゃう体になっちゃうっ_H_」"	CALL PRINT_STRW, @"「%MIX_AEGI(2, TARGET, "要")%如果继续这样的话_H_每次尿的时候身体就会紧绷_H_」"
PRINTFORMW 「ええと……こ、こうですか？」	PRINTFORMW 「欸欸……这、这样吗？」
PRINTFORMW 「あ……ビクビクしてる……」	PRINTFORMW 「啊……哆哆嗦嗦的……」
CALL PRINT_STRW, @"「%CNAME("二人称")%、気持ちいいですか？　いいですよね_H_」"	CALL PRINT_STRW, @"「%CNAME("二人称")%、觉得舒服吗？　不错吧_H_」"
CALL PRINT_STRW, "「隠そうとしても無駄ですよ_H_」"	CALL PRINT_STRW, "「想要隐藏是没有用的_H_」"
PRINTFORMW 「%CNAME("一人称")%だって男ですから。どこをどうすれば気持ちよくなって、気持ちいい時は%ADANA("ペニス")%がどんな風になるのかなんて一目瞭然です」	PRINTFORMW 「因为%CNAME("一人称")%是男人呢。知道要怎么做才能舒服、%ADANA("阴茎")%舒服的时候会变成什么样子，是一清二楚的哟」
CALL PRINT_STRW, @"「このまま\@ABL:サドっ気 >= 4 ? 射精管理 # %ADANA("ペニス")%にご奉仕\@してあげますから、遠慮無く%ADANA("精液")%ピュッピュしちゃってくださいね_H_」"	CALL PRINT_STRW, @"「就这样吧\@ABL:施虐属性 >= 4 ? 射精管理 # 服务%ADANA("阴茎")%什么的\@会好好做的、请不要客气，让%ADANA("精液")%噗噗出来吧_H_」"
CALL PRINT_STRW, @"「その……%CNAME("二人称")%、すごく気持ちよさそうですね……_H_」"	CALL PRINT_STRW, @"「那个……%CNAME("二人称")%、看起来很舒服呢……_H_」"
CALL PRINT_STRW, "「ここをこうしたら……フフッ_H_」"	CALL PRINT_STRW, "「如果这里这样……呼呼_H_」"
CALL PRINT_STRW, @"「%CNAME("二人称")%もこういう風にするの好きなんですか_H_」"	CALL PRINT_STRW, @"「%CNAME("二人称")%也喜欢这样做吧_H_」"
PRINTFORMW 「……上手、ですか？」	PRINTFORMW 「……很擅长、对吧？」
PRINTFORMW 「……そりゃあ、自分相手にいつもやっていることですし」	PRINTFORMW 「……当然、%CNAME("一人称")%总是把自己当作对手呢」
CALL PRINT_STRW, @"「……そ、それならもっと頑張って%CNAME("二人称")%に悦んでもらえるようにします……_H_」"	CALL PRINT_STRW, @"「……那、那就更加的努力，让%CNAME("二人称")%感觉到喜悦……_H_」"
CALL PRINT_STRW, @"「ふむぁっ……_H_いつもこの%ADANA("ペニス")%でいっぱい\@TALENT:恋慕 ? 愛して # いじめて\@くれてますから、お返しです_H_」"	CALL PRINT_STRW, @"「哼哼……_H_%ADANA("阴茎")%总是这样满满的，因为\@TALENT:恋慕 ? 爱着 # 欺负着\@所以还给你_H_」"
CALL PRINT_STRW, @"「はむっ……_H_ペロ……_H_%CNAME("二人称")%の%ADANA("ペニス")%……_H_あはっ……_H_すごい%TEXTS("匂い")%_H_……スー……チュパ……_H_」"	CALL PRINT_STRW, @"「哈呣……_H_舔……_H_%CNAME("二人称")%的%ADANA("阴茎")%……_H_啊哈っ……_H_很厉害的%TEXTS("气味")%_H_……簌……啾吧……_H_」"
PRINTFORMW 「……はっ！　%CNAME("一人称", "どもり")%はなんてことを……」	PRINTFORMW 「……哈！　%CNAME("一人称", "どもり")%怎么会这样……」
CALL PRINT_STRW, @"「%MIX_AEGI(2, TARGET, "要")%チュ……_H_」"	CALL PRINT_STRW, @"「%MIX_AEGI(2, TARGET, "要")%啾……_H_」"
CALL PRINT_STRW, @"「%CNAME("二人称")%_H_大事な%ADANA("ペニス")%なのにこんな汚いままにしてたらダメじゃないですかぁ_H_」"	CALL PRINT_STRW, @"「%CNAME("二人称")%_H_重要的%ADANA("阴茎")%就这样被弄脏是不行的吧_H_」"
CALL PRINT_STRW, @"「他のみなさんのために%CNAME("一人称")%が責任とってお掃除してあげますからね_H_」"	CALL PRINT_STRW, @"「%CNAME("一人称")%会承担其他人的责任，好好清理的_H_」"
PRINTFORMW 「ハァ……あまり汚くしてると良くないですよ」	PRINTFORMW 「哈啊……如果太脏了就不好了」
PRINTFORMW 「%CNAME("一人称")%が綺麗にしてあげますけど、あまり頼りすぎないでくださいね？」	PRINTFORMW 「%CNAME("一人称")%会清理的非常漂亮的、但是请不要太依赖吧？」
CALL PRINT_STRW, @"「%MIX_AEGI(3, TARGET, "要")%ジュル_H_」"	CALL PRINT_STRW, @"「%MIX_AEGI(3, TARGET, "要")%咀噜_H_」"
PRINTFORMW 「……わ、分かりました」	PRINTFORMW 「……啊、我明白了。」
CALL PRINT_STRW, @"「%CNAME("二人称")%の%ADANA("ペニス")%、%CNAME("一人称")%の%ADANA("アナル")%にあんなに出したのにまだこんなに元気いっぱいなんですね_H_」"	CALL PRINT_STRW, @"「%CNAME("二人称")%的%ADANA("阴茎")%、在%CNAME("一人称")%的%ADANA("肛門")%里边射了很多，还那样的精神呢_H_」"
CALL PRINT_STRW, @"「このまま挿れてもらっても気持ちよさそうですが……折角ですし、%CNAME("一人称")%が綺麗にしてあげますね_H_」"	CALL PRINT_STRW, @"「就这样插进去感觉也很舒服……很不容易呢、让%CNAME("一人称")%清理干净吧_H_」"
CALL PRINT_STRW, @"「……さっきまでこれが%CNAME("一人称")%の%ADANA("アナル")%に入っていたんですね_H_」"	CALL PRINT_STRW, @"「……直到刚才还在%CNAME("一人称")%的%ADANA("肛門")%里边放着呢_H_」"
CALL PRINT_STRW, @"「それなら今度はこの上の口に挿れてください_H_%CNAME("一人称")%を喋る度にイッちゃうような淫乱になるくらいに_H_」"	CALL PRINT_STRW, @"「那么下次请插在这上面的嘴里_H_%CNAME("一人称")%每次说话都会变得淫乱_H_」"
CALL PRINT_STRW, @"「%MIX_AEGI(2, TARGET, "要")%……見てください_H_%CNAME("二人称")%の%ADANA("ペニス")%、こんなにピクピクしちゃってますよ_H_」"	CALL PRINT_STRW, @"「%MIX_AEGI(2, TARGET, "要")%……请看_H_%CNAME("二人称")%的%ADANA("阴茎")%、这样的抽动着哟_H_」"
CALL PRINT_STRW, @"「%ADANA("ヴァギナ")%からもエッチな汁をいっぱい出しちゃって……_H_」"	CALL PRINT_STRW, @"「%ADANA("小穴")%也流出了很多色色的液体呢……_H_」"
CALL PRINT_STRW, "「フフッ……気持ちよさそうですね_H_」"	CALL PRINT_STRW, "「呼呼……看起来很舒服呢_H_」"
CALL PRINT_STRW, @"「……このまま出しちゃうのもいいですけど、よかったら%CNAME("一人称")%の%ADANA("アナル")%にいっぱい出してくれませんか_H_」"	CALL PRINT_STRW, @"「……就这样射出来也不错、如果可以的话，在%CNAME("一人称")%的%ADANA("肛門")%满满的射出来吧_H_」"
CALL PRINT_STRW, @"「……このまま%ADANA("ヴァギナ")%にも挿れられちゃって、もっともっと気持ちよくなっちゃいますか_H_」"	CALL PRINT_STRW, @"「……就这样的插入了%ADANA("小穴")%、觉得更舒服了吗？_H_」"
CALL PRINT_STRW, @"「……もっと気持ちよくなって、%CNAME("一人称")%の口にいっぱい%ADANA("精液")%出してくださいね_H_」"	CALL PRINT_STRW, @"「……变得更舒服了吧、%ADANA("精液")%射的%CNAME("一人称")%满嘴都是_H_」"
PRINTFORMW %CALLNAME:TARGET%は熱心に%CALLNAME:PLAYER%のペニスに奉仕している……	PRINTFORMW %CALLNAME:TARGET%热情的服务着%CALLNAME:PLAYER%的阴茎……
PRINTFORMW 「……%CNAME("二人称")%、どうですか？」	PRINTFORMW 「……%CNAME("二人称")%、怎么样？」
PRINTFORMW %CALLNAME:TARGET%は%CALLNAME:PLAYER%のペニスを\@MARK:屈服刻印 == 3 || ABL:欲望 >= 5 ? むしゃぶりつくように # おずおずと\@舐めている……	PRINTFORMW %CALLNAME:TARGET%把%CALLNAME:PLAYER%的，阴茎\@MARK:屈服刻印 == 3 || ABL:欲望 >= 5 ? 紧紧的用力 # 怯生生地\@舔着……
CALL PRINT_STRW, @"「%CNAME("二人称")%_H_どうです？気持ちいいですか_H_」"	CALL PRINT_STRW, @"「%CNAME("二人称")%_H_怎么样？舒服吗？_H_」"
CALL PRINT_STRW, @"「%CNAME("二人称")%も%ADANA("アナル")%いじめられるのに興味出てきたんですね_H_」"	CALL PRINT_STRW, @"「%CNAME("二人称")%对%ADANA("肛門")%被欺负产生了兴趣啊_H_」"
CALL PRINT_STRW, @"「大丈夫ですよ……どこをどうすれば気持ちいいのか、%CNAME("一人称")%は全部知っていますから……_H_」"	CALL PRINT_STRW, @"「没关系的……该怎么办才好呢、%CNAME("一人称")%我都知道了……_H_」"
PRINTFORMW 「……%CNAME("二人称")%って%ADANA("アナル")%に興味あったんですね。意外でした」	PRINTFORMW 「……%CNAME("二人称")%对%ADANA("肛門")%有兴趣啊。很意外」
CALL PRINT_STRW, @"「……いいえ、大丈夫ですよ。%CNAME("二人称")%が%ADANA("アナル")%をいじめられないと我慢できなくなるように、%CNAME("一人称")%がんばりますから_H_」"	CALL PRINT_STRW, @"「……不、没关系的。。为了让%CNAME("二人称")%的%ADANA("肛門")%不再忍耐、%CNAME("一人称")%会加油的_H_」"
PRINTFORMW 「え……？　お尻を舐めるんですか……！？」	PRINTFORMW 「欸……？　要舔屁股吗……！？」
PRINTFORMW 「……ま、まあ良いでしょう……あまり上手くなくても怒らないでくださいよ？」	PRINTFORMW 「……嘛、还可以吧……即使不怎么擅长也不要生气哦？？」
CALL PRINT_STRW, @"「%CNAME("二人称")%_H_とっても気持ちよさそうですねぇ_H_」"	CALL PRINT_STRW, @"「%CNAME("二人称")%_H_感觉非常舒服呢_H_」"
CALL PRINT_STRW, @"「%CNAME("二人称")%の%TEXTR(@"\@ TALENT:PLAYER:ふたなり ? %ADANA("ペニス")% # %ADANA("クリトリス")%\@/ココ")% 、%TEXTR("気持ちよさそうに/エッチに/はしたなく")%勃起しちゃってますよ_H_」"	CALL PRINT_STRW, @"「%CNAME("二人称")%的%TEXTR(@"\@ TALENT:PLAYER:扶她 ? %ADANA("阴茎")% # %ADANA("阴蒂")%\@/这里")% 、%TEXTR("很舒服/色色的/无奈的")%勃起了哟_H_」"
CALL PRINT_STRW, "「もっともっと、おかしくなっちゃうくらい気持ちよくしてあげますから、覚悟してくださいね_H_」"	CALL PRINT_STRW, "「更多、我会让你觉得舒畅，让你变得奇怪、请做好觉悟吧_H_」"
PRINTFORMW 「な、何を……！」	PRINTFORMW 「啊、什么……！」
PRINTFORMW 「……え？　%CNAME("二人称")%って\@MARK:屈服刻印 == 3 ? 処女だった # %CNAME("一人称")%がはじめてな\@んですか？」	PRINTFORMW 「……欸？　听说%CNAME("二人称")%是\@MARK:屈服刻印 == 3 ? 是处女 # %CNAME("一人称")%是第一个\@是吗？？」
PRINTFORMW 「……つまり、%CNAME("一人称")%も%CNAME("二人称")%もそういう経験がないということ……」	PRINTFORMW 「……就是说、%CNAME("一人称")%和%CNAME("二人称")%都没有那样的经验……」
PRINTFORMW 「……多分、出来ないことはないと思います」	PRINTFORMW 「……大概，没有什么做不到的事」
PRINTFORMW 「……その、%CNAME("二人称")%を気持ちよくさせられるように誠心誠意努力します」	PRINTFORMW 「……那个、会真心诚意的努力的，让%CNAME("二人称")%觉得舒服」
PRINTFORMW 「大丈夫です、こういうの%CNAME("一人称")%得意ですから」	PRINTFORMW 「没关系、%CNAME("一人称")%很擅长这样」
CALL PRINT_STRW, @"「%CNAME("二人称")%がイケるようになるくらいに開発してあげますよ_H_」"	CALL PRINT_STRW, @"「为了让%CNAME("二人称")%变得帅气，会努力开发的_H_」"
PRINTFORMW 「……それほど慣れてはいませんが、%CNAME("二人称")%のためにも頑張ります」	PRINTFORMW 「……虽然没那么习惯、但是为了%CNAME("二人称")%会继续努力的」
PRINTFORMW 「……わ、分かりました。いいでしょう」	PRINTFORMW 「……啊、我明白了。可以」
PRINTFORMW 「分かりました……」	PRINTFORMW 「我明白了……」
CALL PRINT_STRW, @"「%CNAME("二人称")%の\@SELECTCOM == 125 ? %ADANA("アナル")% # %ADANA("ヴァギナ")%\@、キュウキュウってなっててすごいっ_H_」"	CALL PRINT_STRW, @"「%CNAME("二人称")%的%ADANA("小穴")%、总是紧紧的吸着，很厉害呢_H_」"
CALL PRINT_STRW, @"「%ADANA("精液")%出るっ_H_出しちゃうっ_H_%CNAME("二人称")%のナカにドピュドピュさせてぇっ_H_」"	CALL PRINT_STRW, @"「%ADANA("精液")%出_H_出来了_H_在%CNAME("二人称")%的里边深深的出来了_H_」"
CALL PRINT_STRW, @"「%CNAME("二人称")%っ_H_きもちいいっ_H_%CNAME("二人称")%っ_H_」"	CALL PRINT_STRW, @"「%CNAME("二人称")%っ_H_好舒服_H_%CNAME("二人称")%っ_H_」"
CALL PRINT_STRW, @"「このままじゃっ_H_%ADANA("精液")%でちゃうぅっ_H_」"	CALL PRINT_STRW, @"「就是这样っ_H_%ADANA("精液")%要出来了っ_H_」"
CALL PRINT_STRW, @"「あっ_H_%CNAME("二人称")%の\@SELECTCOM == 125 ? %ADANA("アナル")% # %ADANA("ヴァギナ")%\@すごいっ_H_」"	CALL PRINT_STRW, @"「啊_H_%CNAME("二人称")%的%ADANA("小穴")%很厉害呢っ_H_」"
CALL PRINT_STRW, @"「%MIX_AEGI(3, TARGET, "要")%こんなのっ_H_すぐ射精しちゃうっ_H_」"	CALL PRINT_STRW, @"「%MIX_AEGI(3, TARGET, "要")%就是这样_H_马上要射精了_H_」"
CALL PRINT_STRW, @"「%CNAME("二人称")%のナカに%ADANA("精液")%みっともなくピュッピュしちゃうっ_H_」"	CALL PRINT_STRW, @"「%CNAME("二人称")%的精液%ADANA("精液")%在里边噗噗的出来了_H_」"
PRINTFORMW 「こ、こうすればいいんですか……？」	PRINTFORMW 「这、这样做可以吗……？」
CALL PRINT_STRW, @"「%AEGI(TARGET,  "要", "通常")%%CNAME("二人称")%の\@SELECTCOM == 125 ? %ADANA("アナル")% # %ADANA("ヴァギナ")%\@、気持ちいい……っ_H_」"	CALL PRINT_STRW, @"「%AEGI(TARGET,  "要", "通常")%%CNAME("二人称")%的%ADANA("小穴")%、好舒服……っ_H_」"
CALL PRINT_STRW, @"「このままじゃ%ADANA("精液")%でちゃうぅっ_H_」"	CALL PRINT_STRW, @"「就这样用%ADANA("精液")%_H_」"

PRINTFORMW 「%CNAME("二人称")%、それは……むぐっ！」	PRINTFORMW 「%CNAME("二人称")%、那样……慢吞吞的！」
PRINTFORMW 「%CNAME("二人称")%、そんなに%CNAME("一人称")%が%ADANA("精液")%飲むところみたいんですか？」	PRINTFORMW 「%CNAME("二人称")%、想要%CNAME("一人称")%把%ADANA("精液")%精液喝下去？」
CALL PRINT_STRW, "「……しょうがないですねぇ_H_」"	CALL PRINT_STRW, "「……真是没办法啊_H_」"
CALL PRINT_STRW, @"「分かりました、%CNAME("二人称")%\@COND("絶頂", PLAYER) >= 2 ? がたっぷり出した # の特濃\@%ADANA("精液")%%TEXTR("ごっくん/ごくごく")%してあげます_H_」"	CALL PRINT_STRW, @"「我明白了。%CNAME("二人称")%\@COND("絶頂", PLAYER) >= 2 ? 已经射出来很多 # 特浓的\@%ADANA("精液")%，会好好的%TEXTR("吞下去的/喝下去的")%_H_」"
CALL PRINT_STRW, @"「だから%CNAME("二人称")%も、%CNAME("一人称")%が精液飲んじゃうところ、じっくり見てくださいね_H_」"	CALL PRINT_STRW, @"「所以%CNAME("二人称")%、我现在在喝%CNAME("一人称")%精液、请仔细看哦_H_」"
CALL PRINT_STRW, @"「%AEGI(TARGET, "要", "Ｍ異物")%%CNAME("二人称")%の%ADANA("精液")%……クセになりそう……_H_」"	CALL PRINT_STRW, @"「%AEGI(TARGET, "要", "Ｍ異物")%%CNAME("二人称")%的%ADANA("精液")%……已经习惯了呢……_H_」"
PRINTFORMW 「え……%CNAME("二人称")%、これ飲んで欲しいんですか？」	PRINTFORMW 「欸……%CNAME("二人称")%、要我喝这个吗？」
PRINTFORMW 「……頑張ってみます」	PRINTFORMW 「……我会努力的」
PRINTFORMW 「……うぅ……%CNAME("二人称")%、なんでこんなもの飲ませようとするんですか……」	PRINTFORMW 「……唔……%CNAME("二人称")%、为什么要喝这样的东西……」
CALL PRINT_STRW, @"「%AEGI(TARGET, "要", "通常", 2)%%CNAME("二人称")%の精子、元気ですね_H_」"	CALL PRINT_STRW, @"「%AEGI(TARGET, "要", "通常", 2)%%CNAME("二人称")%的精子、很有精神呢_H_」"
CALL PRINT_STRW, "「小さいのに口の中でバタバタしてるのが分かります……_H_」"	CALL PRINT_STRW, "「虽然很小，但是在嘴里吧嗒吧嗒的动弹呢……_H_」"
CALL PRINT_STRW, @"「……もう%CNAME("二人称")%の%ADANA("精液")%なしじゃ生きていけない……_H_」"	CALL PRINT_STRW, @"「……没有%CNAME("二人称")%的%ADANA("精液")%就已经活不下去了……_H_」"
CALL PRINT_STRW, @"「……%CNAME("二人称")%の精液だって思うと不思議とおいしく感じます……_H_」"	CALL PRINT_STRW, @"「……一想到%CNAME("二人称")%的精液就觉得不可思议的好吃……_H_」"
CALL PRINT_STRW, @"「……このままじゃ%CNAME("二人称")%の%ADANA("精液")%なしで生きていられなくなっちゃいそうです……_H_」"	CALL PRINT_STRW, @"「……这样的话，没有%CNAME("二人称")%的%ADANA("精液")%就无法生存下去了……_H_」"
PRINTFORMW 「……そんなに飲ませたって意味ないですよ……」	PRINTFORMW 「……喝这么多也没有意义吧……」
CALL PRINT_STRW, @"「%ADANA("尿道")%にズポズポされてるぅっ_H_」"	CALL PRINT_STRW, @"「嗞啵嗞啵的进入了%ADANA("尿道")%_H_」"
CALL PRINT_STRW, @"「%CNAME("一人称")%の%ADANA("尿道")%、モノを突っ込まれてイっちゃう淫乱穴になっちゃったぁ_H_」"	CALL PRINT_STRW, @"「%CNAME("一人称")%的%ADANA("尿道")%、把东西塞进去就变成淫乱的小穴了_H_」"
PRINTFORMW 「痛っ！　な、何の目的でこんなことを……」	PRINTFORMW 「好痛！　为、为什么要做这种事……」
PRINTFORMW 「……ここで気持ちよくなるため？　正気ですか？」	PRINTFORMW 「……为了在这里变舒服？　这样做真的明知吗？」
CALL PRINT_STRW, @"「あっ_H_%ADANA("尿道")%開発されちゃってるっ_H_」"	CALL PRINT_STRW, @"「啊_H_%ADANA("尿道")%已经被开发了_H_」"
CALL PRINT_STRW, @"「このままじゃ%CNAME("一人称")%、まともにおしっこできなくなっちゃうよぉ_H_」"	CALL PRINT_STRW, @"「这样的做话，%CNAME("一人称")%已经没法好好的尿尿了_H_」"
PRINTFORMW 「%MIX_AEGI(3, TARGET, "不要")%、や、やめましょうよ……」	PRINTFORMW 「%MIX_AEGI(3, TARGET, "不要")%、还、还是算了吧……」
CALL PRINT_STRW, @"「こんなの絶対マトモじゃ……%MIX_AEGI(1, TARGET, "要")%」"	CALL PRINT_STRW, @"「绝对是认真的……%MIX_AEGI(1, TARGET, "要")%」"
PRINTFORMW 「……ッ！！　痛い!　痛いですって！」	PRINTFORMW 「……啊！！　痛!　好痛！」
PRINTFORMW 「……こんな調子で、本当に気持ちよくなれるんですか……？」	PRINTFORMW 「……按照现在这个状态、真的会舒服吗……？」
CALL PRINT_STRW, @"「%AEGI(TARGET, "要", "通常")%おしっこするための場所なのにっ_H_」"	CALL PRINT_STRW, @"「%AEGI(TARGET, "要", "通常")%明明是尿尿的地方_H_」"
CALL PRINT_STRW, "「アハッ_H_ハメ撮りしちゃいますか_H_」"	CALL PRINT_STRW, "「啊哈_H_要拍照了吗_H_」"
CALL PRINT_STRW, @"「%CNAME("一人称")%の変態っぷり、たくさん撮ってくださいね_H_」"	CALL PRINT_STRW, @"「%CNAME("一人称")%变态的样子、请多拍一点吧_H_」"
PRINTFORMW 「そ、それで撮るんですか……？　%CNAME("一人称")%を……？」	PRINTFORMW 「要、要用那个拍吗……？　%CNAME("一人称")%……？」
PRINTFORMW 「……せ、せっかく撮るならちゃんと撮ってくださいよ」	PRINTFORMW 「……好、好不容易要拍照，请好好拍照哦」
PRINTFORMW 「えっ……それは……って！　何撮ってるんですか！」	PRINTFORMW 「欸……听说……那是！　在拍什么呢！」
CALL PRINT_STRW, "「アハッ……恥ずかしいところたくさん撮られちゃったぁ……_H_」"	CALL PRINT_STRW, "「啊哈……害羞的地方被拍了很多张呢……_H_」"
PRINTFORMW 「綺麗に撮れましたか？」	PRINTFORMW 「拍得漂亮吗？？」
PRINTFORMW 「なんでこんなことを……」	PRINTFORMW 「为什么会这样……」
PRINTFORMW 「だっ……ダメという訳ではありませんが……」	PRINTFORMW 「啊……并不是说不行……」
CALL PRINT_STRW, "「あっ……_H_」"	CALL PRINT_STRW, "「啊……_H_」"
CALL PRINT_STRW, @"「……ふふっ、%CNAME("一人称")%が恥ずかしくて仕方がなるくらいにいっぱい撮ってくださいね_H_」"	CALL PRINT_STRW, @"「……呼呼、因为%CNAME("一人称")%很害羞，所以多拍点照片吧_H_」"
CALL PRINT_STRW, "「それと……終わったら後で見せてください_H_」"	CALL PRINT_STRW, "「还有……拍完以后要给我看看哦_H_」"
PRINTFORMW 「まったく、%CNAME("二人称")%は……」	PRINTFORMW 「简直、%CNAME("二人称")%……」
CALL PRINT_STRW, @"「……ちゃんと%CNAME("二人称")%が興奮できるように撮ってくださいね_H_」"	CALL PRINT_STRW, @"「……的确%CNAME("二人称")%可以拍出让人兴奋的照片_H_」"
PRINTFORMW 「今回もですか……？」	PRINTFORMW 「这次也是吗……？」
PRINTFORMW 「いや……その……」	PRINTFORMW 「不……那个……」
PRINTFORMW 「……ダメではないです」	PRINTFORMW 「……不是不行」
PRINTFORMW 「これを着るんですか？」	PRINTFORMW 「要穿这个吗？」
PRINTFORMW 「やっぱりいつも着ている服は落ち着きますね」	PRINTFORMW 「果然平时穿的衣服很安心呢」
PRINTFORMW 「Ｙシャツだけ、ですか……」	PRINTFORMW 「只有…T恤吗…」
PRINTFORMW 「……いえ、恥ずかしいのは確かですが……」	PRINTFORMW 「……不，虽然很害羞……」
PRINTFORMW 「……実は、こういう格好に憧れていたので少し嬉しいんです」	PRINTFORMW 「……其实，因为憧憬着这样的打扮稍微高兴」
PRINTFORMW 「……えーと、ズボンとかスカートはどこに……？」	PRINTFORMW 「……那么、裤子和裙子在哪呢……？」
PRINTFORMW 「ない？　……そんなことだろうと思いました」	PRINTFORMW 「没有？　……我想大概就是这样吧」
CALL PRINT_STRW, @"「%CALLNAME:PLAYER%さん、今日の授業は保険体育ですよ_H_なんちゃって_H_」"	CALL PRINT_STRW, @"「%CALLNAME:PLAYER%桑、今天的课是保险体育课_H_开玩笑的_H_」"
PRINTFORMW 「ちょっとピッチリしすぎじゃないですか……？」	PRINTFORMW 「是不是有点太严肃了……？」
CALL PRINT_STRW, @"「患者さんの悪いところは、この\@SIZE("ペニス", PLAYER) == 0 ? かわいい # 立派な\@おちんちんですか？　なんちゃって_H_」"	CALL PRINT_STRW, @"「患者的病情是、\@SIZE("阴茎", PLAYER) == 0 ? 可爱的 # 气派的\@欧金金对吧？　开玩笑的_H_」"
PRINTFORMW 「その……これって女装……」	PRINTFORMW 「那个……这是女装……」
PRINTFORMW 「いつもやってるじゃないかって？　こ、こういうのとは勝手が違うんです……！」	PRINTFORMW 「不是一直在这做吗？　跟、跟那种人是不一样的……！」
PRINTFORMW 「……すみません。スカートがふとももに当たって……」	PRINTFORMW 「……对不起。裙子在脚底下……」
PRINTFORMW 「へえ……ツルツルしてるんだ……」	PRINTFORMW 「嘿……滑滑的呢……」
PRINTFORMW 「……%CNAME("二人称")%のためだって考えると、逆に恥ずかしいですね」	PRINTFORMW 「……只要一想到是为了%CNAME("二人称")%、反而会害羞呢」
PRINTFORMW 「……まったく、%CNAME("二人称")%っていやらしいんですから」	PRINTFORMW 「……简直、%CNAME("二人称")%这个人真是太讨厌了」
PRINTFORM %CALLNAME:TARGET%は	PRINTFORM %CALLNAME:TARGET%
PRINTFORM %TEXTR(@"興奮を隠し切れない様子で/煽情的に体を動かしながら/欲望にみちた瞳を%CALLNAME:PLAYER%に向けながら")%	PRINTFORM %TEXTR(@"掩饰不住兴奋的样子/煽情地活动着身体/充满欲望的眼睛，一边朝向%CALLNAME:PLAYER% ")%
PRINTFORM %TEXTR(@"%CALLNAME:PLAYER%をちらちらと見ながら/恥ずかしそうに/顔を赤らめながら/%CALLNAME:PLAYER%を愛おしそうに見つめながら")%	PRINTFORM %TEXTR(@"偷偷的看着%CALLNAME:PLAYER%/有点害臊的/红着脸/一边可怜地凝视着%CALLNAME:PLAYER%")%
CALL PRINT_STRW, @"「はい、どうぞ_H_%CNAME("二人称")%の好きなだけ見てくださいね_H_」"	CALL PRINT_STRW, @"「好的，请_H_%CNAME("二人称")%喜欢看多少就看多少吧_H_」"
PRINTFORMW 「……もちろん、たっぷりいじめてくれてもいいんですよ？」	PRINTFORMW 「……当然、可以尽情的欺负我吧？」
PRINTFORM %CALLNAME:TARGET%は%TEXTR(@"興奮を隠し切れない様子で/煽情的に体を動かしながら/欲望にみちた瞳を%CALLNAME:PLAYER%に向けながら")%	PRINTFORM %CALLNAME:TARGET%%TEXTR(@"掩饰不住兴奋的样子/一边煽情地活动着身体/眼神中充满了欲望，一边朝向%CALLNAME:PLAYER%")%
CALL PRINT_STRW, @"「み、見ないでください……_H_」"	CALL PRINT_STRW, @"「请，请不要看……_H_」"
PRINTFORM %CALLNAME:TARGET%は%TEXTR("もじもじしながら/顔を赤らめながら/息を少し荒げながら")%	PRINTFORM %CALLNAME:TARGET%%TEXTR("扭扭捏捏的/红着脸/呼吸有些粗重")%
PRINTFORMW 「こ、これでどうですか……？」	PRINTFORMW 「这，这个怎么样……？」
PRINTFORM %CALLNAME:TARGET%は%TEXTR("恥ずかしそうに/顔を赤らめながら/大事なところを小さな手で隠しながら")%	PRINTFORM %CALLNAME:TARGET%%TEXTR("有点害臊的/红着脸/用小小的手遮住重要的地方")%
PRINTFORMW 中性的な肢体を露わにしている……	PRINTFORMW 露出了中性的身体……
CALL PRINT_STRW, "「まったく、ロマンチストなんですから……_H_」"	CALL PRINT_STRW, "「真是的，还是个浪漫主义者……_H_」"
CALL PRINT_STRW, "「み、見ないでぇ……_H_」"	CALL PRINT_STRW, "「不，不要看……_H_」"
CALL PRINT_STRW, @"「%ADANA("アナル")%がっ……！　ヒクヒクしてっ……！　ァアアッ_H_」"	CALL PRINT_STRW, @"「%ADANA("肛門")%っ……！　抽动着っ……！　啊啊啊_H_」"
CALL PRINT_STRW, "「乳首ぃ_H_乳首でイッちゃぁうっ_H_」"	CALL PRINT_STRW, "「乳头_H_乳头一败涂地了_H_」"
CALL PRINT_STR, @"「あはっ_H_%CNAME("二人称")%の前で%ADANA("精液")%出しちゃったぁ_H_」"	CALL PRINT_STR, @"「啊哈_H_在%CNAME("二人称")%的面前，流出%ADANA("精液")%了_H_」"
CALL PRINT_STR, @"「……今日までずっと%CNAME("二人称")%の前でみっともなく射精しちゃう妄想してオナニーしてたんですよ_H_」"	CALL PRINT_STR, @"「……直到今天，还妄想着在%CNAME("二人称")%的面前，妄想着自慰射精呢_H_」"
CALL PRINT_STRW, @"「あっ_H_ああああっ_H_」"	CALL PRINT_STRW, @"「啊_H_啊啊啊啊啊_H_」"
PRINTFORMW 「ひ、人前で出しちゃうなんて……は、恥ずかしい……」	PRINTFORMW 「咿、竟然在人前出来了……好，好害羞……」
CALL PRINT_STR, "「アハァ……_H_"	CALL PRINT_STR, "「啊哈……_H_"
CALL PRINT_STR, @"%ADANA("アナル")%いじめられながら"	CALL PRINT_STR, @"%ADANA("肛門")%被欺负的同时"
CALL PRINT_STR, @"%ADANA("尿道")%ほじくられて"	CALL PRINT_STR, @"%ADANA("尿道")%也裂开了"
CALL PRINT_STR, "乳首いじめられながら"	CALL PRINT_STR, "乳头一边被欺负"
CALL PRINT_STR, "おもちゃにいじめられて"	CALL PRINT_STR, "被玩具欺负着"
CALL PRINT_STR, @"%CNAME("二人称")%に見られながら"	CALL PRINT_STR, @"%CNAME("二人称")%一边被看着"
CALL PRINT_STRW, @"%ADANA("精液")%ビュッビュしちゃってるぅ_H_」"	CALL PRINT_STRW, @"%ADANA("精液")%biubiu的出来了_H_」"
CALL PRINT_STRW, @"「……%CNAME("二人称")%に愛してもらって幸せ……_H_」"	CALL PRINT_STRW, @"「……能被%CNAME("二人称")%爱着，感觉很幸福……_H_」"
PRINTFORMW 「……ぁ」	PRINTFORMW 「……啊」
PRINTFORMW 「あはは……もうムリだ……」	PRINTFORMW 「啊哈哈……已经不行了……」
CALL PRINT_STRW, @"「うわぁ……\@ COND("絶頂", PLAYER) >= 2 ? いっぱい # 濃いの\@がでましたねぇ_H_」"	CALL PRINT_STRW, @"「呜哇……\@ COND("絶頂", PLAYER) >= 2 ? 满满的 # 浓浓的\@出来了呢_H_」"
CALL PRINT_STRW, @"「%CNAME("二人称")%、今度は%CNAME("一人称")%にいっぱいかけてください_H_」"	CALL PRINT_STRW, @"「%CNAME("二人称")%、这次请把%CNAME("一人称")%灌满吧_H_」"
CALL PRINT_STRW, @"「もちろん口や%ADANA("アナル")%だっていっぱい使ってくださってかまいませんからね_H_」"	CALL PRINT_STRW, @"「当然嘴巴和%ADANA("肛門")%也可以多多的使用_H_」"
PRINTFORMW 「……オナニーじゃなくて%CNAME("一人称")%を使ってくれてもいいんですよ？」	PRINTFORMW 「……没必要自慰，可以使用%CNAME("一人称")%吧？」
PRINTFORMW 「相手にされてないみたいでなんだか少しさみしいです……」	PRINTFORMW 「好像没被理过，总觉得有点寂寞……」
CALL PRINT_STRW, "「人が見ている前で射精しちゃうなんて……_H_」"	CALL PRINT_STRW, "「在人前射精……_H_」"
CALL PRINT_STRW, @"「いいなぁ……_H_%CNAME("一人称")%だってやりたい……_H_」"	CALL PRINT_STRW, @"「真好啊……_H_因为%CNAME("一人称")%很想做……_H_」"
PRINTFORMW 「……そんなに気持ちよかったんですか？」	PRINTFORMW 「……所以就那么的舒服吗？」
CALL PRINT_STRW, @"「まったく、%CNAME("二人称")%ってばＭなんですから_H_」"	CALL PRINT_STRW, @"「简直、%CNAME("二人称")%简直是个M嘛_H_」"
CALL PRINT_STRW, "「それなら、これからもやってあげましょうか_H_」"	CALL PRINT_STRW, "「那么，以后也这样做吧_H_」"
PRINTFORMW 「……%CNAME("二人称")%がそんなに好きなら、考えてみます」	PRINTFORMW 「……如果%CNAME("二人称")%那么喜欢的话、可以考虑一下」
CALL PRINT_STRW, @"「あはっ_H_%CNAME("二人称")%のせいで足がベトベトになっちゃったじゃないですか_H_」"	CALL PRINT_STRW, @"「啊哈_H_%CNAME("二人称")%不会因为这样而变得黏糊糊的吗_H_」"
CALL PRINT_STRW, "「責任とって舐めてくれませんか_H_」"	CALL PRINT_STRW, "「请负责人的好好舔吧_H_」"
CALL PRINT_STRW, @"「フフッ_H_%CNAME("二人称")%の%ADANA("精液")%で足がベトベトじゃないですかぁ_H_」"	CALL PRINT_STRW, @"「呼呼_H_因为%CNAME("二人称")%的%ADANA("精液")%，脚变得黏糊糊的了_H_」"
CALL PRINT_STRW, @"「別に綺麗にする必要はありません……けどその代わり、%CNAME("一人称")%が全身真っ白になっちゃうくらいに射精してくださいね_H_」"	CALL PRINT_STRW, @"「没有必要弄干净……但是取而代之的是、请射精到%CNAME("一人称")%全身雪白的程度吧_H_」"
PRINTFORMW 「……まったく、%CNAME("二人称")%って中々の変態ですよね」	PRINTFORMW 「……简直、%CNAME("二人称")%是变态中的变态哟」
PRINTFORMW 「まあ、そんな人を好きになった%CNAME("一人称")%が言えたことじゃないですけど」	PRINTFORMW 「嘛、虽然很喜欢这样的，但是%CNAME("一人称")%并没有说出口」
CALL PRINT_STRW, @"「……%CNAME("二人称")%って足コキされてイっちゃうような人だったんですね……_H_」"	CALL PRINT_STRW, @"「……%CNAME("二人称")%是那种会被足交打败的人哦……_H_」"
PRINTFORMW 「これは調教のしがいが……って%CNAME("一人称")%は何を言ってるんだ……」	PRINTFORMW 「真是个值得调教的家伙……%CNAME("一人称")%在说什么呢……」
PRINTFORMW %CALLNAME:TARGET%は%CALLNAME:PLAYER%に哀れむような視線を向けている……	PRINTFORMW %CALLNAME:TARGET%用悲哀的眼神看着%CALLNAME:PLAYER%……
PRINTFORMW 「ん……ふむ……チュプ……ジュル……」	PRINTFORMW 「嗯……呼呣……咀卜……咀噜……」
CALL PRINT_STRW, @"「%MIX_AEGI(1, TARGET, "要")%……%CNAME("二人称")%の%ADANA("精液")%って濃いんですねぇ_H_」"	CALL PRINT_STRW, @"「%MIX_AEGI(1, TARGET, "要")%……%CNAME("二人称")%的%ADANA("精液")%好浓稠啊_H_」"
CALL PRINT_STRW, "「こんなの飲まされ続けちゃったら……_H_」"	CALL PRINT_STRW, "「一直这样喝下去会醉的……_H_」"
PRINTFORMW 「うえっ……変な味がします……」	PRINTFORMW 「嗯……有奇怪的味道……」
CALL PRINT_STRW, @"「あはっ_H_%CNAME("二人称")%の%ADANA("精液")%っていつも濃厚ですねぇ_H_」"	CALL PRINT_STRW, @"「阿拉_H_%CNAME("二人称")%的%ADANA("精液")%总是很浓厚呢_H_」"
CALL PRINT_STRW, @"「こんな特濃ミルク飲まされちゃったせいで今じゃ一回これを飲まないと満足できない体になっちゃいましたよ……_H_」"	CALL PRINT_STRW, @"「因为被迫喝了这样特浓牛奶，现在不喝一次这个身体就无法满足了……_H_」"
CALL PRINT_STRW, @"「あんっ……_H_%CNAME("二人称")%の精子に口の中犯されてるぅ……_H_」"	CALL PRINT_STRW, @"「啊呣……_H_%CNAME("二人称")%的精子在嘴里侵犯着……_H_」"
CALL PRINT_STRW, @"「うわぁ……いっぱい出しましたね_H_」"	CALL PRINT_STRW, @"「呜哇……出来了很多呢_H_」"
CALL PRINT_STRW, @"「そんなに気持ちよかったんですか……\@ MARK:屈服刻印 == 0 ? 少し # \@嬉しいです_H_」"	CALL PRINT_STRW, @"「那么的舒服嘛……\@ MARK:屈服刻印 == 0 ? 有点 # 很\@高兴呢_H_」"
PRINTFORMW 「うげぇ……」	PRINTFORMW 「呜呜……」
PRINTFORMW 「わわっ！　……こんな男の胸なのに気持ちよくなってくれたんですか」	PRINTFORMW 「哇哇！　……明明是男孩子的胸，感觉很舒服吗」
CALL PRINT_STRW, @"「フフッ_H_%CNAME("二人称")%ってここをこうされるのが好きなんですねぇ_H_」"	CALL PRINT_STRW, @"「呼呼_H_%CNAME("二人称")%很喜欢被这样对待呢_H_」"
CALL PRINT_STRW, @"「分かりますとも。だって%CNAME("二人称")%の%ADANA("ペニス")%が気持ちよさそうにビクビクッってするのが%CNAME("一人称")%の胸に伝わってきますもん_H_」"	CALL PRINT_STRW, @"「我明白了。因为%CNAME("二人称")%的%ADANA("阴茎")%很舒服的颤抖着，已经传递到了%CNAME("一人称")%胸口_H_」"
PRINTFORMW 「%CNAME("二人称")%、気持ちいいんですか？」	PRINTFORMW 「%CNAME("二人称")%、舒服吗？」
CALL PRINT_STRW, @"「……もっと%CNAME("二人称")%に幸せになってもらえるようにがんばりますね_H_」"	CALL PRINT_STRW, @"「……为了让%CNAME("二人称")%更加幸福，我会努力的_H_」"
PRINTFORMW 「……恥ずかしいですけど、%CNAME("二人称")%がそんなに気持ちいいならもう少しがんばってみます」	PRINTFORMW 「……虽然有点不好意思、但是这样%CNAME("二人称")%会很舒服的话，会稍微试着努力的」
CALL PRINT_STRW, "「これを乳首にすり込んだらぁ……_H_アハァ……_H_」"	CALL PRINT_STRW, "「把这个塞进乳头吧……_H_啊哈……_H_」"
CALL PRINT_STRW, @"「フフッ……%CNAME("二人称")%の%ADANA("精液")%……_H_」"	CALL PRINT_STRW, @"「呼呼……%CNAME("二人称")%的%ADANA("精液")%……_H_」"
CALL PRINT_STRW, @"「……その、もっと%CNAME("二人称")%が気持ちよくなれるように頑張りますから、よかったらもっと%ADANA("精液")%出してくださいね_H_」"	CALL PRINT_STRW, @"「……那个、会为了让%CNAME("二人称")%觉得更舒服努力的、方便的话就让%ADANA("精液")%再射出来吧_H_」"
CALL PRINT_STRW, "「あっ、先走りが溢れて……もうすぐなんですね_H_」"	CALL PRINT_STRW, "「啊、提前溢出来了……马上就要出来了_H_」"
CALL PRINT_STRW, "「アハッ_H_いっぱい出てるぅ……_H_」"	CALL PRINT_STRW, "「啊哈_H_出来了很多呢……_H_」"
CALL PRINT_STRW, @"「……まだまだこんなものじゃないですよね、%CNAME("二人称")%_H_」"	CALL PRINT_STRW, @"「……不应该是这样的、%CNAME("二人称")%_H_」"
PRINTFORMW 「え……何かビクビクって……うわぁ！」	PRINTFORMW 「欸……总觉得有些害怕……呜哇！」
PRINTFORMW 「……この%ADANA("精液")%を%CNAME("二人称")%の%ADANA("ペニス")%に……」	PRINTFORMW 「……%ADANA("精液")%从%CNAME("二人称")%的%ADANA("阴茎")%……」
CALL PRINT_STRW, "「フフッ……気持ちいいですか_H_」"	CALL PRINT_STRW, "「呼呼……很舒服吧_H_」"
CALL PRINT_STRW, @"「まだダメですよ_H_まだまだ%CNAME("二人称")%の%ADANA("精液")%で%CNAME("二人称")%の%ADANA("ペニス")%を犯させてあげますから、ちゃんと見ててください_H_」"	CALL PRINT_STRW, @"「还不行哦_H_还会用%CNAME("二人称")%的%ADANA("精液")%侵犯%CNAME("二人称")%的%ADANA("阴茎")%、好好的看着吧_H_」"
PRINTFORMW 「ええと、ここをこうして……フフッ、気持ちよさそうですね」	PRINTFORMW 「那个、就是这里……呼呼、看起来很舒服呢」
PRINTFORMW 「うぅ……拭くものとか無いんですか……」	PRINTFORMW 「唔……有没有需要擦的东西……」
PRINTFORMW 「早く拭かないとガマンできなくなりそうで怖いです……」	PRINTFORMW 「如果赶快擦拭的话，真担心不能够忍耐呢……」
CALL PRINT_STRW, @"「%MIX_AEGI(1, TARGET, "要")%%CNAME("二人称")%の%ADANA("精液")%……_H_」"	CALL PRINT_STRW, @"「%MIX_AEGI(1, TARGET, "要")%%CNAME("二人称")%的%ADANA("精液")%……_H_」"
PRINTFORMW 「……フフッ」	PRINTFORMW 「……呼呼」
CALL PRINT_STRW, @"「あ、ごめんなさい……この中に%CNAME("二人称")%の%ADANA("精液")%があると思ったら嬉しくて……_H_」"	CALL PRINT_STRW, @"「啊，对不起……想到这里面有%CNAME("二人称")%的%ADANA("精液")%就会很高兴呢……_H_」"
PRINTFORMW 「そ、そんなっ！　中出しなんてっ！」	PRINTFORMW 「没，没错！　中出什么的！」
PRINTFORMW 「うう……ドロドロした感じがする……」	PRINTFORMW 「唔……感觉黏糊糊的……」
CALL PRINT_STRW, @"「%MIX_AEGI(1, TARGET, "要")%ゴム越しなのにっ_H_」"	CALL PRINT_STRW, @"「%MIX_AEGI(1, TARGET, "要")%要越过避孕套了_H_」"
CALL PRINT_STRW, @" 「%CNAME("二人称")%のっ_H_%ADANA("精液")%がっ_H_」"	CALL PRINT_STRW, @" 「%CNAME("二人称")%的っ_H_%ADANA("精液")%っ_H_」"
CALL PRINT_STRW, @"「%CNAME("二人称")%の%ADANA("精液")%に%ADANA("アナル")%犯されてイッちゃううぅ_H_」"	CALL PRINT_STRW, @"「%CNAME("二人称")%的%ADANA("精液")%在%ADANA("肛門")%侵犯着_H_」"
CALL PRINT_STRW, @"「あっ_H_メスになるっ_H_%CNAME("二人称")%に中出しされてメスにされちゃうぅぅっ_H_」"	CALL PRINT_STRW, @"「啊_H_被当作雌性_H_被%CNAME("二人称")%当作雌性中出了_H_」"
CALL PRINT_STRW, "「もっとっ_H_もっと出してっ_H_」"	CALL PRINT_STRW, "「更多_H_再多出来点_H_」"
CALL PRINT_STRW, @"「もう%CNAME("二人称")%の%ADANA("精液")%無しじゃ生きていけないっ_H_」"	CALL PRINT_STRW, @"「%CNAME("二人称")%的%ADANA("精液")%没有就已经无法活下去了_H_」"
CALL PRINT_STRW, @"「あっ_H_%CNAME("二人称")%からの%ADANA("精液")%大好きっ_H_」"	CALL PRINT_STRW, @"「啊_H_%CNAME("二人称")%的%ADANA("精液")%最喜欢了_H_」"
CALL PRINT_STRW, "「もっとっ_H_もっとちょうだいっ_H_」"	CALL PRINT_STRW, "「更多_H_再多来一点吧_H_」"
CALL PRINT_STRW, "「アハッ_H_」"	CALL PRINT_STRW, "「啊哈_H_」"
CALL PRINT_STRW, @"「%CNAME("二人称")%からのプレゼントだぁ……_H_」"	CALL PRINT_STRW, @"「来自%CNAME("二人称")%的礼物……_H_」"
CALL PRINT_STRW, @"「こ、こんな所に出されたって気持ちよくないですよ……\@ MARK:屈服刻印 >= 2 ? _H_ # \@」"	CALL PRINT_STRW, @"「在，在这种地方出来，很不舒服……\@ MARK:屈服刻印 >= 2 ? _H_ # \@」"
PRINTFORMW 「え……キスで\@MARK:屈服刻印 == 3 ? %ADANA("精液")%出しちゃった # 射精しちゃった\@んですか？」	PRINTFORMW 「欸……用接吻，让\@MARK:屈服刻印 == 3 ? %ADANA("精液")%出来 # 射出来\@是吗？」
CALL PRINT_STRW, @"「じゃあ%CNAME("一人称")%と一緒に他のところでもイッちゃえるようになりましょうか_H_」"	CALL PRINT_STRW, @"「那么和%CNAME("一人称")%一起去别的地方玩吧_H_」"
CALL PRINT_STRW, @"「ただの口なのにそんなに気持ちよくなるなんて……%CNAME("一人称")%と一緒になっちゃいましたね_H_」"	CALL PRINT_STRW, @"「明明只是嘴巴，却变得那么舒服……%CNAME("一人称")%和你一起了呢_H_」"
CALL PRINT_STRW, @"「なんだか嬉しいです……%CNAME("二人称")%がもっといっぱい気持ちよくなれるように、もっともっとチューしてあげます_H_」"	CALL PRINT_STRW, @"「总觉得很开心……为了让%CNAME("二人称")%心情更加舒畅，让我再多亲你一下_H_」"
PRINTFORMW 「正直、ビックリしました……」	PRINTFORMW 「老实说，吓了一跳……」
PRINTFORMW 「……刺激しているのは\@MARK:屈服刻印 == 3 ? %ADANA("クリトリス")% # クリトリス\@なのに、射精もしちゃうんですね」	PRINTFORMW 「……刺激的是\@MARK:屈服刻印 == 3 ? %ADANA("阴蒂")% # 阴蒂\@可是却射精了」
CALL PRINT_STRW, "「……ならもっと男の子の部分と女の子の部分で一緒にイっちゃうように開発してあげます_H_」"	CALL PRINT_STRW, "「……那么，男孩子和女孩子的部分都会一起开发的_H_」"
CALL PRINT_STRW, @"「……そんなどっちもある%CNAME("二人称")%が大好きですから、どっちも愛してあげますね_H_」"	CALL PRINT_STRW, @"「……无论哪个都最喜欢%CNAME("二人称")%了、无论哪个我都会爱你_H_」"
CALL PRINT_STRW, @"「%CNAME("二人称")%_H_そんなに気持ちよかったんですか_H_」"	CALL PRINT_STRW, @"「%CNAME("二人称")%_H_那么舒服吗_H_」"
CALL PRINT_STRW, @"「それじゃあ%CNAME("一人称")%と同じように中に挿れられないと物足りない体になっちゃいましょう_H_」"	CALL PRINT_STRW, @"「那就是和%CNAME("一人称")%一样，如果不能插在里面的话，这具身体就不能满足_H_」"
CALL PRINT_STRW, "「それじゃあもっとゴリゴリして気持ちよくしてあげますからね_H_」"	CALL PRINT_STRW, "「那么，我会更加努力的让你舒服的_H_」"
CALL PRINT_STRW, @"「%CNAME("二人称")%の顔……気持ちよさそう……_H_」"	CALL PRINT_STRW, @"「%CNAME("二人称")%的脸……很舒服吧……_H_」"
PRINTFORMW 「もっと気持ちよくしてあげますね♪」	PRINTFORMW 「我会让你更舒服的♪」
PRINTFORMW 「%CNAME("二人称", "どもり")%の顔……」	PRINTFORMW 「%CNAME("二人称", "どもり")%的脸……」
PRINTFORMW 「……我慢できません！」	PRINTFORMW 「……无法忍耐了！」
CALL PRINT_STRW, @"「%MIX_AEGI(3, TARGET, "要")%……%CNAME("二人称")%、また出ちゃいそうになったんですか_H_」"	CALL PRINT_STRW, @"「%MIX_AEGI(3, TARGET, "要")%……%CNAME("二人称")%、再次出来了呢_H_」"
CALL PRINT_STRW, @"「いいですよ_H_もっともっと出してください_H_」"	CALL PRINT_STRW, @"「可以哦_H_请再多射出来点吧_H_」"
CALL PRINT_STRW, @"「そのまま%CNAME("一人称")%の口を%CNAME("二人称")%の精液便所にしちゃってください_H_」"	CALL PRINT_STRW, @"「请放进%CNAME("二人称")%的精液便所里来吧，也就是%CNAME("一人称")%的嘴巴里_H_」"
CALL PRINT_STRW, "「ハァ……_H_ハァ……_H_」"	CALL PRINT_STRW, "「哈啊……_H_哈啊……_H_」"
CALL PRINT_STRW, @"「%MIX_AEGI(1, TARGET, "要")%%CNAME("二人称")%……_H_見てくださぁい_H_」"	CALL PRINT_STRW, @"「%MIX_AEGI(1, TARGET, "要")%%CNAME("二人称")%……_H_请看_H_」"
CALL PRINT_STRW, @"「%CNAME("二人称")%のおかげで……_H_%CNAME("一人称")%の%ADANA("アナル")%こんなにエッチになっちゃいましたぁ……_H_」"	CALL PRINT_STRW, @"「多亏%CNAME("二人称")%……_H_%CNAME("一人称")%的%ADANA("肛門")%变的这样的H了……_H_」"
CALL PRINT_STRW, @"「\@COND("絶頂", PLAYER) >= 2 ? たくさん # 濃い\@%ADANA("精液")%……%ADANA("アナル")%に出されちゃったぁ……_H_%AEGI(TARGET, "要", "通常")%」"	CALL PRINT_STRW, @"「\@COND("絶頂", PLAYER) >= 2 ? 很多 # 浓稠的\@%ADANA("精液")%……在%ADANA("肛門")%里出来了……_H_%AEGI(TARGET, "要", "通常")%」"
CALL PRINT_STRW, "「もっと……もっとめちゃくちゃにしてぇ……_H_」"	CALL PRINT_STRW, "「更加……再弄得乱七八糟的吧……_H_」"
CALL PRINT_STRW, @"「……%CNAME("二人称")%……次は中に出してください……_H_」"	CALL PRINT_STRW, @"「……%CNAME("二人称")%……下次也请这样射出来吧……_H_」"
CALL PRINT_STRW, @"「%CNAME("二人称")%の%ADANA("精液")%でいっぱいになっちゃってるぅ……_H_%AEGI(TARGET, "要", "通常")%」"	CALL PRINT_STRW, @"「%CNAME("二人称")%的%ADANA("精液")%满满的……_H_%AEGI(TARGET, "要", "通常")%」"
CALL PRINT_STRW, @"「%CNAME("二人称")%……_H_もっとしてください……_H_」"	CALL PRINT_STRW, @"「%CNAME("二人称")%……_H_请再给我一点……_H_」"
PRINTFORMW 「み、見ないでください……」	PRINTFORMW 「请，请不要看。……」
CALL PRINT_STRW, @"「%AEGI(TARGET, "要", "通常", 4)%%CNAME("二人称")%の%ADANA("精液")%\@ COND("絶頂") >= 2 ? すごい量……それに # \@すごく濃い……_H_」"	CALL PRINT_STRW, @"「%AEGI(TARGET, "要", "通常", 4)%%CNAME("二人称")%的%ADANA("精液")%\@ COND("絶頂") >= 2 ? 数量惊人…而且 # \@还很浓……_H_」"
CALL PRINT_STRW, @"「%AEGI(TARGET, "要", "Ｍ異物", 3)%\@ABL:精液中毒 >= 5 ? %ADANA("精液")%おいしい # 変な味\@……_H_」"	CALL PRINT_STRW, @"「%AEGI(TARGET, "要", "Ｍ異物", 3)%\@ABL:精液中毒 >= 5 ? %ADANA("精液")%很好吃 # 味道怪怪的\@……_H_」"
CALL PRINT_STRW, @"「あんっ……_H_お腹が%CNAME("二人称")%の%ADANA("精液")%で\@COND("絶頂", PLAYER) >= 3 ? 膨れちゃってる # いっぱい\@……_H_」"	CALL PRINT_STRW, @"「啊呣……_H_因为%CNAME("二人称")%的%ADANA("精液")%肚子\@COND("絶頂", PLAYER) >= 3 ? 鼓起来了 # 满满的\@……_H_」"
CALL PRINT_STRW, @"「……%TEXTR("んん……/ふぁ……/あっ……/あはぁ……")%_H_」"	CALL PRINT_STRW, @"「……%TEXTR("嗯……/哈……/啊……/啊哈……")%_H_」"
PRINTFORMW 「ハァ……そりゃあいくらなんでもマニアックすぎますもん。当然ですよ……」	PRINTFORMW 「啊哈……这也太狂热了。当然了。……」
