//EVENT_K27_維吹.ERB
雪女と人間のハーフ。授業をさぼりがちな不良娘。男口調で話す白皙の美少女	雪女与人类的混血儿。经常旷课的不良少女。用男生语调说话的白皙美少女
魂を食べて完全なる雪女になるために入部する	 为了进食灵魂成为完全的雪女而入部
PRINTFORML 「お邪魔します」	PRINTFORML 「打扰了」
PRINTFORML ある日、フェリシエルと共に部室で寛いでいるときに突然その娘は入ってきた	PRINTFORML 那天、正和弗理希艾尔她们一起在部室里放松的时候、突然那个女孩进来了
PRINTFORMW 銀色が混じった黒髪、切れ長の目、白い肌……長身のすらっとした美人である	PRINTFORMW 混杂着银色的黑发、细长清秀的眼睛、白皙的肌肤……是个身材高挑的美人
PRINTFORMW 彼女は部屋を見回し、一つ頷くとフェリシエルに向き直り、おもむろに口を開いた	PRINTFORMW 她环视一圈房间、点了点头、转身面向弗理希艾尔、不慌不忙地开口道：
PRINTFORMW 「アンタ、人間じゃないんだろ？　頼む！　アタシに妖怪になる方法を教えてくれ」	PRINTFORMW 「你、不是人类吧？　求你了！　请教人家成为妖怪的方法」
PRINTFORMW 『……落ち着いてください。とりあえずお茶でも飲んでお話ししましょう？』	PRINTFORMW 『……请冷静一下。总之先喝杯茶再谈吧？』
PRINTFORMW 不躾な頼み事に、忠実なる完璧メイドは笑顔でお茶を進めて事情を訊くのだった	PRINTFORMW 对于这冒昧的请求、女仆礼仪完美的微笑着递出茶水、询问了事情的来龙去脉
PRINTFORMW それから十数分後、彼女……風花 維吹（かざはな いぶき）から聞き出したことをまとめるとこうだ	PRINTFORMW 十几分钟之后、从她……風花 維吹（かざはな いぶき）那里了解到的事情、总的来说就是……
PRINTFORMW 自分は雪女と人間のハーフである。色々あって人間が嫌になったので人間を辞めて母親のところへ行きたい	PRINTFORMW 自身是雪女和人类的混血儿。因为种种原因变得讨厌人类，而想舍弃人类的身份去母亲的那里。
PRINTFORMW しかし今の自分は人間寄りで山に行っても仲間には入れてもらえないだろう	PRINTFORMW 然而现在自己的身体更偏向人类、就算去山里也很难被认可的吧
PRINTFORMW 悩んでいたところに、この部室に人間以外の何かが集まっていることに気が付いた	PRINTFORMW 在烦恼的时候、注意到这个部室里聚集着人类以外的存在
PRINTFORMW （彼女は人間ではない存在がなんとなく分かるらしい）	PRINTFORMW （她似乎能够分辨人类以外的存在）
PRINTFORMW 同類であるフェリシエルに人間の辞め方を教えてもらいたい	PRINTFORMW 想请作为同类的弗理希艾尔告诉她舍弃人类血统的方法
PRINTFORMW 話を聞き終わると何か考えていたフェリシエルだったが、やがて切り出した	PRINTFORMW 弗理希艾尔聆听完起因后思考着什么、少顷开口道：
PRINTFORMW 『人間ではなくなる方法は色々ありますが……、貴女の場合だと人間の魂を食べるのが一番適しているでしょうね』	PRINTFORMW 『不再为人的方法各种各样的都有……、像貴女这种情况、食用人类的灵魂应该是最合适的吧』
PRINTFORMW 「人間の魂？……あー、なんとなくわかるけど……それって食べたら相手は死なないの？」	PRINTFORMW 「人类的灵魂？……啊——、多少能理解、但是……吃掉的话对方不就死了么？」
PRINTFORMW 『死にますね』	PRINTFORMW 『会死呢』
PRINTFORMW 「それは……ちょっと」	PRINTFORMW 「那样的话……有点」
PRINTFORMW 『抵抗ありますか？　そうでしょうね。そこで！　そんな貴女にいい話があるのですが』	PRINTFORMW 『有点反感吗？　是这样没错呢。于是！　对貴女来说有个好消息』
PRINTFORMW 「……その悪魔みたいな優しい笑顔、ロクな予感がしないんだけど」	PRINTFORMW 「……那个恶魔般亲切的笑容、我有不好的预感」
PRINTFORMW 『ご明察です。私は悪魔で、今から貴女に断れない提案をいたします』	PRINTFORMW 『真是慧眼如炬。我就是恶魔哦、我要说的是对于现在的贵女来说、一个无法拒绝的提案』
PRINTFORMW ……こうして雪女ハーフ、風花維吹は入部することになった。	PRINTFORMW ……这就是雪女半妖、風花維吹的入部起因。
PRINTFORMW 「ただし条件がある。避妊はしてくれ。困るだろ？　お互いに」	PRINTFORMW 「但是有个条件。要做好避孕。不然会很困扰吧？　对彼此来说」
PRINTFORMW 『そうですね。じゃあ、契約書に明記しておきましょう。悪魔の契約書ですから実効性抜群です』	PRINTFORMW 『也是呢。那么、在契约书上写明吧。因为悪魔的契約書、実効性可是很抜群的』
PRINTFORMW 『契約書のお代はそうですね……。ご主人様から頂いた魂の2割で結構ですよ？』	PRINTFORMW 『契約書的费用也有呢……。从主人様那获得灵魂的两成就足够了喲？』
CALL PRINT_STRL, "黄色_※契約書は避妊の護符としての効果を持ちます"	CALL PRINT_STRL, "黄色_※契約書附带避妊の護符"
CALL PRINT_STRW, @"黄色_%CALLNAME:TARGET%が持っており、契約者双方（%CALLNAME:MASTER%と%CALLNAME:TARGET%）の同意のもとに破棄されない限り効果は失われません"	CALL PRINT_STRW, @"黄色_由%CALLNAME:TARGET%持有、除非在契約者双方（%CALLNAME:MASTER%和%CALLNAME:TARGET%）都同意的基础上废弃、否则不会失去效果"
PRINTFORMW 「書いたよ。風花維吹だ。よろしくな、%CNAMET(ARG, "主人")%」	PRINTFORMW 「写好了呢。我是風花維吹。请多多指教、%CNAMET(ARG, "主人")%」
PRINTFORMW フェリシエル作成の契約書に署名、捺印後、握手を求めてきた%CALLNAME:TARGET%の手は奇妙なほど冷たかった。	PRINTFORMW 在弗理希艾尔拟定的契約書上署名、并捺印後、主动过来握手的%CALLNAME:TARGET%、手异常的冷。
PRINTFORML ※システムメッセージ※	PRINTFORML ※系统消息※
PRINTFORML %CALLNAME:TARGET%は集めた魂の量(ステータス画面で確認できます)に応じて精霊化（雪女化）イベントが進行します	PRINTFORML 根据%CALLNAME:TARGET%收集的魂(可在能力表示界面上确认)来推进精灵化（雪女化）事件
PRINTFORML 調教（[ベッドに誘う]コマンドによって移行するモードです）後に進行し、やがて[精霊]の素質を獲得します	PRINTFORML 经过調教（[邀请上床]指令下的模式）后的展开、最终获得[精霊]的素質
PRINTFORMW [相思相愛]になるためには[恋慕]に加えて[精霊]の素質が必要です	PRINTFORMW 要成为[相思相愛]的话、必须有[恋慕]和[精霊]这两个素質
PRINTFORML 部屋の隅に鞄と最低限の私物が置いてあるだけの簡素な部屋だ	PRINTFORML 房间的角落上放着提包和起码的私人物品、仅是如此的朴素卧室
PRINTFORMW 声をかけられると%CALLNAME:TARGET%の身体が強張った	PRINTFORMW 一被打招呼、%CALLNAME:TARGET%的身体就紧绷起来了
PRINTFORMW 「嫌ってわけじゃない。人間やめるために了承したさ」	PRINTFORMW 「并不是讨厌。为了不做人类、我可是应承下来了呀」
PRINTFORMW 「でもその、こういうことは初めてなわけなので……、緊張はするよな」	PRINTFORMW 「但是那个、因为做这种事情还是第一次……多少会紧张的吧」
PRINTFORMW 「……なんだよ、悪いか」	PRINTFORMW 「……什么嘛、不行吗」
PRINTFORMW 「やることやって、さっさと済ませよう」	PRINTFORMW 「要干就干、赶紧做完啦」
PRINTFORMW 「……できればお手柔らかに、な」	PRINTFORMW 「……可以的话下手温柔点、好么」
PRINTFORMW 「慣れてきたな。それとも慣らされてきたのか？」	PRINTFORMW 「已经习惯了。还是说被习惯了呢？」
PRINTFORMW 「どっちにしろ、ストレスが少ないのはいいことだよな」	PRINTFORMW 「无论如何、不怎么紧张了的话、是好事啊」
PRINTFORMW 「%CNAME("一人称")%をいじくりまわして楽しいのか？」	PRINTFORMW 「玩弄%CNAME("一人称")%很开心吗？」
PRINTFORMW 「この契約が%CNAME("主人")%に得があるのか、どうもわからない」	PRINTFORMW 「这个契約对%CNAME("主人")%有什么好处吗、怎么也无法理解」
PRINTFORMW 「女抱きたいだけならフェリシエルさんだけで十分じゃないの？」	PRINTFORMW 「如果只是想抱女人的话、光是有弗理希艾尔小姐就足够了吧？」
PRINTFORMW 「始める前に少しいいか？　手を出してくれ」	PRINTFORMW 「开始之前先等一下好吗？　把手伸出来」
PRINTFORMW %CALLNAME:TARGET%はひんやりとした両手で%CALLNAME:MASTER%の手を包み込むと、しばらく目を閉じ、じっとしていた	PRINTFORMW %CALLNAME:TARGET%用冰凉的双手盈握住%CALLNAME:MASTER%的手、随即闭上眼睛、一动不动
PRINTFORMW 「……ありがとう。%CNAME("主人")%と契約してよかった」	PRINTFORMW 「……谢谢。和%CNAME("主人")%契約真是太好了」
PRINTFORMW 「%CNAME("一人称")%はもうすぐ%CNAME("二人称")%たちとはお別れだけど、ここで過ごしたことは忘れない」	PRINTFORMW 「可是%CNAME("一人称")%马上就要和%CNAME("二人称")%分别了、%CNAME("一人称")%不会忘记在这里度过的时光的」
PRINTFORMW 「いずれ%CNAME("一人称")%は山へ行っていなくなる。でもここで過ごしたことはずっと忘れない」	PRINTFORMW 「%CNAME("一人称")%迟早会上山的。但是%CNAME("一人称")%永远不会忘记在这里度过的时光」
PRINTFORMW 「今日はどうする？　できれば%CNAME("一人称")%が攻めたいな」	PRINTFORMW 「今天要怎么做？　可以的话、%CNAME("一人称")%想主动进攻呢」
PRINTFORMW 「だって攻められると%CNAME("二人称")%に感じてる顔を見られるだろ？」	PRINTFORMW 「大概、是因为可以看到%CNAME("二人称")%被攻时、那来感觉的表情吧？」
PRINTFORMW 「されるよりする方が好きなんだよ。されるのって恥ずかしいし、ね……」	PRINTFORMW 「比起被欺负、%CNAME("一人称")%更喜欢这样做喲。被那样欺负太羞耻了、嘛……」
PRINTFORMW 「……気恥ずかしくなってきた。さっさと始めよう」	PRINTFORMW 「……又感觉羞耻起来了。赶紧开始啦」
PRINTFORMW 「お別れまで楽しんでもらえるよう、できるだけもてなすよ」	PRINTFORMW 「在告别之前一起享受快乐吧、我会尽可能地款待你的喲」
PRINTFORMW 「……と、もちろんお代の魂は忘れずに取るからな？」	PRINTFORMW 「……另外、当然也不会忘记给予我灵魂的付出哦？」
PRINTFORMW %CALLNAME:TARGET%は明るく振る舞おうとしているようだ	PRINTFORMW %CALLNAME:TARGET%想要表现得很开朗的样子
PRINTFORMW 「はいはい、それじゃやろうか」	PRINTFORMW 「是是、那来做吧」
PRINTFORMW 「……気が乗らないから明日にしたいんだけど……、ダメか」	PRINTFORMW 「……没什么心情、所以想明天再做啦……不行么」
PRINTFORMW 「今日もできれば優しくお願いするよ」	PRINTFORMW 「可以的话、今天也拜托你温柔一点喲」
PRINTFORMW 「……ちょっと待て。%CNAME("二人称")%、今『激しく行こう』って思っただろ？」	PRINTFORMW 「……等一下。%CNAME("二人称")%、此刻想的是『那就激烈点』是吧？」
PRINTFORMW 「飽きないねえ、%CNAME("主人")%も……」	PRINTFORMW 「真不腻呢、%CNAME("主人")%也……」
PRINTFORMW 「いや、%CNAME("一人称")%は助かってる。ただ……何でもない」	PRINTFORMW 「不对、这是在帮%CNAME("一人称")%而已。只是……没什么」
PRINTFORMW 「……頑張れば成果が出る分、そんなに悪い労働でもないかもね」	PRINTFORMW 「……努力的话就会有结果、也不是那么糟糕的运动的吧」
PRINTFORMW 「世の中、何でもそうならいいのにな？」	PRINTFORMW 「世上、要是什么都是那样就好了呢？」
PRINTFORMW 「出す魂の量って調節できないの？」	PRINTFORMW 「不能控制支出灵魂的量么？」
PRINTFORMW 「できないのか……。じゃあ、頑張るしかないね」	PRINTFORMW 「不行吗……。那么、只好努力了呢」
PRINTFORMW 「こうして何度も声をかけるってことは、%CNAME("二人称")%にも得があるってことか」	PRINTFORMW 「像这样三番五次的邀请这种事情、对%CNAME("二人称")%也有好处吗」
PRINTFORMW 「それなら……まあ、いいんだけどね」	PRINTFORMW 「那样的话……算了、但愿如此吧」
PRINTFORMW それ以上の会話を拒否するように%CALLNAME:TARGET%は身を委ねてきた	PRINTFORMW 为了结束那之后的话题、%CALLNAME:TARGET%委身于你
PRINTFORMW それ以上の会話を拒否するように%CALLNAME:TARGET%は%NAMES("ベッド")%へ向かった	PRINTFORMW 为了结束那之后的话题、%CALLNAME:TARGET%向%NAMES("ベッド")%走去
PRINTFORMW 「%CNAME("主人")%がスケベでよかったよ」	PRINTFORMW 「%CNAME("主人")%是色鬼真是太好了喲」
PRINTFORMW 「色んな相手を抱きたいっていうのは、そういうことだろ？」	PRINTFORMW 「想要左拥右抱、说起来、大概就是这么回事吧？」
PRINTFORMW %CALLNAME:TARGET%は少し自虐的な笑みを浮かべた	PRINTFORMW %CALLNAME:TARGET%露出了些许自虐的笑容
PRINTFORML 「お、おい、%CNAME("主人")%、大丈夫か？」	PRINTFORML 「喂、喂~、%CNAME("主人")%、没事吧？」
PRINTFORML 「無理しすぎだよ」	PRINTFORML 「太勉强啦」
PRINTFORML 「%CNAME("助手")%、%CNAME("主人")%を休ませたいんだけど、後片付けを頼んでもいい？」	PRINTFORML 「%CNAME("助手")%、我想让%CNAME("主人")%休息一下、但是、可以拜托你善后吗？」
PRINTFORMW 「……ありがとう、この埋め合わせはどっかでするよ」	PRINTFORMW 「……谢谢、我会找机会补偿你的」
PRINTFORML 「%CNAME("助手")%、%CNAME("主人")%を頼んだ。休ませてやってくれ」	PRINTFORML 「%CNAME("助手")%、%CNAME("主人")%就拜托你了。让我休息一下吧」
PRINTFORMW 「%CNAME("一人称")%が後片付けしておくから」	PRINTFORMW 「%CNAME("一人称")%之后会收拾的啦」
PRINTFORML 「%CNAME("助手")%、悪いけど後片付けを頼んだ」	PRINTFORML 「%CNAME("助手")%、不好意思、善后就拜托给你了」
PRINTFORMW 「%CNAME("一人称")%は%CNAME("主人")%を休ませるから」	PRINTFORMW 「因为%CNAME("一人称")%得让%CNAME("主人")%好好休息」
PRINTFORML 「ほら、水飲めるか？　自分で飲んだ方がいいんだけど……わかったよ」	PRINTFORML 「给、能喝水吗？　虽说自己也能喝……我知道啦」
PRINTFORML 銀髪になった%CALLNAME:TARGET%は%CALLNAME:MASTER%を抱えると、水を自らの口に含む	PRINTFORML 銀髪的%CALLNAME:TARGET%抱住%CALLNAME:MASTER%后、把水含在自己嘴里
PRINTFORMW 妖力により適温に調節した水を%CALLNAME:MASTER%に口移しで飲ませている……	PRINTFORMW 把由妖力调节成的温水、用嘴喂给%CALLNAME:MASTER%喝下……
PRINTFORMW %CALLNAME:TARGET%は%CALLNAME:MASTER%を抱え、口移しで水を飲ませている……	PRINTFORMW %CALLNAME:TARGET%搂着%CALLNAME:MASTER%、嘴对嘴地喂其水喝……
PRINTFORML 「%CNAME("助手")%、%CNAME("主人")%についてやってくれ」	PRINTFORML 「%CNAME("助手")%、%CNAME("主人")%就交给你了」
PRINTFORMW 「後片付けは%CNAME("一人称")%がやっておく」	PRINTFORMW 「由%CNAME("一人称")%来善后」
PRINTFORMW 「ほら、水飲めるか？　……飲めって。甘えるな」	PRINTFORMW 「来、能喝水吗？　……能喝啊。别撒娇啦」
PRINTFORML 「%CNAME("二人称")%、体力あるんだな……」	PRINTFORML 「%CNAME("二人称")%、还有力气啊……」
PRINTFORML 「これ以上、%CNAME("一人称")%はもう無理……。ちょっと休ませてくれ」	PRINTFORML 「到此为止、%CNAME("一人称")%已经不行了……。让我休息一会儿」
PRINTFORMW %CALLNAME:TARGET%は着衣を整え、疲れたのか座り込んでいる	PRINTFORMW %CALLNAME:TARGET%理了理衣着、也许是太疲惫了、坐着不动
PRINTFORML %CALLNAME:TARGET%は%NAMES("ベッド")%にあおむけになったまま、息を整えている	PRINTFORML %CALLNAME:TARGET%仰面瘫软在%NAMES("ベッド")%上、平缓地调整着呼吸
PRINTFORMW じっとこちらを見ているのでその冷たい手を握ってあげると、心から嬉しそうに笑った	PRINTFORMW 发现你一直盯着她看、伸出那冰凉的小手与你十指紧扣时、由衷开心地笑了
PRINTFORMW 呼吸にあわせて上下する胸に目を奪われていると背を向けてしまった	PRINTFORMW 你差点被那随着喘息上下起伏的峰峦所勾引、背过身去冷静下
PRINTFORML 「最後にもう一度キスしてくれないか？」	PRINTFORML 「最后、能再吻我一下吗？」
PRINTFORML 「嫌なら別に……んっ……ありがとう」	PRINTFORML 「不愿意就算……嗯……谢谢」
PRINTFORML 「……あ、終わり、か」	PRINTFORML 「……啊、结束了、吗」
PRINTFORML 「感じ過ぎてすごい醜態をさらした気がする……」	PRINTFORML 「舒服过头了、总觉得露出了好糗的姿态……」
PRINTFORML 「%TEXTR("ちょ、ちょっとこっち、見るな……/お、思い返すな！　口に出すな！　忘れろ！")%」	PRINTFORML 「%TEXTR("等、等一下这边、别看啊……/别、别想像啊！　不许说！　快忘掉！")%」
PRINTFORML 「今回のお勤め終了か。お疲れさん」	PRINTFORML 「这次的工作结束了吗。辛苦您了」
PRINTFORMW 「少しは雪女に近づいたかな……」	PRINTFORMW 「稍微接近雪女化了吧……」
PRINTFORML 「今回のお勤め終了か。お疲れ」	PRINTFORML 「这次的工作结束了吗。辛苦了」
PRINTFORMW 「午後の授業どうするかな……」	PRINTFORMW 「下午的授课怎么办呢……」
PRINTFORML 「今日はもう寝るよ」	PRINTFORML 「今天该睡觉了」
PRINTFORMW 「一緒に？　やだね、これ以上疲れたくない」	PRINTFORMW 「一起睡？　不要哦、不想再累了」
PRINTFORML 「ほら、水飲んどけよ」	PRINTFORML 「来、喝杯水吧」
PRINTFORML 「部の標語だろ？　部長が守らなくっちゃな」	PRINTFORML 「部室的标语不是写着吗？　部長必须要遵守呢」
PRINTFORMW 「……あれ？　%CNAME("二人称")%が部長だっけ？」	PRINTFORMW 「……对了？　%CNAME("二人称")%是部長吧？」
PRINTFORML 「暑いし、やってたことがやってたことだからな」	PRINTFORML 「这么热、因为是事后嘛」
PRINTFORMW 「いや、%CNAME("一人称")%は雪女だから暑くないけど、水は飲むよ」	PRINTFORMW 「不、%CNAME("一人称")%虽然是雪女不会觉得热、水还是要喝的哦」
PRINTFORMW 「それにしても三人とも汗やら体液やらでべとべとだな」	PRINTFORMW 「话虽如此、我们三个都被汗水啦、体液啦什么的、弄得黏糊糊了呢」
PRINTFORMW 「それにしても二人とも汗やら体液やらでべとべとだな」	PRINTFORMW 「话虽如此、我们两个都被汗水啦、体液啦什么的、弄得黏糊糊了呢」
PRINTFORML 「スポーツの後みたいだな、このやり取り」	PRINTFORML 「就好像体育运动之后一样啊、这种对话」
PRINTFORMW 「うちの部は分類的には運動部なんだろうか…？」	PRINTFORMW 「我们部在分类上算是运动部吗…？」
PRINTFORML 「終わり？　ん、わかった」	PRINTFORML 「结束了？　嗯、知道了」
PRINTFORMW 「休みとはいえ、日が高いうちからこれって……爛れた生活してるよな」	PRINTFORMW 「虽说是休息日、但太阳还高的时候就过着如此……腐烂的生活啊」
PRINTFORML 「じゃ、午後の授業も頑張れよ」	PRINTFORML 「再见、下午的课也要加油喲」
PRINTFORML 「%CNAME("一人称")%？　疲れたからサボる……っていうのもまずいか」	PRINTFORML 「%CNAME("一人称")%？　因为太累就旷课……这样也不太好吧」
PRINTFORMW 「仕方ない。ちょっと休んだら行くよ」	PRINTFORMW 「没办法。稍微休息一会就去吧」
PRINTFORML 「……どうだった、今回。楽しめた？」	PRINTFORML 「……怎么样、此次。有享受吗？」
PRINTFORML 「一般的には魂って貴重だろう？　提供してもらってる立場だし、今更ながらちょっと気になってさ……」	PRINTFORML 「一般来说灵魂是很贵重的吧？　作为被提供的立场、事到如今还是有点在意啊……」
PRINTFORMW 「変な顔するなよ。これでも、%CNAME("二人称")%とはできるだけいい関係を築きたいと思ってるんだ」	PRINTFORMW 「别一副奇怪的表情啦。即使这样、还是想尽可能和%CNAME("二人称")%建立良好的关系」
PRINTFORMW 「奇麗にしてやるからちょっと待ってろ……。はむっ_HH_」	PRINTFORMW 「我会给你干净的啦、稍等一下……。哈姆_HH_」
PRINTFORMW 「これは文句言う権利ない？　……分かったよ、そんな目で見るな」	PRINTFORMW 「我无权抱怨？　……我知道啦、别用那种眼神看我」
PRINTFORMW 「始めるとノッちゃう%CNAME("一人称")%にも問題がある」	PRINTFORMW 「一开始就骑上来的%CNAME("一人称")%也有问题」
PRINTFORMW 「（これはキノコ、これはキノコ……）」	PRINTFORMW 「（这是蘑菇、这是蘑菇……）」
PRINTFORMW 「……やっぱ無理があるな。いいや、行こう」	PRINTFORMW 「……果然还是做不到啊。讨厌、只能上了」
PRINTFORMW 「こんな出して……気持ちよかった、のか？」	PRINTFORMW 「就这样拔出来……太舒服、了吗？」
PRINTFORMW 「ん、と……%CNAME("一人称")%も、気持ちよかった」	PRINTFORMW 「嗯、我……%CNAME("一人称")%也、很舒服」
PRINTFORMW 「こんなに良く出るな……」	PRINTFORMW 「别这样动不动就中出啦……」
PRINTFORMW 「っ……まじまじと見るな」	PRINTFORMW 「唔……别死盯着看啊」
PRINTFORMW 「こっちがしてるんだから、天井の染みでも数えてればいいだろ」	PRINTFORMW 「因为是这种姿势啦、数一下天花板上的浊液就可以了吧」
PRINTFORMW 「いっ、いいから……魂残ってるならさっさと続けるぞ！」	PRINTFORMW 「好、好啦……还残留着灵魂的话赶紧继续啊！」
PRINTFORMW 「%CNAME("主人")%の……。んっ……ごくっ……れろっ」	PRINTFORMW 「%CNAME("主人")%的……。嗯……咕噜……咧啰」
PRINTFORMW 「身も心もどろどろにとかされたみたい……」	PRINTFORMW 「好像身心都与你纠缠不清一样……」
PRINTFORMW 「%CNAME("主人")%になら、溶かされたって構わないよ……？」	PRINTFORMW 「如果是%CNAME("主人")%的话、就算被融化也没关系喲……？」
PRINTFORMW 「%CNAME("主人")%……%CNAME("一人称")%の身体、まだある？」	PRINTFORMW 「%CNAME("主人")%……%CNAME("一人称")%的身体、还在吗？」
PRINTFORMW 「気持ち良すぎてバラバラになったかと思ったよ……」	PRINTFORMW 「太舒服了、还以为变散架了呢……」
PRINTFORMW 「出演が%CNAME("一人称")%だからな……。マニア向け過ぎたかな……」	PRINTFORMW 「因为出演者是%CNAME("一人称")%啊……。是否太过同好向了……」
PRINTFORMW 「はぁ……だからこんなもん売れないって言っただろ……？」	PRINTFORMW 「哈啊……都说了这种东西卖不出去的吧……？」
PRINTFORMW 不良在庫の山を前に、%CALLNAME:MASTER%と%CALLNAME:TARGET%は頭を抱えた…	PRINTFORMW 在堆积如山的不良库存前、%CALLNAME:MASTER%和%CALLNAME:TARGET%抱着头…


//EVENT_K27_DAILY.ERB
PRINTFORML 「早かったかな……」	PRINTFORML 「太早了点吧……」
PRINTFORMW 「どうする？　何もしないなら、適当にしてるけど」	PRINTFORMW 「要如何才行？　什么也不用做啦、只是时机不对」
PRINTFORMW 「%CNAMET(ARG, "主人")%か」	PRINTFORMW 「是%CNAMET(ARG, "主人")%吗」
PRINTFORMW 「見てのとおり、他の人はまだ来てないよ」	PRINTFORMW 「如你所见、其他人还没来哦」
PRINTFORMW 「つまり……その、二人きりだ」	PRINTFORMW 「就是说……那个、只有我们两个」
PRINTFORMW 「何かするなら、今のうちにしてくれると%CNAMET(ARG, "二人称")%の恋人は気が楽だ、ぞ……？」	PRINTFORMW 「要做些什么的话、趁现在作为%CNAMET(ARG, "二人称")%的恋人会感觉轻松些、哦……？」
PRINTFORMW 「ん、%CNAMET(ARG, "主人")%か。お先にくつろがせてもらってるよ」	PRINTFORMW 「嗯、是%CNAMET(ARG, "主人")%吗。我先休息过了哦」
PRINTFORMW %CALLNAME:TARGET%の前のカップのコーヒーはすっかり冷めている	PRINTFORMW %CALLNAME:TARGET%面前杯子里的咖啡都凉了
PRINTFORMW 「%CNAMET(ARG, "二人称")%も呑むか？」	PRINTFORMW 「%CNAMET(ARG, "二人称")%也喝吗？」
PRINTFORMW 「おかえり。……%TEXTR("ご飯にする？　お風呂にする？　それともア……忘れてくれ/おかえりって言えるの、なんかいいね/帰ってきてくれて、よかったよ")%」	PRINTFORMW 「欢迎回来。……%TEXTR("先吃饭？　先洗澡？　还是说先……忘了吧/有机会说欢迎回来、感觉挺不错的呢/你能回来、真是太好了喲")%」
PRINTFORMW 「おかえり。食事にする？　それともお風呂入るか？　……つづきはないよ。期待した目で見るな」	PRINTFORMW 「欢迎回来。先吃饭呢？　还是说先洗澡呢？　……后续没有喲。别人期待的眼神看我啦」
PRINTFORMW 「どうも。疲れたんなら風呂でも入れよ。沸かしてある。居候だからな」	PRINTFORMW 「请。累了就泡个澡吧。已经热好了。因为是寄居嘛」
PRINTFORMW 「やっと来てくれた。また会えて嬉しい」	PRINTFORMW 「终于回来了。很高兴再见到你」
PRINTFORMW 「こんにちわ。お茶でも淹れようか？」	PRINTFORMW 「你好啊。来泡杯茶吧？」
PRINTFORMW 「こんにちわ。……何してたって？　ただ外を見てただけだよ」	PRINTFORMW 「你好啊。……我在做什么？　只是看看外面而已喲」
PRINTFORMW 「ごめん、遅れた。ほとんどそろってんの？　だらだらしすぎたな……」	PRINTFORMW 「抱歉、迟到了。差不多都到齐了么？　太懒散了呢……」
PRINTFORMW 「ごめん、遅れた。ぼーっとしちゃってさ」	PRINTFORMW 「抱歉、迟到了。打瞌睡了啊」
PRINTFORMW 「ごめん、遅れた。ほとんどそろってんの？　遠出しすぎたかな……」	PRINTFORMW 「抱歉、迟到了。差不多都到齐了么？　或许是太远了吧……」
PRINTFORMW 「ごめん、遅れた。天気が良かったから、その辺をぶらぶらしてた」	PRINTFORMW 「抱歉、迟到了。因为天气很好、便在附近闲逛了」
PRINTFORMW 『こんにちわ、%CNAMET(ARG, CSVNAME_ACTOR)%』	PRINTFORMW 『你好、%CNAMET(ARG, CSVNAME_ACTOR)%』
PRINTFORMW %CALLNAME:TARGET%は会釈すると邪魔にならないよう、隅の方へ移動した	PRINTFORMW %CALLNAME:TARGET%打了声招呼为了不妨碍到大家、便往角落里走去
PRINTFORMW %CALLNAME:TARGET%は会釈した	PRINTFORMW %CALLNAME:TARGET%打了声招呼
PRINTFORMW 「またね、%CNAMET(ARG, "主人")%」	PRINTFORMW 「再见哦、%CNAMET(ARG, "主人")%」
PRINTFORMW %CALLNAME:TARGET%は微笑んで見送った	PRINTFORMW %CALLNAME:TARGET%微笑地目送着
PRINTFORMW %CALLNAME:TARGET%は%CALLNAME:MASTER%を見送ると、ため息をついて後片付けを始めた	PRINTFORMW %CALLNAME:TARGET%目送%CALLNAME:MASTER%离开、叹了口气后开始收拾残局
PRINTFORMW 「なんだ、用事があったのか。それじゃまたな」	PRINTFORMW 「什么啊、你有事吗。那么就再见咯」
PRINTFORMW 「火が苦手なのは事実だけど、調理に使う程度なら大丈夫」	PRINTFORMW 「虽然我不善长应付火是事实、但是用在烹饪那种程度的话、没问题」
PRINTFORMW 「むしろ火事になりそうなら一瞬で鎮火できるから、心配はいらないよ」	PRINTFORMW 「倒不如说失火的话一瞬间就能灭火、不用担心喲」
PRINTFORMW 「……でも、気にかけてくれてありがとう」	PRINTFORMW 「……但是、谢谢你的关心」
PRINTFORMW 今日のお弁当は見慣れない野菜が多い	PRINTFORMW 今天的便当有很多陌生的蔬菜
PRINTFORMW 「ああ、それ？　こないだ山で詰んできた野草」	PRINTFORMW 「啊啊、那个？　这种是山上长满的野草」
PRINTFORMW 「洗ってあるし、食べられる奴だから大丈夫」	PRINTFORMW 「已经洗过啦、因为是能吃的家伙、不要紧的」
PRINTFORMW 「お弁当って言ったらご飯だな」	PRINTFORMW 「说到便当就是米饭呢」
PRINTFORMW 「パンも美味しいけど、それだとただ買ってくることになるし」	PRINTFORMW 「虽然面包也很好吃、但是那种只会买回来啦」
PRINTFORMW 「自分で焼く？　……それはちょっと考えたことなかったな」	PRINTFORMW 「自己烤？　……那倒是没想过呢」
PRINTFORMW 「一緒に食べる奴は他にいないのかって？」	PRINTFORMW 「没有其他能一起吃的家伙吗？」
PRINTFORMW 「いないよ、そんなの。%CNAMET(ARG, "一人称")%はクラスで浮いてるからね」	PRINTFORMW 「不存在喲、那种东西。因为%CNAMET(ARG, "一人称")%在班上很不合群呢」
PRINTFORMW 「そーそー、まさにぼっちって奴だよ」	PRINTFORMW 「是——是——、实在是个孤零零的家伙喲」
PRINTFORMW 「はい、どうぞ召し上がれ」	PRINTFORMW 「给、请慢用」
//PRINTFORM 今日は	PRINTFORM 今天的
PRINTFORM %TEXTR("ハンバーグ/アスパラの豚肉巻き/カツオの照り焼き")%	PRINTFORM 便当是以%TEXTR("汉堡肉/芦笋猪肉卷/照烧鲣鱼")%
PRINTFORM %TEXTR("唐揚げ/夏野菜のひき肉炒め/アジフライ")%	PRINTFORM 便当是以%TEXTR("炸鸡块/青菜炒肉/香酥炸鯵鱼块")%
PRINTFORM %TEXTR("かぼちゃコロッケ/カブのひき肉あんかけ/さんまの蒲焼き")%	PRINTFORM 的便当是以%TEXTR("南瓜可乐饼/芜菁浇汁肉/蒲烧秋刀鱼")%
PRINTFORM %TEXTR("肉団子/れんこんのはさみ揚げ/海老チリ")%	PRINTFORM 便当是以%TEXTR("肉丸子/干炸莲藕/干烧虾仁")%
PRINTFORMW を主菜にしたお弁当だ	PRINTFORMW 作为主菜
PRINTFORMW 「美味しい？　そりゃよかった」	PRINTFORMW 「美味吗？　那太好了」
PRINTFORMW 本人の評価は低いが、%CALLNAME:TARGET%のお弁当は美味しい	PRINTFORMW 虽然本人评价很低、但%CALLNAME:TARGET%做的便当很好吃
PRINTFORMW 「お粗末様でした。食後のコーヒーをどーぞ」	PRINTFORMW 「粗食淡饭。吃完了喝杯咖啡吧」
PRINTFORMW そしてなぜか食べてる間は甲斐甲斐しい	PRINTFORMW 不知为何在用餐时、%CALLNAME:TARGET%很殷勤的招呼着
PRINTFORML 「これからはなるべくここに来るようにするよ。用があったら声をかけて」	PRINTFORML 「今后我尽量会到这里来。有用得上的地方就打声招呼」
PRINTFORML 「早く雪女になれるよう、協力は惜しまないから」	PRINTFORML 「为了尽早转变为雪女、我不会吝惜协力的」
PRINTFORML 「あつい……。雪女になれば暑さとは無縁になるらしいけど、本当かな」	PRINTFORML 「好热……。成为雪女的话、好像就會与炎热无缘、真的么」
PRINTFORML 「……おはよう」	PRINTFORML 「……早上好」
PRINTFORML %CALLNAME:TARGET%はまだ眠いのか、ぼーっとしている	PRINTFORML %CALLNAME:TARGET%好像还在犯困、精神恍惚地样子
PRINTFORML 「急に撮るのはナシだろ……」	PRINTFORML 「你没有忽然偷拍吧……」
PRINTFORML 「？　健全過ぎて逆に怪しいが……深く考えるのはやめておくか」	PRINTFORML 「？　（标语）过于健全反而很可疑……还是别想太深吧」
PRINTFORML 「で、この飲み物、飲んでいいの？」	PRINTFORML 「所以、这个饮料、能喝吗？」
PRINTFORML 「なんだ、この張り紙……。ああ、契約書の『ユニフォーム指定があった場合は着替えること』ってこれか」	PRINTFORML 「什么啊、这个标语……。啊啊、契約書上的『在指定制服的情况下要换装』就是这么回事吗？」
PRINTFORML %CALLNAME:TARGET%はしばらく考え込んだ後、指定された服を手に取った	PRINTFORML %CALLNAME:TARGET%经过一番沉思后、拿起了指定的衣服
PRINTFORML 「ふぅ……、着替えるよ。サインしたからな……」	PRINTFORML 「呼~……会换的啦。因为签了名……」
PRINTFORML 「はいはい、今週のユニフォームはこれね」	PRINTFORML 「是是、这周的制服是这个啊」
PRINTFORML 「着替えてくる。ちょっと待っててくれ」	PRINTFORML 「我去换衣服。请稍等一下」
PRINTFORML 「部室にみんなで体操服ってちょっとシュールだな」	PRINTFORML 「大家一起在部室里穿体操服这样、有点超现实呐」
PRINTFORML 「スカートの丈、短すぎないか？　これだと下着が……それが目的か」	PRINTFORML 「裙子的长度、是不是太短了？　这样的话内衣就……那才是目的吗」
PRINTFORML 「同級生なのに見かけたことがない？」	PRINTFORML 「明明是同级生、为什么没有见过我？」
PRINTFORML 「気が向いた時しか来ないからな……」	PRINTFORML 「因为只有在心情好的时候才来呐……」
PRINTFORML 「学校に来ない理由？　嫌われてるから」	PRINTFORML 「不来学校的理由？　因为被讨厌了」
PRINTFORML 「前に聞いたことあるんだけど、%CNAME("一人称")%を見てると落ち着かないんだってさ」	PRINTFORML 「以前听说到、大家因为一看到%CNAME("一人称")%就会心神不宁呢」
PRINTFORML 「クラスのみんなをいらだたせるのも悪いし、なるべく来ないようにしてる」	PRINTFORML 「让班里的同学不安也不好、便像这样尽量不来了」
;ノーマルな感性の人間は冬＝死の精霊である雪女には関わりたがらない	;感性正常的人类不愿意和在冬天等于死亡精灵的雪女有所关联
;何らかの異能があればほぼ無意識レベルで抵抗出来るし、[愚か]だったり人外慣れしてると全く気が付かない	;如果有什么异能的话、大致会在无意识下抵抗出来、[愚蠢]或者习惯了人外娘的人则完全感觉不到
;完全な雪女なら擬態できるが、半端な混ざりモノである維吹はだだもれしてる、という設定	;如果是完全的雪女的话、可以掩盖气息、而作为不彻底的混杂物的維吹则在泄露着、这样的设定
PRINTFORML 「今なら分かる。みんなが%CNAME("一人称")%を嫌った理由」	PRINTFORML 「现在才明白。大家讨厌%CNAME("一人称")%的原因」
PRINTFORML 「%CNAME("一人称")%の半分が雪女で、命を凍らせるモノだからだ」	PRINTFORML 「因为%CNAME("一人称")%有一半是雪女、那是会让生命冻结的存在」
PRINTFORML 「フツーの感性なら関わりたくないんだろう」	PRINTFORML 「感性正常的人、大概是不想接近我的吧」
PRINTFORML 「……まあ、たまに鈍い人もいるけどね」	PRINTFORML 「……虽说、偶尔也会有感觉迟钝的人呢」
PRINTFORML 「ハッピーバレンタイン。これ……、%CNAME("一人称")%の気持ち」	PRINTFORML 「情人节快乐。这个是……、%CNAME("一人称")%的心意」
PRINTFORML %CALLNAME:TARGET%がおずおずと差し出したのは、氷の薔薇だった	PRINTFORML %CALLNAME:TARGET%胆怯地递过来的是、冰雕的蔷薇花
PRINTFORML 「寒い季節に悪いけど、%CNAME("一人称")%を表現したお菓子をって思ったら、やっぱり氷菓かなって……」	PRINTFORML 「虽然在寒冷的季节不太合适、一想到要表现%CNAME("一人称")%心意的点心、果然是冰点心呢……」
PRINTFORML 「……食べづらそうだね。じゃ、一口食べさせてあげるよ」	PRINTFORML 「……看起来不方便吃啊。那、让我喂你一口吧」
PRINTFORML %CALLNAME:TARGET%は花びらを一枚摘んで折ると、%CALLNAME:MASTER%の口に運ぶ	PRINTFORML %CALLNAME:TARGET%掰下一片花瓣、送入%CALLNAME:MASTER%的嘴中
PRINTFORML 氷の花弁は口の中ですぐに溶け、しっとりと甘い味が広がった	PRINTFORML 冰的花瓣入口即化、甜丝丝的滋味扩散开来
PRINTFORML 「%CNAME("二人称")%の魂に反応して溶けるから。好きな時に食べて」	PRINTFORML 「会因为%CNAME("二人称")%的灵魂而融化掉。喜欢时就吃吧」
PRINTFORML 「……重いと思ったら捨てちゃっていいから……」	PRINTFORML 「……若是觉得重的话、扔掉也可以啦……」
;あなたか、あなたの魂を持ってる部員が食べないといつまでも溶けない	;你或者拥有着你灵魂的部员不吃的话、永远不会融化
;これを気持ちとして渡すという重い愛情表現に維吹本人も若干呆れてる	;維吹本人对于这种作为心意交付出如此沉重的爱情表现也有些惊讶
PRINTFORML 「……ん、あげる」	PRINTFORML 「……嗯、给」
PRINTFORML %CALLNAME:TARGET%は唐突に何かを差し出した	PRINTFORML %CALLNAME:TARGET%突然递出了什么
PRINTFORML 丁寧なラッピングに包まれた箱だ	PRINTFORML 一个被精心包装的礼盒
PRINTFORML 「チョコレート。……そういう日だからさ」	PRINTFORML 「巧克力。……因为是那种日子嘛」
PRINTFORML 「一応、手作り。味見はしたから不味くはないと思うけど、感想聞かせて」	PRINTFORML 「姑且是、亲手做的。因为有品尝过、虽然感觉并不算难吃、但还是想听听你的感想」
PRINTFORML 「そしたら次は……」	PRINTFORML 「那样的话、下次……」
PRINTFORML 「次はないか。……ごめん」	PRINTFORML 「没有下次吗。……对不起」
PRINTFORML 「その……好みに合わせて作るよ」	PRINTFORML 「那个……迎合你的口味做吧」
PRINTFORML 「ほら、これ。バレンタインデーだし、チョコやるよ」	PRINTFORML 「给、这个。因为是情人节嘛、送你巧克力喲」
PRINTFORML %CALLNAME:TARGET%がラッピングされた箱を差し出してきた	PRINTFORML %CALLNAME:TARGET%把包装好的礼盒递出来
PRINTFORML 「日頃のお礼の友チョコ？　そんな感謝の気持ち」	PRINTFORML 「平日谢礼的友情巧克力？　作为那种感谢的心意」
PRINTFORML 「市販品だけど味は保証する。この店、好きなんだよね」	PRINTFORML 「虽然是市面上卖的、但味道可以保证。那家店、我还挺中意的呢」
CALL PRINT_STRL, @"黄色_%CALLNAME:TARGET%からチョコレートを貰いました！"	CALL PRINT_STRL, @"黄色_从%CALLNAME:TARGET%那里收到了巧克力！"
PRINTFORML 「よく考えると昨日のアレはやりすぎた」	PRINTFORML 「仔细一想、昨天那个做得太夸张了」
PRINTFORML 「バレンタインで贈り物するなんて%CNAME("二人称")%以外にしたことがないから、はしゃぎすぎた……」	PRINTFORML 「因为情人节赠礼什么的、除了%CNAME("二人称")%以外从没有过啦、欢喜过头了……」
PRINTFORML 「美味しかった？　なら……、作ってよかった。来年も何か作るさ」	PRINTFORML 「很好吃？　那样……真是太好了。来年也作些什么吧」
PRINTFORML 「はいはい。お帰り、%CNAME("主人")%」	PRINTFORML 「好啦。欢迎回来、%CNAME("主人")%」
PRINTFORML 「こっちも気にかけてくれてありがとう」	PRINTFORML 「谢谢你也这么关心我」
PRINTFORML 「ちゃんと後でフォローしておきなよ？」	PRINTFORML 「事后要好好复合喲？」
PRINTFORML 「あっちはいいのか？　%CNAME("二人称")%がいいなら%CNAME("一人称")%もいいけど……」	PRINTFORML 「那边没关系吗？　%CNAME("二人称")%不在意的话、%CNAME("一人称")%也不介意的说……」
PRINTFORML 「節操ないなぁ。あとでモメても%CNAME("一人称")%を巻き込むなよ？」	PRINTFORML 「真没节操啊。以后再吵闹、别把%CNAME("一人称")%也卷入进去哦？」
PRINTFORML 「今度はこっちか。%CNAME("二人称")%も忙しいな」	PRINTFORML 「这次是这边吗。%CNAME("二人称")%也很辛苦呐」
PRINTFORML %CALLNAME:TARGET%の髪が銀色に染まっている	PRINTFORML %CALLNAME:TARGET%的秀发染上了银色
PRINTFORML 掌に幾つも小さな氷塊を作り出し、能力の訓練をしているようだ	PRINTFORML 在手掌上结出几个小冰块、似乎在做能力训练
PRINTFORML 「明日は何時限目から学校に行こうかな」	PRINTFORML 「明天几点去学校好呢」
PRINTFORML 「いっそサボろうか……？」	PRINTFORML 「干脆旷课吧……？」
PRINTFORML 「月が奇麗だ……」	PRINTFORML 「月亮好美啊……」
PRINTFORML 「……ん？　変な意味じゃなくて本当に月が奇麗なんだ」	PRINTFORML 「……嗯？　不是什么奇怪的隐喻、月亮真的很漂亮啊」
PRINTFORML 視線を感じて辺りを見渡すと、%CALLNAME:TARGET%と目が合う	PRINTFORML 感觉到视线而环顾四周、与%CALLNAME:TARGET%的目光撞在一起
PRINTFORM %CALLNAME:TARGET%は何も言わず、	PRINTFORM %CALLNAME:TARGET%什么也没说、
PRINTFORML 優しく微笑んだ	PRINTFORML 温柔地微笑着
PRINTFORML 気まずそうに目をそらした	PRINTFORML 尴尬地移开眸光
PRINTFORML %CALLNAME:TARGET%は%TEXTR("料理の本を読んでいる/スマホで料理のレシピを検索している")%	PRINTFORML %CALLNAME:TARGET%正在%TEXTR("看烹饪书/用手机检索着烹饪食谱")%、
PRINTFORML どうやらお弁当のレパートリーを増やしたいらしい	PRINTFORML 看起来、似乎是想增加便当的知识储备
PRINTFORML %CALLNAME:TARGET%は古びたノートを読んでいる	PRINTFORML %CALLNAME:TARGET%在读一本旧笔记
PRINTFORML 「これが何かって？　……父さんの日記」	PRINTFORML 「这个是什么？　……父亲的日记」
PRINTFORML 「山での過ごし方とか、母さんとの出会いとか書いてある」	PRINTFORML 「上面写着在山上生活的方法、以及和母亲的相遇之类的」
PRINTFORML 「これが何かって？　……ある登山家の記録帖」	PRINTFORML 「这个是什么？　……某登山家的记录本」
PRINTFORML %CALLNAME:TARGET%は機嫌よく鼻歌を歌いながら書き物をしている	PRINTFORML %CALLNAME:TARGET%心情愉快地一边哼着小曲、一边写东西
PRINTFORML %CALLNAME:TARGET%は無言で外の景色を眺めている	PRINTFORML %CALLNAME:TARGET%默默地眺望着外面的景色
PRINTFORML %CALLNAME:TARGET%は表紙に『怪談(Kwaidan)』と書かれた本を読んでいる	PRINTFORML %CALLNAME:TARGET%读着一本封面为『怪談(Kwaidan)』的书
PRINTFORML 「この子たちはどうなったんだろう」	PRINTFORML 「这些孩子们会怎么样呢？」
PRINTFORML %CALLNAME:TARGET%は%TEXTR("登山雑誌/『食べられる野草図鑑』")%を読んでいる	PRINTFORML %CALLNAME:TARGET%在看%TEXTR("登山杂志/『能吃的野草图鉴』")%
PRINTFORML 「キャンプに行きたいな……」	PRINTFORML 「真想去野营啊……」
PRINTFORML 「うぅん……」	PRINTFORML 「呜嗯~……」
PRINTFORML 「寒い……」	PRINTFORML 「冷……」
PRINTFORML 「……お父さん……」	PRINTFORML 「……父亲……」
PRINTFORML 「……ぃた……、……なぃで……」	PRINTFORML 「……疼……、……不要……」
PRINTFORMW 「おだてにはのらない……って言いたいけど妙に嬉しいもんだな」	PRINTFORMW 「我不会受你吹捧的……虽然想这么说、但还是忍不住觉得挺高兴的呢」
PRINTFORMW 「……っ。ごめん。ちょっと、気持ちが抑えられない」	PRINTFORMW 「……。抱歉。有点、压抑不住感情」
PRINTFORMW ためらうようにこちらを伺った後、%CALLNAME:TARGET%は%CALLNAME:MASTER%の手を取り、頬ずりした	PRINTFORMW 犹豫地走到近前之后、%CALLNAME:TARGET%牵起%CALLNAME:MASTER%的手、摩擦着脸颊
PRINTFORMW 冷たいのに暖かい、そんな奇妙な手触りだった	PRINTFORMW 脸颊明明凉凉地、却感觉很暖和、是那样奇妙的手感
PRINTFORMW ためらうようにこちらを伺った後、%CALLNAME:TARGET%は%CALLNAME:MASTER%を抱きしめた	PRINTFORMW 犹豫地走到近前之后、%CALLNAME:TARGET%抱住了%CALLNAME:MASTER%
PRINTFORMW ためらうようにこちらを伺った後、%CALLNAME:TARGET%は%CALLNAME:MASTER%に抱きついた	PRINTFORMW 犹豫地走到近前之后、%CALLNAME:TARGET%拥抱着%CALLNAME:MASTER%
PRINTFORM ひんやりとした肌触りが	PRINTFORM 冰凉的手感
PRINTFORM 汗ばんだ身体に	PRINTFORM 以及香汗淋漓地身体
PRINTFORMW 気持ちいい……	PRINTFORMW 让人很舒服……
PRINTFORMW 「%CNAME("一人称")%も%CNAME("二人称")%が大好き」	PRINTFORMW 「%CNAME("一人称")%也最喜欢%CNAME("二人称")%了」
PRINTFORMW %CALLNAME:TARGET%はそう言ってから耳まで赤くして下を向いた	PRINTFORMW %CALLNAME:TARGET%那么一说就小脸羞红到耳根、低下头去
PRINTFORMW 「……あ、ありがとう。お世辞でも嬉しい、よ」	PRINTFORMW 「……谢、谢谢你。即便是奉承话也很开心、喲」
PRINTFORMW %CALLNAME:TARGET%は戸惑ったように視線をさまよわせている	PRINTFORMW %CALLNAME:TARGET%似乎有些不知所措、眸光四下徘徊着
PRINTFORMW 「不意を打ってそういうことをいうのはやめろよ……」	PRINTFORMW 「别突然说这种话啦……」
PRINTFORMW 横を向いた%CALLNAME:TARGET%の白い頬には朱がさしている	PRINTFORMW 侧身过去的%CALLNAME:TARGET%、白皙的脸颊上泛着朱红的羞意
PRINTFORMW 「……そういうのはいらない。魂だけでいいよ」	PRINTFORMW 「……那种奉承就不必了。只要灵魂就好」
PRINTFORMW %CALLNAME:TARGET%はそっけなく言って横を向いた	PRINTFORMW %CALLNAME:TARGET%冷淡地扭过脸去
PRINTFORMW 「この部に入るまでも人間を辞める方法は色々調べたよ」	PRINTFORMW 「在加入这个部为止、我也对舍弃人类身份的方法做了各种调查喲」
PRINTFORMW 「本とか雑誌とか読むとそんな感じの話も出てくる。こんなのとか」	PRINTFORMW 「书或者杂志之类的、读起来也会出现那种感觉的话。比如说这样的」
PRINTFORMW 鞄から怪しげなオカルト雑誌を数冊取り出して見せた	PRINTFORMW 从包里取出数本奇怪的超自然杂志、展示给你看
PRINTFORMW 「この与太話とか、あんずサン、気に入りそうだけど、信じたりしないよな……？」	PRINTFORMW 「比如说这个怪谈、杏珠同学、虽然看上去挺喜欢的样子、不过你不会相信的是吧……？」
PRINTFORMW 「本当かどうか知らないけど、エノクって人が天使になったって説があるらしい」	PRINTFORMW 「虽然不知道是真是假、传言以诺人变成了天使」
PRINTFORMW 「清く、正しく、信心深くって人物ならそういうこともあるのかもしれないな」	PRINTFORMW 「如果是纯洁、正直、虔诚的人物的话、也许也会发生这样的事」
PRINTFORMW 「吸血鬼にかまれて吸血鬼になる、とかな」	PRINTFORMW 「被吸血鬼咬会变成吸血鬼、之类的」
PRINTFORMW 「でも吸血鬼って結局人間に依存してるから%CNAME("一人称")%が求めてたのとは違うんだよな」	PRINTFORMW 「但是吸血鬼终究是依存于人类的、所以和%CNAME("一人称")%所追求的不一样啊」
PRINTFORMW そこまでいうとシキの視線に気が付いたのか、少しバツが悪そうに頭を掻いた	PRINTFORMW 说到这、可能是注意到织的视线了吧、有些尴尬地挠了挠头
PRINTFORMW 「惜しかったのは羽化登仙……仙人になるって奴だな」	PRINTFORMW 「可惜的是羽化登仙……想成为仙人的家伙吧」
PRINTFORMW 「実践に一番現実的な方法が即身仏になるための方法に限りなく似てたから諦めた」	PRINTFORMW 「实际上最现实的方法无限相似于即身佛、所以放弃了」
PRINTFORMW 「誤読も考えると%CNAME("二人称")%に対するツェツィーリアさんみたいにその道の師匠がいないと無理だね」	PRINTFORMW 「考虑到理解错误的可能、没有像西西莉亚桑那样对%CNAME("二人称")%的内行师父是不行的啊」
PRINTFORMW 「この喋り方？　昔からこうだよ」	PRINTFORMW 「这个说话方式？　以前开始就这样了喲」
PRINTFORMW 「父さんからはよく注意されてたけど、直んなかった」	PRINTFORMW 「虽然父亲为此经常让我注意、但还是没能改掉」
PRINTFORMW 「そういう父さんも人のこと言えなかったからね」	PRINTFORMW 「所以父亲也没能说出其他人的事情吧」
PRINTFORMW 「授業出てない日は……色々だね」	PRINTFORMW 「逃课时的活动……有各种各样的呢」
PRINTFORMW 「山の方に行ったり、川沿いを散歩したり……一人を楽しんでる」	PRINTFORMW 「去往山的方向、在河边散步……享受着独自一人的乐趣」
PRINTFORMW 「今度、休みの日でいいからさ……、一緒に行かない？」	PRINTFORMW 「下次、休息日也行啊……一起去好吗？」
PRINTFORMW 「暗いってツッコミは受け付けないよ」	PRINTFORMW 「不接受吐槽说太颓废喲」
PRINTFORMW 「色々っていうのは……色々だよ。プライバシーの侵害はやめてくれ」	PRINTFORMW 「各种各样的就是……各种各样喲。不要侵犯隐私啦」
PRINTFORMW 「魂が増えるってどういう感覚なの？」	PRINTFORMW 「灵魂增长是种什么样的感觉呢？」
;多分本人にとっては自然なことなので説明できないと思われる	;大概对本人来说是很自然的事情、所以无法说明
PRINTFORMW 「えっと、ありがとう……」	PRINTFORMW 「那个、谢谢你……」
PRINTFORML 「そろそろ帰ってくるかな……」	PRINTFORML 「差不多该回来了吧……」
PRINTFORML 「雪女になってもお湯が気持ちいいのは変わらないな……」	PRINTFORML 「就算变成雪女、热水还是一如既往的舒服呢……」
PRINTFORML 「このまま人間として暮らすのは、……無理か」	PRINTFORML 「就这样作为人类生活下去的话……不行么」
PRINTFORML 「♪～♪～～……ありのままでいられたら苦労ないよなぁ……」	PRINTFORML 「♪～♪～～……如果坚持下去就不会辛苦了喲哦♪~……」維吹哼着日语翻唱的《Let It Go》
PRINTFORMW 「さっぱりした。……%CNAME("主人")%も入ったら？」	PRINTFORMW 「清爽了。……%CNAME("主人")%也要洗么？」
PRINTFORMW 「ところで……もう少し色気がある方がいい？」	PRINTFORMW 「话说……内衣稍微再色气点比较好吗？」
PRINTFORMW 「……%CNAME("一人称")%は訴えないけど、そういうのは控えた方がいいと思うよ……」	PRINTFORMW 「……虽说%CNAME("一人称")%不会报警、但那种事我觉得还是节制些比较好喲……」
PRINTFORMW 「何って、下着物色したり、だよ。言わせるな」	PRINTFORMW 「什么、内衣颜色、什么的。别让我说啦」
PRINTFORMW 「隙あらばシモに走るな、%CNAME("主人")%は……」	PRINTFORMW 「别钻空子啊、%CNAME("主人")%……」
PRINTFORMW 「中身を見られるだろうに、足りないものか？」	PRINTFORMW 「明明能看内衣包裹下的东西、难道还不满足吗？」
PRINTFORMW 「さっぱりした……。ん、%CNAME("二人称")%か、遅かったね」	PRINTFORMW 「洗白白了……。嗯、%CNAME("二人称")%吗、你来晚了呢」
PRINTFORMW 「夕ご飯、どうする？　お風呂入るなら待ってるけど」	PRINTFORMW 「晚饭、吃什么？　要洗澡的话、可以等等你」
PRINTFORMW 「おっと、そうそう……おかえり、%CNAME("主人")%」	PRINTFORMW 「哎呀、对了……欢迎回来、%CNAME("主人")%」
PRINTFORMW 「なんなら洗ってやろうか？　……冗談だからな？」	PRINTFORMW 「需要我帮你洗吗？　……开玩笑啦？」
PRINTFORMW 「%CNAME("主人")%か。気分を変えたかったんで、使わせてもらったよ」	PRINTFORMW 「%CNAME("主人")%吗。因为想转变下心情、让我借用了一下喲」
PRINTFORMW 「学校の部室でシャワーが使えるなんてフェリシエルさん、気が利いてるよな」	PRINTFORMW 「能在学校的部室里使用淋浴什么的、弗理希艾尔小姐可真能干呐」
PRINTFORMW 「%CNAME("主人")%、ご希望通り着替えたよ」	PRINTFORMW 「%CNAME("主人")%、如您所愿的换装了喲」
PRINTFORMW 「念願叶ったご感想は？」	PRINTFORMW 「如愿以偿的感想是？」
PRINTFORMW 「%CNAME("主人")%、服があったけど着てよかったのか？」	PRINTFORMW 「%CNAME("主人")%、我发现多了件衣服、但是穿成这样真的好吗？」
PRINTFORMW 「着る物にはそんなにこだわりないから着てみたけど……ああ、嬉しそうだな……」	PRINTFORMW 「我虽然对着装没什么讲究、但还是试着穿上看看……啊啊、很高兴的样子呢……」
PRINTFORMW 「着替えたけど……この格好、そんなにいいものか？」	PRINTFORMW 「换好了、但是……这身装束、有那么好吗？」
PRINTFORMW 「%CNAME("主人")%、見覚えのない服があったんだけど」	PRINTFORMW 「%CNAME("主人")%、我发现多了件陌生的衣服」
PRINTFORMW 「着て貰いたかった？　……気が向いたらな」	PRINTFORMW 「想让我穿上？　……感兴趣的话再说」
PRINTFORMW 「？　ああ、服か。う～ん、いずれな、いずれ」	PRINTFORMW 「？　啊啊、衣服啊。唔～嗯、再说吧、再说」
PRINTFORMW 周りの目が気になるのか%CALLNAME:TARGET%はそわそわしている	PRINTFORMW 也许是因为在意周围的目光、%CALLNAME:TARGET%显得慌慌张张的
PRINTFORMW 「ひょっとして、お誘い？　なんだ、違うのか」	PRINTFORMW 「该不会是、做爱邀请？　什么啊、不是吗」
PRINTFORMW 「あんまり触られると妙な気分になる。その気がないならやめてくれ」	PRINTFORMW 「被摸太多会感觉怪怪的。不是那个意思的话就停手啦」
PRINTFORMW 「%CNAME("一人称")%の胸触って楽しいの？　ふぅん、そうなんだ……」	PRINTFORMW 「摸%CNAME("一人称")%的胸部会很愉快？　哼嗯、这样啊……」
PRINTFORMW 「……自分で言うのもなんだが、ほとんどないものの触り心地ってどうなんだ？」	PRINTFORMW 「……总觉得自己说有点那个、几乎没有的东西触摸起来感觉如何？」
PRINTFORMW 「%CNAME("二人称")%のおかげで昔より増量したからって触っていいとは言ってないぞ……」	PRINTFORMW 「因为多亏了%CNAME("二人称")%、胸部比以前增大了、可以摸摸看什么的、说不出来啦……」
PRINTFORMW %CALLNAME:TARGET%はじっとしているが、気恥ずかしそうだ	PRINTFORMW %CALLNAME:TARGET%一动不动地、看起来很害羞那样
PRINTFORMW 「別にこってないけど、やってくれるなら。……ん、ちょっとくすぐったい」	PRINTFORMW 「虽然没有那么需要、不过你乐意的话。……嗯、稍微有点痒」
PRINTFORMW 「……ん？　ちょっ、やめろ！　くすぐるなって！」	PRINTFORMW 「……嗯？　停、住手！　别挠痒啦！」
PRINTFORMW 「あはははっ！　やめて！　お返ししてやる！」	PRINTFORMW 「啊哈哈哈！　住手！　奉还给你！」
PRINTFORMW ……しばらく二人でくすぐりあった	PRINTFORMW ……两人玩闹了一阵子
PRINTFORMW 「くっ、あはは！　……本当にやめろ！」	PRINTFORMW 「库、啊哈哈！　……说真的给我住手！」
PRINTFORMW 怒られてしまった……	PRINTFORMW 被教训了……
PRINTFORMW 「……えっ？　なっ、はっ！？　今、キスしたっ？　なんで！？」	PRINTFORMW 「……诶？　什、吓！？　刚刚、接吻了？　为什么！？」
PRINTFORMW 「突然やっていいことと悪いことがあるだろ。これは悪いことに決まってる！」	PRINTFORMW 「突发事件有好有坏是吧。这肯定是坏事！」
PRINTFORMW %CALLNAME:TARGET%は%CALLNAME:MASTER%の首に腕を回して口づけに応えている	PRINTFORMW %CALLNAME:TARGET%手臂环绕在%CALLNAME:MASTER%的脖子上、回应着接吻
PRINTFORMW 「……ん……ちゅっ……」	PRINTFORMW 「……嗯……啾……」
PRINTFORMW 少し苦しくなってきた……	PRINTFORMW 有点窒息起来了……
PRINTFORMW 「し、仕方ないな……。%CNAME("二人称")%だから許すけど……」	PRINTFORMW 「没、没办法啊……。因为是%CNAME("二人称")%才特别允许……」
PRINTFORMW 「……もう一回くらいなら、許すよ……」	PRINTFORMW 「……再来一下的话、可以喲……」
PRINTFORMW %CALLNAME:TARGET%は顔を赤くして、軽くキスを返してきた	PRINTFORMW %CALLNAME:TARGET%满面羞红、轻轻地吻了回去
PRINTFORMW 「そういう雰囲気だったろ、今……」	PRINTFORMW 「就是那种气氛吧、此刻……」
PRINTFORMW 「うっ、あぅ……」	PRINTFORMW 「唔、啊唔……」
PRINTFORMW 「嫌じゃないけど……もうちょっとムードとか……」	PRINTFORMW 「虽然不讨厌……再稍微有情调一点更……」
PRINTFORMW 「だから突然そういうことをするなって」	PRINTFORMW 「所以说、突然做这种事什么的」
PRINTFORMW 「……心臓に悪いんだよ」	PRINTFORMW 「……对心脏不好啦」
PRINTFORMW 「膝枕？　ああ、いいよ。じゃあ、失礼して……」	PRINTFORMW 「膝枕？　啊啊、好啊。那么、失礼了……」
PRINTFORMW 「……これ、なんか面白いのか？」	PRINTFORMW 「……这样、有什么趣味吗？」
PRINTFORMW %CALLNAME:TARGET%は困惑している……	PRINTFORMW %CALLNAME:TARGET%有些困惑……
PRINTFORMW 「悪いね、わざわざ」	PRINTFORMW 「不好意思、特意为我」
PRINTFORMW 「ん、ちょっと熱いな……」	PRINTFORMW 「嗯、有点烫手……」
PRINTFORMW %CALLNAME:TARGET%はふっと息を吹きかけると、平然と飲み始めた	PRINTFORMW %CALLNAME:TARGET%呼的吹了口寒气、便安然地喝了起来
PRINTFORMW %CALLNAME:TARGET%は息を吹きかけながらちょっとずつ飲んでいる	PRINTFORMW %CALLNAME:TARGET%时而吹气、时而小口小口地喝着
PRINTFORMW 「……はしたなかったか？」	PRINTFORMW 「……害羞了吗？」
PRINTFORMW 「暇そうだな。お茶でも飲むか？」	PRINTFORMW 「好像挺闲啊。要喝杯茶吗？」
PRINTFORMW 「はい、%CSTR:お茶の種類%。山でよく飲むからこれを淹れるのには自信がある」	PRINTFORMW 「好的、%CSTR:お茶の種類%。因为在山里经常喝这种茶、对此很有自信」
PRINTFORMW 「お待たせ、%CNAME("主人")%」	PRINTFORMW 「久等了、%CNAME("主人")%」
PRINTFORMW %CALLNAME:TARGET%は元の場所に座った	PRINTFORMW %CALLNAME:TARGET%坐回原位
PRINTFORMW 「%CNAME("主人")%、ちょっと出てくるよ。すぐ戻るから……」	PRINTFORMW 「%CNAME("主人")%、我出去一下喲。马上回来……」
PRINTFORMW %CALLNAME:TARGET%は席を立って出て行った	PRINTFORMW %CALLNAME:TARGET%离开座位出去了
PRINTFORMW 「何って……花を摘みに」	PRINTFORMW 「做什么……去摘花了」
PRINTFORMW %CALLNAME:TARGET%はトイレに行っていたことを婉曲に白状した	PRINTFORMW %CALLNAME:TARGET%委婉地坦白了如厕之事


//EVENT_K27_SHOP.ERB
PRINTFORML 「何か用事でもあるのか？」	PRINTFORML 「有什么需要我做的吗？」
PRINTFORML 「できることなら協力する。できないことは断るけどな」	PRINTFORML 「我会在力所能及的范围内协助你。但是力所不及的话、我拒绝」
PRINTFORMW 「わざわざ一緒に住まなくても学校で会えるだろ？」	PRINTFORMW 「不用特意住在一起、也可以在学校见面的吧？」
PRINTFORMW 「そう、だね……。%CNAME("一人称")%も一緒にいたいし、邪魔じゃないなら喜んで」	PRINTFORMW 「那样、是呢……。%CNAME("一人称")%也想在一起、不觉得打扰的话、我很乐意」
PRINTFORMW 「山での共同生活の予行練習にちょうどいいか……。またお邪魔するよ」	PRINTFORMW 「正好可以预先练习在山上的共同生活吗……。之后去打扰喲」
PRINTFORMW 「ん、お招きか。前使った部屋、まだある？」	PRINTFORMW 「嗯、邀请我吗。还留有、用过的空房间？」
PRINTFORML 「嫌だね。フェリシエルさんに頼めよ」	PRINTFORML 「我不要。去拜托弗理希艾尔小姐吧」
PRINTFORMW 「そもそも%CNAME("一人称")%に料理が出来るようにみえるか？」	PRINTFORMW 「说起来、%CNAME("一人称")%看起来像是会做饭的吗？」
PRINTFORML 「いいよ。何が食べたい？」	PRINTFORML 「可以喲。你想吃什么？」
PRINTFORML 「何でもいいなら、%CNAME("二人称")%の好きそうな味で適当に作ってやるよ」	PRINTFORML 「什么都好的话、按%CNAME("二人称")%喜欢的口味、酌情来做吧」
PRINTFORML 「大丈夫。恋人の味の好みくらい、把握してる」	PRINTFORML 「没问题。对恋人的口味喜好、已经掌握住了」
PRINTFORML 「またか。大して美味しくもないだろうに、物好きだな」	PRINTFORML 「又来吗。明明也不怎么美味、还挺喜欢啊」
PRINTFORML 「引き受けるよ。喜んでもらえてるなら、%CNAME("一人称")%も作り甲斐がある」	PRINTFORML 「我接受了喲。如果你喜欢的话、%CNAME("一人称")%也有制作的意义了」
PRINTFORML 「嫌ではないよ。ちょっとくすぐったいだけさ」	PRINTFORML 「烦倒不烦。只是有点不好意思而已」
PRINTFORMW 「じゃあ、明日朝から台所を使わせてもらうよ」	PRINTFORMW 「那让我、从明早开始使用厨房吧」
PRINTFORML 「いいよ。居候だしね」	PRINTFORML 「可以喲。毕竟我是吃闲饭的呢」
PRINTFORML 「ただ、味は期待しないでくれ。久しぶりなんだ」	PRINTFORML 「不过、对味道不要有所期待。许久没做了」
PRINTFORML 「藪から棒に変な頼み事するんだな、%CNAME("主人")%は」	PRINTFORML 「真是平白无故的奇怪请求啊、%CNAME("主人")%你」
PRINTFORML 「……いいよ。久しぶりだからうまくできるか分からないけど」	PRINTFORML 「……可以喲。但是许久没做了、不知道能不能做好」
PRINTFORMW 「何か食べられないものはある？　アレルギーとかさ」	PRINTFORMW 「有什么不能吃的东西吗？　过敏之类的啦」

//EVENT_K27_UNIQUE_EVENT.ERB
PRINTFORMW 気が付くと%CALLNAME:TARGET%の髪が完全に黒くなっている	PRINTFORMW 回过神来、%CALLNAME:TARGET%的秀发已经完全变得乌黑了
PRINTFORMW 以前、フェリシエルが銀髪が混じっているのは妖力が漏れていたから、と言っていた	PRINTFORMW 以前、之所以混杂着银发是因为妖力泄露的缘故、弗理希艾尔曾经说过
PRINTFORMW どうやら妖力の制御が可能になったようだ……	PRINTFORMW 看来已经可以控制住妖力了……
PRINTFORMW 「……ん？　どうかした？」	PRINTFORMW 「……嗯？　怎么了？」
PRINTFORMW %CALLNAME:TARGET%の髪が銀色に変わり、空中に手を伸ばす	PRINTFORMW %CALLNAME:TARGET%的秀发往银色转变、向空中伸出双手
PRINTFORMW その掌に小さな氷塊が浮かびあがった	PRINTFORMW 在手掌上浮现出零碎的冰块
PRINTFORMW 「……ちょっと分かってきた」	PRINTFORMW 「……稍微有点明白了」
PRINTFORMW 「今は気温をちょっと操作できるくらいだけど、完全になればもっと大がかりに操作できるようになると思う」	PRINTFORMW 「虽然现在只能稍微操纵部分气温、不过我想要是完全体的话、就能进行更大规模地操纵了」
PRINTFORMW 「真夏に吹雪を起こせるくらいに」	PRINTFORMW 「在盛夏可以掀起暴风雪的程度」
PRINTFORMW %CALLNAME:TARGET%は【アドバイス：クールダウン】を得た	PRINTFORMW %CALLNAME:TARGET%获得了【アドバイス：クールダウン】
PRINTFORMW 「ごめん、%CNAMET(ARG, "主人")%」	PRINTFORMW 「抱歉、%CNAMET(ARG, "主人")%」
PRINTFORMW 昼休み、教室に約束のお弁当を持ってきた%CALLNAME:TARGET%は、浮かない顔をしていた	PRINTFORMW 午休时、把约定的便当带到教室的%CALLNAME:TARGET%、一副愁眉不展的表情
PRINTFORMW 「受けたからにはもうちょっと『作った』って感じのものを作るつもりだったんだけど……」	PRINTFORMW 「既然接受了、本来打算做出稍微『像样』点的作品那样的做着、却……」
PRINTFORMW 弁当箱の中身は半分くらいが買ってきた惣菜や冷凍食品だった	PRINTFORMW 便当盒里有一半是买来的熟菜和冷冻食品
PRINTFORMW 「久しぶりすぎて段取り忘れてさ……。間に合わなかった」	PRINTFORMW 「隔太久了步骤都忘了……。来不及了就」
PRINTFORMW 「父さんに作ってた頃はこんな失敗しなかったんだけどな……」	PRINTFORMW 「但是给父亲做的时候从没这么失败过啊……」
PRINTFORMW 「ん？　ああ、父さんは登山家でさ、せめて家にいる時くらいって思ってお弁当を作ってたんだ」	PRINTFORMW 「嗯？　啊啊、我父亲是登山家啊、想着至少趁在家的时候该做点便当」
PRINTFORMW 「でも……、父さんはある日、山へ行って帰ってこなかった」	PRINTFORMW 「但是……、父亲有一天、上山却没再回来」
PRINTFORMW 「小学校を卒業するちょっと前だったかな。それからお弁当は作ってない」	PRINTFORMW 「是小学毕业前不久吧。那之后就没再做便当了」
PRINTFORMW 「……悪い。ご飯の前にする話じゃなかったな」	PRINTFORMW 「……抱歉。这不该在吃饭前说的吧」
PRINTFORMW それからお弁当を食べている間、%CALLNAME:TARGET%は不自然なほどよく喋った……	PRINTFORMW 接着在吃便当的时候、%CALLNAME:TARGET%有些不自然的喋喋不休……
PRINTFORMW 「でも、中学に上がるときにやめた。……ほら、父親ばなれって奴？」	PRINTFORMW 「但是、在上中学的时候就放弃了。……瞧、叛逆父亲的家伙？」
PRINTFORMW 「……別に寂しがったりはしなかったよ」	PRINTFORMW 「……并不觉得特别孤单喲」
PRINTFORMW それからなぜか黙り込んでしまった%CALLNAME:TARGET%とお弁当を食べた	PRINTFORMW 那之后、和不知道为何沉默下来的%CALLNAME:TARGET%一起吃着便当
PRINTFORMW 「……わかった。しばらく一緒に住もうか。今日、荷物を持ってそっちの家に行く」	PRINTFORMW 「……明白了。暂时先住在一起吧。今天、就拿行李去你家」
PRINTFORMW 「家の許可、ね……。いらないし、どうせ家の連中は気にしない」	PRINTFORMW 「家里的许可、么……。不需要啦、反正家里没人介意」
PRINTFORMW 「父さん？　……父さんとは一緒に住んでない」	PRINTFORMW 「父亲？　……没有和父亲住在一起」
PRINTFORMW 不審そうな視線を受けると、%CALLNAME:TARGET%はしぶしぶ口を開いた	PRINTFORMW 受到怀疑的目光、%CALLNAME:TARGET%勉强开了口
PRINTFORMW 「中学に上がるちょっと前、父さんは%CNAME("一人称")%を置いて山へ行って、戻ってこなかった」	PRINTFORMW 「上中学不久之前、父亲留下%CNAME("一人称")%到山上去了、再也没回来」
PRINTFORMW 「今は遠縁の親戚の家にいる。けど、お互いに興味もないし、そもそも向こうも家にいない方が多い」	PRINTFORMW 「现在在远方亲戚家住。但是、彼此都不感兴趣、而且很多时候、亲戚那边也没多少人在家」
PRINTFORMW 「だから許可はいらない。これで納得したか？」	PRINTFORMW 「所以不需要许可。这下理解了吗？」

STR:実行条件 = イエロー_※維吹と[相思相愛]になるには、[恋慕]かつ[精霊]である必要があります（現在未実装）	STR:実行条件 = イエロー_※要和維吹[相思相愛]的话、需要[恋慕]和[精霊]（現在未実装）
