






//ERB\EVENT_K\29 碧\EVENT_K29_DAILY.ERB
PRINTFORML 「もょ、もょょ……（おぉ、おはよ～）」	PRINTFORML 「噢、哦喔噢……（哦、早上好~）」
PRINTFORML 「ん、もう起きとーね。」	PRINTFORML 「嗯、起床吧」
PRINTFORMW 「続き？その前に朝食ば食べんね…？」	PRINTFORMW 「想继续么？在那之前先去吃早饭吧…？」
PRINTFORMW 「そろそろ学校ば行く時間やけ、続きは学校で…良かね？」	PRINTFORMW 「差不多该到了上学的时间了、接下来就是在学校里……可以吗？」
PRINTFORML 「あ、おはよ、%CNAMET(ARG, "二人称")%。」	PRINTFORML 「啊、是%CNAMET(ARG, "二人称")%啊、早上好」
PRINTFORML 「%CNAMET(ARG, "二人称")%、起きんと～？」	PRINTFORML 「%CNAMET(ARG, "二人称")%醒啦？起床吧～？」
PRINTFORMW 「下の体はもう起きとーのに……。」	PRINTFORMW 「下面倒是先起床了呢……」
PRINTFORMW 「今日は体育のある日やけん、体操服忘れとったらつまらんよ。」	PRINTFORMW 「今天有体育课、要是把体操服忘在家里可就没劲咯」
PRINTFORMW 「今日は、何か予定ばあると？」	PRINTFORMW 「今天有什么安排吗？」
PRINTFORMW 「ちょっと待って、緑茶ば入れてくるけん。」	PRINTFORMW 「等一下、我给你倒杯绿茶」
PRINTFORMW 「おはよー、しっかり寝れたと？」	PRINTFORMW 「早上好、睡得还好吗？」
PRINTFORMW 「%CNAMET(ARG, "二人称")%、そげん早う来てどうしたと？」	PRINTFORMW 「%CNAMET(ARG, "二人称")%怎么这么早就来了？」
PRINTFORMW 「いっちば～ん。」	PRINTFORMW 「第一名~。」
PRINTFORMW 「お、他に誰も来とらんごたーね……。」	PRINTFORMW 「哦、还以为是谁来了呢……」
PRINTFORML 「ただいま～」	PRINTFORML 「我回来了~」
PRINTFORMW 「お、%CNAMET(ARG, "二人称")%おるやん。」	PRINTFORMW 「哦、%CNAMET(ARG, "二人称")%也在啊」
PRINTFORMW 「おかえりなさい。待っとったよ～」	PRINTFORMW 「你回来啦。我等了很久哦～」
PRINTFORMW 「お、おかえりー。」	PRINTFORMW 「哦、回来了吗」
PRINTFORMW （お、邪魔せんどこ……）	PRINTFORMW （打、打扰了……）
PRINTFORMW 「う、うわ。何ばしてん…。」	PRINTFORMW 「哇、哇。怎么回事……」
PRINTFORMW 「%TEXTR("失礼するばい/お邪魔しまーす")%。」	PRINTFORMW 「%TEXTR("失礼了啊/打扰了打扰了")%」
PRINTFORMW 「お邪魔しまーす。もう大体みんな集まっとーね。」	PRINTFORMW 「打扰了。大家差不多都到齐了吧」
PRINTFORMW 「こんにちは。…今日は何すると？」	PRINTFORMW 「你好…今天要做些什么呢？」
PRINTFORMW %CALLNAME:ARG%は軽く会釈した。	PRINTFORMW %CALLNAME:ARG%轻轻地点了点头。
PRINTFORMW 「こんにちはー。」	PRINTFORMW 「你好」
PRINTFORMW 『こんにちは、%CNAMET(ARG, CSVNAME_ACTOR)%。』	PRINTFORMW 『你好、%CNAMET(ARG, CSVNAME_ACTOR)%』
PRINTFORMW 『もう大半揃っとるばい。』	PRINTFORMW 『差不多都到齐了吧』
PRINTFORMW 『%CNAMET(ARG, CSVNAME_ACTOR)%、こんにちは。』	PRINTFORMW 『%CNAMET(ARG, CSVNAME_ACTOR)%、你好』
PRINTFORMW 『こんにちはー。』	PRINTFORMW 『你好~』
PRINTFORMW 「今日は%TEXTR("明太子弁当/高菜弁当/梅の実ひじき弁当/やましお煮弁当/ミニ餃子弁当/ごまサバ弁当/かしわめし弁当")%ばい。」	PRINTFORMW 「今天是%TEXTR("明太子便当/高菜便当/梅花实羊便当/煮饭便当/迷你饺子便当/芝麻菜便当/煮面便当")%」
PRINTFORMW 「%CNAMET(ARG, "二人称")%、%TEXTR("海苔弁当/玉子焼き弁当/生姜焼き弁当/おにぎり弁当/鮭の塩焼き弁当")%を作ってきたばい。」	PRINTFORMW %CNAMET(ARG, "二人称")%、今天做的是%TEXTR("海苔便当/玉子烧便当/生姜烧便当/饭团便当/腌鲑鱼烧便当")%」
PRINTFORMW 「デザートの%TEXTR("梨/キウイ/みかん/いちご/羊羹")%もどうぞ。」	PRINTFORMW 「甜点的%TEXTR("梨子/猕猴桃/橘子/草莓/羊羹")%也请收下」
PRINTFORMW 「%CNAMET(ARG, "一人称")%の自信作っちゃん。お味はいかが？」	PRINTFORMW 「这可是%CNAMET(ARG, "一人称")%的自信作品哦。味道怎么样？」
PRINTFORMW %CALLNAME:ARG%は弁当の一部を%CALLNAME:MASTER%の口の前に差し出した。	PRINTFORMW %CALLNAME:ARG%把便当的一部分递到了%CALLNAME:MASTER%嘴边。
PRINTFORMW 「はい、%CNAMET(ARG, "二人称")%、あ～ん★」	PRINTFORMW 「来%CNAMET(ARG, "二人称")%、啊～唔★」
PRINTFORMW 「ちょっと少ないばってん、ちゃんとお腹に足りとうや？」	PRINTFORMW 「量好像有点少呢、能够吃饱吗？」
PRINTFORMW とは言え、%CALLNAME:ARG%の基準で少ないというだけで、丁度良い分量だった。	PRINTFORMW 虽然这么说、但其实只是以%CALLNAME:ARG%的标准来说很少、对%CALLNAME:MASTER%是正好的分量。
PRINTFORML 「ここが部室……けっこー広かね。」	PRINTFORML 「这里是活动室……很宽敞呢」
PRINTFORML 「暑かねー…。」	PRINTFORML 「好热啊……」
PRINTFORML 「ぁっぃ…」	PRINTFORML 「啊…」
PRINTFORML 「う、うわぁ…」	PRINTFORML 「哇、哇……」
PRINTFORML 「ひょっとして、%CNAME("一人称")%の地元より暑いんじゃなかろーか…」	PRINTFORML 「莫非比%CNAME("一人称")%老家那边还要热吗……」
PRINTFORML 「うぅ、汗拭かんと…」	PRINTFORML 「嗯、要擦汗的话……」
PRINTFORML 「……んお」（うとうと）	PRINTFORML 「……迷迷糊糊的」
PRINTFORML 「お、もう朝かいな。」	PRINTFORML 「哦、已经是早上了啊。」
PRINTFORML 「ん、おはよ。」（うとうと）	PRINTFORML 「嗯、早上好。」（迷迷糊糊）
CALL PRINT_STR, @"「%TEXTR(@"ここなら充分にくつろげるばい…/%CNAME("二人称")%、何すると？")%」_L"	CALL PRINT_STR, @"「%TEXTR(@"这里是充分放松的地方…/%CNAME("二人称")%、想做什么呢?")%」_L"
CALL PRINT_STR, @"「%TEXTR(@"ふふ、上手く整頓されとろ？/%CNAME("一人称")%の部屋へようこそー。")%」_L"	CALL PRINT_STR, @"「%TEXTR(@"呵呵、收拾得不错吧？/欢迎来到%CNAME("一人称")%的房间")%」_L"
PRINTFORML 「お、今片付けるけん待っとってー…」	PRINTFORML 「哦、现在要收拾、等一会呢……」
PRINTFORML 「%TEXTR("あっ/おゎ")%…」	PRINTFORML 「%TEXTR("啊/哇")%……」
PRINTFORML 「まったく、%TEXTR("丈が短くてつらかー/目線が正直ばい")%…」	PRINTFORML 「真是的、%TEXTR("太短了感觉有点别扭呢/视线还真是毫不掩饰啊")%……」
PRINTFORML %CALLNAME:TARGET%は%TEXTR("数学/物理/化学/工学/医学/解剖学/生物学/言語学/地理/法律")%の勉強をしている。	PRINTFORML %CALLNAME:TARGET%正在学习%TEXTR("数学/物理/化学/工程/医学/解剖学/生物学/语言学/地理/法律")%。
PRINTFORML 「……………。」	PRINTFORML 「……」
PRINTFORM %CALLNAME:TARGET%は	PRINTFORM %CALLNAME:TARGET%正认真地读着标题是
PRINTFORM 『%TEXTR("今さら聞けない戦時国際法/ものの見つけ方、隠し方/まさかの時の護身術/ブービートラップ写真集/萌え図説・戦時応急処置/筋肉の鍛え方、使い方")%』	PRINTFORM 《%TEXTR("现在没法听到的战时国际法/发现事物的方法、隐藏方法/出其不意的护身术/ baby——street写真集/萌图说·战时应急措施/肌肉的锻炼与使用方法")%》
PRINTFORML と題された本を真剣に読んでいる…。	PRINTFORML 这样的书籍…
PRINTFORML 「%TEXTR("……っ。/………。/…………/うにゅーん…/さんのーがはいっ…/１、２…")%」	PRINTFORML 「%TEXTR("……唔/………。/…………/嗯嗯…/唔、哈…/1、2…")%」
PRINTFORM %CALLNAME:TARGET%は%TEXTR("柔軟体操/腕立て伏せ/プランク/スクワット/単語で説明しづらい類の筋力トレーニング")%	PRINTFORM %CALLNAME:TARGET%正在进行%TEXTR("柔软体操/俯卧撑/平板支撑/深蹲/难以形容的种类的肌肉力量训练")%
PRINTFORML を行っている…	PRINTFORML 的练习…
PRINTFORML 「%TEXTR("………。/…………/・ω・")%」	PRINTFORML 「%TEXTR("………/…………/・ω・")%」
PRINTFORML %CALLNAME:TARGET%は%TEXTR("何かの機械を組み立てて/何かの機械を分解して/ペン回しをしては時折剣のように構えて/身体をほぐして/新聞を読んで")%いる…	PRINTFORML %CALLNAME:TARGET%正在%TEXTR("组装一些机器/拆开什么机器/转动笔、有时会像剑一样架起/放松身体/阅读报纸")%…
PRINTFORML %CALLNAME:TARGET%は%TEXTR("新聞を読んで/地図のようなものを描いて/双眼鏡で外を観察して")%いる…	PRINTFORML %CALLNAME:TARGET%正在%TEXTR("阅读报纸/绘制地图/用双筒望远镜观察外面")%…
PRINTFORML 「ﾋﾟｯﾋﾟﾘﾋﾟｰ ﾊｲｼﾞｮｰ ﾎﾝﾊｰ ﾊｲﾎｰﾍﾝﾍｰ」	PRINTFORML 「神圣顶峰—brive—bluen—bblive—」
PRINTFORML %CALLNAME:TARGET%はすやすやだ。	PRINTFORML %CALLNAME:TARGET%很容易。
PRINTFORML 「…すー……すー……」	PRINTFORML 「…啊……啊……」
PRINTFORML 「…………ｚｚｚ」	PRINTFORML 「……zzz」
PRINTFORML 「…………ほゎ……」	PRINTFORML 「……哎……」
PRINTFORML 「…たのしか………ｚｚｚ」	PRINTFORML 「…「托付……」zzz」
PRINTFORML 「………？…………。」	PRINTFORML 「……？」
PRINTFORML 「…むにゃ、%CNAME("二人称")%…？………ｚｚｚ」	PRINTFORML 「…唔、%CNAME("二人称")%……？……zzz」
PRINTFORML 「…にゅぅ……………」	PRINTFORML 「…嗯……」
PRINTFORML 「…シスプリデータなんか必要なか………ｚｚｚ」	PRINTFORML 「…需要什么SisPri的数据吗……zzz」
PRINTFORML 「ｚｚｚ…ここ……どこかいな…………」	PRINTFORML 「zzz…这里……总觉得……」
PRINTFORML 「なして%TEXTR("ダーツやっとーと/変な生き物に乗っとーと/銃撃戦に巻き込まれとると/脚に何か着けて空飛んどーと/メイドになっとるん")%かいな……ｚｚｚ」	PRINTFORML 「没有%TEXTR("假如遇到奇怪的生物/当你被卷入枪战时、你的脚上有什么东西会飞起来/如何做一个女仆。")%吗……zzz」
PRINTFORML 「…%TEXTR("い、ぃや/や、やだっ/やらぁ")%……%TEXTR("キルトスカート/ビキニアーマー/ハイグレアーマー/愛知万博の着ぐるみ/UNIQLO製の服/エロ系忍者服/刀剣乱舞のコスプレ/男性版キリン装備/男性版ナルガ装備")%なんか着たくなか………ｚｚｚ」	PRINTFORML 「…%TEXTR("不、不要/不要啦/不知道")%……%TEXTR("格子裙/比基尼铠甲/高跟鞋铠甲/爱知世博会服装/UNIQLO制服装/色情的忍者服装/刀剑乱舞cosplay服 /男性版麒麟套装/男性版迅龙套装")%什么的不想穿……zzz」
PRINTFORML 「…えっ、%CNAME("一人称")%…？ｚｚｚ………」	PRINTFORML 「…啊、%CNAME("一人称")%…？zzz……」
PRINTFORM %CALLNAME:TARGET%は、寝起きと思えない程の素早い動きで	PRINTFORM %CALLNAME:TARGET%以根本不像是刚睡醒所能做到的速度火动起来
PRINTFORMW %CALLNAME:MASTER%から飛びのいた。	PRINTFORMW 直接撞上了%CALLNAME:MASTER%。
PRINTFORMW %CALLNAME:MASTER%を羽交い締めにした。	PRINTFORMW 把%CALLNAME:MASTER%从背后的肋下锁住了双臂和脖子。
PRINTFORMW 拳を%CALLNAME:MASTER%の%TEXTR("みぞおち/顔面/下腹部")%に%TEXTR("浴びせた/直撃させた/当てようとしたが避けられた/当てようとしたが躊躇した/寸止めさせた")%。	PRINTFORMW 把拳头对准了%CALLNAME:MASTER%的%TEXTR("胸口/脸/小腹")%%TEXTR("却中途停住了/直接命中/试图击中但被躲开了/虽然试图击中但还是犹豫了/却还是停手了")%。
PRINTFORMW %CALLNAME:MASTER%に抱きついた。	PRINTFORMW 抱住了%CALLNAME:MASTER%。
PRINTFORMW %CALLNAME:MASTER%の腕を締め上げた。	PRINTFORMW 紧紧地握住%CALLNAME:MASTER%的手臂。
PRINTFORMW 「あ…%CNAME("二人称")%、ごめん。」	PRINTFORMW 「啊…%CNAME("二人称")%、对不起」
PRINTFORMW 「なんだ、%CNAME("二人称")%やん……」	PRINTFORMW 「什么嘛、是%CNAME("二人称")%啊……」
PRINTFORMW 「うぅ、早よ寝ょ……。」（ふらふら）	PRINTFORMW 「呜、早点睡吧……」（摇摇晃晃）
PRINTFORMW 「%TEXTR("お、ありがと。/ふふっ…嬉しか。/んー、そうかいな…")%」	PRINTFORMW 「%TEXTR("谢、谢谢/嘿嘿…有点高兴/嗯、是这样吗…")%」
PRINTFORMW 「う、やるやん…。」	PRINTFORMW 「唔、挺会说话的嘛…」
PRINTFORMW 「%CNAME("一人称", "どもり")%も%CNAME("二人称")%のこと好いとーよ…。」	PRINTFORMW 「%CNAME("一人称", "どもり")%也喜欢%CNAME("二人称")%」
CALL PRINT_STR, @"「………_H_」（ぽけー…）_L"	CALL PRINT_STR, @"「………_H_」（发呆…）_L"
PRINTFORMW 「…い、いかん、よだれ垂れてきとる。」（ふきふき）	PRINTFORMW 「…好、好了、都让我有点走神了」（擦口水）
CALL PRINT_STR, @"「えへー…_／／／_」（にこぉ）_L"	CALL PRINT_STR, @"「诶嘿…_／／／_」（笑嘻嘻）_L"
PRINTFORMW 「…っ、いかんいかん。」	PRINTFORMW 「…啊、不行不行」
PRINTFORMW 「えへー…」（にこぉ）	PRINTFORMW 「诶嘿……」（笑嘻嘻）
PRINTFORMW 「…っ、うっかり頬が緩んどるばい…。」	PRINTFORMW 「…啊、不小心脸颊松弛了……」
PRINTFORMW 「………。」（ぽけー…）	PRINTFORMW 「……」（发呆……）
PRINTFORMW 「うん、ありがと……。」	PRINTFORMW 「嗯、谢谢……」
PRINTFORMW 「うーん？（な～んかしけとー…。）」	PRINTFORMW 「嗯？（感觉有哪里不太对劲……）」
PRINTFORMW 「ふーん…」	PRINTFORMW 「哼……」
PRINTFORMW 「……？」	PRINTFORMW 「……？」
PRINTFORMW 意味が上手く通じていないようだ。	PRINTFORMW 好像不太明白意思。
PRINTFORMW 「……あ、ごめん、聞いとらんかった…。」	PRINTFORMW 「……啊、对不起、刚才没听到……」
PRINTFORMW 「『どうして数学を必死こいて学んどるのか』って？」	PRINTFORMW 「为什么要拼命学习数学？」
PRINTFORMW 「いつまでも苦手でおらるーわけにはいかんけんね…。」	PRINTFORMW 「总不能因为觉得棘手就不学吧……」
PRINTFORMW 「…強いて言うなら、『仕事』に必要っちゃんね。」	PRINTFORMW 「…硬要说的话、是因为觉得对于‘工作’是必要的」
PRINTFORMW …数字に強い方が役立つ仕事なんて星の数ほどあると思うが。	PRINTFORMW ……数学越好就越派的上用场的工作什么的、跟天上的星星数量一样多。
PRINTFORMW 「…物理の問題ば解くとに、数学の知識も必要ったいね。」	PRINTFORMW 「…要解物理题的话、也会需要数学上的知识」
PRINTFORMW 「何にしても、学べば何かの役に立とうやー。」	PRINTFORMW 「不管怎样、只要学习了就会有所帮助」
PRINTFORMW 「%CNAME("一人称")%の10年ちょっとの努力をもう上回っとるばい…。」	PRINTFORMW 「比%CNAME("一人称")%10年来的努力锻炼还要更有用……」
PRINTFORMW 「たましいのちからって　ばりすごかー…。」	PRINTFORMW 「灵魂的力量真是厉害啊……」
PRINTFORMW 「あのくさ、%CNAME("二人称")%、身体ばどげんして鍛えよると？」	PRINTFORMW 「那个、%CNAME("二人称")%是靠身体来锻炼的吗？」
PRINTFORMW 「………魂の取引！？それだけじゃつまるもんか、普通に鍛えて維持せやい…。」	PRINTFORMW 「……灵魂的交易！？只是依靠这个的话有点没意思啊、还是普通地锻炼维持下去吧……」
PRINTFORMW 「うーん、何事も無いことこそ、本当の幸せやろやー…。」	PRINTFORMW 「嗯、什么都没发生过、才是真正的幸福吧……」
PRINTFORMW 「%CNAME("一人称")%、こう見えても視力に自信あるとよ。」	PRINTFORMW 「别看%CNAME("一人称")%这样、对视力还是很有自信的」
PRINTFORMW 「天使の%TEXTR("羽/輪っか")%が見え……！」	PRINTFORMW 「看见天使的%TEXTR("羽毛/羽翼")%……！」
PRINTFORMW 「って、今は隠しとらんとか。…なんだつまらん。」	PRINTFORMW 「话说、现在都不隐藏起来了吗……有点儿没劲呐」
PRINTFORMW 「お、箒に乗って誰か飛んどるばい。」	PRINTFORMW 「噢、有人在骑着扫帚飞」
PRINTFORMW 「一人は初等部５年生くらいの女の子、もう一人は…%CNAME("ツェツィーリア")%かいな。」	PRINTFORMW 「一个是初等部5年级的女生、另一个是……%CNAME("ツェツィーリア")%吗？」
PRINTFORMW 「…とは言うたっちゃ、天使や悪魔の特徴ば見えるわけじゃぁないごたーね…。」	PRINTFORMW 「…这么说来、天使和恶魔的特征也看不出来吧……」
PRINTFORMW 「…肩にゴミついとるばい。」	PRINTFORMW 「…肩上沾满了垃圾」
PRINTFORMW 「%CNAME("二人称")%%TEXTR("、ありがとねぇ。/も結構気が利くったいねー。")%」	PRINTFORMW 「%CNAME("二人称")%、%TEXTR("谢谢了/舒服多了")%」
PRINTFORMW 「%TEXTR("もー、おせっかいやねー。/うわ、汗のにおい嗅がれとる……。/（本当に汗を拭くだけかいな……）")%」	PRINTFORMW 「%TEXTR("真是的、多管闲事呢/呜哇、一身汗味……/真想擦擦汗啊……")%」
CALL PRINT_STR, @"「%TEXTR("むぎゅー/ぎぅー/たまには甘えてもよかろー？")%」_L"	CALL PRINT_STR, @"「%TEXTR("唔啾/啾/偶尔也要撒下娇吧？")%」_L"
PRINTFORMW %CALLNAME:TARGET%から微かに花火のような香りがする…。	PRINTFORMW 从%CALLNAME:TARGET%那里隐约飘来烟花般的香气…。
PRINTFORMW 「%CSTR:お茶の種類%ﾄﾞｿﾞｰ」	PRINTFORMW 「%CSTR:お茶の種類%ﾞﾞﾞﾝ」
PRINTFORMW 「よければ%CSTR:お茶の種類%どうぞ。」	PRINTFORMW 「如果可以的话请喝杯%CSTR:お茶の種類%吧」
PRINTFORMW 「%CNAME("二人称")%、い、いい加減にしといてー……。」	PRINTFORMW 「%CNAME("二人称")%、适、适可而止吧……」
PRINTFORMW 「」（かくかくぷるぷる）	PRINTFORMW 「」（咔库咔库布噜布噜）
PRINTFORMW 「まったく、何度も何度も……。」	PRINTFORMW 「真是的、没完没了一直……」
PRINTFORMW 「な、なしてそこまで……。」	PRINTFORMW 「为、为什么要碰那里……」
PRINTFORMW 「な、何ばしよっとね……！？」	PRINTFORMW 「什、什么呀……！？」
PRINTFORMW 「さ、流石に恥ずかしかーよ……。」	PRINTFORMW 「果、果然还是觉得好丢人啊……」
PRINTFORMW 「うぅー…、さっき見たろー？」	PRINTFORMW 「呜呜……刚才被你看到了吗？」
PRINTFORMW 「まだ続けよるとー？」	PRINTFORMW 「还想继续吗？」
PRINTFORMW 「んー…、もうよか？」	PRINTFORMW 「唔……已经好了吗？」
PRINTFORMW 「%CNAME("二人称")%って本当にこういうの好いとーね…。」	PRINTFORMW 「%CNAME("二人称")%真的很喜欢这样啊……」
PRINTFORMW 「うーん、楽しそうに見とーね…。」	PRINTFORMW 「嗯、看起来也很开心的样子呢……」
PRINTFORMW 「そ、そんなに下着見たいと……？」	PRINTFORMW 「就、就那么想看内裤吗……？」
PRINTFORMW 「し、しつこかーよ…。」	PRINTFORMW 「哎、真缠人啊……」
PRINTFORMW 「%CNAME("二人称", "どもり")%、鼻くっついとーばい……！？」	PRINTFORMW %CNAME("二人称", "どもり")%、鼻子都和那里贴在一起了……！？
PRINTFORMW 「ん、そういうのも好いとーとね…。」	PRINTFORMW 「嗯、感觉也并不坏呢……」
PRINTFORMW 「うぅー、恥ずかしかー……。」	PRINTFORMW 「呜呜、还是觉得害羞……」
PRINTFORMW 「まくられるのと自分からまくるの、どっちがマシかいな…」	PRINTFORMW 「你来掀开和我自己卷起来、比较想要哪一种呢……」
PRINTFORMW 「…さっき見えとったよね？」	PRINTFORMW 「…刚才看见了吧？」
PRINTFORMW 「いくら何でも恥ずかしかよ……。」	PRINTFORMW 「不管怎么想都觉得好害羞……」
PRINTFORMW 「え、えっと…、これで良か？」	PRINTFORMW 「嗯、那个……这样可以吗？」
PRINTFORMW 「んー…分かった、犯人は%CNAME("二人称")%ばい……。」	PRINTFORMW 「嗯……知道了、犯人如果是%CNAME("二人称")%的话……」
PRINTFORML 「…ん。」（げしっ）	PRINTFORML 「…嗯」（警觉）
PRINTFORMW %CALLNAME:TARGET%の%TEXTR("蹴り/拳")%が%CALLNAME:MASTER%の%TEXTR("みぞおち/顔面/下腹部")%に直撃した…。	PRINTFORMW %CALLNAME:TARGET%的%TEXTR("秀腿/拳头")%直接命中了%CALLNAME:MASTER%的%TEXTR("胸口/面部/小腹")%…。
PRINTFORMW 「……っ、なんだ、%CNAME("二人称")%やん…。」	PRINTFORMW 「……啧、什么啊、原来是%CNAME("二人称")%啊…」
PRINTFORMW 「っ、何ばしよっとね……？」	PRINTFORMW 「啊、什么呀……？」
PRINTFORMW 「おぉう、再確認やめて欲しかー……。」	PRINTFORMW 「哇、能不能再确认一下……」
PRINTFORMW 「こ、こら！勝手にまくらんといてぇー…。」	PRINTFORMW 「喂、喂！不要随便任性的叫啊……」
PRINTFORMW 「……っは！？」	PRINTFORMW 「……哈！？」
PRINTFORMW 「ひゃ、いきなりせんといてー……。」	PRINTFORMW 「哎呀、突然说不行……」
PRINTFORMW 「や、やだっ、流石に止めて……！」	PRINTFORMW 「不、不要啊、再怎么说还是停下吧……！」
PRINTFORMW 「えー、またー…？」	PRINTFORMW 「诶、又……？」
PRINTFORML 「无て例の事件が魔術絡みと分かったかって？」	PRINTFORML 「你知道那个前所未有的事件和魔术有关吗？」
PRINTFORML 「%CNAME("一人称")%の母桑が魔術に詳しいけん、独自に調べて分かったとよ。」	PRINTFORML 「%CNAME("一人称")%的母亲对魔术很了解、她独自调查后才知道。」
PRINTFORML 「行方不明变成了と思われとる場所で魔術を使った痕跡があったけん…」	PRINTFORML 「在最后被认为行踪下落不明的地方有使用魔术的剑的痕迹…」
PRINTFORML 「……『魔術を用いた誘拐事件』かもしれんって言っとった。」	PRINTFORML 「……据说可能是"使用魔术的绑架事件"。」
PRINTFORML 「こないだ司書桑から聞いたばってん、」	PRINTFORML 「前几天刚从司书桑那里听说过、」
PRINTFORML 「こないだクラスの子から聞いたばってん、」	PRINTFORML 「最近刚从班上的同学那里听说过、」
PRINTFORML 「例の事件が、この学園近辺でも起きよるげな。」	PRINTFORML 「那个事件、好像在这所学校附近也会发生。」
PRINTFORML 「他の部員にも言っとくけん、%CNAME("二人称")%も……気ぃ付けといて。」	PRINTFORML 「和其他部员也可以说一下、%CNAME("二人称")%也……请小心。。」
PRINTFORMW 「流石に防刃仕様は無かろうね…」	PRINTFORMW 「到底有没有预防的方法呢…」
PRINTFORMW 「これは…機能美……！」	PRINTFORMW 「这是…机能美……！」
PRINTFORMW 「……もう少し丈夫なのが欲しかね。」	PRINTFORMW 「……你想要再结实一点的吗？。」
PRINTFORMW 「%CNAME("一人称")%の姉酱について？」	PRINTFORMW 「关于%CNAME("一人称")%的姐姐？」
PRINTFORML 「うーん、悪い人では無かばってん、%CNAME("一人称")%から見ると……」	PRINTFORML 「嗯、不包庇坏人、在%CNAME("一人称")%看来……」
PRINTFORM 「%TEXTR("朝になればいつでも消えてしまいそうな/出会った偶然を大事にしそうな/会話じゃない言葉だけを交わしとる/明日に怯えていそうな/誰かの為に生きられるなら何も怖く無さそうな/優しさに甘えなさそうな/一人でも傷ついた夢を取り戻しそうな/冷たい夜空の下で哀しくおどけていそうな/一人では消せない心の疼痛を持っとる/自由を持て余したくなさそうな/そのうち逃跑より先に不幸がまわってくる/無数の愛に囲まれてても心は一人きりな/時々黙りがちになる")%	PRINTFORM 「%TEXTR("到了早上好像随时都会消失的样子/珍惜相遇的偶然/只交换不像是对话的话/似乎在害怕明天/如果能为了谁而活着的话、就什么都不怕了/不会对人温柔撒娇的/即使一个人也能找回受伤的梦想/在冰冷的夜空下/一个人无法抹去的心痛/似乎不想太过自由/比不幸跑的更快/即使被无数的爱包围着、心还是孤独一人/时常变得沉默寡言。")%
PRINTFORMW 印象が%TEXTR("あろうね/あるやろね/あるかも/するばい/するかもしれん")%。」	PRINTFORMW %TEXTR("大概是这种的/有这种的/也许有这种的")%。印象深刻」
PRINTFORMW 「%CNAME("二人称")%、暇やったら幾つか護身術でも教えたろーか？」	PRINTFORMW 「有空的话教%CNAME("二人称")%几个护身术吧？」
PRINTFORML %CALLNAME:TARGET%はにこやかな表情を浮かべながら既に構えを取っている。本気だ…！	PRINTFORML %CALLNAME:TARGET%脸上浮现出笑容、已经做好了准备。看起来是认真的…！
PRINTFORMW %CALLNAME:MASTER%は色々と理由を付けてお断りした…	PRINTFORMW %CALLNAME:MASTER%带着各种各样的理由拒绝了…
PRINTFORMW 「大丈夫、実戦形式だから辛いかもしれんばってん、絶対身に付くけん。」	PRINTFORMW 「没关系、因为是实战形式、所以可能会很辛苦、但绝对会掌握的。」
PRINTFORMW %CALLNAME:MASTER%は取り敢えずお断りした…	PRINTFORMW 先拒绝了%CALLNAME:MASTER%…
CALL PRINT_STR, @"「……%TEXTR("身体は鍛えとっても損にならんけんね/これでも習慣化すると結構楽しかよ？/筋肉は一日にして成らず")%」_L"	CALL PRINT_STR, @"「……%TEXTR("身体即使锻炼也不会吃亏的/即使这样习惯化了也会很开心的吧？/肌肉一天也是练不成的。")%」_L"
PRINTFORMW 「……これ？　%CNAME("一人称")%の……日課」	PRINTFORMW 「……这个？%CNAME("一人称")%的……每天的功课。」
PRINTFORMW 「%CNAME("二人称")%ほど沢山の魂を持っとー訳じゃなかけん、训练は重要ばい……」	PRINTFORMW 「并不是说拥有像%CNAME("二人称")%那样多的灵魂、训练很重要……」
PRINTFORMW 「お、%CNAME("二人称")%も一緒にやる……？」	PRINTFORMW 「哦、%CNAME("二人称")%也一起做……？」
PRINTFORML 「……あのくさ、%CNAME("二人称")%はどのぐらい筋肉付いとるのが好み？」	PRINTFORML 「……那么、%CNAME("二人称")%喜欢很多肌肉吗？」
PRINTFORMW 「んや……、ちょっと聞いてみただけばってん。」	PRINTFORMW 「嗯……只是稍微问问而已。」
PRINTFORML 「」（かくかく扑鼻）	PRINTFORML 「」（扑鼻）
PRINTFORMW 寒さで会話どころではないようだ。	PRINTFORMW 冷得根本谈不上话。。
PRINTFORML 「……お、雪が降っとる。」	PRINTFORML 「……哦、下雪了。」
PRINTFORMW 「%CNAME("一人称")%の地元でも雪は降るばってん、ここまで多くは降らんね……。」	PRINTFORMW 「%CNAME("一人称")%的老家也总是下雪、到这里会不会也下很多雪呢……。」
PRINTFORMW 「ぅぅ……寒うて力が出らんばい。」	PRINTFORMW 「嗯……冷得浑身无力了快。」
PRINTFORMW 「%CNAME("哈娜")%は……よー外に出てらるーなぁ。」	PRINTFORMW 「%CNAME("哈娜")%是……ー出去了啊。」
PRINTFORMW 「冬が……近づいて来とるね。%CNAME("一人称")%は寒いの苦手ばい……」	PRINTFORMW 「冬天……就这么靠近了。%CNAME("一人称")%挺怕冷的……」
PRINTFORMW 「あー……これから余計さむーなるごたーね……」（かたかた扑鼻）	PRINTFORMW 「啊……今后就更少了……"咔哒咔哒扑鼻）
PRINTFORMW 「桜が綺麗かね……。」	PRINTFORMW 「樱花漂亮吗……。」
PRINTFORMW 「%CNAME("一人称")%の地元やと……、もう葉が出とる頃かいな？」	PRINTFORMW 「在%CNAME("一人称")%的老家……叶子应该已经长出来了吧？」
PRINTFORMW 「ちっとは暖かくなってきとるね……。」	PRINTFORMW 「天气渐渐暖和起来了呢……。」
PRINTFORMW 「ずっとこのぐらいだと……良かばってん。」	PRINTFORMW 「一直这样的话……也蛮不错啊。」
PRINTFORMW 「どうしたと、%CNAME("二人称")%？　……呼んでみただけ？」	PRINTFORMW 「怎么了、%CNAME("二人称")%？　……只是试着叫了一下？」
PRINTFORMW 「%CNAME("一人称")%の地元について……？」	PRINTFORMW 「关于%CNAME("一人称")%的老家……？」
PRINTFORMW 「美人が多いと聞くばってん……、実際どうなのやろね？」	PRINTFORMW 「一直听说美女很多……实际上又怎么样呢？」
PRINTFORMW 「%CNAME("一人称")%も美人ってや？………ふふっ。」	PRINTFORMW 「%CNAME("一人称")%也是美女吗？……嘻嘻嘻。」
PRINTFORMW 「茶葉の産地としては……他所の方が有名やね。」	PRINTFORMW 「作为茶叶的产地……其他地方比较有名呢。」
PRINTFORMW 「都会と田舎が適度に混ざった住みやすい所かな……？」	PRINTFORMW 「都市和乡下适度混合的适合居住的地方吧……？」
PRINTFORMW 「空気中を移動する物体の速度は直ぐに計算しきるばってん、星の公転速度がなー…。」	PRINTFORMW 「在空气中移动的物体的速度会马上计算出来、星星的公转速度是……。」
PRINTFORMW 「この思想の、○○という部分は勘違いが頻発する所かもしれんね。」	PRINTFORMW 「这种思想中、○○这个部分可能是错误频频发生的地方吧。」
PRINTFORMW 「一歩まちごーたら全然逆の意味になってしまうやん……」	PRINTFORMW 「一步之差、意思就完全相反了……」
PRINTFORMW 「秒速840mの物体の水平速度が2000mで秒速340mになると仮定した時、中間速度はおよそ秒速590m。」	PRINTFORMW 「假设秒速840m的物体的水平速度为2000米每秒340米、中间速度约为秒速590m。」
PRINTFORML 「（中略）3．39秒の間に物体が落下する距離（空気抵抗無視）	PRINTFORML 「（中略）3.39秒内物体落下的距离（无视空气阻力））
PRINTFORMW 　は『0．5×9．8×（3．39）＾2＝56．31［m］』であり………。」	PRINTFORMW 　是"0.5×9.8×（3.39）＾2＝56.31〔m〕"……。」
PRINTFORMW 「この歴史問題、无てこっちが正解なんやろか……？」	PRINTFORMW 「这个历史问题、没有什么是正确答案吗……？」
PRINTFORMW 「あーね、この学年ならそこまで習わんとか………」	PRINTFORMW 「啊、这个年级的话就要学习到那种程度……」
PRINTFORMW 「……物理、化学なら得意ばってん、地学が特に難しかー。」	PRINTFORMW 「……物理、化学都很擅长、地理学却学的特别难啊。」
PRINTFORMW 「岩の名前やら性質やら、一々覚えきらんもん………」	PRINTFORMW 「岩石的名字和性质、我都记不住了……」
PRINTFORM 「%CNAME("二人称")%、この本に書かれとる	PRINTFORM 「%CNAME("二人称")%、写在这本书上
PRINTFORMW ってどげな意味やろか？」	PRINTFORMW 这是什么意思？」
PRINTFORMW 「その式を使えば良かったとか。全然違う解き方しとったね……」	PRINTFORMW 「用那个公式就好了之类的。完全不同的解法呢……」
PRINTFORMW 「物理の勉強？%CNAME("一人称")%が一つ例題出したろーか。」	PRINTFORMW 「物理学习比较勉强？%CNAME("一人称")%出一个例题吧。」
PRINTFORMW 『気圧を1013hPa、外気温を華氏14度とした際、秒速850mをマッハ数で表しなさい』	PRINTFORMW 《气压为1013hPa、外部气温为华氏14度时、请以马赫数表示秒速850m》
PRINTFORMW 「%CNAME("二人称")%、ちょっと良かや？　ここがイマイチ理解出来とらんくてね……」	PRINTFORMW 「%CNAME("二人称")%、稍微好点吗？这一点还不能理解呢……」
PRINTFORMW 「なん、%CNAME("二人称")%にも分からんとね…？　そげなんでつまるもんかい………」	PRINTFORMW 「什么、%CNAME("二人称")%也不知道呢…？怎么能那么笨呢……」
PRINTFORMW 「うわぁ、%CNAME("一人称")%はこげん簡単なことも分からんくなりよるとか……」	PRINTFORMW 「哇、%CNAME("一人称")%变得连这么简单的事情都不知道了……」
PRINTFORMW 「ちょっと良か？ここがいっちょん分からんとばってん……」	PRINTFORMW 「好一点吗？完全搞不懂这里……」
PRINTFORMW 「……あら、文法ごと間違えとったとね。これは気付かんかったばい……」	PRINTFORMW 「……哎呀、连语法都弄错了。这个没注意到啊……」
PRINTFORMW 「この歴史に出てくるこいつ、個人的に嫌いなんよね……」	PRINTFORMW 「出现在这段历史上的这家伙、我个人很讨厌呢……」
PRINTFORMW 「%CNAME("二人称")%、周日の予定%TEXTR("空いとる/入っとる")%……？」	PRINTFORMW 「%CNAME("二人称")%、周日的预定%TEXTR("占下/确认")%……？」
PRINTFORMW 「この前言っとった、救出作戦に来てくれんやろか？」	PRINTFORMW 「之前说过了、可以来营救我吗?」
PRINTFORMW 「というのも、こないだ『工場地帯辺りを捜索しよう』っちゅう話になっとった……やろ？」	PRINTFORMW 「也就是说、前几天说了"搜索工厂地带附近"的话……不是吗？」
PRINTFORM 「ばってん、	PRINTFORM 「飞天、
PRINTFORM %CNAME("二人称")%のお母桑	PRINTFORM %CNAME("二人称")%的母亲桑
PRINTFORMW が誘拐組織の拠点を発見してくれとるらしいんよ。」	PRINTFORMW 好像是绑架组织的据点被发现了。。」
PRINTFORMW 「%CNAME("一人称")%は父桑の経営しとる警備会社の職員達と共に人質を救出しに行くけん、」	PRINTFORMW 「%CNAME("一人称")%和父亲桑经营的保安公司的职员们一起去营救人质。」
PRINTFORMW 「今度の周日、良かったら……一緒に来てくれんやろか？」	PRINTFORMW 「如果这个星期天可以的话……能一起来吗？」
PRINTFORMW 「%TEXTR("良かったら/暇しとーなら")%出掛けに行こうやー。」	PRINTFORMW 「%TEXTR("如果可以的话/如果有时间的话")%我们出去吧。」
PRINTFORMW 「……ありがとう、%CNAME("二人称")%。」	PRINTFORMW 「……谢谢你、%CNAME("二人称")%。」
PRINTFORMW 「学園から歩いて行ききる距離やけん、正門前で待ち合わせるばい。」	PRINTFORMW 「从学校步行到尽头的距离、在正门前等着吧。」
PRINTFORMW 「出来れば何処行くかも決めとってやー。」	PRINTFORMW 「如果可以的话也要决定去哪里。」
PRINTFORMW 「うん……分かった。」	PRINTFORMW 「嗯……我明白了。」
PRINTFORMW 「別に今すぐというわけでもないけん、予定が%TEXTR("空いとる/無か")%時は教えてやー……」	PRINTFORMW 「并不是现在马上、只是有预定%TEXTR("确定/无吗？")%时间告诉我吧……」
PRINTFORMW 『……ほぇ、今からげな！？』	PRINTFORMW 『……哎、现在开始啰!?"
PRINTFORMW 『そういうこたぁ少なくとも前の日に言うもんやろ…』	PRINTFORMW "这种事至少提前一天会说吧…"
PRINTFORMW 『わかった、準備が出来しだい行くけん待っとってー。』	PRINTFORMW "知道了、说是准备好了再去等。"
PRINTFORMW 「ん、今から行くと？」	PRINTFORMW 「嗯、现在去的话？」
PRINTFORMW 「ほんなら、準備するけん待っとってね。」	PRINTFORMW 「那就等着我准备吧。」
PRINTFORMW 「おっ……決めとった時間よりも早く来とるやん。」	PRINTFORMW 「哦……比规定的时间来得早。」
PRINTFORMW 「ほんじゃ、案内しちゃるばい。」	PRINTFORMW 「那么、我带你去吧。」
//ERB\EVENT_K\29 碧\EVENT_K29_SHOP.ERB
PRINTFORML 「%TEXTR("んん/おっ/おや/あら")%、%TEXTR("何/どうして欲しいと/どういう頼み/どんなお願い")%かいな？」	PRINTFORML 「%TEXTR("嗯/喔/哦呀/啊啦")%、%TEXTR("怎么了/想要什么吗/想拜托什么吗/有什么愿望吗")%？」
PRINTFORML 「%CNAME("二人称")%、どうしたと？」	PRINTFORML 「%CNAME("二人称")%、怎么了？」
PRINTFORML 「…%CNAME("一人称")%に出来る範囲で聞くけん。」	PRINTFORML 「在%CNAME("一人称")%力所能及的范围内的话听一听也无妨」
PRINTFORMW 「呼び名？……どう呼んで欲しいと？」	PRINTFORMW 「称呼？……你希望我怎么称呼你？」
PRINTFORMW 「『%CNAME("二人称")%』って呼べば良かとね。これからはそう呼ぶばい。」	PRINTFORMW 「『%CNAME("二人称")%』…想这样被称呼吗。那么以后就这么称呼你吧。」
PRINTFORMW 「%TEXTR("おっ/おや/あら/あっ")%、違うと？」	PRINTFORMW 「%TEXTR("喔/喔呀/啊啦/啊")%、不对吗？」
PRINTFORML 「うーん、悪い気持ちはせんばってん、%CNAME("二人称")%の	PRINTFORML 「唔—、虽然并不是很讨厌、但是关于%CNAME("二人称")%的事情
PRINTFORMW 　ことをまだ%CNAME("一人称")%が上手く分かっとらんとよねー。」	PRINTFORMW %CNAME("一人称")%至今为止还不是很了解。」
PRINTFORML 「……うん、気持ちは嬉しいばってん、	PRINTFORML 「……嗯、虽然很开心、
PRINTFORMW 　%CNAME("一人称")%自身%TEXTR("の考えが定まっとらんけん/にも立場があるけん")%ね……。」	PRINTFORMW 但是%CNAME("一人称")%也有着%TEXTR("自己的想法/自己的立场呢")%……」
PRINTFORMW 「%TEXTR("それ本当かいな…。/もっと他に良か人おろーもん…？/まだ心の準備が出来とらんばい……。")%」	PRINTFORMW 「%TEXTR("这是真的么…/或许还有更好的人…/那个、我可能还没有做好心理准备……")%」
PRINTFORMW 「ご、ごめん%CNAME("二人称")%。%CNAME("一人称")%、今は都合が悪いけん…。」	PRINTFORMW 「对、对不起。%CNAME("一人称")%、%CNAME("一人称")%现在不方便……」
PRINTFORMW 「うーん、流石に無いもんは無理ばい……。」	PRINTFORMW 「唔、果然没有的东西也根本无法给你……」
PRINTFORMW 「い、今は履いとらんけん…、ぃゃー言わせんといてー……。」	PRINTFORMW 「现、现在没有穿着…不小心就说出来了…」
PRINTFORMW 「な、何言っとーと……！？」	PRINTFORMW 「说、说什么呢……！？」
PRINTFORMW 「お弁当はちと自信なかよ。」	PRINTFORMW 「便当么、没有做那种东西的自信啊」
PRINTFORMW 「%CNAME("二人称")%の好いとう味が分からんけんね……。」	PRINTFORMW 「不知道%CNAME("二人称")%喜欢什么味道呢……」
PRINTFORMW 「%CNAME("一人称")%のお弁当、気に入ったとかいな。」	PRINTFORMW 「听说你喜欢%CNAME("一人称")%的便当呢」
PRINTFORMW 「それならまた作ったげるばい。」	PRINTFORMW 「那下次再为%CNAME("二人称")%做吧」
PRINTFORMW 「まぁ、一緒に住んどっちゃけん、作ってもよかよ。」	PRINTFORMW 「嘛、一起住的话、试试看也行啊」
PRINTFORMW 「うん、頑張って作っちゃーよ。」	PRINTFORMW 「嗯、会努力的」
PRINTFORMW 「%CNAME("二人称")%の舌に合うかどーかは知らんばってん…。」	PRINTFORMW 「不知道合不合%CNAME("二人称")%的胃口……」
PRINTFORMW 「……なしてそげな不思議そうな顔ばしよっと？」	PRINTFORMW 「怎么露出那种不可思议的表情？？」
PRINTFORMW 「%CNAME("一人称", "どもり")%だってお弁当ば作りきぃとばい？」	PRINTFORMW 「是%CNAME("一人称", "どもり")%做的便当很奇怪吗？」
PRINTFORMW 「ごめん、それは出来んとよ…」	PRINTFORMW 「对不起、我做不到……」
PRINTFORMW 「えー…、それは困るばい。」	PRINTFORMW 「诶…那样的话稍微有些困扰」
PRINTFORMW 「ごめんばってん、やだ。」	PRINTFORMW 「对不起、%CNAME("一人称")%拒绝」
PRINTFORMW 「もう、しょんなかー…」	PRINTFORMW 「真是的、真拿%CNAME("二人称")%没有办法」
PRINTFORMW 「おぉ、分かったー。」	PRINTFORMW 「哦、知道了」
PRINTFORMW 「そげんことなら良かよー。」	PRINTFORMW 「如果是这样的话好吗？」
PRINTFORMW 「流石に水着で外出はあｋ」	PRINTFORMW 「就这样穿着泳衣出来了」
PRINTFORMW 「あ、待って%CNAME("二人称")%、置いてけぼりにせんといてー……」	PRINTFORMW 「啊、等一下、%CNAME("二人称")%、不要丢下%CNAME("一人称")%一个人啊……」
PRINTFORMW 「まぁ、泳装とかよりはマシやろばってん……」	PRINTFORMW 「嘛、比起游泳装什么的、我更擅长游泳……」
PRINTFORMW 「%CNAME("一人称")%はもうやばいと思う…」	PRINTFORMW 「%CNAME("一人称")%想%CNAME("一人称")%已经变成一个变态了…呜...」
PRINTFORMW 「せめて上に何か着るべきばい。」	PRINTFORMW 「至少应该在上身穿点什么啊」
PRINTFORMW 　%CALLNAME:MASTER%は%CALLNAME:TARGET%の手を掴んで强行出かけました。	PRINTFORMW 　%CALLNAME:MASTER%抓住%CALLNAME:TARGET%的手强行出去了。
PRINTFORML 「嫌ぁー。%CNAME("一人称")%を凍え死なす気かぁー……」	PRINTFORMW 「讨厌啊。%CNAME("一人称")%这感觉要冻死了啊……」
//ERB\EVENT_K\29 碧\EVENT_K29_片峰碧.ERB
LOCALS = ぼく_ぼく	LOCALS = 僕_僕
LOCALS = 部長_ぶちょう	LOCALS = 部长_部长
LOCALS = %CALLNAME:PLAYER%くん_%CALLNAME:PLAYER%くん	LOCALS = %CALLNAME:PLAYER%君_%CALLNAME:PLAYER%君
LOCALS = %CALLNAME:PLAYER%ちゃん_%CALLNAME:PLAYER%ちゃん	LOCALS = %CALLNAME:PLAYER%酱_%CALLNAME:PLAYER%酱
LOCALS = %CALLNAME:PLAYER%先輩_%CALLNAME:PLAYER%せんぱい	LOCALS = %CALLNAME:PLAYER%先輩_%CALLNAME:PLAYER%前辈
LOCALS = %CALLNAME:PLAYER%先生_%CALLNAME:PLAYER%せんせい	LOCALS = %CALLNAME:PLAYER%先生_%CALLNAME:PLAYER%老师
LOCALS = %CALLNAME:ASSI%くん_%CALLNAME:ASSI%くん	LOCALS = %CALLNAME:ASSI%君_%CALLNAME:ASSI%君
LOCALS = %CALLNAME:ASSI%ちゃん_%CALLNAME:ASSI%ちゃん	LOCALS = %CALLNAME:ASSI%酱_%CALLNAME:ASSI%酱
LOCALS = %CALLNAME:ASSI%先輩_%CALLNAME:ASSI%せんぱい	LOCALS = %CALLNAME:ASSI%先輩_%CALLNAME:ASSI%前辈
LOCALS = %CALLNAME:ASSI%先生_%CALLNAME:ASSI%せんせい	LOCALS = %CALLNAME:ASSI%先生_%CALLNAME:ASSI%老师
あなたの同級生で、某県からの転校生。	你的同级生、是来自某县的转校生。
地元で起こっている集団行方不明事件の調査をしているらしい。	好像是在调查当地发生的集体失踪事件。
PRINTFORMW 「（『悪魔と契約しても平気な人がいる』って聞いたとばってん…）」	PRINTFORMW 「（听说了『有即使与恶魔签订契约也不在乎的人』这样的传闻才来的……）」
PRINTFORMW 「（ここ何の部活かいな、活動内容は…？）」	PRINTFORMW 「（这是什么社团啊、活动内容是……？）」
PRINTW 「……あのくさ、もしかして…あなたが部長さんかいな？」	PRINTW 「……什么东西、难道……你就是部长吗？」
PRINTW 突然、部室に黒髪ポニテの同級生が入り込んで来た……	PRINTW 一头黑发、扎着马尾的一位同学突然进入了活动室……
PRINTFORML 「…%CNAMET(ARG, "一人称")%は%NAME:ARG%って言うっちゃん」	PRINTFORML 「…%CNAMET(ARG, "一人称")%叫%NAME:ARG%」
PRINTFORMW %NAME:ARG%。ここからだいぶ離れた県からの転校生だ。	PRINTFORMW %NAME:ARG%。是从离这里很远的县转校过来的学生。
PRINTFORMW どうやらかなり慌てているようだが……	PRINTFORMW 看起来好像很着急的样子……
PRINTFORML 「最近、1日で10人前後の若い子が一度に行方不明になる事件が数ヶ月に一度起こっとるとよね」	PRINTFORML 「从前段时间开始、每几个月就会发生一天之内10人左右的年轻人同时失踪的事件」
PRINTFORMW 「%CNAME("一人称")%の姉ちゃんも巻き込まれとるとよ・・・」	PRINTFORMW 「%CNAME("一人称")%的姐姐也被卷了进去」
PRINTW そう言えば、碧の地元で大規模な行方不明事件が発生しており、	PRINTW 说起来、碧所在的当地好像是发生了大规模失踪事件、
PRINTFORMW 悪魔や魔術が絡んでいる可能性があると%NAME:FINDCHARA(NO, 20)%から聞いていた。	PRINTFORMW 从%NAME:FINDCHARA(NO, 20)%那里听说这事可能是与恶魔或者魔法什么的有关系。
PRINTW 「うん…確かに、悪魔ば絡んどると突き止めたばって、なして知っとーと？」	PRINTW 「嗯……确实、我想要找到恶魔、然后阻止他、这方面的你有头绪吗？」
PRINTW 「うん…確かに、魔術ば絡んどると突き止めたばって、なして知っとーと？」	PRINTW 「嗯……确实、我想要找到和魔術有关系的地方、然后去阻止他、这方面的你有头绪吗？」
PRINTFORML 「………あぁ、あの執事ちゃんから。それなら話は早かね。」	PRINTFORML 「……啊、这些是从执事那里听来的。说来话长呢」
PRINTFORMW 悪魔や魔術が絡んでいる可能性があると%NAME:FINDCHARA(NO, 1)%から聞いていた。	PRINTFORMW 从%NAME:FINDCHARA(NO, 1)%那里听说这事可能是与恶魔或者魔法什么的有关系。
PRINTFORML 「………あぁ、あのメイドちゃんから。それなら話は早かね。」	PRINTFORML 「……啊、这些是从女仆那里听来的。说来话长呢」
PRINTW 「その事件の解決に、協力して欲しーとばってん……」	PRINTW 「希望你能协助我、把这个事件解决……」
PRINTFORMW 「………なに、条件として『%CNAME("一人称")%の体が欲しい』とね？」	PRINTFORMW 「……什么、作为条件『想要%CNAME("一人称")%的身体』呢？」
PRINTW 「んー……、生贄的な意味じゃないなら良かばってん……。」	PRINTW 「唔……如果不是指为事业牺牲死去的意思那也还行吧……」
PRINTFORMW %CALLNAME:ARG%があなたの部活動に加わった。	PRINTFORMW %CALLNAME:ARG%加入了你的社团活动。
PRINTFORML そこそこ整頓されているが、本棚はジャンルがバラバラに並んでいる。	PRINTFORML 能看出来有整理过。但是书架上书籍的种类依旧七零八落地排列着。
PRINTFORML ベッド下には何か取り付けられているようだが暗くてよく分からない。	PRINTFORML 床底下好像有什么东西、但是太暗了看不太清楚。
PRINTFORMW 「ん…、す、するとー？」	PRINTFORMW 「嗯……呜、要做、做……」
PRINTFORMW %CALLNAME:TARGET%は緊張しているとも警戒しているとも見えるような表情を浮かべている…	PRINTFORMW %CALLNAME:TARGET%脸上浮现出了紧张与警戒的表情……
PRINTFORMW しかし、%CALLNAME:PLAYER%が%CALLNAME:TARGET%を抱き寄せようとする前に、自分から抱きついてきた。	PRINTFORMW 可是、在%CALLNAME:PLAYER%打算抱住%CALLNAME:TARGET%之前、反而被主动抱住了。
PRINTFORMW 「こげな可愛か子に『体が欲しい』って言われたっちゃ、%CNAME("一人称")%も嬉しかばい……♪」	PRINTFORMW 「被可爱的孩子说‘想要身体’之类的的话、%CNAME("一人称")%也很高兴呢……♪」
PRINTFORMW 「%CNAME("一人称")%みたいな変な子の何処を好いとーかいな…。」	PRINTFORMW 「像%CNAME("一人称")%一样奇怪的孩子、该去哪里好呢…」
PRINTFORMW 「まぁ……自信は無いばってん、心の準備は出来とーばい。」	PRINTFORMW 「嘛……没有自信吗、要做好心理准备呐。」
PRINTFORMW 「でも、%CNAME("一人称")%はこういう経験が無かけん、優しくして欲しかよ…。」	PRINTFORMW 「但是、%CNAME("一人称")%没有这样的经验呜、希望能温柔一点……」
PRINTFORMW 「%CNAME("一人称", "どもり")%、もうだめぽ……」	PRINTFORMW 「%CNAME("一人称", "どもり")%、已经不行了呢、哈……」
PRINTFORMW 「もうめんどうみきれよう。」（がくり）	PRINTFORMW 「真是麻烦死了啦。」（がくり）
CALL PRINT_STR, @"「%TEXTR("ぁっ…あぁっ…/っは……/もう無理……ばぃ。")%」_L"	CALL PRINT_STR, @"「%TEXTR("啊…啊…/诶……/已经不行了……。")%」_L"
CALL PRINT_STR, @"%CALLNAME:TARGET%は%TEXTR("力なく横たわっている/あからさまに疲労困憊している")%……。_L"	CALL PRINT_STR, @"%CALLNAME:TARGET%は%TEXTR("无力地躺着/疲软地忍耐着疲劳")%……。_L"
PRINTFORMW 不良在庫の山を前に、%CALLNAME:MASTER%と%CALLNAME:TARGET%は頭を抱えた…	PRINTFORMW 在堆积成山的不良库存前、%CALLNAME:MASTER%和%CALLNAME:TARGET%抱住了脑袋……
//EVENT_K29_LONG.ERB
PRINTFORMW 話は今朝に遡る……	PRINTFORMW 这话要追溯到今天早上……
PRINTFORMW 朝、%CALLNAME:MASTER%が%CALLNAME:TARGET%と共に登校していた時であった。	PRINTFORMW 早上、%CALLNAME:MASTER%和%CALLNAME:TARGET%一起上学的时候。
PRINTFORMW 「誘拐犯から逃げ出せた子がおって、話ば聞いてきたばってん、」	PRINTFORMW 「听说有从绑架犯那里逃出来的孩子传出的流言」
PRINTFORMW 「その犯人は変な形の杖を持っとるとげな。」	PRINTFORMW 「那个犯人还携带着奇怪形状的拐杖。。」
PRINTFORMW 「ほら、丁度あんな感じの………　　　おるやん！」	PRINTFORMW 「你看、正好是那种感觉……在那！」
PRINTFORMW %CALLNAME:TARGET%が指差した先には確かに変な形の杖を持った人物が居た。	PRINTFORMW %CALLNAME:TARGET%指向的前方确实有一个手持奇怪形状拐杖的人。
PRINTFORML 謎の人物は%CALLNAME:MASTER%達に気付いたらしく、	PRINTFORML 神秘的人物似乎注意到了%CALLNAME:MASTER%们、
PRINTFORMW 何やら呪文を呟くと共に杖を振り上げると白い煙が辺りを覆った。	PRINTFORMW 一边嘟囔着咒语、一边举起拐杖、白烟笼罩了四周。。
PRINTFORML %CALLNAME:MASTER%は放たれた白い煙を危険なものだと直感し、	PRINTFORML %CALLNAME:MASTER%的直觉告诉自己发出的白烟是危险的、
PRINTFORMW 鼻と口を塞ごうとしたが間に合わず、その場で意識を失った……。	PRINTFORMW 想要堵住鼻子和嘴、但却来不及、当场失去了意识……。
PRINTFORMW 「%CNAME("二人称")%、おはよー。」	PRINTFORMW 「%CNAME("二人称")%、早上好。」
PRINTFORMW %CALLNAME:TARGET%の声で目が覚めると、そこは保健室だった。	PRINTFORMW 听到%CALLNAME:TARGET%的声音醒来、发现这里是保健室。
PRINTFORMW 話によると、魔術に抵抗出来た%CALLNAME:TARGET%は	PRINTFORMW 据说、能够抵抗魔术的%CALLNAME:TARGET%
PRINTFORMW 次の魔術が放たれる前に実行犯を縛り上げ、	PRINTFORMW 在下一个魔术被释放之前将实行犯束缚了起来、
PRINTFORMW %CALLNAME:MASTER%が倒れる前後に携帯で撮った証拠映像と共に	PRINTFORMW 将%CALLNAME:MASTER%倒下前后用手机拍下的影像证据一起
PRINTFORMW 実行犯を最寄りの交番へ引き渡したそうだ。	PRINTFORMW 据说把罪犯交给了最近的派出所。。
PRINTFORMW 「ほら、早よ教室行かんと授業ば始まるばい…。」	PRINTFORMW 「看、早上不去教室的话就要开始上课了哦…。」
PRINTFORML なお、その日最初の授業に	PRINTFORML 还有、那天的第一堂课
PRINTFORMW （超絶にギリギリだったとは言え）間に合ったのはもう一つの幸いだった。	PRINTFORMW (虽说是超绝的勉强)赶上了真是另一个万幸啊。
PRINTFORML 選択肢の部分まで飛ばしますか？	PRINTFORML 要跳过选项吗？
PRINTFORML [0] はい	PRINTFORML [0]是
PRINTFORML [1] いいえ	PRINTFORML [1]否
PRINTFORMW 昼の出来事……	PRINTFORMW 白天发生的事……
PRINTFORML 昼休みに、部室近くだが本来使われていないはずの個室を覗いてみると、	PRINTFORML 午休的时候、去了房间附近本来不用的一个单间、
PRINTFORMW 誰かと%CALLNAME:TARGET%が机越しに向かい合う形で座っていた。	PRINTFORMW 不知是谁和%CALLNAME:TARGET%隔着桌子坐在对面。
PRINTFORMW 「あ、%CNAME("二人称")%。丁度よか所に来れたね。」	PRINTFORMW 「哦、是%CNAME("二人称")%啊。你来得正好。」
PRINTFORMW 「こないだ言っとった『誘拐犯から逃げ出せた子』と話をしとったとよ。」	PRINTFORMW 「之前说的"从绑架犯中逃出来的孩子"。」
PRINTFORMW 「その名前は小団扇 倖帆（こうちわ さちほ）。風紀委員の一人ばい。」	PRINTFORMW 「那个人名字叫小团扇 幸帆（こうちわ さちほ）。是风纪委员的一员。」
PRINTFORMW 「逃げ出せたとは言うばってん、全くの無事っちゅうわけでもないったいね…。」	PRINTFORMW 「虽说是逃出来了、其实也不是完全没事……。」
PRINTFORML その小団扇という人物は、腰まである長い黒髪を二つお下げにしており、	PRINTFORML 那个叫小团扇的人、长到腰的黑发留了两个辫子、
PRINTFORMW 眼鏡が似合う大人しげな美少年のように見えた。	PRINTFORMW 看起来像很适合戴眼镜的成熟美少年。
PRINTFORML 小団扇 倖帆	PRINTFORML 小团扇 幸帆
PRINTFORMW 「・・・と上記で言われてますが、私は元々女性ですからね！？」	PRINTFORMW 「・・・虽然上面的人这么说、但是我本来就是女性！？」
PRINTFORML 小団扇はその容姿に違わないソプラノテノールめいた声で	PRINTFORML 小团扇的声音和女高音的声音一样
PRINTFORMW 地の文にツッコミを入れつつ、学生証を%CALLNAME:MASTER%に見せた。	PRINTFORMW 一边吐槽着、一边让%CALLNAME:MASTER%看到下学生证。
PRINTFORML 学生証の顔写真は面影こそあれど、顔全体に女性的な丸みと平たさがあり、	PRINTFORML 学生证的面部照片虽然有面影、但整体上却有女性般的圆润和平坦、
PRINTFORMW まるで別人のようにさえ見える……	PRINTFORMW 看起来简直就像是另一个人一样……
PRINTFORML 小団扇の話によると、当時は学校周辺で見回り活動を行っており、	PRINTFORML 据小团扇说、当时是在学校周边进行着巡视活动、
PRINTFORMW そこで不審な人物を見かけた瞬間に気を失って連れ去られてしまったという。	PRINTFORMW 据说在那里看到可疑人物的瞬间就失去意识并被带走了。。
PRINTFORML 攫われた先では人体実験のようなものが無理矢理行われていて、	PRINTFORML 在被拐走的地方强行进行着人体实验、
PRINTFORMW 小団扇を含め何人かの人々が男女を問わず美少年の姿に改造されたとのこと。	PRINTFORMW 包括小团扇在内的几个人、不论男女都被改造成美少年的样子。
PRINTFORMW その際ある人が人体実験を拒んで物凄く暴れ出した為、そのどさくさに紛れて	PRINTFORMW 当时有人拒绝进行人体实验、结果引起了很大的骚动。
PRINTFORMW 多くが逃げ始めたが、改造された人のうち逃げ出せたのは小団扇だけだった。	PRINTFORMW 虽然有很多人开始逃跑、但是改造后的人中能逃出来的只有小团扇。
PRINTFORML まだ改造されていない人たちは殆どが逃げ出せたものの、	PRINTFORML 而还没有改造的人大部分都逃了出来、
PRINTFORMW 事件を怖がっている為か、その多くは不登校になっているそうだ……。	PRINTFORMW 也许是因为害怕这个事件吧、据说很多人都不去上学了……。
PRINTFORML 小団扇	PRINTFORML 小团扇
PRINTFORMW 「建物を出た先は工業地帯のようになっていて、」	PRINTFORMW 「从建筑物出来的地方是一个工业地带、」
PRINTFORMW 「道なりに進むとすぐに学園の校舎が見えました。」	PRINTFORMW 「沿着道路走、很快就能看到学校的校舍。」
PRINTFORMW 「この学園付近且つ、工業地帯の学園方向つったら…この辺りかいな？」	PRINTFORMW 「在这个学园附近而且是工业地带的学园方向…这附近吗？」
PRINTFORMW %CALLNAME:TARGET%は学園周辺の地図の一部に丸を付けた。	PRINTFORMW %CALLNAME:TARGET%在学园周边的地图上画了一个圆圈。
PRINTFORMW 今度はその範囲をしらみ潰しに探すことになりそうだ……。	PRINTFORMW 这次好像要把那个范围内彻底地探查……。
PRINTFORMW その時、%CALLNAME:ACTOR%が駆けつけ、%CALLNAME:MASTER%の耳元で囁いた。	PRINTFORMW 这时、%CALLNAME:ACTOR%赶来、在%CALLNAME:MASTER%的耳边喃喃私语。
PRINTFORML %CALLNAME:ACTOR%曰く、小団扇に施された人体改造は	PRINTFORML %CALLNAME:ACTOR%说、用小团扇进行的人体改造
PRINTFORMW 魂の取引を行えば元に戻すことが可能らしい。	PRINTFORMW 如果进行魂交易的话、似乎可以恢复原状。。
PRINTFORMW 「こ、この度はありがとうございました。」	PRINTFORMW 「那么这次就谢谢您了。」
PRINTFORMW 「私からは何も出来ませんが、事件の解決を応援しています・・・。」	PRINTFORMW 「虽然我什么都做不了、但我会支持帮助解决案件的……。」
PRINTFORMW しかし今は、その為に使う%CALLNAME:MASTER%の魂が足りないようだ…。	PRINTFORMW 但是现在、为了这个而使用的%CALLNAME:MASTER%的灵魂好像不够……。
PRINTFORML 小団扇を女性に戻しますか？	PRINTFORML 把小团扇还原成女性吗？
PRINTFORML [0] はい（魂－１。※後々のイベント内容が変わります）	PRINTFORML [0]是（魂 1）。※之后的活动内容会发生变化）
PRINTFORML [1] いいえ（保留となります）	PRINTFORML [1]不（保留魂））
PRINTFORMW 「ほ、本当に治るんですか！？」	PRINTFORMW 「真的能治好吗！？」
PRINTFORMW 小団扇は今にも嬉し泣きしそうな顔で喜んでいる。	PRINTFORMW 小团扇高兴得快要哭出来了。
PRINTFORMW 「では、そのままお待ち下さい。数分で終わりますので…。」	PRINTFORMW 「那么、请就这样等着。几分钟就会结束了…。」
CALL PRINT_STRW, @"黄色_小団扇が完治しました"	CALL PRINT_STRW, @"黄色_小团扇完全治好了"
CALL PRINT_STRW, @"黄色_%CALLNAME:TARGET%の信頼Lvが上がりました"	CALL PRINT_STRW, @"黄色_%CALLNAME:TARGET%的信赖等级上升了"
PRINTFORMW 「……お、みんな集まっとるね。この地下ばい。」	PRINTFORMW 「啊、大家都聚在一起、在这个地下卖场。」
PRINTFORML 学園付近の廃工場の一つに到着した。	PRINTFORML 到了学校附近的一个废弃工厂。
PRINTFORMW この地下に誘拐組織の拠点が有るらしい。	PRINTFORMW 这个地下好像有绑架组织的据点。
PRINTFORMW 廃工場前には、作業着の上に分厚いベストを着た人々が集まっている…	PRINTFORMW 废弃工厂前、工地上聚集着穿着厚厚的马甲的人们…
PRINTFORMW その内の一人が話し掛けてきた。	PRINTFORMW 其中一个人向我搭话了。。
PRINTFORMW 「久しぶり、%CALLNAME:TARGET%。隣に居るのが父さんの言ってた『リザレクション』能力者かな？」	PRINTFORMW 「好久不见、%CALLNAME:TARGET%。在旁边的人是爸爸说的"Rethering"（译者注：大概代指主角的魂回复能力）能力者吗？」
PRINTFORMW 「お、お姉ちゃん……　全っ然行方不明になっとらんやん。」	PRINTFORMW 「是、是姐姐……不是应该完全下落不明了吗。」
PRINTFORMW なんと、こちらに話し掛けてきたのは%CALLNAME:TARGET%の姉であった。	PRINTFORMW 和我搭话的竟然是%CALLNAME:TARGET%的姐姐。
PRINTFORML %CALLNAME:TARGET%の姉	PRINTFORML %CALLNAME:TARGET%的姐姐
PRINTFORMW 「ごめん、つい最近まで身を隠してたのよね。」	PRINTFORMW 「对不起、一直隐瞒到最近吧。」
PRINTFORMW 「その誘拐組織が片峰家に因縁を持ってるらしくて…」	PRINTFORMW 「那个绑架组织好像和片峰家有因缘…」
PRINTFORML %CALLNAME:TARGET%の姉曰く、片峰家が調査済みの情報と	PRINTFORML %CALLNAME:TARGET%的姐姐说、片峰家调查完毕的情报和
PRINTFORMW %CALLNAME:MASTER%の通う学園で入手した情報を照らし合わせた結果、	PRINTFORMW 对照在%CALLNAME:MASTER%所在的学园得到的情报的结果、
PRINTFORMW 誘拐を行っていた組織は魔術犯罪組織『カーキラス』であることが判明した。	PRINTFORMW 进行绑架的组织被证明是魔术犯罪组织"卡基拉斯"（Kerkylas）。
PRINTFORMW この組織は現在の片峰家で行っている魔術研究の妨害を行っているらしく、	PRINTFORMW 这个组织似乎在妨碍现在的片峰家进行的魔术研究、
PRINTFORML その被害を防ぐ為に%CALLNAME:TARGET%の姉は自ら行方不明扱いとなり、	PRINTFORML 为了防止受害、%CALLNAME:TARGET%的姐姐自己被当做失踪处理、
PRINTFORMW その間、研究室をF県の山奥へ移設していたのだ。	PRINTFORMW 在那期间、研究室搬到了F县的深山里。。
PRINTFORMW 「そう言えば自己紹介が遅れたね、僕は片峰 珪。」	PRINTFORMW 「这么说来自我介绍有点晚了、我是片峰珪。」
PRINTFORMW 「そしてここに集まってるのは警備会社『片峰セキュリティ』の特殊実働隊だよ。」	PRINTFORMW 「然后聚集在这里的是警备公司"片峰安全"的特别行动队。。」
PRINTFORMW 「実質上の私兵やね……ばって、魔術犯罪組織が相手ならしょんなかろーね。」	PRINTFORMW 「实际上是私兵……对了、有魔术犯罪组织这种对手的话就没办法了。」
PRINTFORMW その時、特殊実働隊の一人がハンドシグナルを送ってきた。	PRINTFORMW 这时、一个特别行动队队员发来了信号。
PRINTFORMW どうやら突入の準備が完了したらしい…	PRINTFORMW 看来突入的准备已经完成了…
PRINTFORML 珪（%CALLNAME:TARGET%の姉）	PRINTFORML 珪（%CALLNAME:TARGET%的姐姐）
PRINTFORMW 「よし、『カーキラス』の連中には気付かれていないようだ。今のうちに突入しよう。」	PRINTFORMW 「好吧、好像没有被《卡基拉斯》里的人注意到。趁现在闯进去吧。」
PRINTFORMW 珪は突入の指示を出した。	PRINTFORMW 珪发出了突入的指示。。
PRINTFORMW 早速、地下へ繋がるドアを特殊実働隊がこじ開け始めた…	PRINTFORMW 特别行动队马上开始撬开通往地下的门…
PRINTFORMW 結果を先に言うならば、救出作戦は余りにも呆気なく成功した。	PRINTFORMW 如果先把结果说出来、营救行动进行的非常顺利。
PRINTFORML 暫くして「警視庁神秘事件対処部隊」も駆け付けたが	PRINTFORML 不久、"警视厅神秘事件处理部队"也赶到了现场。
PRINTFORMW 到着した時には既に全員の救出が完了していた。	PRINTFORMW 到了这个时候、已经把全部的人都救出来了。
PRINTFORML やたら髪の毛がフサフサな謎のオッサン	PRINTFORML 头发乱蓬蓬的神秘大叔
PRINTFORMW 「おい！お前ら何やってんだ！痛い！止めろ！法廷で告発するぞ！私には政府とのパイプｍ」	PRINTFORMW 「喂！你们在干什么！好痛！住手！我要在法庭上告发你！我可是和政府有联系!」
PRINTFORML 警視庁神秘事件対処部隊の一人	PRINTFORML 警视厅神秘事件应对部队的某人
PRINTFORMW 「な、なんなんだこのオッサンは‥‥」	PRINTFORMW 「什、这大叔怎么会……」
PRINTFORMW 「『カーキラス』の幹部格だ。表ではそこそこの資産家だとか。」	PRINTFORMW 「他是《卡其拉斯》的干部。表面上还算是个资本家。」
PRINTFORMW 兎にも角にも、『カーキラス』の幹部や構成員たちは悉く警察にしょっ引かれた。	PRINTFORMW 不管怎么说、《卡基拉斯》的干部和成员们都被警察逮捕了。
PRINTFORMW その後、特に捜査への圧力が掛かることは無かったようだ…	PRINTFORMW 在那之后、似乎并没有对搜查施加特别的压力……
PRINTFORML 救出された人々は、護国機関が秘密裏に治療を行ったのち	PRINTFORML 被救出的人们、在护国机关秘密进行了治疗之后
PRINTFORMW 本来の住所へ引き渡されることとなった。	PRINTFORMW 被移交给原来的住址。
PRINTFORMW 「…そして、片峰セキュリティのことについては警察が伏せてくれるだろうね。」	PRINTFORMW 「……而且、关于片峰家的安全人员的问题、警察会隐瞒的吧。」
PRINTFORMW %CALLNAME:MASTER%と%CALLNAME:TARGET%はそろそろ帰路につくことにした。	PRINTFORMW %CALLNAME:MASTER%和%CALLNAME:TARGET%差不多该回去了。
PRINTFORMW 珪は%CALLNAME:TARGET%の姿が見えなくなるまでずっと手を振って見送ってくれていた……	PRINTFORMW 珪一直挥手目送我们直到看不见%CALLNAME:TARGET%的身影……