
//文件: EVENT_K33_COMM.ERB
CALL PRINT_STR, @"『鈴ちゃんはちっちゃくてかわいいねー…_WH_』_W"	CALL PRINT_STR, @"『铃酱小巧的很可爱呀…_WH_』_W"
PRINTFORMW 『もし私に妹がいたらこんな感じだったのかな…』	PRINTFORMW 『如果我有妹妹的话，大概会是这样的感觉吧…』
PRINTFORMW 「鈴も…綾乃お姉さんが、本当のお姉さんだったらいいなって思います……」	PRINTFORMW 「鈴也觉得…綾乃姐姐是、真正的姐姐的话就好了……」
PRINTFORMW 『ふふ、だめだよ…私がお姉さんだったら、こーんな尻尾が生えてるんだよ…？そんなのいやでしょ…？』	PRINTFORMW 『呼呼、这样不行哟…如果我是姐姐的话、会长出这——样的尾巴哦…？你讨厌那样吧…？』
PRINTFORMW 「お姉さんとお揃いなら…鈴はうれしいです……」	PRINTFORMW 「和姐姐一样的话…铃也会高兴的……」
CALL PRINT_STR, @"『じゃあ、今度鈴ちゃん用の尻尾を用意してあげようかな…_WH_』_W"	CALL PRINT_STR, @"『那、下次给铃酱准备专用的尾巴吧…_WH_』_W"
PRINTFORMW 「綾乃お姉さんは、やさしくて…かわいくて……」	PRINTFORMW 「綾乃姐姐又温柔…又可爱……」
PRINTFORMW 「おっぱいも大きくて…えっちな事をいっぱい知ってて……」	PRINTFORMW 「胸部也很大…H的事情也知道很多……」
PRINTFORMW 「…鈴、お姉さんが羨ましいです……」	PRINTFORMW 「…鈴、很羡慕大姐姐……」
CALL PRINT_STR, @"『そう？ありがとう…_WH_』_W"	CALL PRINT_STR, @"『是吗？谢谢…_WH_』_W"
PRINTFORMW 『でも、私も鈴ちゃんが羨ましいなって思う所、あるんだよ…？』	PRINTFORMW 『但是，铃酱也有让我羡慕的地方哟…？』
PRINTFORMW 「え…？そんなの、鈴にありますか……？」	PRINTFORMW 「诶…？那种地方，铃有吗……？」
PRINTFORMW 『鈴ちゃんは、後輩くんが初めての人だよね…？』	PRINTFORMW 『鈴酱的话、后辈君是第一次的对象吧…？』
PRINTFORMW 『きっと後輩くんじゃなかったら、鈴ちゃんを満足させる事が出来ないと思うし…』	PRINTFORMW 『肯定如果不是后辈君的话、我觉得是无法让铃酱满足的…』
PRINTFORMW 『以前の私みたいに男の子をとっかえひっかえする必要があったと思うの…』	PRINTFORMW 『我觉得有必要像以前的我那样紧紧的抓住男孩子哦…』
PRINTFORMW 『でも…それだと気持ち良くなれるのは体ばっかりで、心はあんまり、ね…？』	PRINTFORMW 『但是…那样的话就只能让身体舒服起来、心里的话就不太舒服、你懂吧…？』
PRINTFORMW 「綾乃お姉さん……」	PRINTFORMW 「綾乃姐姐……」
PRINTFORMW 『ふふ…ちょっと暗かったかな…ごめんね？』	PRINTFORMW 『呼呼…话题稍微有点阴暗了…抱歉呢？』
PRINTFORMW 『それにね、男の子はえっちな事を知らないコを自分好みにするのも好きだから…』	PRINTFORMW 『而且呢、男孩子也有爱好懵懂无知的孩子那一类哦…』
CALL PRINT_STR, @"『えっちな事をあまり知らないってのも…鈴ちゃんの魅力のひとつなんだよ…_WH_』_W"	CALL PRINT_STR, @"『对H的事情不怎么了解也是…铃酱的魅力之一哦…_WH_』_W"
PRINTFORMW 「でも…鈴も綾乃お姉さんみたいに気持ちよくしてあげたいです……」	PRINTFORMW 「但是…铃也想像綾乃姐姐一样能让对方舒服起来……」
CALL PRINT_STR, @"『大丈夫…_WH_えっちな事ならお姉さんがいくらでも教えてあげるから…_WH_』_W"	CALL PRINT_STR, @"『没问题的…_WH_H的事情的话，姐姐我无论多少都会回答的哦…_WH_』_W"
CALL PRINT_STR, @"「はい…ありがとうです……_BHH_」_W"	CALL PRINT_STR, @"「是…非常感谢……_BHH_」_W"
CALL PRINT_STR, @"『鈴ちゃん、これ、プレゼント…_WH_』_W"	CALL PRINT_STR, @"『铃酱、这个、礼物…_WH_』_W"
PRINTFORMW 「…？ほそながくて、おもたい……」	PRINTFORMW 「…？这个细长的东西、是……」
PRINTFORMW 「何ですか？これ……」	PRINTFORMW 「是什么啊？这个……」
PRINTFORMW 『ふふ、何だと思う…？』	PRINTFORMW 『呼呼、你觉得是什么…？』
PRINTFORMW 「うぅ…まったくわからないです……」	PRINTFORMW 「唔…完全没有头绪……」
PRINTFORMW 『これはねー、ぎゅっとしたまま持ち上げて…』	PRINTFORMW 『这个啊、就像这样紧紧的抓着…』
CALL PRINT_STR, @"『そのまま落とさないようにぎゅーっとして鍛えるための道具なんだよ…_WH_』_W"	CALL PRINT_STR, @"『是为了不让自己掉下来，用来锻炼自己紧紧抓住的道具哟…_WH_』_W"
PRINTFORMW 「手のちからを鍛えるんですか……？」	PRINTFORMW 「是锻炼手的力量吗……？」
CALL PRINT_STR, @"『手でもいいけど…本命はこっち…_WH_』_W"	CALL PRINT_STR, @"『手的话也是可以的，但是…其实是用在这边…_WH_』_W"
CALL PRINT_STR, @"「ひっ！？お姉さん、そこ…きゃぅっ_BHH_」_W"	CALL PRINT_STR, @"「咦！？姐姐、那里…呀！_BHH_」_W"
CALL PRINT_STR, @"『鈴ちゃんのココ、元々小さいし…後輩くんのだとガバガバになっちゃうかもだから…_WH_』_W"	CALL PRINT_STR, @"『铃酱的这里、本来就小巧的…如果是后辈君的…的话可能会变得很粗暴…_WH_』_W"
CALL PRINT_STR, @"「わっ、わかったので…_BHH_  動かさないぃ…_BHH_  でくださいぃ…_BHH_」_W"	CALL PRINT_STR, @"「知、知道了啦，所以…_BHH_  请不要…_BHH_  再动了…_BHH_」_W"
CALL PRINT_STR, @"『でも…これだけ可愛らしくきゅっきゅって締めつけてくるなら必要無かったかな…？_WH_』_W"	CALL PRINT_STR, @"『但是…如果像这样可爱的紧紧缠上的话，可能已经不需要了呢…？_WH_』_W"
CALL PRINT_STR, @"「う、うぅ……_BHH_」_W"	CALL PRINT_STR, @"「呜、呜……_BHH_」_W"

//文件: EVENT_K33_DAILY.ERB
PRINTFORMW ふと目が覚めると、妙に股間がもどかしい…	PRINTFORMW 猛然睁开眼睛、从双腿间传来了奇怪的感觉…
PRINTFORMW 下半身に目をやると、%CALLNAME:ARG%が%CALLNAME:MASTER%のペニスから溢れ出す先走り汁をペロペロと舐め取っていた…	PRINTFORMW 看向下半身的话、%CALLNAME:ARG%把从%CALLNAME:MASTER%的肉棒里溢出来的先走汁舔进了嘴里…
PRINTFORMW 「あ、%CNAME("二人称")%…おはようございます……」	PRINTFORMW 「啊、%CNAME("二人称")%…早上好啊……」
PRINTFORMW 「%CNAME("二人称")%がなかなかおきてくれないので、%CNAME("二人称")%のおちんちんであそんでました……」	PRINTFORMW 「因为%CNAME("二人称")%不管怎么叫都叫不醒、所以就开始玩%CNAME("二人称")%的小鸡鸡了……」
PRINTFORMW %CALLNAME:ARG%は微笑みながら両手で%CALLNAME:MASTER%のペニスを激しく扱くと、あと少しというところで動きを止めてしまった…	PRINTFORMW %CALLNAME:ARG%微笑着用双手猛烈地套弄着%CALLNAME:MASTER%的肉棒、就在快要射的时候动作停了下来…
PRINTFORMW 「こうやってびくびくーってなると、おちんちんからヌルヌルがいっぱい出てきます……」	PRINTFORMW 「像这样一颤一颤的话、会从小鸡鸡里面出来很多黏糊糊的东西呐……」
CALL PRINT_STR, @"「ふふ…%CNAMET(ARG, "一人称")%とおそろいですね……_BHH_」_W"	CALL PRINT_STR, @"「呼呼…就像%CNAMET(ARG, "一人称")%一样呢……_BHH_」_W"
PRINTFORMW %CALLNAME:ARG%は%CALLNAME:MASTER%の股間の上に跨ると、%CALLNAME:MASTER%見せ付けるように%TEXTR("小さな/幼い")%%TEXTR("膣/性器")%をくぱぁと開いた…	PRINTFORMW %CALLNAME:ARG%跨坐在%CALLNAME:MASTER%双腿之上、像是要给%CALLNAME:MASTER%看一样，咕啪的一下将%TEXTR("小巧的/稚嫩的")%%TEXTR("蜜穴/性器")%撑开了…
PRINTFORMW ヒクつく%TEXTR("膣口/膣穴")%からドロリと愛液が垂れ落ち、%CALLNAME:MASTER%のペニスをドロドロにしていく……	PRINTFORMW 从一缩一缩紧张的%TEXTR("蜜穴口/阴穴")%内流出了爱液、把%CALLNAME:MASTER%的肉棒弄得黏糊糊的……
PRINTFORMW 「%CNAMET(ARG, "二人称", "どもり")%はもうガマンできないですよね…？」	PRINTFORMW 「%CNAMET(ARG, "二人称", "どもり")%已经忍不住了吧…？」
PRINTFORMW 「%CNAME("二人称")%がどっちでも…%CNAMET(ARG, "一人称")%がもうガマンできないです……」	PRINTFORMW 「不管%CNAME("二人称")%是哪一个…%CNAMET(ARG, "一人称")%也无法忍耐了……」
CALL PRINT_STR, @"「%CNAME("二人称")%の%TEXTR("せーし/せーし/せーえき/おちんちんみるく")%…%CNAMET(ARG, "一人称")%の%TEXTR("しきゅー/しきゅー/おまんこ")%に%TEXTR("いっぱい/たっぷり/たくさん")%%TEXTR("のませて/のませて/のませて/ビュービューして/ドピュドピュして/ぶっコイて/むだうちして")%ください……_BHH_」_W"	CALL PRINT_STR, @"「%CNAME("二人称")%的%TEXTR("精子/精液/小鸡鸡牛奶")%…请在%CNAMET(ARG, "一人称")%的%TEXTR("子宫/小穴")%里%TEXTR("灌进去一样的/BiuBiu的/咕啾咕啾的/噗——的/一滴也不浪费的")%射进去%TEXTR("大量的/足够多的/非常多的")%精液……_BHH_」_W"
PRINTFORMW %CALLNAME:ARG%は%TEXTR("小さな/幼い")%%TEXTR("膣/性器")%を広げたまま腰を下ろすと、見せ付けるようにペニスをヌルっと一気に咥えこんだ…	PRINTFORMW %CALLNAME:ARG%将%TEXTR("小巧的/稚嫩的")%%TEXTR("蜜穴/性器")%就这样撑开着把腰压了下来、就像是在展示一样把肉棒润湿一口气吞了下去…
PRINTFORMW 膣奥を刺激される感覚に惚けた表情をする%CALLNAME:ARG%は、そのまま子宮口に打ち付けるように腰を跳ねさせている…	PRINTFORMW 被刺激蜜穴深处所带来的快感所迷住的%CALLNAME:ARG%、就那样像是在撞击子宫口一样上下跳动着腰部…
PRINTFORMW どぷっ！どぷるるるっ！どぱっ！どぴゅるるるっ！どぴゅっ！	PRINTFORMW 咚噗——！咚噗噜噜噜——！咚啪——！咚啾噜噜噜——！咚啾——！
PRINTFORMW 寝てる間に焦らされていた%CALLNAME:MASTER%は、懸命にしがみつく%CALLNAME:ARG%の幼膣の刺激に少しも耐えることができずに	PRINTFORMW 在睡觉时被吊足了胃口的%CALLNAME:MASTER%、完全无法忍耐住%CALLNAME:ARG%拼命吸紧纠缠的稚嫩蜜穴所带来的刺激
PRINTFORMW 情けない声を漏らしながら、%CALLNAME:ARG%の子宮に吸われるままにたっぷりと精を吐き出した…	PRINTFORMW 一边从嘴中漏出了丢人的呻吟、一边就这样被%CALLNAME:ARG%的子宫吮吸着喷吐出了大量的精液…
CALL PRINT_STR, @"「あっ！_BHH_  あっ！_BHH_  %CNAMET(ARG, "一人称", "かな")%もぉっ！_BHH_BHH_  イきっ！_BHH_  イっちゃっ！_BHH_」_W"	CALL PRINT_STR, @"「啊！_BHH_  啊！_BHH_  %CNAMET(ARG, "一人称", "かな")%也一起！_BHH_BHH_  要！_BHH_  要去了——！_BHH_」_W"
CALL PRINT_STR, @"「うう゛ぅううぅっ！！_BHH_BHH_BHH_」_W"	CALL PRINT_STR, @"「呜咕！咕唔哦哦哦！！_BHH_BHH_BHH_」_W"
PRINTFORMW 子宮に精液を注がれる感覚で絶頂した%CALLNAME:ARG%は、一段と力強く腰を震わせながら潮を撒き散らした…	PRINTFORMW 因为精液注射进子宫的感觉而达到绝顶的%CALLNAME:ARG%、一边更加用力的抖动着腰部一边喷出了潮水…
PRINTFORMW 結合部からは精液があまり漏れ出ておらず、%CALLNAME:ARG%の下腹部が明らかにポッコリと膨れ上がっている…	PRINTFORMW 因为并没有多少精液从结合的部位漏出来、%CALLNAME:ARG%的小腹明显鼓鼓的膨胀起来…
CALL PRINT_STR, @"「%CNAME("二人称")%のがいっぱいです…えへへ……_BHH_」_W"	CALL PRINT_STR, @"「%CNAME("二人称")%的那个进来好多…欸嘿嘿……_BHH_」_W"
PRINTFORMW 「もうすこしだけ…このままでいてくれませんか……？」	PRINTFORMW 「再稍微一会就好…就保持这样不行吗……？」
PRINTFORMW %CALLNAME:ARG%は\@ MARK:ARG:淫紋 > 1 ? 精を注がれてチカチカと光る淫紋 # 自分のお腹 \@を撫でながら、幸せな表情をしていた…	PRINTFORMW %CALLNAME:ARG%在抚摸着\@ MARK:ARG:淫紋 > 1 ? 被注入精液而闪闪发光的淫纹 # 自己的腹部 \@的时候、脸上流露出幸福的表情…
PRINTFORML 朝、目が覚めると妙に下腹部が暖かい…	PRINTFORML 早上、睁开眼睛之后下腹部莫名的暖和起来…
PRINTFORMW 目をやると%CALLNAME:ARG%が上に跨って喘いでいる……	PRINTFORMW 放眼望去，%CALLNAME:ARG%正跨坐在上面喘息着……
CALL PRINT_STR, "「んぅ…あっ…、んっ…_BHH_　はぁ……きもちいぃ……っ_BHH_」_W"	CALL PRINT_STR, "「んぅ…あっ…、んっ…_BHH_はぁ……きもちいぃ……っ_BHH_」_W"
PRINTFORMW %CALLNAME:ARG%は後ろ手を付いて、%CALLNAME:MASTER%のペニスを自分のキモチイイ場所に擦り付けるたびに	PRINTFORML %CALLNAME:ARG%は後ろ手を付いて、%CALLNAME:MASTER%のペニスを自分のキモチイイ場所に擦り付けるたびに
PRINTFORMW 仰け反っている%CALLNAME:ARG%のお腹に%CALLNAME:MASTER%のペニスの形が浮かび上がっている……	PRINTFORMW 反弓着身体的%CALLNAME:ARG%的腹部浮现出了%CALLNAME:MASTER%的肉棒的形状……
PRINTFORMW %CALLNAME:MASTER%と%CALLNAME:ARG%の肌がぶつかり合い、大きな音を立てている……	PRINTFORMW %CALLNAME:MASTER%与%CALLNAME:ARG%的肌肤互相碰撞着、发出了很大的响声……
CALL PRINT_STR, "「あっ、はぁ……ああぁぁっ_BHH_BHH_」_W"	CALL PRINT_STR, "「啊、哈……啊啊——_BHH_BHH_」_W"
PRINTFORMW 悩ましい光景に%CALLNAME:MASTER%はペニスをビクッと震わせると、いい場所に当たったのか	PRINTFORML 悩ましい光景に%CALLNAME:MASTER%はペニスをビクッと震わせると、いい場所に当たったのか
PRINTFORMW %CALLNAME:ARG%は身体を震わせながらピュっと軽く潮を吹いてから、目が覚めている%CALLNAME:MASTER%と目が合った。	PRINTFORMW %CALLNAME:ARG%一边颤抖着身体一边很容易的就潮吹了、然后睁开了眼睛和已经醒了的%CALLNAME:MASTER%的视线重合了。
CALL PRINT_STR, @"「お、おはようございます、%CNAME("二人称")%……_／／／_」_W"	CALL PRINT_STR, @"「早、早上好啊、%CNAME("二人称")%……_／／／_」_W"
CALL PRINT_STR, "「今、どきますので……んああぁぁっ_BHH_BHH_」_W"	CALL PRINT_STR, "「马、马上就让开……嗯啊啊啊——_BHH_BHH_」_W"
PRINTFORMW %CALLNAME:ARG%の%TEXTR("小さな/幼い")%%TEXTR("性器/膣")%から%CALLNAME:MASTER%のペニスが抜ける寸前で、%CALLNAME:MASTER%は%CALLNAME:ARG%の腰を掴んで引きずり降ろした！	PRINTFORMW %CALLNAME:ARG%の%TEXTR("小さな/幼い")%%TEXTR("性器/膣")%からあなたのペニスが抜ける寸前で、あなたは%CALLNAME:ARG%の腰を掴んで引きずり降ろした！
PRINTFORMW そのまま%CALLNAME:MASTER%は、自分が気持ち良いように腰を動かし始めた……	PRINTFORMW そのままあなたは、自分が気持ち良いように腰を動かし始めた……
CALL PRINT_STR, "「あっ、あっ_BHH_　今っ、イったっ_BHH_　ばかりっ、なのにっ_BHH_　やっ、やだぁっ_BHH_BHH_」_W"	CALL PRINT_STR, "「あっ、あっ_BHH_今っ、イったっ_BHH_ばかりっ、なのにっ_BHH_やっ、やだぁっ_BHH_BHH_」_W"
CALL PRINT_STR, "「お願っ、やめっ_BHH_　おっ、お゛っ_BHH_BHH_　お゛お゛ぉっ_BHH_BHH_BHH_」_W"	CALL PRINT_STR, "「お願っ、やめっ_BHH_おっ、お゛っ_BHH_BHH_お゛お゛ぉっ_BHH_BHH_BHH_」_W"
PRINTFORMW 腰をガクガク震わせる%CALLNAME:ARG%を気に留めずに、%CALLNAME:MASTER%は少しでも深く繋がるために強くピストンすると	PRINTFORMW 腰をガクガク震わせる%CALLNAME:ARG%を気に留めずに、あなたは少しでも深く繋がるために強くピストンすると
PRINTFORMW %CALLNAME:ARG%は身体を仰け反らせながら、獣のような雄叫びをあげながら激しく潮を吹いた！	PRINTFORMW %CALLNAME:ARG%的身体剧烈的后仰着、一边发出野兽一般的吼声一边猛烈的潮吹着！
CALL PRINT_STR, "「おっ！_BHH_　おおぅっ！！_BHH_　お゛お゛おぉぉっ！！_BHH_BHH_BHH_」_W"	CALL PRINT_STR, "「おっ！_BHH_おおぅっ！！_BHH_お゛お゛おぉぉっ！！_BHH_BHH_BHH_」_W"
PRINTFORMW どぴゅっ！ぶりゅるるっ！どびゅるるっ！ぴゅくるるっ！どびゅるっ！	PRINTFORMW 咚啾っ！噗啾噜噜っ！咚啾噜噜っ！啾咕噜噜っ！咚啾噜っ！
PRINTFORMW 激しい絶頂を迎えながらも精を搾り取ろうと亀頭に吸い付いてくる子宮の刺激に耐え切れず、	PRINTFORMW 虽然她已经迎来了激烈的绝顶，但却因为无法忍耐住为了榨取精液而紧紧吸住龟头的子宫带来的刺激、
PRINTFORMW %CALLNAME:MASTER%も腰を震わせながら、%TEXTR("小さな/幼い")%%TEXTR("子宮/膣/性器")%に朝一番の濃い精液をぶちまけた……	PRINTFORMW あなたも腰を震わせながら、%TEXTR("小さな/幼い")%%TEXTR("子宮/膣/性器")%に朝一番の濃い精液をぶちまけた……
CALL PRINT_STR, "「はっ……_BHH_　はぁ……、ふぁ……_BHH_　ふぅ……_BHH_」_W"	CALL PRINT_STR, "「はっ……_BHH_はぁ……、ふぁ……_BHH_ふぅ……_BHH_」_W"
PRINTFORMW %CALLNAME:MASTER%は絶頂が落ち着いた後に、イキ疲れて動かなくなった%CALLNAME:ARG%の軽い身体を持ち上げると、	PRINTFORMW あなたは絶頂が落ち着いた後に、イキ疲れて動かなくなった%CALLNAME:ARG%の軽い身体を持ち上げると、
PRINTFORMW 物足りなさげに吸い付いてくる%CALLNAME:ARG%の%TEXTR("小さな/幼い")%%TEXTR("性器/膣")%から、にゅぽん！と音を立てて%CALLNAME:MASTER%のペニスが抜け落ちた。	PRINTFORMW 物足りなさげに吸い付いてくる%CALLNAME:ARG%の%TEXTR("小さな/幼い")%%TEXTR("性器/膣")%から、にゅぽん！と音を立ててあなたのペニスが抜け落ちた。
PRINTFORMW まるで射精してなかったかのように、%CALLNAME:ARG%の膣口は愛液のみを垂らしながらヒクついていたが、	PRINTFORMW 简直就像是完全没有射精进去一样、%CALLNAME:ARG%的蜜穴口一边颤抖着一边只有爱液滴落下来、
PRINTFORMW %CALLNAME:ARG%のお腹のぽっこりと膨れている部分をグイっと押すと、	PRINTFORMW 但是如果用力摁一下%CALLNAME:ARG%肚子鼓胀起来的部分的话、
PRINTFORMW %CALLNAME:ARG%の%TEXTR("幼い/小さな")%%TEXTR("膣口/膣")%から下品な音を立ててドロリとした精液が漏れ出した…	PRINTFORMW 就会从%CALLNAME:ARG%的%TEXTR("稚嫩的/小巧的")%%TEXTR("蜜穴口/蜜穴")%里面发出下流的声音，黏糊糊的精液也会随之一滴一滴地漏出来…
CALL PRINT_STR, "「今、どきますので……んうぅぅ_BHH_」_W"	CALL PRINT_STR, "「马、马上就让开……嗯唔唔唔——_BHH_BHH_」_W"
PRINTFORMW %CALLNAME:ARG%が腰を上げると、名残惜しげにしがみ付く%CALLNAME:ARG%の%TEXTR("小さな/幼い")%%TEXTR("性器/膣")%から	PRINTFORMW 当%CALLNAME:ARG%抬起腰的时候、从依依不舍紧紧吸住的%CALLNAME:ARG%%TEXTR("小巧的/稚嫩的")%%TEXTR("性器/蜜穴")%里面
PRINTFORMW にゅぽん！と音を立てて%CALLNAME:MASTER%のペニスが抜け落ちた。	PRINTFORMW にゅぽん！と音を立ててあなたのペニスが抜け落ちた。
PRINTFORMW 愛棒を失われて切なげにヒクつく%CALLNAME:ARG%の膣口は、白く濁った愛液を垂れ流した…	PRINTFORMW 失去了心爱的肉棒而苦闷的抽搐着的%CALLNAME:ARG%的蜜穴口里、流下了白浊的爱液…
PRINTFORML %CALLNAME:MASTER%は目の前の愛液を垂れ流す%CALLNAME:ARG%の%TEXTR("つるつるの/ピッタリと閉じた")%%TEXTR("たてすじ/ワレメ")%に手を添えると、	PRINTFORML %CALLNAME:MASTER%は目の前の愛液を垂れ流す%CALLNAME:ARG%のツルツルの縦スジに手を添えると、
PRINTFORML %CALLNAME:MASTER%は目の前のぐしょぐしょの%CALLNAME:ARG%のパンツを大きくずらすと、	PRINTFORML %CALLNAME:MASTER%将眼前湿漉漉的%CALLNAME:ARG%的胖次用力挪开、
PRINTFORM %TEXTR("つるつるの/ピッタリと閉じた")%%TEXTR("たてすじ/ワレメ")%を	PRINTFORM 縦スジを
PRINTFORMW グッと左右に割り開いて、%TEXTR("綺麗な色の/鮮やかな色の/色素の薄い")%%TEXTR("幼い/小さな")%%TEXTR("膣/膣口/粘膜")%を露にさせた……	PRINTFORMW 咕！的一下子左右分开、%TEXTR("颜色很漂亮的/颜色很鲜艳的/颜色很浅的")%%TEXTR("稚嫩的/小巧的")%%TEXTR("蜜穴/蜜穴口/粘膜")%完全露了出来……
PRINTFORMW 「んっ！？んぷっ！んぽっ！じゅるっ！んっ！んぽっ！」	PRINTFORMW 「嗯っ！？嗯噗っ！嗯啵っ！啾噜っ！嗯っ！嗯啵っ！」
PRINTFORMW %CALLNAME:MASTER%が目覚めたことに気づいた%CALLNAME:ARG%は、慌てるように激しく動き始めた！	PRINTFORMW あなたが目覚めたことに気づいた%CALLNAME:ARG%は、慌てるように激しく動き始めた！
PRINTFORMW %CALLNAME:ARG%の動きに合わせて大きく広げられた膣口がヒクつき、	PRINTFORMW 随着%CALLNAME:ARG%的动作而大幅张开的蜜穴口开始颤抖起来、
PRINTFORMW \@ TALENT:ARG:処女 ? 処女膜の隙間から # 夥しい量の \@愛液が溢れ出てきている……	PRINTFORMW \@ TALENT:ARG:処女 ? 从处女膜的缝隙中 # 大量的 \@爱液满溢出来……
PRINTFORMW 目の前の悩ましい光景と、%CALLNAME:ARG%の奉仕の激しい刺激に耐え切れず	PRINTFORMW 完全无法忍耐眼前这妖艳的光景、和%CALLNAME:ARG%激烈侍奉所带来的刺激
PRINTFORMW 反撃の余地無く%CALLNAME:MASTER%は腰を震わせながら吐精した…	PRINTFORMW 反撃の余地無くあなたは腰を震わせながら吐精した…
PRINTFORMW びゅくっ！びゅるるるっ！どびゅるるっ！どくっ！どびゅっ！	PRINTFORMW 啾咕っ！啾噜噜噜っ！咚啾噜噜っ！咚咕っ！咚啾っ！
CALL PRINT_STR, "「じゅっ_BHH_　じゅるる…_BHH_　ずぼぼっ_BHH_　ずろろろろっ_BHH_BHH_」_W"	CALL PRINT_STR, "「啾っ_BHH_啾噜噜…_BHH_噗啵啵っ_BHH_噗啰啰啰啰っ_BHH_BHH_」_W"
CALL PRINT_STR, "「ちゅーっ_BHH_　ちゅるるる…_BHH_　っぷはぁ……_BHH_BHH_」_W"	CALL PRINT_STR, "「啾——っ_BHH_啾噜噜噜…_BHH_っ噗哈……_BHH_BHH_」_W"
PRINTFORMW 「おはようございます、%CNAME("二人称")%」	PRINTFORMW 「早上好、%CNAME("二人称")%」
CALL PRINT_STR, "「ごちそう様でした、とっても美味しかったです……_BHH_」_W"	CALL PRINT_STR, "「多谢招待、非常的美味……_BHH_」_W"
CALL PRINT_STR, "「んっ！？ちゅるるる…っぷはぁ……_BHH_」_W"	CALL PRINT_STR, "「嗯っ！？啾噜噜噜…っ噗哈……_BHH_」_W"
PRINTFORMW %CALLNAME:MASTER%が目覚めたことに気づいた%CALLNAME:ARG%は、唾液でベトベトだったペニスを綺麗に舐め取ると	PRINTFORMW あなたが目覚めたことに気づいた%CALLNAME:ARG%は、唾液でベトベトだったペニスを綺麗に舐め取ると
PRINTFORMW 慌てながら%CALLNAME:MASTER%の身体の上から降りた……	PRINTFORMW 慌てながらあなたの身体の上から降りた……
PRINTFORMW 「ごめんなさい、普通に起こそうと思ったんですけど……」	PRINTFORMW 「非常抱歉、本来是想普通的叫%CNAME("二人称")%起来的……」
PRINTFORMW 「寝てる%CNAME("二人称")%を見てたら我慢できなくなって、つい……」	PRINTFORMW 「但是看到了睡着的%CNAME("二人称")%之后一下子没忍住、不知不觉就……」
PRINTFORMW %CALLNAME:MASTER%は%CALLNAME:ARG%の頭をやさしく撫でながら、後でいっぱい可愛がってあげると伝えた…	PRINTFORMW あなたは%CALLNAME:ARG%の頭をやさしく撫でながら、後でいっぱい可愛がってあげると伝えた…
CALL PRINT_STR, "「んっ…ちゅっ……んっ…んぷっ……んうっ……んー_BHH_」_W"	CALL PRINT_STR, "「嗯っ…啾っ……嗯っ…嗯噗っ……嗯唔っ……嗯——_BHH_」_W"
PRINTFORMW %CALLNAME:MASTER%と目が合った%CALLNAME:ARG%は、ペニスを咥えたまま笑顔で手を振ってきた……	PRINTFORML %CALLNAME:MASTER%と目が合った%CALLNAME:ARG%は、ペニスを咥えたまま笑顔で手を振ってきた……
PRINTFORMW %CALLNAME:ARG%は%CALLNAME:MASTER%と目を合わせたまま、精液を搾り取ろうと激しく動いている…	PRINTFORMW %CALLNAME:ARG%はあなたと目を合わせたまま、精液を搾り取ろうと激しく動いている…
PRINTFORMW 目が覚めるまで執拗に焦らされていた%CALLNAME:MASTER%は、	PRINTFORMW 目が覚めるまで執拗に焦らされていたあなたは、
PRINTFORMW %CALLNAME:ARG%の甲斐甲斐しい奉仕に為す術も無く、腰を震わせながら吐精した…	PRINTFORMW 完全拿%CALLNAME:ARG%勤快的侍奉一点办法都没有、只能颤抖着腰部喷吐出了精液…
CALL PRINT_STR, "「じゅっ_BHH_じゅるる…_BHH_ずぼぼっ_BHH_ずろろろろっ_BHH_BHH_」_W"	CALL PRINT_STR, "「啾っ_BHH_啾噜噜…_BHH_噗啵啵っ_BHH_噗啰啰啰啰っ_BHH_BHH_」_W"
CALL PRINT_STR, "「ちゅーっ_BHH_ちゅるるる…_BHH_っぷはぁ……_BHH_BHH_」_W"	CALL PRINT_STR, "「啾——っ_BHH_啾噜噜噜…_BHH_っ噗哈……_BHH_BHH_」_W"
PRINTFORMW %CALLNAME:ARG%は口の中の朝一番の搾りたてミルクを%CALLNAME:MASTER%に見せ付けると、味わうように飲み干した…	PRINTFORMW %CALLNAME:ARG%は口の中の朝一番の搾りたておちんぽみるくをあなたに見せ付けると、味わうように飲み干した…
PRINTFORMW %CALLNAME:ARG%は%CALLNAME:MASTER%と目を合わせたまま、唾液でベトベトだったペニスを綺麗に舐め取った…	PRINTFORMW %CALLNAME:ARG%はあなたと目を合わせたまま、唾液でベトベトだったペニスを綺麗に舐め取った…
PRINTFORML 「お、おはようございます……」	PRINTFORML 「早、早上好……」
PRINTFORMW %CALLNAME:ARG%は顔を真っ赤にしながら、そそくさと部屋から出ていった…	PRINTFORMW %CALLNAME:ARG%的脸变得通红、匆匆忙忙的从房间里出去了…
PRINTFORMW 「まだ誰もいないみたいです」	PRINTFORMW 「看起来好像谁都不在呢」
CALL PRINT_STR, "「今のうちにしちゃいますか？なんて……_／／／_」_W"	CALL PRINT_STR, "「想趁着这个机会来一发吗？开玩笑的……_／／／_」_W"
PRINTFORMW %CALLNAME:ARG%は自分の言った言葉で顔を真っ赤にしている…	PRINTFORMW %CALLNAME:ARG%被自己说的话弄得满脸通红…
PRINTFORMW 「ふたりきりですね……」	PRINTFORMW 「就我们两个人呢……」
PRINTFORMW %CALLNAME:ARG%は緊張してるのか、どうやら落ち着かない様子でいる。	PRINTFORMW %CALLNAME:ARG%可能是因为紧张吧、看起来总是心神不定的样子。
PRINTFORMW 「た、ただいまです……」	PRINTFORMW 「我、我回来了……」
PRINTFORMW 「おかえりです、%CNAME("二人称")%」	PRINTFORMW 「欢迎回来、%CNAME("二人称")%」
PRINTFORMW 「あ、お、おかえりです、%CNAME("二人称")%……」	PRINTFORMW 「啊、欢、欢迎回来、%CNAME("二人称")%……」
PRINTFORMW 「遅かったですね%CNAME("二人称")%、何かあったんですか？」	PRINTFORMW 「来的很晚呢%CNAME("二人称")%、发生什么事了吗？」
PRINTFORMW 「%CNAMET(ARG, "一人称")%は…少しでも早く%CNAME("二人称")%に会いたかったです……」	PRINTFORMW 「%CNAMET(ARG, "一人称")%想要…尽早的和%CNAME("二人称")%见面……」
PRINTFORMW 「あ、%CNAME("二人称")%…今日は%CNAMET(ARG, "一人称")%の方が早かったですね」	PRINTFORMW 「啊、%CNAME("二人称")%…今天是%CNAMET(ARG, "一人称")%这边来得更早呢」
PRINTFORMW 「%TEXTR("な、何かあったんですか…？/ど、どうかしたんですか…？/な、何か急ぎのごようでしょうか…？")%」	PRINTFORMW 「%TEXTR("发、发生什么事了吗…？/怎、怎么了吗…？/有、有什么着急的事吗…？")%」
PRINTFORMW 呼び出された%CALLNAME:ARG%は、部室の扉の隙間から恐る恐るこちらの様子を覗いている。	PRINTFORMW 被叫出来的%CALLNAME:ARG%、从活动室的门缝间战战兢兢的看着这边的样子。
PRINTFORMW 「%CNAMET(ARG, "一人称", "どもり")%にも後でお願いできませんか…？」	PRINTFORMW 「之后也可以再拜托%CNAMET(ARG, "一人称", "どもり")%帮忙吗…？」
PRINTFORMW %CALLNAME:ARG%は羨ましそうにこちらを見ている…	PRINTFORMW %CALLNAME:ARG%象是非常羡慕一样看着这边…
PRINTFORMW 「あ、お、おじゃましました……」	PRINTFORMW 「啊、打、打扰了……」
PRINTFORMW 部室から出て行こうとする%CALLNAME:ARG%を慌てて呼び戻した…	PRINTFORMW 急急忙忙的把从部室出去的%CALLNAME:ARG%给叫了回来…
PRINTFORMW 「%CNAMET(ARG, "相手")%、いいなぁ……」	PRINTFORMW 「%CNAMET(ARG, "相手")%、真好啊……」
PRINTFORMW %CALLNAME:ARG%は奉仕されている%CALLNAME:TARGET%を羨ましそうに見ている…	PRINTFORMW %CALLNAME:ARG%非常羡慕地看着被侍奉着的%CALLNAME:TARGET%…
CALL PRINT_STR, @"「あ、お、おじゃまします……_／／／_」_W"	CALL PRINT_STR, @"「啊、打、打扰了……_／／／_」_W"
PRINTFORMW %CALLNAME:ARG%は顔を真っ赤にしながらも、部室の扉の隙間から食い入るように覗いている…	PRINTFORMW %CALLNAME:ARG%虽然脸变得通红、但是还是像要钻进来似的从门缝中间偷窥着…
PRINTFORMW 「あ…%CNAMET(ARG, "相手")%のおちんちん……」	PRINTFORMW 「啊…%CNAMET(ARG, "相手")%的小鸡鸡……」
PRINTFORMW %CALLNAME:ARG%は%CALLNAME:TARGET%のペニスに釘付けになっている…	PRINTFORMW %CALLNAME:ARG%牢牢地盯着%CALLNAME:TARGET%的肉棒…
PRINTFORMW 「%CNAMET(ARG, "一人称", "どもり")%のも、いかがですか……？」	PRINTFORMW 「%CNAMET(ARG, "一人称", "どもり")%的那个、意下如何……？」
PRINTFORMW %CALLNAME:ARG%は負けじと、%CALLNAME:MASTER%のほうに近寄ってきた…	PRINTFORMW %CALLNAME:ARG%は負けじと、あなたのほうに近寄ってきた…
PRINTFORMW 「あ…、やっぱり大きいおっぱいが好きなんですか……？」	PRINTFORMW 「啊…、果然还是喜欢大一点的欧派吗……？」
PRINTFORMW %CALLNAME:ARG%は自分のなだらかな胸に手を当てて悲しそうな表情をしている…	PRINTFORMW %CALLNAME:ARG%把手覆在自己平坦但柔软的胸部上，露出了悲伤的表情…
PRINTFORMW 「あ…、もしかして、小さいおっぱいが好きなんですか……？」	PRINTFORMW 「啊…、难道说、比较喜欢小一点的欧派吗……？」
PRINTFORMW %CALLNAME:ARG%は大きくなった自分の胸に手を当てて、悲しそうな表情をしている…	PRINTFORMW %CALLNAME:ARG%用手捂着自己变大的胸部、露出了悲伤的表情…
PRINTFORMW 「あ…%CNAME("二人称")%のおちんちん……おいしそう……」	PRINTFORMW 「啊…%CNAME("二人称")%的小鸡鸡……看起来好好吃啊……」
PRINTFORMW %CALLNAME:ARG%は%CALLNAME:MASTER%のペニスに釘付けになっている…	PRINTFORMW %CALLNAME:ARG%はあなたのペニスに釘付けになっている…
PRINTFORMW %CALLNAME:ARG%は部室の扉の隙間から恐る恐るこちらの様子を覗いている…	PRINTFORMW %CALLNAME:ARG%从部室的门缝间战战兢兢的窥视着这边的样子…
PRINTFORMW 「よ、よかったら%CNAMET(ARG, "一人称")%のも見ますか……？」	PRINTFORMW 「要、要是愿意的话要不要也看一下%CNAMET(ARG, "一人称")%的那个呢……？」
PRINTFORMW %CALLNAME:ARG%は恥ずかしがりながらも、スカートの裾を掴んでヒラヒラさせている…	PRINTFORMW %CALLNAME:ARG%虽然很害羞、但还是抓着裙子的下摆晃来晃去…
PRINTFORMW 言葉とは裏腹に、%CALLNAME:ARG%は恥ずかしさのあまり俯いている…	PRINTFORMW 和说的话正相反、%CALLNAME:ARG%因为太过害羞了一直低着头…
CALL PRINT_STR, @"「よ、よかったら後で、%CNAMET(ARG, "一人称")%にもお願いします……_／／／_」_W"	CALL PRINT_STR, @"「要、要是愿意的话、之后也请拜托%CNAMET(ARG, "一人称")%……_／／／_」_W"
PRINTFORMW %CALLNAME:ARG%は下腹部を押さえながら、切なそうな表情で訴えている…	PRINTFORMW %CALLNAME:ARG%按住下腹部的同时、用殷切的表情说着…
PRINTFORMW 「遅くてごめんなさい…%TEXTR("先生/友達")%がなかなか離してくれなくて……」	PRINTFORMW 「抱歉迟到了…%TEXTR("老师/朋友们")%迟迟不肯放我走……」
PRINTFORMW 「お、おそくなりました……」	PRINTFORMW 「来、来晚了……」
PRINTFORMW 「%TEXTR("な、何かあったんですか…？/ど、どうかしたんですか…？/な、何か急いそぎのごようでしょうか…？")%」	PRINTFORMW 「%TEXTR("发、发生什么事了吗…？/怎、怎么了吗…？/有、有什么着急的事吗…？")%」
PRINTFORMW 「おじゃまします……」	PRINTFORMW 「打扰了……」
PRINTFORMW 『先生、こんにちわ……』	PRINTFORMW 『老师、您好……』
PRINTFORMW 『こ、こんにちわ……』	PRINTFORMW 『你、你好……』
PRINTFORMW こっちを見ている%CALLNAME:TARGET%がしょんぼりしている…	PRINTFORMW こっちを見ている鈴がしょんぼりしている…
PRINTFORMW %CALLNAME:ARG%が持ってきたお弁当袋の中には、アルミホイルで巻かれたたくさんの小さなおにぎりに、	PRINTFORMW %CALLNAME:ARG%拿着的便当带里面、装着很多用铝箔纸裹起来的小饭团、
PRINTFORMW ミニハンバーグ、タコさんウィンナー、玉子焼き、ミニトマトなどが入ったお弁当箱が入っていた。	PRINTFORMW 还有一个装着迷你小汉堡、章鱼小香肠、鸡蛋烧、圣女果的便当盒放在里面。
PRINTFORMW 「いつもなら、お弁当はお母さんが作ってくれるんです」	PRINTFORMW 「平时的话、一直是妈妈给我做的便当」
PRINTFORMW 「なので、%CNAMET(ARG, "一人称")%がお弁当を作りたいって言って、お母さんに手伝ってもらいながら作りました」	PRINTFORMW 「但是、因为%CNAMET(ARG, "一人称")%说了想自己做便当、妈妈就帮忙一起做出来了」
PRINTFORMW 「でも、特には何も言ってないのに、２個のお弁当が出来たんです……」	PRINTFORMW 「而且、明明什么都没有说的、却做出来了两人份的便当……」
PRINTFORMW …妙な気味悪さを感じながらも、%CALLNAME:ARG%の持ってきた弁当はあっという間に空になった。	PRINTFORMW …虽然感觉到了微妙的尴尬、但是%CALLNAME:ARG%带来的便当眨眼间就被一扫而光了。
PRINTFORMW 今日のお弁当には、野菜炒めが入っている…	PRINTFORMW 今天的便当里加入了炒野菜…
PRINTFORMW 「%CNAMET(ARG, "一人称")%、いつもは我慢して食べるんですが、やっぱりピーマンは苦手です……」	PRINTFORMW 「%CNAMET(ARG, "一人称")%、虽然一直忍耐着吃掉了、但是果然还是不喜欢吃青椒啊……」
PRINTFORMW %CALLNAME:MASTER%は口を開けながらジェスチャーすると、%CALLNAME:ARG%はおずおずと箸でピーマンを%CALLNAME:MASTER%の口へ差し出した…	PRINTFORMW あなたは口を開けながらジェスチャーすると、%CALLNAME:ARG%はおずおずと箸でピーマンをあなたの口へ差し出した…
PRINTFORMW 「あ、ありがとうございます…%CNAME("二人称")%……」	PRINTFORMW 「非、非常感谢…%CNAME("二人称")%……」
PRINTFORMW %CALLNAME:ARG%にあーんしてもらえたらどんなものでも美味しいと言うと、%CALLNAME:ARG%は恥ずかしそうに俯いた…	PRINTFORMW 说了从%CALLNAME:ARG%那里“啊——嗯”的喂着吃的东西，无论是什么都很美味之后、%CALLNAME:ARG%害羞地低下了头…
PRINTFORMW 今日のお弁当にも、小さなおにぎりがたくさん入っている…	PRINTFORMW 今天的便当里面、也放了很多小饭团…
PRINTFORMW 「おにぎり、やっぱり小さいですよね…%CNAMET(ARG, "一人称")%の手だと、どうしても小さくなっちゃうんです……」	PRINTFORMW 「那个饭团、果然很小呢…%CNAMET(ARG, "一人称")%的手的话、无论怎么捏都会变小的……」
PRINTFORMW かわいくて食べやすい上に%CALLNAME:ARG%の頑張りを感じられてとてもいいと言うと、%CALLNAME:ARG%は恥ずかしそうに俯いた…	PRINTFORMW 说了又可爱吃起来又方便，还可以感觉到%CALLNAME:ARG%的努力，这样就很好之后、%CALLNAME:ARG%害羞地低下了头…
PRINTFORMW 今日のお弁当は一口サイズのサンドイッチだ。	PRINTFORMW 今天的便当是一口就能吃掉的三明治哒。
PRINTFORMW 「%CNAMET(ARG, "一人称")%は、サンドイッチはハムとチーズが一番だと思うんです……」	PRINTFORMW 「%CNAMET(ARG, "一人称")%的话、觉得三明治里面火腿和奶酪是最好的……」
PRINTFORMW %CALLNAME:MASTER%は%CALLNAME:ARG%に食べさし合いっこを提案して、%CALLNAME:ARG%にハムとチーズのサンドイッチを差し出した。	PRINTFORMW あなたは%CALLNAME:ARG%に食べさし合いっこを提案して、%CALLNAME:ARG%にハムとチーズのサンドイッチを差し出した。
PRINTFORMW %CALLNAME:ARG%はしばらく迷った後、なんと%CALLNAME:MASTER%の指ごとしゃぶりついた！	PRINTFORMW %CALLNAME:ARG%はしばらく迷った後、なんとあなたの指ごとしゃぶりついた！
CALL PRINT_STR, @"「んっ…ちゅるる……、もぐもぐ……、%CNAME("二人称")%の味がしておいしいです……_BHH_」_W"	CALL PRINT_STR, @"「嗯っ…啾噜噜……、我嚼我嚼……、%CNAME("二人称")%的味道尝起来很好吃……_BHH_」_W"
PRINTFORML 「ところで、ここは何の部活なんですか？」	PRINTFORML 「话说回来、这里有什么社团活动吗？」
PRINTFORML 「%CNAME("二人称")%を中心に助け合いをする部活？……なんだがよくわからないですね」	PRINTFORML 「以%CNAME("二人称")%为中心互相帮助的社团活动？……怎么说呢，不是很明白」
PRINTFORML 「はぁ…あついです……」	PRINTFORML 「哈啊…好热啊……」
PRINTFORML 「%CNAME("一人称")%はあついのはあまり好きじゃないです……」	PRINTFORML 「%CNAME("一人称")%不是很喜欢热天啊……」
PRINTFORML 「すごく…ベトベトです……」	PRINTFORML 「超级的…黏答答的……」
PRINTFORML %CALLNAME:TARGET%の身体から、ポタポタと液体が滴っている…	PRINTFORML 从%CALLNAME:TARGET%的身体上、液体啪嗒啪嗒的滴落下来…
PRINTFORML 「%CNAME("一人称", "どもり")%からイヤなにおいしてないですよね……？」	PRINTFORML 「从%CNAME("一人称", "どもり")%身上没有闻到难闻的气味吧……？」
PRINTFORML %CALLNAME:TARGET%の身体から、ほのかに甘い匂いが漂っている…	PRINTFORML 从%CALLNAME:TARGET%的身体上、隐约飘散出甜甜的味道…
CALL PRINT_STR, @"「%CNAME("二人称")%…、どうするんですかこれ……んっ_BHH_」_L"	CALL PRINT_STR, @"「%CNAME("二人称")%…、你是怎么做到的、这个……嗯っ_BHH_」_L"
PRINTFORML 何度も射精したせいで%CALLNAME:TARGET%の胎内に収まりきらなかった精液が、	PRINTFORML 由于多次射精，无法进入%CALLNAME:TARGET%的子宫里的精液、
PRINTFORML %CALLNAME:TARGET%の\@ CHECK_CLO("Ｖ露出", TARGET) ? 幼膣 # 身体 \@から溢れ出ている…	PRINTFORML 从%CALLNAME:TARGET%的\@ CHECK_CLO("Ｖ露出", TARGET) ? 幼穴 # 身体 \@里面溢出来了…
CALL PRINT_STR, @"「なんだか、おなかがぽかぽかしてしあわせです……_BHH_」_L"	CALL PRINT_STR, @"「怎么说呢、肚子里面暖洋洋的感觉很幸福……_BHH_」_L"
CALL PRINT_STR, @"「ねてる%CNAME("一人称")%を見て、がまんできなかったんですか……？_BHH_」_L"	CALL PRINT_STR, @"「看到睡着了的%CNAME("一人称")%之后、已经要忍不住了吗……？_BHH_」_L"
CALL PRINT_STR, @"「きもちよかったですか？%CNAME("二人称")%……_BHH_」_L"	CALL PRINT_STR, @"「舒服吗？%CNAME("二人称")%……_BHH_」_L"
PRINTFORM %CALLNAME:TARGET%は%CALLNAME:MASTER%を見つめながら、精液で	PRINTFORM %CALLNAME:TARGET%はあなたを見つめながら、精液で
PRINTFORM ぽっこりと膨れている	PRINTFORM 软乎乎的膨胀起来
PRINTFORM 目に見えて膨らんでいる	PRINTFORM 肉眼可见的膨胀起来
PRINTFORM わずかに膨らんでいる	PRINTFORM 微微膨胀起来
CALL PRINT_STR, @"上に_ハートピンク_淫紋が怪しく光っている_"	CALL PRINT_STR, @"的上面_粉红色心形的_淫纹发出了奇怪的光_"
PRINTFORML お腹を撫でている…	PRINTFORML 的腹部…
PRINTFORML 「なんだか、おなかがぽかぽかしててしあわせな気分です……」	PRINTFORML 「怎么说呢、肚子里面暖呼呼的有种很幸福的感觉……」
PRINTFORML %CALLNAME:TARGET%は不思議そうな顔をしながら、下腹部をさすっている…	PRINTFORML %CALLNAME:TARGET%露出不可思议的表情的同时、抚摸着小腹处…
PRINTFORML 「ふぁ…%CNAME("二人称")%のことを待ちくたびれてねてました……」	PRINTFORML 「呼啊…%CNAME("二人称")%等的%CNAME("一人称")%都睡着了……」
PRINTFORML 「あれ…%CNAME("一人称")%はいつの間にねてたんですか……？」	PRINTFORML 「啊咧…%CNAME("一人称")%是什么时候睡着的……？」
PRINTFORML %CALLNAME:TARGET%は眠い目を擦って、なんとか目を覚まそうとしている…	PRINTFORML %CALLNAME:TARGET%揉着惺忪的睡眼、试着清醒过来…
CALL PRINT_STR, @"「ここに%CNAME("一人称")%をつれて来て、いったいどうするつもりですか……_BHH_」_L"	CALL PRINT_STR, @"「把%CNAME("一人称")%带到这里来、到底是想做什么……_BHH_」_L"
PRINTFORML %CALLNAME:TARGET%は熱を帯びた目で%CALLNAME:MASTER%を見つめている……	PRINTFORML %CALLNAME:TARGET%用热切地目光看着%CALLNAME:MASTER%……
CALL PRINT_STR, @"「すー…はー…、%CNAME("二人称")%のにおいがする……_BHH_」_L"	CALL PRINT_STR, @"「斯——…哈——…、有%CNAME("二人称")%的味道……_BHH_」_L"
PRINTFORML %CALLNAME:TARGET%は%CALLNAME:MASTER%の部屋の空気を堪能しているようだ…	PRINTFORML %CALLNAME:TARGET%はあなたの部屋の空気を堪能しているようだ…
PRINTFORML 「お、おじゃまします……」	PRINTFORML 「打、打扰了……」
PRINTFORML %CALLNAME:TARGET%は%CALLNAME:MASTER%の部屋をきょろきょろと見回している…	PRINTFORML %CALLNAME:TARGET%はあなたの部屋をきょろきょろと見回している…
PRINTFORML 「%CNAME("二人称")%…%CNAME("一人称", "どもり")%はいきなりでも大丈夫ですよ……」	PRINTFORML 「%CNAME("二人称")%…%CNAME("一人称", "どもり")%就算突然来也没有关系哟……」
PRINTFORML %CALLNAME:TARGET%は太腿を擦り合わせてもじもじしている…	PRINTFORML %CALLNAME:TARGET%扭扭捏捏的摩擦着大腿…
PRINTFORML 「えっと…な、何をしますか…？」	PRINTFORML 「那っ个…要、要做什么呢…？」
PRINTFORML %CALLNAME:TARGET%はこれからする事を想像しているのか、緊張しているようだ…	PRINTFORML %CALLNAME:TARGET%想象着之后会做的事情、看起来很紧张的样子…
PRINTFORML 「%CNAME("二人称")%、どこ見てるんですか……？」	PRINTFORML 「%CNAME("二人称")%、到底在看哪里啊……？」
PRINTFORML 「もしかして…%CNAME("一人称")%のココが気になりますか…？」	PRINTFORML 「难不成…%CNAME("二人称")%很在意%CNAME("一人称")%的这里吗…？」
PRINTFORML 「あ、あんまり見ないでください……」	PRINTFORML 「请、请不要一直盯着看……」
PRINTFORML %CALLNAME:TARGET%はスカートを押さえながら恥ずかしがっている…	PRINTFORML %CALLNAME:TARGET%害羞的按着裙子…
PRINTFORML 「そ、そんなにジロジロ見ないでください………」	PRINTFORML 「请、请不要那样紧紧盯着这边………」
PRINTFORML %CALLNAME:TARGET%はスカートの中を見られて恥ずかしがっている…	PRINTFORML %CALLNAME:TARGET%因为被看到裙子里面感到很害羞…
PRINTFORML 「あんまり触らないでください…濡れてきちゃうので……」	PRINTFORML 「请不要一直摸那里…因为会变湿的……」
PRINTFORML 「でも、%CNAME("二人称")%がどうしてもというなら……」	PRINTFORML 「但是、要是%CNAME("二人称")%怎么说都想要的话……」
PRINTFORML 秘部を触られることに対して%CALLNAME:TARGET%は満更でもなさそうだ…	PRINTFORML 对于秘处被触碰这件事%CALLNAME:TARGET%好像还没有完全满足…
PRINTFORML 「%CNAME("二人称", "どもり")%のえっち……」	PRINTFORML 「%CNAME("二人称", "どもり")%这个色鬼……」
PRINTFORML %CALLNAME:TARGET%との距離が少し遠くなった…	PRINTFORML 与%CALLNAME:TARGET%之间的距离稍微变远了一点…
PRINTFORML 「も、もういいですよね……？」	PRINTFORML 「已、已经够了吧……？」
PRINTFORML 恥ずかしさに耐えれなくなった%CALLNAME:TARGET%は、開いている股を閉じようとしている…	PRINTFORML 害羞的无法忍耐的%CALLNAME:TARGET%、想要把张开的大腿合上…
PRINTFORML 「%CNAME("二人称", "どもり")%のヘンタイ……」	PRINTFORML 「%CNAME("二人称", "どもり")%这个变态……」
PRINTFORML 「うぅ…すごく見られてます……」	PRINTFORML 「呜呜…被清楚地看到了……」
PRINTFORML 羞恥心からか、%CALLNAME:TARGET%は時折腰をくねらせている…	PRINTFORML 也许是因为羞耻心、%CALLNAME:TARGET%不时地扭动着腰部…
PRINTFORML 「%CNAME("二人称", "どもり")%のいじわる……」	PRINTFORML 「%CNAME("二人称", "どもり")%这坏心眼……」
PRINTFORML %CALLNAME:TARGET%は愛液が垂れるのを少しでも抑えようと、股間を手でギュっと抑えている…	PRINTFORML %CALLNAME:TARGET%为了尽量抑制爱液滴下来、用手紧紧地按住双腿之间…
PRINTFORML 「もうやめてください…それ以上するとパンツが……」	PRINTFORML 「请快点停下来…要是再继续的话胖次就……」
PRINTFORML 分泌される愛液で、%CALLNAME:TARGET%のパンツのシミが広がっていく…	PRINTFORML 随着爱液的分泌、%CALLNAME:TARGET%胖次上的污渍慢慢扩散开…
PRINTFORML 「そ、そんなの見せないでください……」	PRINTFORML 「请、请不要给我看那种东西……」
PRINTFORML %CALLNAME:MASTER%は%CALLNAME:TARGET%に見せつけるように、指に絡んだ愛液の触感を楽しんだ…	PRINTFORML %CALLNAME:MASTER%像是故意展示给%CALLNAME:TARGET%看一样、享受着缠绕在手指上的爱液的触感…
CALL PRINT_STR, @"「ふぅー…_BHH_　ふぅー……_BHH_」_L"	CALL PRINT_STR, @"「呼——…_BHH_　呼——……_BHH_」_L"
PRINTFORML %CALLNAME:TARGET%の股間がどんどん湿り気を帯びていく…	PRINTFORML %CALLNAME:TARGET%的双腿之间变得越来越潮湿…
PRINTFORML 「%CNAME("二人称", "どもり")%のすけべ……」	PRINTFORML 「%CNAME("二人称", "どもり")%这个淫鬼……」
CALL PRINT_STR, @"「はーっ…はーっ…_BHH_」_L"	CALL PRINT_STR, @"「哈——っ…哈——っ…_BHH_」_L"
PRINTFORML %CALLNAME:TARGET%は解放されたクリトリスをピクピク震わせている…	PRINTFORML %CALLNAME:TARGET%的被解放了的阴蒂微微颤抖着…
CALL PRINT_STR, @"「んひぃ_BHH_！う、うぅ……」_L"	CALL PRINT_STR, @"「嗯咦ぃ_BHH_！唔、呜呜……」_L"
PRINTFORML 吸い付いてくる%CALLNAME:TARGET%の膣穴から指を引き抜くと、ちゅぽん！と小気味良い音が鳴った…	PRINTFORML 从紧紧吸附着的%CALLNAME:TARGET%的肉穴里面拔出手指的话、那里发出了啾啵！一声让人心情舒畅的声音…
CALL PRINT_STR, @"「んっ…_BHH_　ふっ…_BHH_　ふっ…_BHH_」_L"	CALL PRINT_STR, @"「嗯っ…_BHH_　呼っ…_BHH_　呼っ…_BHH_」_L"
PRINTFORML %CALLNAME:TARGET%は腰を震わせながら、%CALLNAME:MASTER%の舌で弄られた膣口をヒクつかせながら愛液を溢している…	PRINTFORML %CALLNAME:TARGET%的要颤抖的时候、被%CALLNAME:MASTER%的舌头肆意玩弄的蜜穴口一边抖动着着一边溢出了爱液…
PRINTFORML 「せきにん…とってください……」	PRINTFORML 「请好好的…负起责任……」
PRINTFORML 「ふぅ…ごちそうさまです……」	PRINTFORML 「呼唔…多谢招待……」
PRINTFORML %CALLNAME:TARGET%は満足そうな表情で一息ついている…	PRINTFORML %CALLNAME:TARGET%带着满意的表情喘了一口气…
PRINTFORML %CALLNAME:TARGET%は%CALLNAME:MASTER%の膝の上で、借りてきた猫のようになっている…	PRINTFORML %CALLNAME:TARGET%在%CALLNAME:MASTER%的膝盖上、就像一只借来的猫一样…
PRINTFORML %CALLNAME:TARGET%は%CALLNAME:MASTER%の膝枕を堪能している…	PRINTFORML %CALLNAME:TARGET%享受着%CALLNAME:MASTER%的膝枕…
PRINTFORML %CALLNAME:TARGET%は胸を触っている%CALLNAME:MASTER%の手をキュッと抱きしめている…	PRINTFORML %CALLNAME:TARGET%紧紧的抱着摸着自己胸的%CALLNAME:MASTER%的手…
PRINTFORML 「うぅ…濡れてきちゃいます……」	PRINTFORML 「唔唔…已经湿了啦……」
PRINTFORML %CALLNAME:TARGET%は股間に手を当ててもじもじしている…	PRINTFORML %CALLNAME:TARGET%把手放在双腿间扭来扭去…
PRINTFORML %CALLNAME:TARGET%は静かに、胸を触られる感覚に集中しているようだ…	PRINTFORML %CALLNAME:TARGET%似乎安静的专注于胸部被抚摸的感觉上…
PRINTFORML 「ちょっとくすぐったいです……」	PRINTFORML 「稍微有点痒……」
PRINTFORML 胸を触られている%CALLNAME:TARGET%は平然とした素振りをしているが、鼓動が段々と早くなっているのを感じる…	PRINTFORML 被摸着胸部的%CALLNAME:TARGET%装作一副若无其事的样子、但是却可以感觉到她的心跳变得越来越快…
PRINTFORML 「あ…あんまりつよく触らないでほしいです……」	PRINTFORML 「希…希望能不要太用力的摸……」
PRINTFORML %CALLNAME:TARGET%は痛がってはいないが、股間に手を当ててもじもじしている…	PRINTFORML %CALLNAME:TARGET%虽然不痛、但是却把手放在双腿间扭来扭去…
PRINTFORML 「%CNAME("一人称")%の家族ですか？」	PRINTFORML 「%CNAME("一人称")%的家人吗？」
PRINTFORML 「%CNAME("一人称")%にはおかあさんと…、おばあちゃんがいます」	PRINTFORML 「%CNAME("一人称")%的家人话有妈妈…、还有奶奶」
PRINTFORML 「あと…、おとうさんですかね……」	PRINTFORML 「然后…、还有爸爸这样吧……」
PRINTFORML %CALLNAME:TARGET%は落ち着かない様子でそわそわしている…	PRINTFORML %CALLNAME:TARGET%看起来心神不定的在那动来动去…
PRINTFORML %CALLNAME:TARGET%は自分の内股を確認している…	PRINTFORML %CALLNAME:TARGET%确认着自己的大腿内侧…
PRINTFORML %CALLNAME:TARGET%は周りをキョロキョロと確認している…	PRINTFORML %CALLNAME:TARGET%东张西望的确认着周围…
PRINTFORML 「うぅ…えっちなニオイがする…気がします……」	PRINTFORML 「唔唔…好像有…一股H的味道……」
PRINTFORML %CALLNAME:TARGET%はこれからすることを想像してるのか顔を赤くしている…	PRINTFORML %CALLNAME:TARGET%想象到接下来要做的事情脸一下子变得通红…
PRINTFORML 「ちょっと埃っぽいですね……」	PRINTFORML 「稍微有点灰尘啊……」
PRINTFORML 「ここって普通に立ち入りして大丈夫なんですか？」	PRINTFORML 「就这样正常的进出这里没问题吗？」
PRINTFORML 「見つかって怒られるのはいやです……」	PRINTFORML 「被发现之后挨骂很讨厌啊……」
PRINTFORML 「ココなら服を脱いでても怪しくない……？」	PRINTFORML 「在这里就算把衣服脱了也不奇怪……？」
PRINTFORML 「そういう問題じゃないと思います……」	PRINTFORML 「%CNAME("一人称")%觉得并不是那种问题就是了……」
PRINTFORML %CALLNAME:TARGET%はロッカーの中をひとつひとつ調べている…	PRINTFORML %CALLNAME:TARGET%一个接一个的检查着储物柜里面…
PRINTFORML 「ここって普通に使われてる場所ですよね……？」	PRINTFORML 「这里是平常使用的地方对吧……？」
PRINTFORML 「%CNAME("一人称")%は保健室を使うほうなので…なんだか落ち着く気がします……」	PRINTFORML 「因为%CNAME("一人称")%经常使用保健室…总觉得能够冷静下来……」
PRINTFORML %CALLNAME:TARGET%は保健室に他の人がいないか探しているようだ…	PRINTFORML %CALLNAME:TARGET%似乎正在确认保健室里面有没有其他人…
PRINTFORML %CALLNAME:TARGET%はスマホでゲームをしているようだ	PRINTFORML %CALLNAME:TARGET%好像在玩手机游戏
PRINTFORML 画面が目まぐるしく回転していてよく分からない…	PRINTFORML 因为画面转的眼花缭乱看不清楚玩的是什么…
PRINTFORML 一見何も無い風景の中に潜むパズルを探しているようだ…	PRINTFORML 乍一看之下好像是在什么都没有的风景中寻找迷题的游戏…
PRINTFORML 書類にスタンプを押すゲームをしている…	PRINTFORML 玩着在给//文件盖章的游戏…
PRINTFORML 金ぴかの壷に入ってるおじさんをとてつもないスピードで操作している…	PRINTFORML 正在以惊人的速度操作着被放入金光闪闪的壶里面的一个大叔…
PRINTFORML %CALLNAME:TARGET%はこそこそと自分の股間を確認している…	PRINTFORML %CALLNAME:TARGET%偷偷摸摸的确认着自己的双腿间…
PRINTFORML 「しっぱいした…しっぱいした……」	PRINTFORML 「搞砸了…搞砸了……」
PRINTFORML 「んにゃぴ……」	PRINTFORML 「嗯喵咪……」
PRINTFORML 「いなりが…はいってない…です……」	PRINTFORML 「稻子…还没有…放进来……」
PRINTFORML 「ぽっちゃま……」	PRINTFORML 「小丸子……」
PRINTFORML 「デキセ…ドリンは……とうよ…しなくて…いい……です……」	PRINTFORML 「不要用…右旋……安非他命…真的…太……好了……」
PRINTFORML 「かいでん…おめでとうです……」	PRINTFORML 「恭喜…获得真传……」
PRINTFORML 「クレープをもった……うちゅぅじん…が……」	PRINTFORML 「出现了……拿着可丽饼的…宇宙人……」
PRINTFORML 「すー…すー……」	PRINTFORML 「嘶——…嘶——……」
PRINTFORML 「んむぅ……」	PRINTFORML 「嗯呣……」
PRINTFORML 「すー……」	PRINTFORML 「嘶——……」
PRINTFORML 「%CNAME("一人称", "かな")%…%CNAME("一人称", "かな")%は……%CNAME("一人称", "かな")%…です……」	PRINTFORML 「%CNAME("一人称", "かな")%…%CNAME("一人称", "かな")%的话……%CNAME("一人称", "かな")%…这样……」
PRINTFORML 「おかぁ…さん……」	PRINTFORML 「妈…妈……」
PRINTFORMW 「ほんとうにここでしても大丈夫ですか……？」	PRINTFORMW 「在这里做的话真的没问题吗……？」
PRINTFORMW 「%CNAME("二人称")%が大丈夫っていうなら…%CNAME("一人称")%はしんじますけど……」	PRINTFORMW 「%CNAME("二人称")%说没问题的话…%CNAME("一人称")%倒是会相信就是了……」
PRINTFORMW %CALLNAME:TARGET%の身長に合わせるために、%CALLNAME:MASTER%は腰掛けてから股を開くと	PRINTFORMW 为了配合%CALLNAME:TARGET%的身高、%CALLNAME:MASTER%坐下后张开了双腿
PRINTFORMW %CALLNAME:TARGET%の色白で小さなお尻を誘導して、何もしなくてもグチョグチョになってる幼膣にペニスを咥えこませた…	PRINTFORMW 诱导着%CALLNAME:TARGET%白皙小巧的屁股、什么都没做就变得湿哒哒的稚嫩蜜穴里衔着肉棒…
PRINTFORMW 「んっ、んぅ、ふっ、んっ」	PRINTFORMW 「嗯っ、嗯唔、呼っ、嗯っ」
CALL PRINT_STR, @"「はぁ、はっ、あ、あぁ_BHH_  あっ_BHH_」_W"	CALL PRINT_STR, @"「哈啊、哈っ、啊、啊啊_BHH_  啊っ_BHH_」_W"
PRINTFORMW %CALLNAME:MASTER%をイかせるために、健気に速めのスピードで腰を振る%CALLNAME:TARGET%だったが	PRINTFORMW 为了让%CALLNAME:MASTER%快点射出来、%CALLNAME:TARGET%勇敢的加快了摆动腰部速度
CALL PRINT_STR, @"「――っ！_BHH_  ふーっ_BHH_  うぅ…_BHH_  ふーっ_BHH_」_W"	CALL PRINT_STR, @"「――っ！_BHH_  呼——っ_BHH_  唔唔…_BHH_  呼——っ_BHH_」_W"
PRINTFORMW しばらくすると自分が気持ちよくなって動けなくなり、軽く潮を吹きながら幼膣をビクつかせている…	PRINTFORMW 但是过了一会发现自己舒服的动弹不得、轻轻的潮吹着的时候稚嫩的蜜穴也在微微抽动着…
PRINTFORMW 「ご、ごめんなさい…ちゃんと%CNAME("二人称")%がきもちよくなるまでしますので……」	PRINTFORMW 「对、对不起…会好好做到让%CNAME("二人称")%也变得舒服起来的……」
CALL PRINT_STR, @"「ふっ、ふぅ_BHH_  はっ、はぁ_BHH_  はっ_BHH_BHH_」_W"	CALL PRINT_STR, @"「呼っ、呼唔_BHH_  哈っ、哈啊_BHH_  哈っ_BHH_BHH_」_W"
CALL PRINT_STR, @"「んぅ―――っ！！_BHH_BHH_BHH_」_W"	CALL PRINT_STR, @"「嗯唔―――っ！！_BHH_BHH_BHH_」_W"
PRINTFORMW 何度もあと少しのところで寸止めされ、ついに%CALLNAME:MASTER%は理性が保てなくなってしまい	PRINTFORMW 好几次都在快要射的时候点到为止、最终%CALLNAME:MASTER%失去了理智
PRINTFORMW 絶頂でビクついている%CALLNAME:TARGET%の腰をガシっと掴み、オナホでしごくように荒々しく動かした！	PRINTFORMW 暴起抓住因为绝顶正在抽搐的%CALLNAME:TARGET%的腰部、然后用对待飞机杯一样粗暴的动作起来！
CALL PRINT_STR, @"「ひっ！_BHH_  やらっ_BHH_  やああぁぁっ！_BHH_BHH_BHH_  あっ！_BHH_BHH_  あぁっ！_BHH_BHH_」_W"	CALL PRINT_STR, @"「呀っ！_BHH_  噗要っ_BHH_  呀啊啊啊啊っ！_BHH_BHH_BHH_  啊っ！_BHH_BHH_  啊啊っ！_BHH_BHH_」_W"
CALL PRINT_STR, @"「やあ゛あ゛ぁああっ！！_BHH_BHH_BHH_」_W"	CALL PRINT_STR, @"「呀嘎嘎啊啊啊っ！！_BHH_BHH_BHH_」_W"
PRINTFORMW びゅくっ！びゅるるっ！どびゅるるる！びゅるっ！びゅるるるっ！	PRINTFORMW 啾咕っ！啾噜噜っ！咚啾噜噜噜！啾噜っ！啾噜噜噜っ！
PRINTFORMW 突き刺すように深い場所で精液をぶち撒けると、衝撃を受けた子宮が吐精中の亀頭に吸い付いてしまい	PRINTFORMW 像是要顶穿进去一样在深处将精液倾倒进去之后、受到剧烈冲击的子宫将射精中的龟头紧紧的吸住
PRINTFORMW 悶えるようにペニスが暴れまわると、刺激された膣壁がより一層激しく収縮し	PRINTFORMW 象是很痛苦一样肉棒在里面乱闹搅动着的话、被刺激到的肉穴壁就会更加剧烈地收缩起来
PRINTFORMW お互いに強烈な絶頂を感じて、腰を大きく震わせた…	PRINTFORMW 彼此都达到了强烈的绝顶、腰部都剧烈的颤抖着…
PRINTFORMW %CALLNAME:TARGET%の腰を掴んでいる腕の力が抜けると、%CALLNAME:TARGET%はお尻を突き出す姿勢のまま崩れ落ちた…	PRINTFORMW 抓着%CALLNAME:TARGET%的腰的手臂一放松下来之后、%CALLNAME:TARGET%就这样挺着自己的屁股塌下来了…
PRINTFORMW 繋がったままだった%CALLNAME:MASTER%のペニスが%CALLNAME:TARGET%の%TEXTR("小さな/幼い")%%TEXTR("性器/膣")%から引き抜かれ、にゅぽん！と音が鳴ると	PRINTFORMW 保持着插入的%CALLNAME:MASTER%的肉棒从%CALLNAME:TARGET%的%TEXTR("小巧的/稚嫩的")%%TEXTR("性器/蜜穴")%里面拔出来的时候发出了呢啵！一样的声音
PRINTFORMW %CALLNAME:TARGET%の膣口はパクパクと開閉しながら精液を垂らし、ペニスの圧迫から解放され潮を撒き散らしている…	PRINTFORMW %CALLNAME:TARGET%的蜜穴口啪嗒啪嗒的开闭的同时滴下精液、从肉棒的压迫中解放出来的潮水噗嗤一下喷洒出来…
CALL PRINT_STR, @"「ひっ_BHH_  ひぃ_BHH_  ふぅ_BHH_  ふっ_BHH_」_W"	CALL PRINT_STR, @"「咦っ_BHH_  咦_BHH_  呼唔_BHH_  呼っ_BHH_」_W"
PRINTFORMW ぐったりとした%CALLNAME:TARGET%を保健室まで運んでベッドで寝かせた…	PRINTFORMW ぐったりとした鈴を保健室まで運んでベッドで寝かせた…
PRINTFORMW 疲れたので%CALLNAME:MASTER%も隣のベッドで休憩して次の授業から戻ることにした…	PRINTFORMW 因为很累了，所以%CALLNAME:MASTER%也决定在旁边的床上休息一下，下节课再回去…
PRINTFORMW 「グショグショになっちゃいました…うぅ……」	PRINTFORMW 「浑身都变得湿哒哒的了…呜呜……」
PRINTFORMW 夢中になって%CALLNAME:TARGET%の幼い性器を弄っていると、愛液が滴り落ちるほどになってしまった…	PRINTFORMW 全神贯注的玩弄%CALLNAME:TARGET%稚嫩的性器的时候、爱液都几乎要滴落下来了…
PRINTFORMW %CALLNAME:TARGET%は愛液が滴るパンツを脱いだ…	PRINTFORMW %CALLNAME:TARGET%脱掉了滴上了爱液的胖次…
PRINTFORMW 執拗に%TEXTR("悪戯された/苛められた")%せいで、%TEXTR("大きく/立派に")%%TEXTR("勃起した/張り詰めた/せり上がった")%%TEXTR("陰核/クリトリス")%が%TEXTR("幼い/ぷにっとした")%%TEXTR("たてすじ/ワレメ")%から顔を覗かせている…	PRINTFORMW 因为一直被纠缠不休的%TEXTR("恶作剧/欺负")%的原因、%TEXTR("变大/漂亮的")%%TEXTR("勃起的/绷紧的/立起来的")%%TEXTR("阴核/阴蒂")%从%TEXTR("稚嫩的/软乎乎的")%%TEXTR("蜜裂/蜜缝")%里面露了出来…
GREETING = こんばんわです	GREETING = 晚上好
GREETING = こんにちわです	GREETING = 你好
GREETING = おはようです	GREETING = 早上好
PRINTFORMW 「あ、%GREETING%、%CNAME("二人称")%……」	PRINTFORMW 「啊、%GREETING%、%CNAME("二人称")%……」
PRINTFORMW 「はい、%GREETING%、%CNAME("二人称")%♪」	PRINTFORMW 「嗯！%GREETING%、%CNAME("二人称")%♪」
PRINTFORMW 「うぅ…なんらか…クラクラしますぅ……」	PRINTFORMW 「呜呜…总觉得…有点晕乎乎的……」
PRINTFORMW 「いや…%CNAME("一人称")%なんて全然……」	PRINTFORMW 「不是…%CNAME("一人称")%的话完全……」
PRINTFORMW 言葉とは裏腹に、%CALLNAME:TARGET%は嬉しそうな表情を見せている…	PRINTFORMW 和嘴上说的正相反、看见了%CALLNAME:TARGET%非常开心的表情…
PRINTFORMW 「%CNAME("一人称")%はそんな…すごくはないです……」	PRINTFORMW 「%CNAME("一人称")%的话哪有…一点也不厉害啦……」
PRINTFORMW 「%CNAME("二人称")%…イジワルしないでください……」	PRINTFORMW 「%CNAME("二人称")%…请不要这样欺负我……」
PRINTFORMW 甘い言葉を囁かれた%CALLNAME:TARGET%の内股から、透明な液体が垂れてきている…	PRINTFORMW 从被耳语着甜言蜜语的%CALLNAME:TARGET%的大腿内侧、透明的液体垂了下来…
PRINTFORMW 「そんなこと言われると…好きになっちゃいますよ……？」	PRINTFORMW 「要是说了那样的话…会喜欢上%CNAME("二人称")%的哟……？」
PRINTFORMW %CALLNAME:TARGET%は%CALLNAME:MASTER%と目を合わせられなくなってるようだ…	PRINTFORMW %CALLNAME:TARGET%はあなたと目を合わせられなくなってるようだ…
PRINTFORMW 「え…%CNAME("一人称")%に言ってるんですか……？」	PRINTFORMW 「诶…是在对%CNAME("一人称")%说话吗……？」
PRINTFORMW %CALLNAME:TARGET%は自分に向けてへの言葉だと受け入れてないようだ…	PRINTFORMW %CALLNAME:TARGET%好像并不觉得这是对自己说的话…
PRINTFORMW 「%CNAME("二人称")%…おはなしもいいですけど、そろそろ……」	PRINTFORMW 「%CNAME("二人称")%…聊天当然也是可以的、但是差不多……」
PRINTFORMW %CALLNAME:TARGET%は潤んだ目で情欲を訴えている……	PRINTFORMW %CALLNAME:TARGET%用水润的眼睛诉说着情欲……
PRINTFORMW 「%CNAME("一人称")%がやってるゲームですか？」	PRINTFORMW 「%CNAME("一人称")%在玩的游戏吗？」
PRINTFORMW 「あまり万人受けするものじゃないので…おすすめはしませんが……」	PRINTFORMW 「因为不是什么很受欢迎的东西…所以没办法推荐呢……」
PRINTFORMW 「興味があるなら…後でゲームのページに飛べるメッセージを送っておきますね」	PRINTFORMW 「但是要是有兴趣的话…稍后我会发一条可以跳转到游戏界面的邮件哦」
PRINTFORMW 「%CNAME("二人称")%とおはなししてると…とても楽しいです……」	PRINTFORMW 「和%CNAME("二人称")%聊天的话…非常的开心……」
PRINTFORMW 「%CNAME("一人称")%はあまりおはなしが得意じゃないので……」	PRINTFORMW 「因为%CNAME("一人称")%不是很会聊天的说……」
PRINTFORMW 「この猫の動画おもしろいですよ」	PRINTFORMW 「这个猫的动画很有趣哟」
PRINTFORMW 「太っている猫のほうが…狭いところに入るんです……」	PRINTFORMW 「胖一点的猫…才更能够挤进狭窄的地方……」
PRINTFORMW 「フェリシエルさんって…本当に悪魔なんですか……？」	PRINTFORMW 「弗理希艾尔桑的话…真的是恶魔吗……？」
PRINTFORMW 「%CNAME("一人称")%は…悪魔ってもっと…恐ろしいイメージを抱いてて……」	PRINTFORMW 「%CNAME("一人称")%还以为…恶魔的话会是那种…更加恐怖一点的形象……」
PRINTFORMW 「ナプキンだと抑えきれないんですよね…だけどオムツってのもイヤなんです……」	PRINTFORMW 「如果是餐巾纸的话是压不住的吧…但是尿布的话又不是很喜欢……」
PRINTFORMW 「テープで抑えても、後から剥がれてきます……」	PRINTFORMW 「就算用胶布压住的话，之后也还是会掉下来……」
PRINTFORMW 「タンポンは…怖くて試してないです……」	PRINTFORMW 「卫生棉条那种…很可怕所以没有试过……」
PRINTFORMW 「%CNAME("一人称")%は…お家でゲームしてることが多いです……」	PRINTFORMW 「%CNAME("一人称")%的话…在家玩游戏的情况比较多……」
PRINTFORMW 「長い時間外に出るのは…ちょっと難しいので……」	PRINTFORMW 「因为长时间外出的话…稍微有点困难呢……」
PRINTFORMW 「%CNAME("一人称")%…ここで倒れたんですよね……」	PRINTFORMW 「%CNAME("一人称")%…是在这里倒下的吧……」
PRINTFORMW 「もし他の場所で倒れてたらと思うと……うぅ……」	PRINTFORMW 「一想到要是在其他地方倒下的话……呜……」
PRINTFORMW 「本当に%CNAME("一人称")%はここにいていいんですか……・？」	PRINTFORMW 「%CNAME("一人称")%留在这里真的可以吗……・？」
PRINTFORMW 「なんだか…場違いなような気がして……」	PRINTFORMW 「总觉得…好像不是很合适的样子……」
PRINTFORMW 「%CNAME("二人称", "どもり")%…ありがとうです……」	PRINTFORMW 「%CNAME("二人称", "どもり")%…非常感谢……」
PRINTFORMW 「でも…あまり触られると…別のでベタベタになるので……」	PRINTFORMW 「但是…要是碰得太多的话…别的地方就要变得湿哒哒得了……」
PRINTFORMW 「あ、ありがとうです……」	PRINTFORMW 「非、非常感谢……」
CALL PRINT_STR, @"「やだっ、ひっぱらないでくださいぃ…伸びちゃいます……_BHH_」_W"	CALL PRINT_STR, @"「讨厌、请不要这样使劲的扯呀…会变长的……_BHH_」_W"
PRINTFORMW %CALLNAME:MASTER%は、%CALLNAME:TARGET%の幼い身体に不相応な大きい乳首を摘み上げた…	PRINTFORMW %CALLNAME:MASTER%揉搓着与%CALLNAME:TARGET%幼稚的身体不相称的大乳头…
CALL PRINT_STR, @"「んっ、んぅぅ…_BHH_　んうぅ……」_W"	CALL PRINT_STR, @"「嗯、嗯啊啊…_BHH_　嗯唔呜……」_W"
PRINTFORMW %CALLNAME:TARGET%は口に手を当てながら、%CALLNAME:MASTER%の乳首責めに耐えようとしている…	PRINTFORMW %CALLNAME:TARGET%用手捂着嘴的同时、忍受着%CALLNAME:MASTER%对乳头的折磨…
CALL PRINT_STR, @"「ひっ_BHH_　や、やさしく…してください……」_W"	CALL PRINT_STR, @"「咦_BHH_　请、请温柔…一点……」_W"
PRINTFORMW %CALLNAME:MASTER%が思うままに乳首をこねくり回すと、%CALLNAME:TARGET%は時々ビクリと身体を震わせた…	PRINTFORMW %CALLNAME:MASTER%随心所欲地揉捏着乳头、%CALLNAME:TARGET%时不时颤抖一下身体…
PRINTFORMW 「%CNAME("一人称")%のでも…さわってて楽しいですか……？」	PRINTFORMW 「就算是%CNAME("一人称")%的…摸起来也会开心吗……？」
PRINTFORMW %CALLNAME:TARGET%の心配を気にせず、%CALLNAME:MASTER%は%TEXTR("すべすべ/ぷにぷに")%の肌触りを堪能した…	PRINTFORMW 并不介意%CALLNAME:TARGET%担心的事、%CALLNAME:MASTER%享受了%TEXTR("滑滑溜溜/柔柔软软")%的肌肤的触感…
PRINTFORMW 「%CNAME("二人称")%のせいでこんなになったんですよ……？」	PRINTFORMW 「因为%CNAME("二人称")%的错变成了这样哟……？」
PRINTFORMW %CALLNAME:MASTER%は、%CALLNAME:TARGET%の発達した胸を愛でるように撫で回した…	PRINTFORMW %CALLNAME:MASTER%像爱抚一样来回抚摸着%CALLNAME:TARGET%发育充分的胸部…
PRINTFORMW 「んっ…急に何するんですか……」	PRINTFORMW 「嗯…突然做什么啊？！……」
PRINTFORMW %CALLNAME:MASTER%は、%CALLNAME:TARGET%の胸の形を確認するように撫で回した…	PRINTFORMW %CALLNAME:MASTER%像是确认形状一样来回抚摸着%CALLNAME:TARGET%的胸部…
PRINTFORMW 「きゃっ！う、うぅ……」	PRINTFORMW 「呀！呜、唔唔……」
PRINTFORMW %CALLNAME:TARGET%は反射で胸を守ろうとしてしまい、%CALLNAME:MASTER%の手をギュっと抱きしめてしまった…	PRINTFORMW %CALLNAME:TARGET%反射一样想要保护自己的胸部、结果却紧紧地抱住了%CALLNAME:MASTER%的手…
PRINTFORMW 胸に押し付けられた手のひらから、緊張している%CALLNAME:TARGET%の鼓動が感じられる…	PRINTFORMW 胸に押し付けられた手のひらから、緊張している鈴の鼓動が感じられる…
PRINTFORMW 「ひゃっ…どうかしたんですか？」	PRINTFORMW 「呀…你干嘛呀？」
PRINTFORMW 「いえ、別にイヤではないです……」	PRINTFORMW 「倒、倒不是讨厌啦……」
PRINTFORMW 「あの…%CNAME("一人称")%の胸なんかさわっても楽しくないと思うんですけど……」	PRINTFORMW 「那个…%CNAME("一人称")%觉得%CNAME("一人称")%的胸就算摸了也不会开心就是了……」
PRINTFORMW 「あの…%CNAME("一人称")%の胸は大きいほうではないと思うんですけど……」	PRINTFORMW 「那个…%CNAME("一人称")%觉得%CNAME("一人称")%的胸并不是很大就是了……」
PRINTFORMW %CALLNAME:TARGET%は胸を触られることに特に気にしてないようで、されるがままになっている…	PRINTFORMW %CALLNAME:TARGET%似乎并不是很在意胸部被触碰这件事、任君采摘…
PRINTFORMW 「%CNAME("二人称")%の手、あったかくてキモチいいです……」	PRINTFORMW 「%CNAME("二人称")%的手、暖暖的很舒服……」
PRINTFORMW 「%CNAME("二人称")%には、カチカチになっててマッサージしてほしいところはないですか……？」	PRINTFORMW 「%CNAME("二人称")%的话、有没有想用手按摩的那种变得嘎吱嘎吱硬邦邦的地方啊……？」
PRINTFORMW 「できるなら…%CNAME("一人称")%が%CNAME("二人称")%のことをキモチよくさせてあげたいです……」	PRINTFORMW 「要是能做到的…%CNAME("一人称")%想让%CNAME("二人称")%变得舒服起来……」
PRINTFORMW 「マッサージしてほしいところですか……？」	PRINTFORMW 「有想要按摩的地方是吗……？」
PRINTFORMW 「そ、それは…ベッドの上でお願いしたいです……」	PRINTFORMW 「那、那种事…想拜托你在床上做……」
PRINTFORMW 「%CNAME("一人称")%をマッサージする必要は無いと思いますけど……」	PRINTFORMW 「虽然%CNAME("一人称")%觉得并没有按摩的必要就是了……」
PRINTFORMW 「まぁ…気持ちはいいです……」	PRINTFORMW 「嘛…很舒服就是了……」
PRINTFORMW 「もしかして、%CNAME("一人称")%の体に触りたいだけですか……？」	PRINTFORMW 「难道说、就只是想要摸%CNAME("一人称")%的身体是吗……？」
PRINTFORMW 「%CNAME("一人称")%は別に%CNAME("二人称")%になら触られてもいいですけど……」	PRINTFORMW 「虽然%CNAME("一人称")%要是%CNAME("二人称")%的话，碰了也无所谓就是了……」
PRINTFORMW 「%CNAME("一人称")%が%CNAME("二人称")%をマッサージしたほうがいいんじゃないですか……？」	PRINTFORMW 「让%CNAME("一人称")%来给%CNAME("二人称")%来按摩的话不是更好吗……？」
PRINTFORMW 「後でベッドでしてもらう…？う、うぅ……」	PRINTFORMW 「之后的事让我们在床上…？唔、唔唔……」

PRINTFORMW 「%CNAME("二人称")%…そろそろもう……」	PRINTFORMW 「%CNAME("二人称")%…差不多该……」
PRINTFORMW 「い、いえ、嫌じゃないですし…むしろ嬉しいですけど…でも……」	PRINTFORMW 「啊、不是、并不是讨厌…倒不如说很开心…但是……」
CALL PRINT_STR, @"「う、うぅ……_／／／_」_W"	CALL PRINT_STR, @"「呜、呜……_／／／_」_W"
PRINTFORMW %CALLNAME:TARGET%は恥ずかしさでどんどん顔が赤くなっている…	PRINTFORMW %CALLNAME:TARGET%因为害羞脸渐渐的变红了…
PRINTFORMW 「え、今ですか…？」	PRINTFORMW 「诶、现在吗…？」
PRINTFORMW 「わ、わかりました…じゃ、じゃあ……」	PRINTFORMW 「我、我明白了…那、那么……」
PRINTFORMW %CALLNAME:TARGET%は他の人に見られているのが恥ずかしいようで、カチカチになっている…	PRINTFORMW %CALLNAME:TARGET%因为被他人看见而感到羞耻、身体变得很僵硬了…
CALL PRINT_STR, @"「はーっ_BHH_　はぁ…_BHH_　%CNAME("二人称")%のにおい…_BHH_」_W"	CALL PRINT_STR, @"「哈——_BHH_　哈啊…_BHH_　%CNAME("二人称")%的味道…_BHH_」_W"
PRINTFORMW %CALLNAME:TARGET%は%CALLNAME:MASTER%の股間に顔を埋めている…	PRINTFORMW %CALLNAME:TARGET%把脸埋进了%CALLNAME:MASTER%的双腿间…
CALL PRINT_STR, @"「はぁ…_BHH_　%CNAME("二人称")%っ…_BHH_　%CNAME("二人称")%っ…_BHH_」_W"	CALL PRINT_STR, @"「哈啊…_BHH_　%CNAME("二人称")%…_BHH_　%CNAME("二人称")%…_BHH_」_W"
PRINTFORMW %CALLNAME:TARGET%は%CALLNAME:MASTER%の股間に頬擦りしている…	PRINTFORMW %CALLNAME:TARGET%用脸颊在%CALLNAME:MASTER%的双腿间不断摩擦…
CALL PRINT_STR, @"「ふっ…_BHH_　ふぅ…_BHH_　んっ…_BHH_」_W"	CALL PRINT_STR, @"「呼…_BHH_　呼唔…_BHH_　嗯…_BHH_」_W"
PRINTFORMW %CALLNAME:TARGET%は%CALLNAME:MASTER%の股間の匂いを嗅ぎながら自慰をしている…	PRINTFORMW %CALLNAME:TARGET%一边嗅着%CALLNAME:MASTER%股间的气味一边自慰着…
PRINTFORMW 「し、しつれいします…」	PRINTFORMW 「失、失礼了…」
PRINTFORMW 「%CNAME("二人称")%のおひざ…なんだかとても安心します……」	PRINTFORMW 「%CNAME("二人称")%的膝枕…不知为何感觉非常让人安心……」
PRINTFORMW 「%CNAME("二人称")%のおひざ…柔らかくて気持ちいいです……」	PRINTFORMW 「%CNAME("二人称")%的膝枕…柔柔软软的很舒服……」
PRINTFORMW %CALLNAME:TARGET%はとてもリラックスして%CALLNAME:MASTER%の膝枕を楽しんでいる…	PRINTFORMW %CALLNAME:TARGET%非常放松地享受了%CALLNAME:MASTER%的膝枕…
PRINTFORMW 「あ…ありがとうございます」	PRINTFORMW 「非…非常感谢」
PRINTFORMW 「んく…んっ……」	PRINTFORMW 「嗯咕…嗯……」
PRINTFORMW %CALLNAME:TARGET%は差し出されたお茶を勢いよく飲んでいる…	PRINTFORMW %CALLNAME:TARGET%大口大口地喝着递过去的茶…
PRINTFORMW 「なんだか…ぽかぽかしてくるジュースですね……」	PRINTFORMW 「怎么说呢…真是让人觉得暖和的果汁啊……」
PRINTFORMW %CALLNAME:MASTER%は、弱い果実酒をさらにジュースで薄めたものを%CALLNAME:TARGET%に飲ませた…	PRINTFORMW %CALLNAME:MASTER%让%CALLNAME:TARGET%喝了用果汁稀释过的度数低的果酒…
PRINTFORMW 「んっ……」	PRINTFORMW 「嗯っ……」
PRINTFORMW %CALLNAME:TARGET%は目を閉じて頭を撫でられている感覚に集中している…	PRINTFORMW 鈴は目を閉じて頭を撫でられている感覚に集中している…
PRINTFORMW 「%CNAME("一人称")%は…いいこではないですよ……？」	PRINTFORMW 「鈴は…いいこではないですよ……？」
PRINTFORMW 「別にわるいこでもないですけど……」	PRINTFORMW 「虽然也不是坏孩子就是了……」
PRINTFORMW 「頭を撫でられるのはきらいじゃないですけど……」	PRINTFORMW 「虽然并不是讨厌摸头就是了……」
PRINTFORMW 「でも…ちょっと恥ずかしいです……」	PRINTFORMW 「但是…稍微有点害羞……」
PRINTFORMW 「な、何言ってるんですか……」	PRINTFORMW 「什、到底在说什么啊……」
PRINTFORMW 「い、今見せるのはいやです……」	PRINTFORMW 「现、现在不想给%CNAME("二人称")%看……」
PRINTFORMW 「そ、そういうのは他の人に頼んでください……」	PRINTFORMW 「那、那种事情请拜托别人去……」
PRINTFORMW %CALLNAME:TARGET%は軽蔑の表情で%CALLNAME:MASTER%を見ている…	PRINTFORMW %CALLNAME:TARGET%用轻蔑的表情看着%CALLNAME:MASTER%…
CALL PRINT_STR, @"「ひうっ_BHH_　やっ…コリコリしないでくださいぃ_BHH_」_W"	CALL PRINT_STR, @"「咦呜_BHH_　呀…请不要一戳一戳的_BHH_」_W"
PRINTFORMW %CALLNAME:MASTER%は%CALLNAME:TARGET%のたてすじから顔を出している肥大した陰核を優しく摘み上げた…	PRINTFORMW %CALLNAME:MASTER%用温柔的动作轻轻揉捏着从%CALLNAME:TARGET%的蜜裂中露出来的肥大化的阴蒂…
PRINTFORMW %CALLNAME:MASTER%が刺激するたびに、%CALLNAME:TARGET%はガクガクと腰を震わせながら愛液を撒き散らしている…	PRINTFORMW 每次%CALLNAME:MASTER%刺激的时候、%CALLNAME:TARGET%都是咯吱咯吱的颤抖着腰部，爱液喷撒得到处都是…
CALL PRINT_STR, @"「んっ_BHH_　そんなおさえ方じゃおさまらないですよぉ…_BHH_」_W"	CALL PRINT_STR, @"「嗯_BHH_　要是用那种方式按压的话会忍不住的哦…_BHH_」_W"
PRINTFORMW %CALLNAME:MASTER%は%CALLNAME:TARGET%のヒクヒクと震える膣口に、処女膜を傷つけないように浅く指を挿れた…	PRINTFORMW %CALLNAME:MASTER%在%CALLNAME:TARGET%一颤一颤的抖动的蜜穴口内、为了不伤害处女膜浅浅的抽插着手指…
PRINTFORMW %CALLNAME:TARGET%の膣口は涎を垂れ流しながらも、%CALLNAME:MASTER%の指を離さないように吸い付いてくる…	PRINTFORMW %CALLNAME:TARGET%的蜜穴口虽然流淌着液体、但像是不想要%CALLNAME:MASTER%的手指离开一样紧紧吸附着…
CALL PRINT_STR, @"「ひっ_BHH_　引っ掻かないでくださいぃ_BHH_」_W"	CALL PRINT_STR, @"「请_BHH_　请不要这样搅拌那种地方_BHH_」_W"
PRINTFORMW %CALLNAME:MASTER%は%CALLNAME:TARGET%の幼い膣穴を、愛液を掻き出すように中指で穿った…	PRINTFORMW %CALLNAME:MASTER%在%CALLNAME:TARGET%稚嫩的小穴里、就像要把爱液掏出来一样用中指搅拌抽插着…
PRINTFORMW 敏感なＧスポットを擦られる度に、%CALLNAME:TARGET%は腰をビクビクと震わせている…	PRINTFORMW 每次摩擦敏感的G点的时候、%CALLNAME:TARGET%的腰都一颤一颤的抖动着…
CALL PRINT_STR, @"「こんなんじゃ…うっ_BHH_　いつまでたっても収まらなぃいっ_BHH_！…です」_W"	CALL PRINT_STR, @"「这种事情…呜_BHH_　无论什么时候做都没办法_BHH_！…忍住啊」_W"
PRINTFORMW %CALLNAME:MASTER%は%CALLNAME:TARGET%の%TEXTR("幼い/小さな")%%TEXTR("性器/膣")%を広げ、溢れ出た愛液を綺麗に舐めとろうとした…	PRINTFORMW %CALLNAME:MASTER%将%CALLNAME:TARGET%的%TEXTR("稚嫩的/小巧的")%%TEXTR("性器/蜜穴")%撑开、将满溢出来的爱液漂亮的舔干净了…
PRINTFORMW しかし何度綺麗に舐めとっても、%CALLNAME:TARGET%が腰を震わせるたびに愛液がドロリと溢れてくる…	PRINTFORMW 但是无论如何漂亮的舔干净、每次%CALLNAME:TARGET%的腰猛地颤抖之后爱液还是会噗嗤噗嗤的溢出来…
PRINTFORMW 「あっ、だ、だめです%CNAME("二人称")%」	PRINTFORMW 「啊、不、不要这样%CNAME("二人称")%」
CALL PRINT_STR, @"「そ、そこ弄っちゃ…んうぅ_BHH_」_W"	CALL PRINT_STR, @"「那、那样玩弄那里的话…嗯唔！_BHH_」_W"
PRINTFORMW %CALLNAME:MASTER%は%CALLNAME:TARGET%の%TEXTR("ツルツル/プニプニ")%の%TEXTR("たてすじ/ワレメ")%を、陰核を探るように指でグニグニと弄った。	PRINTFORMW %CALLNAME:MASTER%在%CALLNAME:TARGET%的%TEXTR("光滑无毛/软软弹弹")%的%TEXTR("蜜缝/蜜裂")%上、像试探阴蒂似的用手指咕哩咕哩的捏了一下。
PRINTFORMW %CALLNAME:TARGET%は言葉で抵抗しながらも%CALLNAME:MASTER%の愛撫を受け入れ、甘い吐息を漏らしている…	PRINTFORMW %CALLNAME:TARGET%只是嘴上说着不要，身体却接受了%CALLNAME:MASTER%的爱抚、嘴里漏出了甜蜜的呼吸…
PRINTFORMW 「ひ、ひろげちゃだめです…」	PRINTFORMW 「那、那里不能撑开啊…」
CALL PRINT_STR, @"「%CNAME("二人称", "どもり")%の息が当たって…んっ_BHH_」_W"	CALL PRINT_STR, @"「%CNAME("二人称", "どもり")%的呼吸吹在上面…嗯！_BHH_」_W"
PRINTFORMW %CALLNAME:MASTER%は%CALLNAME:TARGET%の%TEXTR("幼い/小さな")%%TEXTR("性器/膣")%を、両手の指で広げて観察した。	PRINTFORMW %CALLNAME:MASTER%把%CALLNAME:TARGET%%TEXTR("稚嫩的/小巧的")%%TEXTR("性器/蜜穴")%、用双手的手指扩开观察了里面。
PRINTFORMW %CALLNAME:TARGET%は羞恥で身体を震わせながら、広げられた\@ TALENT:処女 ? 処女膜 # 膣口 \@をヒクつかせながら愛液を垂らしている…	PRINTFORMW %CALLNAME:TARGET%羞耻地身体一颤一颤的同时、张开的\@ TALENT:処女 ? 処女膜 # 蜜穴口 \@一边收缩着一边滴着爱液…
PRINTFORMW 「あんまりツンツンしないでください…」	PRINTFORMW 「请不要在那种地方一戳一戳的…」
CALL PRINT_STR, @"「やっ_BHH_　擦るのはもっとだめです……」_W"	CALL PRINT_STR, @"「呀_BHH_　要是摩擦的话会变得更糟糕的……」_W"
PRINTFORMW %CALLNAME:MASTER%は%CALLNAME:TARGET%の%TEXTR("ぷにっとした/少女特有の")%%TEXTR("たてすじ/大陰唇")%の触感を楽しんだ。	PRINTFORMW %CALLNAME:MASTER%在%CALLNAME:TARGET%的胖次上面、享受着%TEXTR("香滑酥软的/少女特有的")%%TEXTR("蜜缝/陰唇")%的触感。
PRINTFORMW %CALLNAME:TARGET%は言葉で抵抗しながらも、とろけた表情で%CALLNAME:MASTER%の愛撫を受け入れている…	PRINTFORMW %CALLNAME:TARGET%只是嘴上说着不要、但是脸上却带着要融化一样的表情接纳着%CALLNAME:MASTER%的爱抚…
PRINTFORMW 「どうしても見たいんですか……？」	PRINTFORMW 「无论如何都想看吗……？」
PRINTFORMW 「うぅ…恥ずかしいです……」	PRINTFORMW 「呜…太羞耻了……」
PRINTFORMW 「わかりました…%CNAME("二人称")%がそう言うなら……」	PRINTFORMW 「我明白了…要是%CNAME("二人称")%这么说的话……」
PRINTFORMW 「ちょっとだけですよ……？」	PRINTFORMW 「只是稍微看一下哟……？」
PRINTFORMW 「そ、そんなにジロジロ見ないでください……」	PRINTFORMW 「请、请不要那样仔仔细细地盯着看……」
PRINTFORMW 「濡れてきちゃいますから……」	PRINTFORMW 「不然的话会变湿的……」
PRINTFORMW 「やっ、だめです！見ないでください！」	PRINTFORMW 「呀、不能这样！请不要看这里！」
PRINTFORMW 「いやです！やめてください！」	PRINTFORMW 「不要！请不要这样！」
PRINTFORMW 「な、泣いちゃいますよ…いいんですか……？」	PRINTFORMW 「要、要哭了哟…这样也可以吗……？」
PRINTFORMW %CALLNAME:TARGET%に激しく抵抗されてしまった…	PRINTFORMW 被%CALLNAME:TARGET%激烈地抵抗了…
PRINTFORMW 今のところは%CALLNAME:TARGET%の%PANTIES(TARGET, "パンツ")%をじっくり見るのは無理のようだ…	PRINTFORMW 今のところは%CALLNAME:TARGET%のパンツをじっくり見るのは無理のようだ…
CALL PRINT_STR, @"「そ、そこ擦っちゃ…んうぅ_BHH_」_W"	CALL PRINT_STR, @"「那、不能摩擦那里… 呜_BHH_」_W"
PRINTFORMW %CALLNAME:MASTER%は%CALLNAME:TARGET%の%PANTIES(TARGET, "パンツ")%の上から、陰核を探るように指でグニグニと弄った。	PRINTFORMW %CALLNAME:MASTER%は%CALLNAME:TARGET%のパンツの上から、陰核を探るように指でグニグニと弄った。
CALL PRINT_STR, @"「ぬ、布地と擦れて…あっ_BHH_」_W"	CALL PRINT_STR, @"「和、和胖次摩擦的话…呀_BHH_」_W"
PRINTFORMW %CALLNAME:MASTER%は%CALLNAME:TARGET%の%PANTIES(TARGET, "パンツ")%越しに、%TEXTR("幼い/小さな")%%TEXTR("性器/膣")%を指で広げて観察した。	PRINTFORMW %CALLNAME:MASTER%は%CALLNAME:TARGET%のパンツ越しに、%TEXTR("幼い/小さな")%%TEXTR("性器/膣")%を指で広げて観察した。
PRINTFORMW %CALLNAME:TARGET%は羞恥で身体を震わせながら、%CALLNAME:MASTER%の眼前で%PANTIES(TARGET, "パンツ")%を湿らせた…	PRINTFORMW %CALLNAME:TARGET%は羞恥で身体を震わせながら、%CALLNAME:MASTER%の眼前でパンツを湿らせた…
PRINTFORMW %CALLNAME:MASTER%は%CALLNAME:TARGET%の%PANTIES(TARGET, "パンツ")%の上から、%TEXTR("ぷにっとした/少女特有の")%%TEXTR("たてすじ/大陰唇")%の触感を楽しんだ。	PRINTFORMW %CALLNAME:MASTER%は%CALLNAME:TARGET%のパンツの上から、%TEXTR("ぷにっとした/少女特有の")%%TEXTR("たてすじ/大陰唇")%の触感を楽しんだ。
PRINTFORMW 「うぅ…あんまり見ないでくださいね……」	PRINTFORMW 「呜…请不要一直盯着看呀……」
PRINTFORMW 「じゃないと…ビチョビチョになっちゃいます……」	PRINTFORMW 「不然的话…会变得湿漉漉的……」
PRINTFORMW 「そんなにいいものじゃないと思うんですけど……」	PRINTFORMW 「虽然%CNAME("一人称")%觉得并不是什么好东西……」
PRINTFORMW 「でも、%CNAME("二人称")%が夢中になってくれるなら悪い気はしないです……」	PRINTFORMW 「但是、如果%CNAME("二人称")%对这个着迷的话，%CNAME("一人称")%也不会觉得不舒服……」
PRINTFORMW 「し、湿ってないですか……？」	PRINTFORMW 「不、不会很湿吗……？」
PRINTFORMW 「グショグショになってたら…%CNAME("二人称")%のせいですからね……」	PRINTFORMW 「要是变得湿漉漉的话…就是%CNAME("二人称")%的错哦……」
PRINTFORMW 「な、何しようとしてるんですか……？」	PRINTFORMW 「在、在做什么啊……？」
PRINTFORMW 「なんですか？その手つきは……」	PRINTFORMW 「想干什么啊？那个手势……」
PRINTFORMW 「もしかして、触ろうとしてないですか……？」	PRINTFORMW 「难道说、该不会是想碰吧……？」
PRINTFORMW %CALLNAME:MASTER%は%CALLNAME:TARGET%の股間に手を近づけようとすると、%CALLNAME:TARGET%は怪訝な目つきをして身体を引いた…	PRINTFORMW 每次%CALLNAME:MASTER%想把手靠近%CALLNAME:TARGET%的股间的时候、%CALLNAME:TARGET%都会带着惊讶的眼神拉开身体…
PRINTFORMW 今のところは%CALLNAME:TARGET%の股間を詳しく調べるのは無理のようだ…	PRINTFORMW 现在想要详细调查%CALLNAME:TARGET%的股间的话好像是不行的样子…
PRINTFORMW 「んっ…あんまりイタズラしないでください……」	PRINTFORMW 「嗯…请不要太捉弄%CNAME("一人称")%了……」
PRINTFORMW 「やっ…やめてください……」	PRINTFORMW 「请…请不要这样……」
CALL PRINT_STR, @"「ひゃっ_BHH_　う、うぅ……」_W"	CALL PRINT_STR, @"「呀_BHH_　呜、呜……」_W"
PRINTFORMW %CALLNAME:MASTER%は%CALLNAME:TARGET%の股間を上下になぞり上げた…	PRINTFORMW %CALLNAME:MASTER%在%CALLNAME:TARGET%的股间上下摩擦的动作着…
PRINTFORMW %CALLNAME:MASTER%の指が陰核の場所を通過するたび、%CALLNAME:TARGET%はピクリと腰を震わせている…	PRINTFORMW 每次%CALLNAME:MASTER%的手指摩擦过阴核的位置、%CALLNAME:TARGET%的腰都会猛地一震…
PRINTFORMW 「%CNAME("二人称", "どもり")%…どこ見てるんですか……」	PRINTFORMW 「%CNAME("二人称", "どもり")%…在看哪里啊……」
PRINTFORMW 「あ、あんまり見ないでください……」	PRINTFORMW 「请、请不要一直看着这里……」
PRINTFORMW 「ど…どうぞ……」	PRINTFORMW 「请…请用……」
CALL PRINT_STR, @"「う、うぅ…恥ずかしいです……_／／／_」_W"	CALL PRINT_STR, @"「呜、呜…好羞耻……_／／／_」_W"
PRINTFORMW 「ちゃ、ちゃんと%CNAME("二人称")%の言うとおりに…穿いてないです……」	PRINTFORMW 「有、有好好按照%CNAME("二人称")%说的那样…底下是真空的……」
PRINTFORMW 「見たかったんですよね……？」	PRINTFORMW 「是想看这里对吧……？」
PRINTFORMW 「ん…%CNAME("二人称")%……何を…してるんです……？」	PRINTFORMW 「嗯…%CNAME("二人称")%……是…在做什么呢……？」
PRINTFORMW 「きゃっ！や、やめてください……」	PRINTFORMW 「呀！请、请不要这样……」
PRINTFORMW 抵抗しようと身体に力が入ったせいか、さらけ出された%CALLNAME:TARGET%の幼いワレメから愛液が溢れ出てきている…	PRINTFORMW 不知道是不是因为身体用力抵抗了、暴露在外面的%CALLNAME:TARGET%的稚嫩的蜜裂里面溢出了爱液…
PRINTFORMW 「やだっ、見な、見ないでください……」	PRINTFORMW 「讨厌、别、别看这里……」
PRINTFORMW 「さっき…見えたんじゃないんですか……？」	PRINTFORMW 「刚才…难道没有看见吗……？」
PRINTFORMW 「もしかして…ちゃんと確認したくなったんですか……？」	PRINTFORMW 「难不成…想要好好的确认一下吗……？」
CALL PRINT_STR, @"「でも…%CNAME("一人称")%のことが気にしてくれるのは…うれしいです……_／／／_」_W"	CALL PRINT_STR, @"「但是…在意%CNAME("一人称")%的事这样的…很开心……_／／／_」_W"
PRINTFORMW 「%TEXTR("ひゃっ/きゃっ")%！さっき見たんじゃないんですか……？」	PRINTFORMW 「%TEXTR("呀/哇")%！刚刚没有看到吗……？」
PRINTFORMW 「べつに…見せたくて見せてるわけじゃないです……」	PRINTFORMW 「才不是…因为你想看所以才给你看的……」
PRINTFORMW 「%CNAME("二人称")%…真っ先にスカートをめくっちゃうぐらいムラムラしてるんですか……？」	PRINTFORMW 「%CNAME("二人称")%…要立马掀起裙子那种程度的躁动难耐嘛……？」
PRINTFORMW 「そのムラムラ…%CNAME("一人称")%にぶつけてもいいですよ……？」	PRINTFORMW 「那种躁动难耐…对%CNAME("一人称")%发泄出来也是没问题的哟……？」
PRINTFORMW %CALLNAME:TARGET%は抵抗するでもなく、心配そうな表情でこちらを見ている…	PRINTFORMW %CALLNAME:TARGET%并没有抵抗、而是用担心的表情看着这边…
PRINTFORMW 「%TEXTR("ひゃっ/きゃっ")%！いきなり何するんですか……」	PRINTFORMW 「%TEXTR("呀/哇")%！突然之间做什么呢！……」
PRINTFORMW 「これが挨拶の代わり…？%TEXTR("理解できない/訳が分からない")%です……」	PRINTFORMW 「这个是代替打招呼…？%TEXTR("不太能理解/有点莫名其妙")%……」
PRINTFORMW 「えっ、%CNAME("二人称", "どもり")%！やめてください！」	PRINTFORMW 「诶、%CNAME("二人称", "どもり")%！请不要这样！」
PRINTFORMW 「%CNAME("二人称")%の言うとおりにパンツ穿いてないんです！」	PRINTFORMW 「因为按照%CNAME("二人称")%说的那样没有穿胖次！」
PRINTFORMW 「えっ、%CNAME("二人称", "どもり")%！やめてください！今パンツ穿いてないんです！」	PRINTFORMW 「诶、%CNAME("二人称", "どもり")%！请不要这样！现在没有穿胖次！」
PRINTFORMW 「やっ、やだっ、知らない人に見られちゃいますっ」	PRINTFORMW 「讨、讨厌、被不认识的人看见了」
CALL PRINT_STR, @"「%CNAME("二人称")%…うぅ…すごく恥ずかしいです……_／／／_」_W"	CALL PRINT_STR, @"「%CNAME("二人称")%…呜…实在是非常的羞耻……_／／／_」_W"
PRINTFORMW %CALLNAME:TARGET%は最初は抵抗していたが、観念したのか顔を真っ赤にして動かなくなってしまった。	PRINTFORMW %CALLNAME:TARGET%最初是抵抗的，但是也许是意识到了吧，脸涨得通红的一动也不动。
PRINTFORMW 抵抗しようとして身体に力が入ったせいか、	PRINTFORMW 不知道是不是因为身体用力抵抗了、
PRINTFORM 普段から挿入してもらってる	PRINTFORM 从平时開始就插在里面
PRINTFORM %CALLNAME:TARGET%にぴったりの子供サイズのバイブ	PRINTFORM %CALLNAME:TARGET%将正合适的儿童规格的振動棒
PRINTFORM %CALLNAME:TARGET%には大きめの普通サイズのバイブ	PRINTFORM %CALLNAME:TARGET%将大号普通规格的振動棒
PRINTFORM %CALLNAME:TARGET%の腕の太さの巨根サイズのバイブ	PRINTFORM %CALLNAME:TARGET%将胳膊粗的巨根规格的振動棒
PRINTFORM 500mlペッドボトルほどのサイズのバイブ	PRINTFORM 500ml塑料瓶差不多规格的振動棒
PRINTFORMW が%TEXTR("幼い/小さな")%膣から抜け落ちそうになっている…	PRINTFORMW 从%TEXTR("稚嫩的/小巧的")%小穴里面快要挤掉下去了…
PRINTFORMW 「え、ちょっと、%CNAME("二人称")%、だめです、%CNAME("一人称")%が自分で戻しますからっ」	PRINTFORMW 「诶、等下、%CNAME("二人称")%、不行、%CNAME("一人称")%会自己放回去的啦，所以……」
CALL PRINT_STR, @"「あっ、だめっ、やああああぁぁぁ_BHH_BHH_BHH_」_W"	CALL PRINT_STR, @"「啊、不行、呀啊啊啊啊啊_BHH_BHH_BHH_」_W"
PRINTFORMW グイッと一気に奥まで押し込んでやると、%CALLNAME:TARGET%の%TEXTR("幼い/可愛らしい")%%TEXTR("膣口/膣")%から%TEXTR("夥しい/尋常じゃない")%量の愛液が飛び散った…	PRINTFORMW 嘿咻……一口气挤进最深处之后、从%CALLNAME:TARGET%的%TEXTR("稚嫩的/可愛的")%%TEXTR("蜜穴口/蜜穴")%里面%TEXTR("很多的/不寻常的")%量的愛液飞散了出来…
PRINTFORMW 極度に興奮したせいか、%CALLNAME:TARGET%の%TEXTR("幼い/可愛らしい/小さな")%%TEXTR("ワレメ/たてすじ/")%から%TEXTR("夥しい/尋常じゃない")%量の愛液が溢れ出てきている…	PRINTFORMW 不知道是不是极度兴奋的原因、从%CALLNAME:TARGET%的%TEXTR("稚嫩的/可愛的/小巧的")%%TEXTR("蜜裂/蜜缝/")%里面%TEXTR("很多的/不寻常的")%量的愛液溢了出来…
PRINTFORMW 「は…恥ずかしいです…けど……」	PRINTFORMW 「虽…虽然很害羞…但是……」
PRINTFORMW 「ちゃんと%CNAME("二人称")%の言うとおりに…挿れてますよ……？」	PRINTFORMW 「有好好按照%CNAME("二人称")%说的…插在里面哦……？」
PRINTFORM スカートの中では、%TEXTR("幼い/可愛らしい")%膣に	PRINTFORM 裙子底下、%TEXTR("稚嫩的/可愛的")%的小穴里面
PRINTFORM ぴったりの子供サイズのバイブ	PRINTFORM 正合适的儿童规格的振動棒
PRINTFORM は大きめの普通サイズのバイブ	PRINTFORM 大号普通规格的振動棒
PRINTFORM は大きすぎる巨根サイズのバイブ	PRINTFORM 大的过分的巨根规格的振動棒
PRINTFORMW が挿入されている…	PRINTFORMW 插在里面…
PRINTFORMW 「%CNAME("二人称", "どもり")%、他の人に見られちゃいます……」	PRINTFORMW 「%CNAME("二人称", "どもり")%、会被其他人看到的……」
PRINTFORMW 「は…恥ずかしい…です……」	PRINTFORMW 「有…有点害羞…啊……」
PRINTFORMW 「でも…%CNAME("二人称")%が見たいなら…我慢します……」	PRINTFORMW 「但是…如果%CNAME("二人称")%想看的话…会忍耐的……」
PRINTFORMW 「あっ…見られちゃいました……」	PRINTFORMW 「啊…被看见了……」
PRINTFORMW 「%CNAME("二人称")%は…こういうの好きですよね……？」	PRINTFORMW 「%CNAME("二人称")%的话…喜欢这样的事情对吧……？」
PRINTFORMW 「%TEXTR("きゃっ/ひゃっ")%！見ないでください……」	PRINTFORMW 「%TEXTR("呀/哇")%！请不要看过来……」
PRINTFORMW 「違うんです、これはぐちゃぐちゃで穿けなくなったからで……」	PRINTFORMW 「不是这样的、是因为乱糟糟的所以没有穿上……」
PRINTFORMW 「%TEXTR("きゃっ/ひゃっ")%！やめてください……」	PRINTFORMW 「%TEXTR("呀/哇")%！请不要这样……」
PRINTFORMW 「す、好きで穿いてないわけじゃないです……」	PRINTFORMW 「才、才不是因为喜欢才穿上的……」
PRINTFORMW 「%CNAME("二人称")%って、%PANTIES(TARGET, "パンツ")%好きですね……」	PRINTFORMW 「%CNAME("二人称")%って、パンツ好きですね……」
PRINTFORMW 「もっとじっくり見ても…いいですよ……？」	PRINTFORMW 「就算更加仔细点看…也是可以的哟……？」
PRINTFORMW 「%CNAME("二人称")%も飽きないですね……」	PRINTFORMW 「%CNAME("二人称")%也不会腻呢……」
PRINTFORMW 「%CNAME("一人称")%は%CNAME("二人称")%になら…どれだけでも見せてあげてもいいですけど……」	PRINTFORMW 「%CNAME("一人称")%的话，如果是%CNAME("二人称")%…无论是什么地方都可以看的哦……」
PRINTFORMW 「%TEXTR("きゃっ/ひゃっ")%！何するんですか……」	PRINTFORMW 「%TEXTR("呀/哇")%！干什么呀……」
PRINTFORMW 「やっ、やめてください……」	PRINTFORMW 「请、请不要这样……」

PRINTFORMW 写真には「%MAIL_BODY%」というメッセージが添えられている…	PRINTFORMW 照片上附加了「%MAIL_BODY%」这样的信息…
PRINTFORMW 「%CNAME("二人称", "どもり")%…日曜日って空いてますか……？」	PRINTFORMW 「%CNAME("二人称", "どもり")%…这周日有空吗……？」
PRINTFORMW 「もし良かったら…日曜日に%CNAME("一人称")%と遊びに行きませんか……？」	PRINTFORMW 「如果可以的话…这周日不和%CNAME("一人称")%一起去玩一玩吗……？」
PRINTFORMW 「日曜に遊びに行くんですか？別に大丈夫ですけど……」	PRINTFORMW 「周日一起去玩是吗？虽然没问题就是了……」
PRINTFORMW 「他に誰がいるんですか？え、ふたりきり……？」	PRINTFORMW 「有其他人一起吗？诶、就我们两个……？」
PRINTFORMW 「わ、わかりました……」	PRINTFORMW 「我、我明白了……」
PRINTFORMW 「えっ…%CNAME("一人称", "どもり")%で良ければ…いくらでも……」	PRINTFORMW 「诶…%CNAME("一人称", "どもり")%可以的话…无论多少次都……」
PRINTFORMW %CALLNAME:MASTER%の誘いに%CALLNAME:TARGET%はあたふたしているが、嬉しそうな表情が伺える…	PRINTFORMW %CALLNAME:MASTER%的邀请让%CALLNAME:TARGET%有点慌慌张张的、脸上露出了高兴的表情…
PRINTFORMW 『もしもし、どうかしたんですか%CNAME("二人称")%……』	PRINTFORMW 『喂喂喂、发生什么了啦%CNAME("二人称")%……』
PRINTFORMW 『え、遊びに？今からですか？』	PRINTFORMW 『诶、一起去玩？从今天开始吗？』
PRINTFORMW 『う、うぅ…わかりました、今から準備しますので……』	PRINTFORMW 『呜、呜…我明白了、现在开始准备……』
PRINTFORMW 『いえっ！行きたくないわけじゃないですっ！とってもうれしいですっ！』	PRINTFORMW 『不，不是！并不是不想去！%CNAME("一人称")%非常的开心！』
PRINTFORMW 「えっ、今から遊びに行くんですか？」	PRINTFORMW 「诶、现在开始去玩吗？」
PRINTFORMW 「わわわ、わかりました…急いで支度するのでっ！」	PRINTFORMW 「哇哇哇、我明白了…要赶紧准备了！」
PRINTFORMW 「あっ、あっ、でもっ、時間がかかるのでっ！う、ううぅ……」	PRINTFORMW 「啊、啊、但是、因为要花点时间！呜、呜呜……」
PRINTFORMW %CALLNAME:MASTER%は慌てふためく%CALLNAME:TARGET%を落ち着かせ、ゆっくり準備させた…	PRINTFORMW %CALLNAME:MASTER%让慌慌张张的%CALLNAME:TARGET%冷静下来、慢慢准备…
PRINTFORMW 「%CNAME("二人称")%…今日は誘ってくれてありがとうございます……」	PRINTFORMW 「%CNAME("二人称")%…今天能邀请%CNAME("一人称")%非常的感谢……」
PRINTFORMW 「%CNAME("一人称")%はとっても楽しかったです……」	PRINTFORMW 「%CNAME("一人称")%非常的高兴……」
PRINTFORMW %CALLNAME:TARGET%は%CALLNAME:MASTER%の手を握り締めながら、ピッタリと体を触れ合わせている…	PRINTFORMW %CALLNAME:TARGET%紧紧握住%CALLNAME:MASTER%的手的同时、身体恰好碰在了一起…
PRINTFORMW 「今日はありがとうございました…とっても楽しかったです……」	PRINTFORMW 「今天非常感谢…%CNAME("一人称")%非常的开心……」
PRINTFORMW 「あまりこうやって外で遊ばないので…ちょっと疲れちゃいました……」	PRINTFORMW 「因为没怎么像这样出来玩过…稍微有点累了……」
//文件: EVENT_K33_SELECT.ERB
PRINTFORMW 「うぅ…%CNAME("二人称")%がそういうなら……」	PRINTFORMW 「呜…%CNAME("二人称")%这么说的话……」
PRINTFORMW 「でも…あまりひどい事しないでほしいです……」	PRINTFORMW 「但是…希望不会做很过分的事情……」
PRINTFORMW 「%CNAME("二人称")%のこと…信じてるので……」	PRINTFORMW 「因为……我相信着%CNAME("二人称")%……」
PRINTFORMW 青空鈴で使用不能だったコマンドが全て使えるようになりました。	PRINTFORMW 青空铃不能使用的指令现在全都变成了可以使用。
PRINTFORMW 勿論ですが、この機能で使えるようになったコマンドでは喋りません…	PRINTFORMW 当然的、开启这个机能的指令不会再出现了…
//文件: EVENT_K33_SHOP.ERB
PRINTFORMW 「%CNAME("一人称")%にお願い事ですか？」	PRINTFORMW 「想要拜托%CNAME("一人称")%来做的事是吗？」
PRINTFORMW 「%CNAME("一人称", "どもり")%にできることだったら良いんですが……」	PRINTFORMW 「如果是%CNAME("一人称", "どもり")%能够做到的事情就好了……」
PRINTFORMW 「頼みたいこと…ですか？」	PRINTFORMW 「想要拜托的事情…是吗？」
PRINTFORMW 「あんまりえっちなお願いはその、あの、うぅ……」	PRINTFORMW 「不是很H的请求的话那个、那个、呜……」
PRINTFORMW 「%CNAME("一人称", "どもり")%にお願いがあるんですか…？」	PRINTFORMW 「想要拜托%CNAME("一人称", "どもり")%的来做事情是吗…？」
PRINTFORMW 「%CNAME("一人称")%にできることは、そんなにないと思うんですけど……」	PRINTFORMW 「%CNAME("一人称")%能够做到的事情、我觉得并没有那么多哦……」
PRINTFORMW 「え…冗談ですよね……？」	PRINTFORMW 「诶…是在开玩笑吧……？」
PRINTFORMW 「だ、だって…%CNAME("一人称")%は%CNAME("二人称")%に比べたら小さいですし……」	PRINTFORMW 「因、因为…%CNAME("一人称")%和%CNAME("二人称")%比起来很小……」
PRINTFORMW 「あ、あんまり%CNAME("一人称")%のこと、からかわないでください……」	PRINTFORMW 「请、请不要太过于戏弄%CNAME("一人称")%了……」
PRINTFORMW 「うれしいです…でも本気じゃないですよね……？」	PRINTFORMW 「虽然我很高兴…但是这不是认真的吧……？」
//文件: EVENT_K33_鈴.ERB
初等部の学生。	初等部的学生。
おいしそうなニオイに導かれて部室に辿りついたらしい。	被很好闻的味道吸引过来一路到了部室。
本人は自分が何かの病気だと思っているが、	虽然本人觉得自己是不是生了什么病、
彼女の身体の中では尋常じゃないほどの精に対する欲求が渦巻いている。	但其实是她身体中对精魂的异常欲求在作怪。
PRINTFORMW 昼休みに%CALLNAME:MASTER%が部室に向かうと、部室の前で見覚えの無い少女が座り込んでいた。	PRINTFORMW %CALLNAME:MASTER%在午休时前往部室的时候、发现部室门前坐着一个没有见过的少女。
PRINTFORMW 声をかけようとするが、その前に少女はパタリとその場で倒れてしまった……	PRINTFORMW 在打算问一下之前、少女就啪嗒一声倒在了地上……
PRINTFORMW 『ご主人様、どうかしましたか？……って、何ですかこの床』	PRINTFORMW 『主人大人、怎么了？……呃、地板上这是什么情况』
PRINTFORMW 既に部室にいたフェリシエルが出てくると、びしょ濡れの廊下を見てため息をついた。	PRINTFORMW 听见声响从部室里出来的弗理希艾尔、看着濡湿的走廊叹了口气。
PRINTFORMW 『ローショントラップ…？ですか、こんなイタズラには引っかかりませんよ？』	PRINTFORMW 『潤滑液陷阱…？吗、这样的恶作剧是不会有人上钩的哦？』
PRINTFORMW %CALLNAME:MASTER%が身に覚えの無い罪を着せられてキョトンとしていると、	PRINTFORMW 在%CALLNAME:MASTER%因为这口冤枉的大锅而生气的时候、
PRINTFORMW 倒れている少女に気づいたフェリシエルは少し何かを考える素振りを見せ、	PRINTFORMW 弗理希艾尔注意到了倒在地上的少女、稍微思考了一下、
PRINTFORMW おもむろに倒れている少女のスカートを捲り上げた。	PRINTFORMW 然后就把倒地少女的裙子掀起来了。
PRINTFORMW 『見て下さいご主人様、普通じゃこんなのありえないですよ』	PRINTFORMW 『主人大人来看一下、发生了正常情况下根本不可能出现的事情』
PRINTFORMW フェリシエルが捲り上げた少女のスカートの中では、	PRINTFORMW 弗理希艾尔掀起的少女的裙中、
PRINTFORMW ぐしょぐしょになってるショーツの中から夥しい量の愛液が溢れ出ていた……	PRINTFORMW 肉眼可见的从内裤里咕嘟咕嘟地往外溢出愛液……
PRINTFORMW 『よくわからないですけど、とりあえずベッドで寝かせておきましょうか……』	PRINTFORMW 『虽然不知道发生了什么、总而言之先让她躺在床上休息一下吧……』
PRINTFORMW 『ご主人様も手伝ってくれますよね？』	PRINTFORMW 『主人様能来帮把手吗？』
PRINTFORMW %CALLNAME:MASTER%はフェリシエルと協力して、少女をベッドで寝かせてから床の掃除をした……	PRINTFORMW %CALLNAME:MASTER%和弗理希艾尔共同協力、把少女架到了床上、然后打掃了走廊的地面……
PRINTFORMW しばらくすると少女は目を覚ました。	PRINTFORMW 稍微过了一会，少女睁开了眼睛。
PRINTFORMW 「あれ？ここはどこですか？%CNAMET(ARG, "一人称")%は一体なにを……」	PRINTFORMW 「啊咧？这里是哪？%CNAMET(ARG, "一人称")%到底发生什么了……」
PRINTFORMW 『聞きたいのはこっちですよ……何で初等部の生徒がこんな所にいるんですか？』	PRINTFORMW 『我们才想问你呢……为什么初中部的学生会到这里来？』
PRINTFORMW %CALLNAME:MASTER%はここは自分の部活の部室であることを伝え、どうやってここに来たのかを尋ねた。	PRINTFORMW %CALLNAME:MASTER%告诉对方这里是自己的社团部室、并询问她是怎么来到这里的。
PRINTFORMW 「そういえば……なんだか、おいしそうなニオイがしたんです……そのあとは、なんだかボーっとして……」	PRINTFORMW 「这么说的话……怎么说呢、好像闻到了很美味的味道……在那之后、就这样呆呆地……」
PRINTFORMW 『おいしそうなニオイですか、それが何のニオイかは分かるんですか？』	PRINTFORMW 『好闻的味道、大概能知道是什么样的味道吗？』
PRINTFORMW 少女は顔を真っ赤にしながら、やや俯きがちに答えた。	PRINTFORMW 少女嘭的一下红透了脸、低着头回答。
PRINTFORMW 「わからない……けど、たぶん、えっちなニオイ……だと、おもいます……」	PRINTFORMW 「不知道……但是、大概、是H的味道……我、我是这么觉得的……」
PRINTFORMW 『ははぁ、えっちなニオイですか』	PRINTFORMW 『哈哈、H的味道吗』
PRINTFORMW 『まぁ、貴女のほうも相当えっちなニオイですけどね』	PRINTFORMW 『嘛、你这边的味道也相当的H就是了』
PRINTFORMW フェリシエルはベッドで寝ている少女のスカートを捲り上げた！	PRINTFORMW 弗理希艾尔直接掀起了躺在床上的少女的裙子！
PRINTFORMW ぴったりと閉じたツルツルの幼いワレメからは、溢れんばかりの愛液が垂れ流れている…	PRINTFORMW 紧閉着的光滑幼嫩缝隙里、不停向外流淌着溢出来的愛液…
CALL PRINT_STR, "「いやっ！みないでください……」_W"	CALL PRINT_STR, "「不要！请不要看这里……」_W"
PRINTFORMW 『はぁ…ご主人様、どうしますか？この子、放っておくと大変なことになると思いますよ』	PRINTFORMW 『哈啊…主人大人、该怎么做呢？这孩子、放着不管的话感觉会出大事。』
PRINTFORMW 『この子はほぼ人間ですが、僅かながら淫魔の力を感じますね』	PRINTFORMW 『虽然基本上是个人类没有错、不过能依稀地感觉到一点淫魔的力量』
PRINTFORMW 『おそらく淫魔に呪われているか、人間と淫魔の子か孫ってところでしょうね』	PRINTFORMW 『可能是被淫魔给诅咒了、或者是人类和淫魔的孩子孙子之类的情况』
PRINTFORMW 『もし助けてあげるならどうしてあげたら良いかなんて……ご主人様ならお分かりですよね？』	PRINTFORMW 『如果要帮的话应该怎么做……主人大人的话是明白的吧？』
PRINTFORMW 『貴女にはとりあえず自分の名前と、床とベッドを汚した事の言い訳でも言ってもらいましょうか』	PRINTFORMW 『总之你先说一下自己的名字、还有你弄脏了地板和床的理由』
PRINTFORMW 「えっと……%CNAMET(ARG, "一人称")%は青空 鈴（あおぞら すず）って言います」	PRINTFORMW 「那个……%CNAMET(ARG, "一人称")%叫青空 鈴（あおぞら 鈴）」
PRINTFORMW 「部室を汚してしまってごめんなさい……」	PRINTFORMW 「弄脏了部室非常对不起……」
PRINTFORMW 「%CNAMET(ARG, "一人称")%のこの、えっと……えっちなお汁は、ここ最近でいっぱい出てくるようになっちゃって……」	PRINTFORMW 「%CNAMET(ARG, "一人称")%的这个、H……H的汁液的话、最近这里变成出来了很多的情况……」
PRINTFORMW 「どうやってもおさまらないんです……」	PRINTFORMW 「怎么都停不下来的样子……」
PRINTFORMW 「うぅ……%CNAMET(ARG, "一人称", "どもり")%はえっちじゃないのに……」	PRINTFORMW 「呜……明明%CNAMET(ARG, "一人称", "どもり")%不是H的孩子……」
PRINTFORMW 『大体は察しが付きました。もしかしたらご主人様なら、鈴ちゃんの病気を治せるかもしれませんよ？』	PRINTFORMW 『大致明白了。如果是主人大人的话、说不定能治好铃酱的病哟？』
PRINTFORMW 「ほんとうですか？でも、一体どうやって……？」	PRINTFORMW 「真的吗？但是、到底要怎么治……？」
PRINTFORMW 『ここに来て、部活を見学すれば分かるようになりますよ』	PRINTFORMW 『到部室来、见习我们的部活的话就知道了哟』
PRINTFORMW ―%NAME:ARG%は部室に見学しに来るようになります。	PRINTFORMW ―%NAME:ARG%開始来部室参观見学了。
PRINTFORMW 「ところで、パンツは返してもらえないんでしょうか……」	PRINTFORMW 「话说回来、不能把胖次还回来吗……」
PRINTFORMW 『洗濯して乾いたら返してあげるので今は諦めてください』	PRINTFORMW 『洗完晾乾了之后会还的、现在你就放弃吧』
PRINTFORMW 『代わりといっては何ですが、ここにある下着なら好きなのを借りてもいいですよ？』	PRINTFORMW 『作为代替或者说是别的什么的、这里有的内裤你可以尽管选一条自己喜欢的穿也没関系的呦？』
PRINTFORMW フェリシエルが開けた棚には、Ｈな下着が並んでいる……	PRINTFORMW 弗理希艾尔打開橱子、里面整齐地摆放着H的内裤……
PRINTFORMW 「うぅ…じゃあいいです……」	PRINTFORMW 「呜…那也行吧……」
PRINTFORMW 「あ……やっぱりするんですね……」	PRINTFORMW 「啊……果然还是要做啊……」
PRINTFORMW 「フェリシエルさんがいろいろ教えてくれたんです」	PRINTFORMW 「弗理希艾尔桑教了%CNAME("一人称")%很多事情」
PRINTFORMW 「ここに来てる人は、%CNAME("二人称")%とえっちしなくちゃならない人たちだって」	PRINTFORMW 「来到这里的人都是、一些不得不和%CNAME("二人称")%做H的事情的一群人」
PRINTFORMW 「そして%CNAME("一人称")%もえっちなことしないといけない病気だって」	PRINTFORMW 「而且%CNAME("一人称")%也是得了不做H的事情就不行的病」
PRINTFORMW 「それも、普通の人間とは違うから抑えが効かなくなってるって」	PRINTFORMW 「而且、和普通的人类不一样单纯的压抑自己是不会起效果的」
PRINTFORMW 「%CNAME("一人称")%にとってはウソっぽい話ですけど……」	PRINTFORMW 「虽然对%CNAME("一人称")%来说像是谎话一样的感觉……」
PRINTFORMW 「でも、実際に大変なコトになってて……」	PRINTFORMW 「但是、实际上变成了不得了的事情……」
PRINTFORMW 「それに%CNAME("二人称")%となら、えっちなことをしてもいいかなって」	PRINTFORMW 「并且也觉得如果是%CNAME("二人称")%的话、H也不是不可以……」
PRINTFORMW 「きっとこのままだと、%CNAME("一人称")%が%CNAME("一人称")%じゃなくなっちゃうだろうから……」	PRINTFORMW 「如果这样下去的话、%CNAME("一人称")%可能就会变成不是%CNAME("一人称")%了……」
PRINTFORMW 「だから%CNAME("二人称")%、おねがいします」	PRINTFORMW 「所以%CNAME("二人称")%、拜托了」
PRINTFORMW 「%CNAME("一人称")%にえっちなことを、教えてください……」	PRINTFORMW 「好好教一教%CNAME("一人称")%、关于H的事情吧……」
PRINTFORMW %CALLNAME:MASTER%は%CALLNAME:TARGET%の頭をやさしく撫でてあげると、震えている身体をそっと抱き寄せた……	PRINTFORMW %CALLNAME:MASTER%温柔地抚摸着%CALLNAME:TARGET%的头、轻轻地抱住了她还在颤抖的身体……
PRINTFORMW 「%CNAME("一人称")%、いつもお腹がジンジンして苦しかったんです…」	PRINTFORMW 「%CNAME("一人称")%、肚子一直一紧一紧的很痛苦…」
PRINTFORMW 「でも、%CNAME("二人称")%に…うぅ……」	PRINTFORMW 「但是、%CNAME("二人称")%に…呜……」
PRINTFORMW 「%CNAME("二人称")%のせ、せーえきを、な…なかだししてもらったら……」	PRINTFORMW 「%CNAME("二人称")%的精、精液、能…能在里面中出的话……」
PRINTFORMW 「%CNAME("一人称")%のおなかがぽかぽかして、しあわせになって、」	PRINTFORMW 「%CNAME("一人称")%的里面就会暖洋洋的、感觉变得很幸福、」
PRINTFORMW 「そのあとは…エッチなおつゆも、びっくりするぐらい出なくなって……」	PRINTFORMW 「那之后就是…H的汁液的话、也不会出来了让%CNAME("一人称")%吓了一跳……」
PRINTFORMW 「で、でも…その……今は…また……」	PRINTFORMW 「但、但是…那个……现在…又……」
PRINTFORMW %CALLNAME:TARGET%は下腹部に着けてる衣類を脱ぎ捨てると	PRINTFORMW %CALLNAME:TARGET%把穿在下腹部的衣服脱下来扔掉了
PRINTFORMW 脚を広げて%CALLNAME:MASTER%に見せ付けるように両手でぴったりと閉じた縦すじを割り広げた…	PRINTFORMW 然后张开双腿，就像主动给%CALLNAME:MASTER%看一样，用双手将紧贴在一起的蜜缝分开…
PRINTFORMW 幼い性器には不釣合いなほどにビンビンに勃起したクリトリスをピクピクと震わせ、	PRINTFORMW 在稚嫩的性器上与之不相称的阴蒂坚硬的挺立着，一抖一抖的颤动着、
PRINTFORMW %CALLNAME:MASTER%のペニスが挿入っていたとは思えないほどの小さな膣口がヒクヒクと蠢きながら	PRINTFORMW 小到让人觉得%CALLNAME:MASTER%的肉棒没有办法插进去的蜜穴口在一抽一抽的蠕动着
PRINTFORMW 夥しい量の愛液をダラダラと垂れ流し、辺りに淫靡な香りが充満した…	PRINTFORMW 大量的爱液滴滴答答地流下来、周围弥漫着淫靡的香气…
PRINTFORMW 「%CNAME("二人称")%…どうか、おねがいします……」	PRINTFORMW 「%CNAME("二人称")%…请一定、要温柔点哦……」
PRINTFORMW 「%CNAME("二人称")%の、お、おちんちん、%CNAME("一人称")%のおまんこにいれてください……」	PRINTFORMW 「请把%CNAME("二人称")%的、小、小鸡鸡、插到%CNAME("一人称")%的小穴里面……」
PRINTFORMW 「%CNAME("二人称")%のおちんちんで、%CNAME("一人称")%のしきゅー…をいっぱいトントンしてください……」	PRINTFORMW 「请用%CNAME("二人称")%的小鸡鸡、把%CNAME("一人称")%的子宫…使劲撞得咚咚直响……」
PRINTFORMW 「%CNAME("二人称")%のせーえき、%CNAME("一人称")%のしきゅーにいっぱいだしてください……」	PRINTFORMW 「请把%CNAME("二人称")%的精液、再使劲点射更多进%CNAME("一人称")%的子宫里……」
PRINTFORMW 「じゃないと、%CNAME("一人称")%、%CNAME("一人称")%は……」	PRINTFORMW 「要是不这样的话、%CNAME("一人称")%会、%CNAME("一人称")%会……」
PRINTFORMW 恥ずかしさで顔を赤くして泣きそうな表情で懇願する%CALLNAME:TARGET%を、%CALLNAME:MASTER%はギュっと抱きしめてあげた……	PRINTFORMW %CALLNAME:MASTER%紧紧地抱住了因为害羞而脸变得通红，带着一幅快要哭出来一样的表情恳求着的%CALLNAME:TARGET%……
CALL PRINT_STR, @"＜%CALLNAME:TARGET%は_ハートピンク_[膣内射精に弱い]_を得た＞_W"	CALL PRINT_STR, @"＜%CALLNAME:TARGET%得到了_粉色的心_[膣内射精に弱い]_＞_W"
CALL PRINT_STR, @"「はーっ…_BHH_  はぁーっ_BHH_…  はぁ…_BHH_  はーっ…_BHH_」_W"	CALL PRINT_STR, @"「哈——…_BHH_  哈——っ_BHH_…  哈…_BHH_  哈——…_BHH_」_W"
PRINTFORMW %CALLNAME:TARGET%はベッドに仰向けに倒れ、息も絶え絶えだが表情はどことなく幸せそうにしている…	PRINTFORMW %CALLNAME:TARGET%仰面倒在床上、虽然喘不过气来但是露出了幸福的表情…
PRINTFORMW 下腹部に目をやると、%CALLNAME:MASTER%の精液が詰まっていることを示すようにポッコリと膨れ上がっていた…	PRINTFORMW 看向下腹部的话、就像%CALLNAME:MASTER%的精液被堵住了一般咕嘟咕嘟的膨胀起来…
CALL PRINT_STR, @"「んひっ！_BHH_  んうぅぅー！_BHH_BHH_  ふぅ…_BHH_  はぁ…_BHH_」_W"	CALL PRINT_STR, @"「嗯啊！_BHH_  嗯唔唔唔！_BHH_BHH_  呼…_BHH_  哈…_BHH_」_W"
PRINTFORMW 膨らんでいるお腹を指先で軽く押してやると、%CALLNAME:TARGET%は呻き声を上げながら腰を跳ねさせ	PRINTFORMW 膨らんでいる部分を指先で軽く押してやると、%CALLNAME:TARGET%は呻き声を上げながら腰を跳ねさせ
PRINTFORMW ぴったりと閉じた縦すじからごぽりと音を立てて精液が漏れ出てきた…	PRINTFORMW 从紧紧闭合的蜜缝当中发出咕噜咕噜的声音，精液也漏了出来…

PRINTFORMW %CALLNAME:MASTER%は%CALLNAME:TARGET%の未発達な体を探るように触れてみた	PRINTFORMW %CALLNAME:MASTER%试探性地触摸着%CALLNAME:TARGET%尚未发育的身体
PRINTFORMW %CALLNAME:TARGET%の肌は若々しくすべすべで、とても撫で心地が良い…	PRINTFORMW %CALLNAME:TARGET%的肌肤既年轻又很嫩滑、摸起来非常舒服…
PRINTFORMW 「ちょっとくすぐったい、です……」	PRINTFORMW 「稍微有点痒、痒痒的……」
PRINTFORM %CALLNAME:MASTER%は	PRINTFORM %CALLNAME:MASTER%
PRINTFORM %CALLNAME:TARGET%のスカートを捲り上げ、	PRINTFORM 把%CALLNAME:TARGET%的裙子掀了起来、
PRINTFORMW %CALLNAME:TARGET%の秘部を見つめた…	PRINTFORMW 仔细观察了%CALLNAME:TARGET%的阴部…
PRINTFORMW パンツをずらして%CALLNAME:TARGET%の秘部を曝け出した…	PRINTFORMW 错开内裤，露出了%CALLNAME:TARGET%的阴部…
PRINTFORMW まだ毛も生えないその場所は白磁のようにつるんとしており、	PRINTFORMW 那个地方还是光秃秃的像白瓷一样光滑、
PRINTFORMW 芸術のような曲線美で一本のすじが描かれている…	PRINTFORMW 用艺术般的曲线美划出了一条小缝儿…
PRINTFORMW 「あの…%CNAME("二人称")%……？そ、そんなにじっと見られると、その…うぅ……」	PRINTFORMW 「那个…%CNAME("二人称")%……？像、像那样紧紧的盯着的话、那个…呜……」

PRINTFORMW \@ TALENT:TARGET:処女 ? 糸を張ったような処女膜 # 小さな膣口 \@の向こう側は%CALLNAME:MASTER%を誘うかのように蠢いており、	PRINTFORMW \@ TALENT:TARGET:処女 ? 像拉紧的线一样的处女膜 # 小巧的蜜穴口 \@的对面像是在诱惑%CALLNAME:MASTER%一样蠢蠢欲动着、
PRINTFORMW 少しずつ愛液が垂れ流れてきている…	PRINTFORMW 爱液一点一点地流了下来…
PRINTFORMW 「はっ…はぁ…はっ……」	PRINTFORMW 「哈…哈…哈……」
PRINTFORMW ふと%CALLNAME:TARGET%の様子を伺うと、恥ずかしさからか両手で顔を覆いながら呼吸を早めていた	PRINTFORMW 突然观察了一下%CALLNAME:TARGET%的样子、不知道是不是因为害羞而用双手遮住了脸，呼吸也加快了许多
PRINTFORMW %CALLNAME:TARGET%の呼吸が荒くなるにつれ分泌される愛液の量も増え、誘うような甘い香りが濃くなっていく…	PRINTFORMW 随着%CALLNAME:TARGET%的呼吸越来越剧烈，爱液的量也分泌的更多了，诱人的甜美香气也变得更加浓厚了…
PRINTFORMW %CALLNAME:MASTER%は欲望に抗えず、%CALLNAME:TARGET%の\@ TALENT:TARGET:処女 ? 処女膜 # 膣口 \@にキスをした…	PRINTFORMW %CALLNAME:MASTER%抵抗着欲望、亲吻了一下%CALLNAME:TARGET%的\@ TALENT:TARGET:処女 ? 处女膜 # 蜜穴口 \@…
CALL PRINT_STR, @"「え！？な、何してるんですか、そんなとこなめたら…きたなひぃっ！_BHH_」_W"	CALL PRINT_STR, @"「诶！？在、在做什么啊、要是舔那种地方…很脏的…咦！_BHH_」_W"
PRINTFORMW %CALLNAME:MASTER%は愛液を舐め取るように、舌を伸ばして%CALLNAME:TARGET%の秘裂を下から上までなぞり上げると	PRINTFORMW %CALLNAME:MASTER%像是在舔取爱液一样、伸出舌头把%CALLNAME:TARGET%的秘裂从下到上仔细的舔着
PRINTFORMW 硬さのある突起に触れたところで、%CALLNAME:TARGET%は大きく腰を震わせた…	PRINTFORMW 在碰到坚硬的突起的时候、%CALLNAME:TARGET%的腰剧烈的颤抖了一下…
CALL PRINT_STR, @"「や、やだ…んぅっ！_BHH_  や、やめ…んっ_BHH_  やめてくうぅっ！_BHH_  や、やぁあっ！_BHH_」_W"	CALL PRINT_STR, @"「讨、讨厌…嗯唔！_BHH_  不、不要…嗯_BHH_  请不要…嗯唔！_BHH_  不、别…啊！_BHH_」_W"
PRINTFORMW 未知の快楽から逃れようと、弱々しく抵抗してくる%CALLNAME:TARGET%にかまわず	PRINTFORMW 不理会弱弱的抵抗着的想从未知的快感中逃离出来的%CALLNAME:TARGET%
PRINTFORMW %CALLNAME:MASTER%は溢れてくる蜜の味を確かめるように、繰り返し舌で掬い上げた…	PRINTFORMW %CALLNAME:MASTER%像是要品尝溢出来的甜蜜的味道一般、用舌头反复在那里舔舐着将爱液舀进嘴里…
PRINTFORMW %CALLNAME:MASTER%は%CALLNAME:TARGET%の小さな胸の中で激しく主張している突起に目が行った	PRINTFORMW %CALLNAME:MASTER%看到了%CALLNAME:TARGET%小巧的胸部中间那强烈主张自己的突起
PRINTFORMW 誘われるように%CALLNAME:TARGET%の乳首を口に含むと、コロコロと舐め回してみた…	PRINTFORMW 像是被邀请了一样把%CALLNAME:TARGET%的乳头含在嘴里、咕噜咕噜地来回舔着…
PRINTFORMW 「%CNAME("一人称", "どもり")%のおっぱいなんて、吸ってもたのしくないと思うんですけど……」	PRINTFORMW 「虽然%CNAME("一人称", "どもり")%觉得像这样的胸部、就算是吸了也不会觉得开心就是了……」
PRINTFORMW %CALLNAME:MASTER%は%CALLNAME:TARGET%の胸に触れてみると、なだらかな起伏の中には違和感のある突起を見つけた	PRINTFORMW %CALLNAME:MASTER%抚摸着%CALLNAME:TARGET%的胸部的时候、在平稳地起伏当中发现了违和的突起
PRINTFORMW 確かめるように触ってみるが、胸の大きさにしては乳首が大きいような気がする…	PRINTFORMW 像是确认一样摸了摸、感觉相比胸部的大小的话好像乳头更大一些…
PRINTFORMW 「や、つままないでください…うぅ……」	PRINTFORMW 「请、请不要捏那种地方…呜……」
PRINTFORMW %CALLNAME:MASTER%は%CALLNAME:TARGET%を抱き寄せて、至近距離で向かい合った…	PRINTFORMW %CALLNAME:MASTER%把%CALLNAME:TARGET%抱在怀里、近距离面对面着…
PRINTFORMW 「あ……」	PRINTFORMW 「啊……」
PRINTFORMW 「ふつうにキスするのははじめてですね……」	PRINTFORMW 「这样普通的接吻的话还是第一次呢……」
PRINTFORMW 「んっ…、ちゅ……、んぅ……」	PRINTFORMW 「嗯…、啾……、嗯……」
PRINTFORMW 「ぷぁ……、ふぅ……」	PRINTFORMW 「噗哈……、呼……」
PRINTFORMW 唇と唇の橋が架かり、その橋が落ちて二人の視線が下がる…	PRINTFORMW 嘴唇与嘴唇之间架起了一座桥、那座桥随着两人视线的下降滴落了下去…
PRINTFORMW 「つぎは…下でするんですか……？」	PRINTFORMW 「接下来…是下面要做是吗……？」
PRINTFORMW 「あ、いや、なんでもないです……」	PRINTFORMW 「啊、不是、什么都没有……」
PRINTFORMW %CALLNAME:MASTER%は不意に%CALLNAME:TARGET%を抱き寄せて、優しく口付けをした…	PRINTFORMW %CALLNAME:MASTER%突然将%CALLNAME:TARGET%抱进怀里、然后温柔地将嘴唇覆了上去…
PRINTFORMW 「んっ！…ぷはぁ……」	PRINTFORMW 「嗯！…噗哈……」
PRINTFORMW 「ひどいです、%CNAME("二人称")%…」	PRINTFORMW 「太过分了、%CNAME("二人称")%…」
PRINTFORMW 「どうせしてくれるなら、おちんちんより…先にしてほしかったです……」	PRINTFORMW 「反正都要做的话、比起小鸡鸡…更希望这边先做……」
PRINTFORMW %CALLNAME:MASTER%は%CALLNAME:TARGET%を抱き寄せると、頭を撫でながら優しく口付けをした…	PRINTFORMW %CALLNAME:MASTER%将%CALLNAME:TARGET%抱在怀里、一边抚摸着头一边温柔地将嘴唇覆了上去…
PRINTFORMW 「ぷはぁ、はぁ…ふぅ……」	PRINTFORMW 「噗哈、哈…呼……」
PRINTFORMW 「あまりよくわからないですけど…なんとなく%CNAME("二人称")%のやさしさが伝わってきます……」	PRINTFORMW 「虽然并不是很清楚就是了…总觉得能感受到%CNAME("二人称")%的温柔的地方……」
PRINTFORMW %CALLNAME:MASTER%は%CALLNAME:TARGET%の股間に手を滑り込ませ、性器の形を確かめるように撫でまわした	PRINTFORMW %CALLNAME:MASTER%的手滑进了%CALLNAME:TARGET%的双腿之间、像是在确认性器的形状一样来回抚摸着
PRINTFORMW ツルツルで肌触りがよく、ぷにぷにで気持ちが良い触感だ…	PRINTFORMW 光滑柔软又富有弹性的肌肤的触感摸起来非常的舒服…
PRINTFORMW 「あ…や、やだ…う、うぅ……」	PRINTFORMW 「啊…讨、讨厌…呜、呜呜……」
PRINTFORMW 恥ずかしさからか%CALLNAME:TARGET%は性器を触られている腕をギュっと掴み、足を閉じて抵抗していたが	PRINTFORMW 可能是因为害羞吧%CALLNAME:TARGET%紧紧的夹住了摸着性器的手臂、并拢双腿进行着抵抗
PRINTFORMW %CALLNAME:MASTER%は気に留めずに触り続けると、次第に触感はヌルヌルへ変化していき	PRINTFORMW %CALLNAME:MASTER%毫不在意地继续抚摸着的时候，那里的触感逐渐变得黏糊糊湿哒哒的
PRINTFORMW 新たなコリコリな触感も見つけ、気の赴くままに触り心地を楽しんだ…	PRINTFORMW 发现了新的咕哩咕哩的触感之后、尽情享受了随心所欲触摸的感觉…
CALL PRINT_STR, @"「あっ…あっ_BHH_  %CNAME("二人称", "どもり")%…ぅ、あ、あぁっ_BHH_」_W"	CALL PRINT_STR, @"「啊…啊_BHH_  %CNAME("二人称", "どもり")%…呜、啊、啊啊_BHH_」_W"
PRINTFORMW もはや%CALLNAME:TARGET%は抵抗というより、縋るように%CALLNAME:MASTER%の腕を抱きしめている…	PRINTFORMW 与其说%CALLNAME:TARGET%是在抵抗、不如说是在依赖%CALLNAME:MASTER%的手臂一般紧紧的抱着…
PRINTFORMW さすがに濡れてない状態で処女を奪うのは可哀想だ…	PRINTFORMW 怎么说在还没有湿透的情况下夺走处女果然还是太可怜了…
PRINTFORMW %CALLNAME:TARGET%ぐらいの年齢だと、きっと初潮前でコンドームは必要無いだろうが	PRINTFORMW 像%CALLNAME:TARGET%这样的年龄、因为肯定在初潮之前所以应该也不需要套套吧
PRINTFORMW もしかしたら早熟で既に初潮を迎えているかもしれない…	PRINTFORMW 不过可能因为早熟所以早就迎来了初潮也说不定呢…
PRINTFORMW %CALLNAME:TARGET%の気持ちの事もあるので、%CALLNAME:TARGET%にゴムの有無を聞いたほうがいいだろう。	PRINTFORMW 因为也要照顾到%CALLNAME:TARGET%的心情、所以还是问问%CALLNAME:TARGET%有没有套套吧。
PRINTFORMW 「え、ゴ、ゴム…ですか……？」	PRINTFORMW 「诶、套、套套…是吗……？」
PRINTFORMW 「えっと、その…%CNAME("一人称", "どもり")%は…まだ……」	PRINTFORMW 「诶多、那个…%CNAME("一人称", "どもり")%的话…还没……」
PRINTFORMW %CALLNAME:TARGET%は言葉の途中で何かを思いついたようで、	PRINTFORMW %CALLNAME:TARGET%似乎在说话的途中想到了什么一样、
PRINTFORMW しばらく何かを考えた後、頬を染めながら白々しく口を開いた…	PRINTFORMW 想了一会儿什么之后、脸颊染的绯红的同时张开了白皙的嘴巴…
CALL PRINT_STR, @"「あ、あの…%CNAME("二人称")%……ゴム？って…なんですか？……_BHH_」_W"	CALL PRINT_STR, @"「那、那个…%CNAME("二人称")%……套套？的话…是什么东西？……_BHH_」_W"
PRINTFORM %CALLNAME:TARGET%の言葉に興奮した%CALLNAME:MASTER%は、	PRINTFORM 因为%CALLNAME:TARGET%说的话而兴奋起来的%CALLNAME:MASTER%、
PRINTFORM %CALLNAME:TARGET%を押し倒して股を開かせると	PRINTFORM 推倒了%CALLNAME:TARGET%然后张开了她的双腿
PRINTFORM %CALLNAME:TARGET%を四つん這いにさせると	PRINTFORM 让%CALLNAME:TARGET%四肢着地趴在地上
PRINTFORM %CALLNAME:TARGET%をひっくり返すと	PRINTFORM 把%CALLNAME:TARGET%翻转过来
PRINTFORMW 膣口にペニスを宛がった…	PRINTFORMW 把肉棒插进了蜜穴口里面…
PRINTFORMW が、%CALLNAME:TARGET%の性器は幼い外見相応に小さく、うまく挿入できない…	PRINTFORMW 但是、%CALLNAME:TARGET%的性器就和稚嫩的外表看上去一样小巧、不能很好的插入…
PRINTFORMW 「こ、こうしたほうがいいですか……？」	PRINTFORMW 「这、这样做的话会比较好吗……？」
PRINTFORMW %CALLNAME:MASTER%が苦戦していると、%CALLNAME:TARGET%は自ら性器を両手で割り開いた…	PRINTFORMW %CALLNAME:MASTER%正在苦战的时候、%CALLNAME:TARGET%自己主动用双手分开了自己的性器…
PRINTFORMW 改めて狙いを定めると、嘘のように%CALLNAME:TARGET%の小さな膣にペニスが吸い込まれていき	PRINTFORMW 重新决定目标之后、就像是骗人一样肉棒被%CALLNAME:TARGET%小巧的肉穴给吸了进去
PRINTFORMW 細い膣穴をギチギチと広げながらも、ヌルっと膣奥まで飲み込まれた…	PRINTFORMW 细小的肉穴被咯吱咯吱的撑开了、但还是将肉棒给吞入了肉穴深处…
PRINTFORM %CALLNAME:MASTER%のペニスは	PRINTFORM %CALLNAME:MASTER%的肉棒
PRINTFORMW %CALLNAME:TARGET%の膣にピッタリと納まっている…	PRINTFORMW 完美的容纳进了%CALLNAME:TARGET%的肉穴里面…
PRINTFORMW 根元まで数センチ残っているが、おそらくこれ以上は入らないだろう…	PRINTFORMW 在离根部还有几厘米的时候、恐怕没有办法再进去了吧…
PRINTFORMW 半分しか入っていないが、おそらくこれ以上は入らないだろう…	PRINTFORMW 虽然已经插进去了一半、但是恐怕没有办法再进去了吧…
PRINTFORMW 先っぽしか入っていないが、これ以上入れるのは酷だろう…	PRINTFORMW 虽然先头已经插进去了、但是要是继续插的话实在是太过分了…
PRINTFORMW 爆発した！ナムサン！（ペニスのサイズがよくわからないエラー）	PRINTFORMW 爆炸了！南无三！（肉棒的尺寸出现了不明错误）
PRINTFORMW 「いぎっ…！いたくて…くるしいです……」	PRINTFORMW 「咦呀っ…！很痛…很难受……」
PRINTFORMW %CALLNAME:TARGET%は痛々しい表情をしながら、限界まで広げられた膣でペニスを痛いほどに締め付けている…	PRINTFORMW %CALLNAME:TARGET%一边带着痛苦的表情、一边用扩张到极限的肉穴将肉棒紧紧的勒到有点痛…
PRINTFORMW %CALLNAME:MASTER%は%CALLNAME:TARGET%の涙を手で掬いながら、ペニスをゆっくりと抜こうとしたが…	PRINTFORMW %CALLNAME:MASTER%用手将%CALLNAME:TARGET%的眼泪擦掉的同时、慢慢的想要把他的肉棒拔出来…
PRINTFORMW 「やっ！やめないで…ください……」	PRINTFORMW 「请っ！请不要…这么做……」
PRINTFORMW 「すごくいたいですけど…でも、それ以上に……」	PRINTFORMW 「虽然非常的痛…但是、除此之外……」
PRINTFORMW 「おなかの奥が、うずいて…もどかしいです……」	PRINTFORMW 「肚子的深处、有点躁动难耐…非常的让人焦急……」
PRINTFORMW 「%CNAME("二人称")%、おねがいです…さいごまでしてください……」	PRINTFORMW 「%CNAME("二人称")%、拜托了…请做到最后吧……」
PRINTFORMW 「%CNAME("一人称")%の、お、おまんこで…きもちよくなってください……」	PRINTFORMW 「%CNAME("一人称")%的、小、小穴…请让小穴舒服起来……」
PRINTFORMW %CALLNAME:MASTER%は自責の念に駆られながらも%CALLNAME:TARGET%の言うとおりに抜けかけていたペニスを再び奥まで押し込むと…	PRINTFORMW %CALLNAME:MASTER%被自责的念头驱使着按照%CALLNAME:TARGET%所请求的把快要拔出来的肉棒又一次插入了深处…
CALL PRINT_STR, @"「うあぁっ_BHH_  はっ…はぁ……」_W"	CALL PRINT_STR, @"「唔啊啊っ_BHH_  哈っ…哈啊……」_W"
CALL PRINT_STR, @"「もっと、もっとしてください……_BHH_」_W"	CALL PRINT_STR, @"「再来、请再做更多……_BHH_」_W"
PRINTFORMW %CALLNAME:TARGET%は気持ちよさそうな声を上げ、破瓜血を洗い流すように愛液が溢れ出てきた…	PRINTFORMW %CALLNAME:TARGET%发出了似乎很舒服的声音、爱液像是要冲刷掉破瓜血一样流了出来…
PRINTFORMW おそるおそる抽挿すると、子宮口を刺激するたびに%CALLNAME:TARGET%は甘い声を漏らし	PRINTFORMW 小心翼翼抽插的时候、每次刺激子宫口的时候%CALLNAME:TARGET%都会发出甜美的声音
PRINTFORMW 続きを望むように、小さな膣にキュッキュとペニスを吸い付かれ	PRINTFORMW 像是期望着继续下去一样、小巧的肉穴紧紧的吸住了肉棒
PRINTFORMW 無意識に腰の動きは早まり、いつしか水音が鳴り響くほどに%CALLNAME:TARGET%の幼い身体を貪っていた…	PRINTFORMW 腰部的动作不知不觉的加快了、不知从何时开始%CALLNAME:MASTER%开始贪婪的享受着%CALLNAME:TARGET%稚嫩的身体，甚至响起了啪啪啪的水声…
PRINTFORMW %CALLNAME:MASTER%は%CALLNAME:TARGET%の眼前にペニスを突き出すと、%CALLNAME:TARGET%は戸惑いの表情を見せた…	PRINTFORMW %CALLNAME:MASTER%把肉棒伸到%CALLNAME:TARGET%的眼前、%CALLNAME:TARGET%露出了困惑的表情…
PRINTFORMW 「あの、%CNAME("二人称")%…%CNAME("一人称")%は普通のキスをしたことがないです……」	PRINTFORMW 「哪个、%CNAME("二人称")%…%CNAME("一人称")%还没有做过普通的那种接吻……」
PRINTFORMW 「それでもいいんですか……？」	PRINTFORMW 「就算是那样也可以吗……？」
PRINTFORMW 「%CNAME("一人称")%は…%CNAME("二人称")%がいいというなら……」	PRINTFORMW 「%CNAME("一人称")%的话…要是%CNAME("二人称")%说这样可以的话……」
PRINTFORMW %CALLNAME:MASTER%は自分のファーストキスを%CALLNAME:TARGET%の膣口に捧げていたことを%CALLNAME:TARGET%に話した…	PRINTFORMW %CALLNAME:MASTER%把自己初吻献给了%CALLNAME:TARGET%的蜜穴口这件事告诉给了%CALLNAME:TARGET%…
PRINTFORMW 「……え？」	PRINTFORMW 「……诶？」
PRINTFORMW 「お、%CNAME("二人称")%は…あれが初めてだったんですか……？」	PRINTFORMW 「喔、%CNAME("二人称")%…原来那是第一次吗……？」
PRINTFORMW 「そ、そうなんですか……」	PRINTFORMW 「原、原来是这样吗……」
PRINTFORMW %CALLNAME:TARGET%は微妙そうな顔をしていたが、"%CALLNAME:MASTER%の初めて"を思い返したのか仄かに頬を染めると…	PRINTFORMW %CALLNAME:TARGET%虽然表情很微妙、大概是想到了"%CALLNAME:MASTER%的初次"脸颊微微泛起了红色…
PRINTFORMW 「こ、これで…おあいこですね……」	PRINTFORMW 「这、这样的话…我们就彼此彼此了呢……」
PRINTFORMW 愛おしむかのように、%CALLNAME:MASTER%のペニスの鈴口に優しく口付けをした…	PRINTFORMW 仿佛是怜爱一般、温柔的亲吻了一下%CALLNAME:MASTER%肉棒的龟头…
CALL PRINT_SELECT, "先に普通のキスをする/ペニスにファーストキスしてほしい"	CALL PRINT_SELECT, "先来个普通的接吻/想要把初吻给肉棒"
PRINTFORMW %CALLNAME:MASTER%は%CALLNAME:TARGET%の頭を撫でながら「ごめんね」と謝り、そっと肩を抱き寄せて優しくキスをした…	PRINTFORMW %CALLNAME:MASTER%一边抚摸着%CALLNAME:TARGET%的头一边道歉说「对不起」、然后轻轻地抱住%CALLNAME:TARGET%的肩膀温柔的吻了一下…
PRINTFORMW 「%CNAME("二人称")%、ありがとうです……」	PRINTFORMW 「%CNAME("二人称")%、非常感谢……」
PRINTFORMW 「%CNAME("一人称")%は、%CNAME("二人称")%みたいなやさしい人が"はじめて"で、とってもうれしいです……」	PRINTFORMW 「%CNAME("一人称")%的话、"初次的对象"能够是像%CNAME("二人称")%这样温柔的人、非常的开心……」
PRINTFORMW %CALLNAME:MASTER%は%CALLNAME:TARGET%が嫌じゃないならしてほしいとお願いした…	PRINTFORMW %CALLNAME:MASTER%拜托%CALLNAME:TARGET%要是不讨厌的话希望能够继续下去…
PRINTFORMW 「わ、わかりました…%CNAME("二人称")%がそういうなら……」	PRINTFORMW 「明、明白了…要是%CNAME("二人称")%这么说的话……」
PRINTFORMW %CALLNAME:TARGET%は%CALLNAME:MASTER%のペニスを見据えた後、緊張で震えながらも少しずつ%CALLNAME:MASTER%のペニスに近づいていき…	PRINTFORMW %CALLNAME:TARGET%紧紧的盯着%CALLNAME:MASTER%的肉棒之后、一边紧张的颤抖的同时一边一点点的小心翼翼地接近着%CALLNAME:MASTER%的肉棒…
PRINTFORMW %CALLNAME:MASTER%のペニスに初めてのキスを捧げた…	PRINTFORMW 然后将初吻献给了%CALLNAME:MASTER%的肉棒…
PRINTFORMW %CALLNAME:TARGET%の頭を撫でてあげると、何も言わなくとも%CALLNAME:TARGET%はペニスを深く咥えこみ	PRINTFORMW 轻轻的抚摸着%CALLNAME:TARGET%的头的时候、即使什么都不说%CALLNAME:TARGET%也深深的将肉棒吞了进去
PRINTFORMW %CALLNAME:MASTER%を喜ばせようと、拙い動作でペニスをしゃぶりはじめた…	PRINTFORMW 像是为了取悦%CALLNAME:MASTER%一样、用笨拙的动作开始了吮吸肉棒…
PRINTFORMW %CALLNAME:TARGET%は眼前に突き出されたペニスをじっと観察している…	PRINTFORMW %CALLNAME:TARGET%仔细的观察着伸到眼前的肉棒…
PRINTFORMW 「こ、これが…おちんちん……」	PRINTFORMW 「这、这就是…小鸡鸡……」
PRINTFORMW 「はじめてなので…上手に出来ないと思うんですけど……」	PRINTFORMW 「因为是第一次…所以觉得自己没法做的很好就是了……」
PRINTFORMW %CALLNAME:TARGET%はたどたどしい手使いでペニスを擦り始めた…	PRINTFORMW %CALLNAME:TARGET%开始用手笨拙的磨擦起肉棒来…
PRINTFORMW %CALLNAME:TARGET%はたどたどしい舌使いでペニスを舐め始めた…	PRINTFORMW %CALLNAME:TARGET%开始用舌头笨拙的舔起肉棒来…
PRINTFORMW %CALLNAME:MASTER%が%TEXTR("目配せすると/お願いすると/何も言わなくても")%%CALLNAME:TARGET%は%CALLNAME:MASTER%の股間の前で跪き、%CALLNAME:MASTER%のペニスをじっと見つめた…	PRINTFORMW %CALLNAME:MASTER%%TEXTR("使了个眼色后/拜托了之后/即使什么都不说")%%CALLNAME:TARGET%跪在了%CALLNAME:MASTER%的胯前、紧紧地盯着%CALLNAME:MASTER%的肉棒…
CALL PRINT_STR, @"「%CNAME("二人称")%のおちんちんさん…、%TEXTR("今日もよろしくです/いつもありがとうです/おいしそうです")%……_BHH_  んっ…」_W"	CALL PRINT_STR, @"「%CNAME("二人称")%小鸡鸡君…、%TEXTR("今天也请多关照了/一直以来非常感谢/看起来很好吃")%……_BHH_  嗯っ…」_W"
PRINTFORMW %CALLNAME:TARGET%は%TEXTR("瞳を閉じる/深呼吸する")%と、%CALLNAME:MASTER%のペニスの%TEXTR("先端/鈴口")%にそっと%TEXTR("口付けをし/唇を合わせ")%た…	PRINTFORMW %CALLNAME:TARGET%%TEXTR("闭上了眼睛/深呼吸了一下")%之后、轻轻的%TEXTR("用嘴吻在了/将嘴唇合在了")%%CALLNAME:MASTER%肉棒的%TEXTR("前端/龟头")%上…
PRINTFORMW 「んっ…んぅ…んっ……」	PRINTFORMW 「嗯っ…嗯唔…嗯っ……」
PRINTFORMW %CALLNAME:TARGET%は%CALLNAME:MASTER%の表情を観察しながら、小さな口でペニスをしゃぶっている…	PRINTFORMW %CALLNAME:TARGET%一边观察着%CALLNAME:MASTER%的表情、一边用小巧的嘴巴吮吸着肉棒…
PRINTFORMW 「ぇろ…ん…ちゅっ……」	PRINTFORMW 「呃噜…嗯…啾っ……」
PRINTFORMW %CALLNAME:TARGET%は%CALLNAME:MASTER%の表情を観察しながら、小さな舌でペニスを舐めまわしている…	PRINTFORMW %CALLNAME:TARGET%一边观察着%CALLNAME:MASTER%的表情、一边用小巧的舌头舔舐着肉棒…
PRINTFORMW 頭を撫でてあげると目を細め、より熱のこもった奉仕をし始めた…	PRINTFORMW %CALLNAME:TARGET%被摸着头的时候眼睛也眯了起来、然后开始更加热情地侍奉起来…
PRINTFORMW 恥ずかしくなって目を逸らすと、%CALLNAME:TARGET%は奉仕を中断して抗議してきた…	PRINTFORMW 害羞的移开了视线之后、%CALLNAME:TARGET%停止了服务然后提出了抗议…
PRINTFORMW 「あっ、だめです…目をそらさないでください……」	PRINTFORMW 「啊っ、讨厌…请不要移开眼睛……」
PRINTFORMW 「%CNAME("二人称")%が気持ちよくなってるか、確認しながらしたいので……」	PRINTFORMW 「%CNAME("二人称")%到底是不是很舒服、%CNAME("一人称")%想要好好确认之后再继续做……」
PRINTFORMW そう言われれば仕方が無いので、%CALLNAME:MASTER%は%CALLNAME:TARGET%の方を向きなおした…	PRINTFORMW 被说了这样的话那也没办法了、%CALLNAME:MASTER%只好重新转向%CALLNAME:TARGET%的方向…
CALL PRINT_STR, @"「%CNAME("二人称")%が気持ちよさそうな顔…いっぱい見れるようにがんばります……_BHH_」_W"	CALL PRINT_STR, @"「%CNAME("二人称")%非常舒服的那种表情…为了能够看见很多所以一直在努力哦……_BHH_」_W"
PRINTFORMW %CALLNAME:TARGET%は淫靡に目を細め、より熱のこもった奉仕をし始めた…	PRINTFORMW %CALLNAME:TARGET%淫靡的眯着眼睛、然后开始更加热情地侍奉起来…
CALL PRINT_STRL, @"執拗に与えられた快楽により%CALLNAME:TARGET%は_ハートピンク_[陶酔]_状態になった！"	CALL PRINT_STRL, @"持续地被给予着快感的%CALLNAME:TARGET%变成了_粉色心形_[陶醉]_的状态！"
CALL PRINT_STRL, "（挿入行為での痛みが_黄色_物凄く_減少し、抵抗も_ハートピンク_緩く_なります）"	CALL PRINT_STRL, "（因为插入行为造成的痛苦_黄色_极大的_减少了、抵抗也_粉色心形_变得_松散下来）"
CALL PRINT_STR, @"「はっ_BHH_  はっ_BHH_  %CNAME("二人称", "かな")%_BHH_  なんだかっ_BHH_  おなかのなかっ_BHH_  ぞわぞわしますっ_BHH_」_W"	CALL PRINT_STR, @"「哈っ_BHH_  哈っ_BHH_  %CNAME("二人称", "かな")%_BHH_  总感觉っ_BHH_  肚子里面っ_BHH_  非常的难受っ_BHH_」_W"
CALL PRINT_STR, @"「あっ_BHH_  なにこれっ_BHH_  あぁっ_BHH_  あああっ_BHH_  ひっ_BHH_BHH_」_W"	CALL PRINT_STR, @"「啊っ_BHH_  这是什么っ_BHH_  啊啊っ_BHH_  啊啊啊っ_BHH_  咦っ_BHH_BHH_」_W"
CALL PRINT_STR, @"「ん――っ！_BHH_BHH_BHH_  くぅ―――っ！！_BHH_BHH_BHH_」_W"	CALL PRINT_STR, @"「嗯――っ！_BHH_BHH_BHH_  咕唔―――っ！！_BHH_BHH_BHH_」_W"
PRINTFORMW %CALLNAME:TARGET%は今まで訳も分からず疼いてた子宮を刺激され続け、腰を大きく跳ねせながら絶頂した…	PRINTFORMW %CALLNAME:TARGET%至今为止一直莫名疼痛的子宫被持续的刺激着、一边用力弹起了腰部一边到达了高潮…
CALL PRINT_STR, @"「あ゛ぁ―っ！_BHH_BHH_BHH_  うあ゛ぁあ――っ！！_BHH_BHH_BHH_」_W"	CALL PRINT_STR, @"「嘎啊―っ！_BHH_BHH_BHH_  唔嘎啊啊――っ！！_BHH_BHH_BHH_」_W"
PRINTFORMW 性交渉をするには早すぎるはずの小さな女の子が、	PRINTFORMW 一个被邀请性交还为时过早的小巧女孩子、
PRINTFORMW 初めての性交で惚けた表情でよがっているという異常な光景を目にし、	PRINTFORMW 第一次性交的时候就看到了所谓的神情恍惚着表达着快感的表情、
PRINTFORMW 未知の快楽に慌てふためく幼い膣壁にペニスを締め付けられた%CALLNAME:MASTER%は、	PRINTFORMW 被未知的快感弄得有些惊慌的稚嫩肉穴紧紧吸住了肉棒的%CALLNAME:MASTER%、
PRINTFORMW 背徳感に襲われながらも嗜虐心から逃れることができずに、	PRINTFORMW 虽然有种背德感但是却无法从嗜虐心中逃离出来、
PRINTFORMW 身体をガクガク震わせる%CALLNAME:TARGET%を押さえ込み、射精に向けてひたすら腰を振り続けた…	PRINTFORMW 按住了身体嘎吱嘎吱颤抖着的%CALLNAME:TARGET%、为了射精持续的摆动着腰部…
PRINTFORMW 「んぅっ！？んく、んくっ…んく…ちぅ……」	PRINTFORMW 「嗯唔っ！？嗯咕、嗯咕っ…嗯咕…啾……」
PRINTFORMW 「ぷはぁ…ふぅ……」	PRINTFORMW 「噗哈啊…呼唔……」
PRINTFORMW 初めて口内射精されたにも拘らず、%CALLNAME:TARGET%はごく自然に精液を飲み干してしまった…	PRINTFORMW 初めて口内射精されたにも拘らず、鈴はごく自然に精液を飲み干してしまった…
PRINTFORMW その事をあなたが褒めてあげると、%CALLNAME:TARGET%は顔を真っ赤にしながら言い訳をし始めた…	PRINTFORMW その事をあなたが褒めてあげると、鈴は顔を真っ赤にしながら言い訳をし始めた…
PRINTFORMW 「え、あの、その、無意識に…飲まなきゃって…う、うぅ……」	PRINTFORMW 「诶、那个、这个、无意识的就…喝下去了…唔、唔唔……」
PRINTFORMW 「あ、でも…変な味ですけど…嫌いじゃないというか……」	PRINTFORMW 「啊、但是…虽然味道怪怪的…但是该说是不讨厌吗……」
CALL PRINT_STR, @"「%CNAME("二人称")%のだったら…%CNAME("一人称")%は欲しい…です……_BHH_」_W"	CALL PRINT_STR, @"「%CNAME("二人称")%のだったら…鈴は欲しい…です……_BHH_」_W"
CALL PRINT_STR, @"「あ゛ああぁ―っ！！_BHH_BHH_  あ゛あ゛ああぁぁ――っっ！！_BHH_BHH_BHH_」_W"	CALL PRINT_STR, @"「嘎啊啊啊―っ！！_BHH_BHH_  嘎嘎啊啊啊啊――っっ！！_BHH_BHH_BHH_」_W"
PRINTFORMW 未知の絶頂に震えながらも初めて膣内射精された%CALLNAME:TARGET%は、一段と身体を大きく震わせながら悶え	PRINTFORMW 在未知的绝顶中颤抖的同时也是初次被穴内射精的%CALLNAME:TARGET%、一边越发剧烈的颤抖着一边扭动着身体
PRINTFORMW 無意識にも幼い膣肉を、射精中のペニスにしがみ付くように締め付けた…	PRINTFORMW 无意识地用稚嫩的穴肉、紧紧地抓住了射精中的肉棒…
PRINTFORMW とろけるような射精の快楽が薄れ、意識がハッキリしてくると	PRINTFORMW 令人心醉的射精的快感快要消失的时候、意识逐渐清醒了过来
PRINTFORMW ピクピクと痙攣する幼い%CALLNAME:TARGET%の小さな体に、%CALLNAME:MASTER%のペニスが深々と突き刺さってる事実を改めて認識した…	PRINTFORMW 再次认识到了在一抖一抖痉挛着的稚嫩的%CALLNAME:TARGET%的小巧身体里、%CALLNAME:MASTER%的肉棒深深的插了进去这样的事实…
PRINTFORMW あまりにも倒錯的な光景に、何もできずに呼吸を整えていると…	PRINTFORMW 面对如此反常的光景、什么都做不了只能调整一下呼吸…
PRINTFORMW 「あ…%CNAME("二人称")%…おしまいですか……？」	PRINTFORMW 「啊…%CNAME("二人称")%…已经结束了是吗……？」
CALL PRINT_STR, @"「%CNAME("一人称")%は、その…もっとしてほしいです……_BHH_」_W"	CALL PRINT_STR, @"「%CNAME("一人称")%的话、那个…想做更多爱做的事……_BHH_」_W"
PRINTFORMW 続きを催促するように幼い膣に締めつけられ、%CALLNAME:MASTER%のペニスはムクムクと硬さを取り戻していった…	PRINTFORMW 像是在催促着继续一样，稚嫩的肉穴紧紧的吸住、%CALLNAME:MASTER%的肉棒也渐渐重新变得坚挺…
CALL PRINT_STR, @"＜%CALLNAME:TARGET%の_ハートピンク_[Ｖ名器Ⅲ]_が明らかになった＞_L"	CALL PRINT_STR, @"＜%CALLNAME:TARGET%的_粉色心形_[Ｖ名器Ⅲ]_变得清楚了＞_L"
CALL PRINT_STR, @"＜%CALLNAME:TARGET%の_ハートピンク_[子宮性感]_が明らかになった＞_L"	CALL PRINT_STR, @"＜%CALLNAME:TARGET%的_粉色心形_[子宮性感]_变得清楚了＞_L"
CALL PRINT_STR, @"＜%CALLNAME:TARGET%は_ハートピンク_[Ｖ性向]_を得た＞_W"	CALL PRINT_STR, @"＜%CALLNAME:TARGET%获得了_粉色心形_[Ｖ性向]_＞_W"

PRINTFORMW ある日の休み時間、%CALLNAME:TARGET%は同じクラスの男子に呼び出されていた…	PRINTFORMW ある日の休み時間、鈴は同じクラスの男子に呼び出されていた…
PRINTFORMW 「は…話ってなんですか……？」	PRINTFORMW 「要…要说的话是什么……？」
PRINTFORMW 『青空、おれ、この前見たぞ』	PRINTFORMW 『青空、我、之前看到了哦』
PRINTFORMW 『昨日、別の校舎の保健室で、かなり上の先輩とセックスしてただろ』	PRINTFORMW 『昨天、在别的校舍的保健室里面、你和高年级的前辈做爱了吧』
PRINTFORMW 「え、な、なんで……」	PRINTFORMW 「诶、为、为什么……」
PRINTFORMW 『なんでだっていいだろ！』	PRINTFORMW 『为什么什么的怎么样都好吧！』
PRINTFORMW 『皆に言いふらされたくなかったら、お、おれにもヤらせろよ』	PRINTFORMW 『如果不想让大家知道的话、我、也让我干一下吧』
PRINTFORMW 「え……」	PRINTFORMW 「诶……」
PRINTFORMW 『いいだろ別に、１回でいいから』	PRINTFORMW 『这样也没关系吧、就只干1回的话』
PRINTFORMW 「…いいです、みんなに言っても」	PRINTFORMW 「…可以哦、和大家说的话」
PRINTFORMW 『は？お前、何言ってんだよ、１回ぐらいならいいじゃねーかよ』	PRINTFORMW 『哈？你这家伙、在说什么啊、就只是干1回的话也没关系的吧』
PRINTFORMW 「だって%CNAME("一人称")%…%CNAME("二人称")%のことが好きだから……」	PRINTFORMW 「因为%CNAME("一人称")%…喜欢%CNAME("二人称")%……」
PRINTFORMW 「だから、%CNAME("二人称")%以外とするのは…いやです……」	PRINTFORMW 「所以、和%CNAME("二人称")%以外的人做的话…不行……」
PRINTFORMW 「それじゃ……」	PRINTFORMW 「那就告辞了……」
PRINTFORMW 『おい！待てよ、待てって！』	PRINTFORMW 『喂！等下、等一下啊！』
PRINTFORMW 『お、おれはお前のことが好きだ！』	PRINTFORMW 『我、我喜欢你！』
PRINTFORMW 「え…？」	PRINTFORMW 「诶…？」
PRINTFORMW 『だから、初等部が行かないような場所に入っていく青空を見て…』	PRINTFORMW 『所以、看到了进入初等部不会进去的地方的青空你…』
PRINTFORMW 『気になって、追いかけていったら…ぐすっ』	PRINTFORMW 『非常的在意、追上去之后…咕唔っ』
PRINTFORMW 『おれ…青空のことが、好きで……』	PRINTFORMW 『因为我…喜欢、青空你啊……』
PRINTFORMW 「…ごめんね」	PRINTFORMW 「…抱歉呢」
PRINTFORMW 「ってことがあったんですけど……」	PRINTFORMW 「虽然有过这样的事情……」
PRINTFORMW 「言いふらされてたら%CNAME("一人称")%、学校に行けなくなるかもです……」	PRINTFORMW 「要是说出去的话%CNAME("一人称")%、可能就会变成不能来学校了吧……」
PRINTFORMW %CALLNAME:TARGET%の話を聞いた%CALLNAME:MASTER%は…	PRINTFORMW 听到了%CALLNAME:TARGET%说的话之后的%CALLNAME:MASTER%…
CALL PRINT_STR, @"イエロー_※[ 1]を選んだ場合NTR要素(寝取らせ)が含まれます！※_L"	CALL PRINT_STR, @"黄色_※[ 1]这个选项选择了之后会包含NTR要素(牛头人)！※_L"
CALL PRINT_SELECT, "フェリシエルにお願いしてなんとかしてもらう/１回きりのセックスをして忘れてもらおうと提案する"	CALL PRINT_SELECT, "拜托弗里希艾尔帮忙想想办法/提议让他们做一次爱然后忘记这件事"
PRINTFORMW その場で一緒に話を聞いていたフェリシエルにお願いすることにした…	PRINTFORMW 决定去拜托在场一起说话的弗里希艾尔帮个忙…
PRINTFORMW 『対処しろと言われればしますけど…その代わり、取引としてしっかり対価はもらいますので』	PRINTFORMW 『如果想要我处理的话我会做的…但是作为代价、作为报酬我会好好的拿走的』
PRINTFORMW 『きっと必要のないことだと思いますけどね……フフ♪』	PRINTFORMW 『虽然我觉得这肯定是不必要的啊……呼呼♪』
PRINTFORMW 魂の取引を出来たフェリシエルは満足そうだ…	PRINTFORMW 取得了魂作为报酬的弗里希艾尔非常地满足…
PRINTFORMW 「%CNAME("二人称")%、フェリシエルさん、ありがとうです……」	PRINTFORMW 「%CNAME("二人称")%、弗里希艾尔桑、非常感谢……」
PRINTFORMW 『まぁ、元はといえばご主人様があちこちでヤりまくるのが悪いのですけどね』	PRINTFORMW 『嘛啊、说到底的话还是因为主人大人到处乱搞的错呢』
PRINTFORMW 「そう…なんですか？」	PRINTFORMW 「是…那样吗？」
CALL PRINT_STR, @"『そうです、ご主人様の節操の無いこのペニスが悪いんです_H_』_W"	CALL PRINT_STR, @"『是那样、是主人大人没有节操的肉棒的错』_W"
CALL PRINT_STR, @"「じゃあ…おしおきですね……_BHH_」_W"	CALL PRINT_STR, @"「那么…要好好调教呢……_BHH_」_W"
PRINTFORMW あなたは二人に押し倒され、力尽きるまでペニスからの“謝罪”を求められた…	PRINTFORMW 你被两人推倒了、一直到筋疲力尽为止都被要求用肉棒来“謝罪”…
PRINTFORMW 希望通り１回だけセックスをさせてあげればいいと言った…	PRINTFORMW 说了按照他希望的那样做一次爱就可以了…
PRINTFORMW 「%CNAME("二人称")%…それでいいんですか……？」	PRINTFORMW 「%CNAME("二人称")%…那样可以吗……？」
PRINTFORMW 「そうですね、%CNAME("二人称")%は他の人とエッチなことしてますしね……」	PRINTFORMW 「说得也是呢、%CNAME("二人称")%也和别人做了H的事情呢……」
PRINTFORMW 「わかりました…でも、そのかわり%CNAME("二人称")%にも一つお願いが……」	PRINTFORMW 「我明白了…但是、作为代替对%CNAME("二人称")%也有一个请求……」
PRINTFORMW %CALLNAME:MASTER%は%CALLNAME:TARGET%を使って、件の保健室に例の彼を呼び出していた…	PRINTFORMW %CALLNAME:MASTER%用%CALLNAME:TARGET%作为借口、把他叫来了那个保健室…
PRINTFORMW 『おい、青空、何のつもりだ、まさか口封じでもするつもりかよ』	PRINTFORMW 『喂、青空、想干什么啊、不会是想要封住我的口吧』
PRINTFORMW 「うん…１回してあげたら、ないしょにしてくれるんだよね……」	PRINTFORMW 「唔嗯…要是让你干1次的话、会保密的对吧……」
PRINTFORMW 『え？おい、青空……』	PRINTFORMW 『诶？喂、青空……』
PRINTFORMW %CALLNAME:TARGET%は手際よく服を脱いでハダカになると、ベッドに横たわった…	PRINTFORMW %CALLNAME:TARGET%熟练的脱掉衣服变成了裸体、躺在了床上…
PRINTFORMW 「したかったんでしょ…？早く脱ぎなよ……」	PRINTFORMW 「你想做对吧…？快点脱掉吧……」
PRINTFORMW 『お、おう……』	PRINTFORMW 『哦、哦……』
PRINTFORMW 彼はあなたの視線を気にしながらも、服を脱いでハダカになった…	PRINTFORMW 虽然男生很在意你的视线、但还是把衣服脱掉变成了裸体…
PRINTFORMW 「じゃあ、好きにしていいよ……」	PRINTFORMW 「那么、随你喜欢的做吧……」
PRINTFORMW 「あ、でもキスはだめだからね……」	PRINTFORMW 「啊、但是不准接吻哦……」
PRINTFORMW 『うん……』	PRINTFORMW 『唔嗯……』
PRINTFORMW 『うわ、すごいビシャビシャになってる……』	PRINTFORMW 『呜哇、变得超级湿了……』
PRINTFORMW 「うぅ…はやくおちんちん挿れなよ……」	PRINTFORMW 「唔唔…快点吧小鸡鸡插进来啊……」
PRINTFORMW 彼は拙い動作でいきり立った小さなペニスを%CALLNAME:TARGET%のワレメに押し付けると、	PRINTFORMW 他用笨拙的动作把勃起的小小的肉棒按在了%CALLNAME:TARGET%的蜜缝上、
PRINTFORMW 何度か滑って挿入失敗した後に、勢いあまって一気に%CALLNAME:TARGET%の膣にペニスを沈めてしまった…	PRINTFORMW 好几次滑开插入失败之后、一鼓作气地将肉棒插入了%CALLNAME:TARGET%的肉穴里…
PRINTFORMW 『な、何だこれ！？ちんちんが、ちんちんが！うっ！』	PRINTFORMW 『这、这是什么！？小鸡鸡被、小鸡鸡要被！唔っ！』
PRINTFORMW 幼い彼には%CALLNAME:TARGET%の膣は刺激が強すぎたのか、一度も抽挿することなく腰を震わせて絶頂した…	PRINTFORMW 对于年幼的他来说%CALLNAME:TARGET%肉穴的刺激可能是过于强烈了吧、一次都没有抽插就颤抖着腰部达到了绝顶…
PRINTFORMW 「え…今ので…もう……？」	PRINTFORMW 「诶…才刚进来…就……？」
PRINTFORMW %CALLNAME:TARGET%は寝返りを打つようにして上下を入れ替えると、手早く腰を上げてペニスを引き抜いた	PRINTFORMW 鈴は寝返りを打つようにして上下を入れ替えると、手早く腰を上げてペニスを引き抜いた
PRINTFORMW 普段はあなたの精液をあまり零さない%CALLNAME:TARGET%の膣口から、拒むように精液がダラダラと垂れ落ちている…	PRINTFORMW 普段はあなたの精液をあまり零さない鈴の膣口から、拒むように精液がダラダラと垂れ落ちている…
PRINTFORMW 「%CNAME("二人称")%…約束どおり、射精された精液、%CNAME("二人称")%のおちんちんで掻き出してください……」	PRINTFORMW 「%CNAME("二人称")%…和约定的一样、射出来的精液、要用%CNAME("二人称")%的小鸡鸡把他们刮出来……」
PRINTFORMW %CALLNAME:MASTER%は%CALLNAME:TARGET%の求めるままにキスをしてあげてから、後ろ向きに抱き抱え、	PRINTFORMW %CALLNAME:MASTER%按照%CALLNAME:TARGET%要求的那样亲吻了她、然后从后面抱住了她、
PRINTFORMW 結合部を彼に見せつけるようにして腰を振りたてた…	PRINTFORMW 就像是把结合部位展示给男生看一样动起了腰部…
CALL PRINT_STR, @"「あっ_BHH_　やっぱりいっ_BHH_　%CNAME("二人称")%のっ_BHH_　おちんちんがっ_BHH_　はぁっ_BHH_　いいですっ_BHH_」_W"	CALL PRINT_STR, @"「啊っ_BHH_　果然很舒服っ_BHH_　%CNAME("二人称")%的っ_BHH_　小鸡鸡っ_BHH_　果然っ_BHH_　很舒服っ_BHH_」_W"
CALL PRINT_STR, @"「もっと_BHH_　おくっ_BHH_　うっ_BHH_　つよくっ_BHH_　どちゅどちゅ_BHH_BHH_　してほしっ_BHH_　ですっ_BHH_」_W"	CALL PRINT_STR, @"「再插_BHH_　深一点っ_BHH_　唔っ_BHH_　再用力一点っ_BHH_　想要被搞出_BHH_BHH_　咚啾咚啾的っ_BHH_　声音っ_BHH_」_W"
CALL PRINT_STR, @"「あっ_BHH_　だめっ_BHH_　もっ_BHH_　いっ_BHH_　イきますっ_BHH_」_W"	CALL PRINT_STR, @"「啊っ_BHH_　不要っ_BHH_　已经っ_BHH_　要っ_BHH_　去了っ_BHH_」_W"
CALL PRINT_STR, @"「うっ！_BHH_　ううっ！！_BHH_BHH_　いぃっ！！_BHH_BHH_　い゛っ！！_BHH_BHH_　イくうぅっ！！！_BHH_BHH_BHH_」_W"	CALL PRINT_STR, @"「唔っ！_BHH_　唔唔っ！！_BHH_BHH_　要っ！！_BHH_BHH_　要去っ！！_BHH_BHH_　去了っ！！！_BHH_BHH_BHH_」_W"
PRINTFORMW どぴゅっ！どぷるるっ！どぴゅるるっ！どぷぷっ！	PRINTFORMW 咚啾っ！咚噗噜噜っ！咚啾噜噜っ！咚噗噗っ！
CALL PRINT_STR, @"「あぁっ！！_BHH_BHH_　あ゛あぁっ！！！_BHH_BHH_BHH_　あ゛っ！！_BHH_BHH_」_W"	CALL PRINT_STR, @"「啊啊っ！！_BHH_BHH_　嘎啊啊っ！！！_BHH_BHH_BHH_　嘎っ！！_BHH_BHH_」_W"
PRINTFORMW ベッドで横たわる彼目掛けて%CALLNAME:TARGET%は潮を吹き、%CALLNAME:MASTER%も絶頂に合わせて精液を注ぎ込んだ…	PRINTFORMW 在男生的面前躺在床上的%CALLNAME:TARGET%喷着潮水、%CALLNAME:MASTER%也配合着到达了高潮注射进了精液…
PRINTFORMW %CALLNAME:TARGET%の下腹部は%CALLNAME:MASTER%の精液を飲み干した子宮のせいでぽっこり膨らんでおり、	PRINTFORMW %CALLNAME:TARGET%鈴の下腹部は%CALLNAME:MASTER%の精液を飲み干した子宮のせいでぽっこり膨らんでおり、
PRINTFORMW %CALLNAME:MASTER%のペニスを引き抜いても、注いだ精液が垂れ落ちてくることは無かった…	PRINTFORMW 即使%CALLNAME:MASTER%拔出了肉棒、注射进去的精液一滴也没有滴落出来…
PRINTFORMW 『おれ、ここで起きた事、絶対誰にも言わねーから……』	PRINTFORMW 『我、在这里发生的事、绝对不会对别人说的……』
PRINTFORMW 彼は悲しそうな表情をして保健室を出て行った…	PRINTFORMW 男生带着悲伤的表情从保健室里面出去了…
PRINTFORMW 『…やっぱりコレ、必要無かったんじゃないですかね？』	PRINTFORMW 『…果然这种事、是没有必要做的对吧？』
PRINTFORMW カーテンが閉まっていた隣のベッドから、一部始終を撮影していたフェリシエルが出てきた…	PRINTFORMW 从拉上了窗帘的隔壁床上、一直在拍摄整个过程的弗里希艾尔走了出来…
PRINTFORMW 『確かに弱みを握るには有効ですが…わざわざ映像で撮る必要は無いですよね？』	PRINTFORMW 『确实抓住对方的弱点是很有效的…但是特地的拍摄下来还是没有必要的吧？』
PRINTFORMW 『悪魔の私が言うのも何ですが…趣味悪いですよ、ご主人様』	PRINTFORMW 『虽然由作为恶魔的我来说有点那啥…主人大人你，还真的是恶趣味啊』
PRINTFORMW 「そうですね…%CNAME("二人称")%は悪趣味でサイテーです……」	PRINTFORMW 「是这么回事呢…%CNAME("二人称")%真是个是个恶趣味的渣滓呢……」
CALL PRINT_STR, @"「だから…今からふたりで%CNAME("二人称")%を懲らしめませんか……？_BHH_」_W"	CALL PRINT_STR, @"「所以说…从现在开始不让我们来惩罚%CNAME("二人称")%吗……？_BHH_」_W"
PRINTFORMW 『フフ…いい考えですね、是非そうしましょう♪』	PRINTFORMW 『呼呼…真是个好想法呢、务必这么做吧♪』
PRINTFORMW %CALLNAME:MASTER%は二人に押し倒され、精力尽き果てるまで辱められた…	PRINTFORMW %CALLNAME:MASTER%被两人推倒了、一直到筋疲力尽为止都在被羞辱着…
PRINTFORMW ＥＮＤ名２の本文です	PRINTFORMW ＥＮＤ２
PRINTFORMW ＥＮＤ名３の本文です	PRINTFORMW ＥＮＤ３
//文件: K33_FUNC.ERB

PRINTFORMW %CALLNAME:MASTER%は%CALLNAME:TARGET%に%TEXTR("種付け/中出し")%しながらスマホを構えた…	PRINTFORMW %CALLNAME:MASTER%一边对%CALLNAME:TARGET%%TEXTR("播种/中出")%一边把手机摆好了…
PRINTFORML ﾋﾟｯ	PRINTFORML 咔嚓（攝像聲）
STR:写真 = %TEXTR("おまんこ/膣内/子宮")%に%TEXTR("精液を注がれる/射精される")%感覚で%TEXTR("仰け反って絶頂している/惚けた表情をしている/トロ顔になっている")%%CALLNAME:TARGET%	STR:写真 = 因为%TEXTR("小穴/蜜穴/子宫")%被%TEXTR("精液注入的/射精的")%感觉，%TEXTR("身体仰反着绝顶了的/神情恍惚了的/表情融化了一样的")%%CALLNAME:TARGET%
PRINTFORMW %CALLNAME:MASTER%は『%STR:写真%』を写真に収めた。	PRINTFORMW %CALLNAME:MASTER%拍下了『%STR:写真%』的照片收了起来。
