
//EVENT_K34_真.ERB


真面目でおとなしく、引っ込み思案な少女	认真老实，畏缩不前的少女
人付き合いは得意な方ではなく、色恋沙汰とも無縁な生活を送っていたが	不擅长对人际関係、特别是不擅长应付異性、过着与恋爱無縁的生活
禁断の知識の一端に触れてしまった反動によって、性欲の箍が歪んだ形で外れかかっている	因为触动了禁断の知識的一角的反作用、被紧箍着的性欲歪曲到了错误的方向
PRINTFORMW 『あっ、ごしゅじん、さまぁっ♪　あっ♪』	PRINTFORMW 『啊、主人、大人♪　啊♪』
PRINTFORMW ある日の昼休み、人目に付かない空き教室で一時の逢瀬を楽しむ%CALLNAME:MASTER%と%CALLNAME:FINDCHARA(NO, 1)%。	PRINTFORMW 某日的午休、%CALLNAME:MASTER%%CALLNAME:FINDCHARA(NO, 1)%正在没有人的空教室里享受一時的欢愉。
PRINTFORMW その様子を廊下から密かに窺っている少女がいた。	PRINTFORMW 然而此时正有一个少女在走廊里悄悄地窺视着。
PRINTFORMW 「んっ……はあ……」	PRINTFORMW 「嗯……哈啊……」
PRINTFORMW 少女は声を押し殺しながら、僅かに開いた扉の隙間から情事を覗き見る。	PRINTFORMW 少女屏住呼吸、从稍微打開的门缝里偷窥着情事。
PRINTFORMW その手はスカートの下にある性器――少女の身には似つかわしくないペニスを弄っていた。	PRINTFORMW 一只手在玩弄着裙下的性器――与少女身体完全不相称的阴茎。
PRINTFORMW 誰かに見られるかもしれない羞恥心と、異常な状況下で興奮してしまっている嫌悪感。	PRINTFORMW 在可能被誰看到的羞恥心、以及異常状況下興奮着的嫌悪感。
PRINTFORMW それらの悪感情が、目の前の情事とペニスを刺激する快感と混ざり合い、倒錯的な快楽を生み出す。	PRINTFORMW 这些负面的感情、与眼前的情事、刺激阴茎的快感混合在一起、生出了倒錯的的快楽。
PRINTFORMW 『あっ、イくっ♪　イきます、ごしゅじんさま、あぁっ♪』	PRINTFORMW 『啊、要去♪　要去了、主人大人、啊啊啊♪』
PRINTFORMW 「んんっ……！」	PRINTFORMW 「唔嗯……！」
PRINTFORMW %CALLNAME:FINDCHARA(NO, 1)%が絶頂を迎えるのと同時に、少女も弓なりに腰を突き出し、自らのペニスから精を放った。	PRINTFORMW 在%CALLNAME:FINDCHARA(NO, 1)%迎来絶頂的同時、少女也弓着腰、从阴茎中射出了精液。
PRINTFORMW 荒い息を整えながら、少女は自らの手についた精液を目にし、快楽と後悔が綯い交ぜになった表情で涙を流す。	PRINTFORMW 一边平静着急促的呼吸、少女看着自己手上的精液、快楽与後悔交织的表情下不禁流出了涙水。
PRINTFORMW 『ナニをしているんですか？』	PRINTFORMW 『你在干什么？』
PRINTFORMW 気がつくと、乱れた服装を僅かに繕った%CALLNAME:FINDCHARA(NO, 1)%が、扉に手をかけ少女を見下ろしていた。	PRINTFORMW 回过神来、已经把凌乱的衣服整理好的%CALLNAME:FINDCHARA(NO, 1)%、正把手搭在门上、向下看着茫然的少女。
PRINTFORMW しばし呆けていた少女は淫らな美女を目の前に、蛇に睨まれた蛙のように固まってしまう。	PRINTFORMW 发呆的少女在淫乱的美女前、就像被蛇盯上的青蛙一样僵住了。
PRINTFORMW 「あ、あのっ、違うんですこれはっ」	PRINTFORMW 「啊、那个、不是这样的。」
PRINTFORMW 必死に取り繕おうとするも、未だに勃起しているペニスと精液で汚れた手は誤魔化しようが無い。	PRINTFORMW 就算想要极力掩饰、还在勃起着的阴茎和被精液弄脏的手也藏不住。
PRINTFORMW 言い訳を考える間もなく、%NAME:ARG%は%CALLNAME:FINDCHARA(NO, 1)%に手を掴まれ、扉の向こうに引きずり込まれていった……	PRINTFORMW 来不及思考借口、%NAME:ARG%就被%CALLNAME:FINDCHARA(NO, 1)%拉着手、拽向了门的另一边……

PRINTFORMW 『ちょっとマズいかもしれないですねぇ』	PRINTFORMW 『可能有点不好吧……』
PRINTFORMW %NAME:TARGET%を部活に拉致――もとい、勧誘する前のこと。	PRINTFORMW %NAME:TARGET%被绑架到社团活动——这是劝诱之前的事。
PRINTFORMW %CALLNAME:MASTER%は、%CALLNAME:FINDCHARA(NO, 1)%が珍しく困り顔で話していたことを思い出していた。	PRINTFORMW %CALLNAME:MASTER%想起了%CALLNAME:FINDCHARA(NO, 1)%难得愁眉苦脸地说话。
PRINTFORMW 『ご主人様も見ましたね？　彼女におちんちんが生えていたのを』	PRINTFORMW 『主人也看见了吧？我发现她下面长的那个家伙。』
PRINTFORMW 『けれど、その後は消えて無くなっていました。間違いなく具現の力でしょうね』	PRINTFORMW 『但是，那之后就消失了。毫无疑问是具现的力量。』
PRINTFORMW 『そのせいなのかもしれませんが、%CALLNAME:TARGET%さんの女の子を見る目、ちょっと普通じゃないんですよ』	PRINTFORMW 『也许正是这个原因，%CALLNAME:TARGET%看女子的目光有点不同寻常。』
PRINTFORMW 『今の%CALLNAME:TARGET%さんは、偶然手にした異常な快楽の虜になっているのでしょう』	PRINTFORMW 『现在的%CALLNAME:TARGET%，是被偶然得到的异常的快乐俘虏了吧。』
PRINTFORMW 『このまま放っておけば、彼女は歪んだ業を抱え続け、普通の生活に戻れなくなる恐れがあります』	PRINTFORMW 『如果再这样放任下去，她可能会继续做出扭曲的事，无法回到正常的生活。』
PRINTFORMW 『今さら具現の力を取り上げる方法もありませんからねぇ』	PRINTFORMW 『事到如今，已经没有办法谈论具现的力量了。』
PRINTFORMW %CALLNAME:FINDCHARA(NO, 1)%は%CALLNAME:MASTER%に向けて二つ指を立てた。	PRINTFORMW %CALLNAME:FINDCHARA(NO, 1)%像%CALLNAME:MASTER%竖起两根手指。
PRINTFORMW 『選択は二つ。%CALLNAME:TARGET%さんのことは見なかったことにして、赤の他人に戻るか』	PRINTFORMW 『两个选择，①：你假装没有看见%CALLNAME:TARGET%的事，回到陌生人的身份』
PRINTFORMW 『それとも、%CALLNAME:TARGET%さんの業を受け入れるか』	PRINTFORMW 『还是%CALLNAME:TARGET%，接受这样的工作？』
PRINTFORM 『方法はご主人様におまかせします。	PRINTFORM 『办法就交给主人了。
PRINTFORMW 少々手こずるかもしれませんが、ご主人様を信じていますよ♪』	PRINTFORMW 虽然有点棘手，但我相信你的主人。♪』
PRINTFORMW 大丈夫、ご主人様ならきっと何の問題もないですよ♪』	PRINTFORMW 没关系，你主人的话一定没有任何问题。♪』
PRINTFORML 　・　・　・	PRINTFORML ...
PRINTFORMW 「あ、あの……これっていわゆる、口止めというか、お仕置きというか」	PRINTFORMW 「啊，那个……这就是所谓的封口，还是老一套的？」
PRINTFORMW 「そういうアレってことなんでしょうか……？」	PRINTFORMW 「是这样吗……？」
PRINTFORMW %CALLNAME:TARGET%は落ち着かない様子でしきりに目を泳がせていた。	PRINTFORMW %CALLNAME:TARGET%一副坐立不安的样子，不断转移着目光。
PRINTFORMW 彼女はこちらを見ようとしないが、既に顔は上気しており、性欲を持て余しているのがわかる。	PRINTFORMW 她不肯看这边，但看得出她的脸色已经很好，没有性欲了。
PRINTFORMW しかしチラチラと%CALLNAME:MASTER%の体を見ており、自らの興奮を抑えようと必要以上に体を強張らせている。	PRINTFORMW 但是看着%CALLNAME:MASTER%的身体，就会为了抑制自己的兴奋而过度的用力。
PRINTFORMW 「あ……」	PRINTFORMW 「啊……」
PRINTFORMW %CALLNAME:MASTER%がゆっくり近付くと、%CALLNAME:TARGET%は僅かに後ずさりながら、期待と不安の入り混じった吐息を漏らした。	PRINTFORMW 当%CALLNAME:MASTER%慢慢地靠近时，%CALLNAME:TARGET%也微微地向后退，发出了夹杂着期待与不安的叹息。
PRINTFORMW %CALLNAME:MASTER%が肩に手を当ててやると、%CALLNAME:TARGET%はまるで魔法にかかったように脱力し、ぼうっと%CALLNAME:MASTER%の顔を見上げた。	PRINTFORMW 当%CALLNAME:MASTER%把手放在肩膀上的时候，%CALLNAME:TARGET%如同中了魔法一样无力，呆呆地望着%CALLNAME:MASTER%的脸。
PRINTFORMW 思えばほとんど拉致同然に部活に引き込んだ%CALLNAME:TARGET%だが、今日も彼女は%CALLNAME:MASTER%の言葉に従い、大人しく身体を許していた。	PRINTFORMW 回想起来，几乎就像被绑架一样被拉进社团的%CALLNAME:TARGET%，今天她也按照%CALLNAME:MASTER%的话，原谅了老实的身体。
PRINTFORMW 「……あ、あの……なんですか？」	PRINTFORMW 「……啊，那个……是吗？」
PRINTFORMW %CALLNAME:MASTER%の視線に気付いた%CALLNAME:TARGET%が、恥ずかしそうに自分の身体を抱きしめる。	PRINTFORMW 注意到%CALLNAME:MASTER%的视线，%CALLNAME:TARGET%羞涩地抱住了自己的身体。
PRINTFORMW なんとなく嫌ではないのかと聞いてみると、%CALLNAME:TARGET%は困ったように視線を彷徨わせる。	PRINTFORMW 当我问她为什么不讨厌时，%CALLNAME:TARGET%困惑地彷徨着视线。
PRINTFORMW 「そ、その……」	PRINTFORMW 「那个，那个……」
PRINTFORMW 言い淀んだきり、はっきりとした答えは返ってこなかった。	PRINTFORMW 她一直沉默着，没有给出明确的回答。
PRINTFORMW 「あ、あの……お願いがあるんですけど」	PRINTFORMW 「啊，那个……我有个请求。」
PRINTFORMW %CALLNAME:MASTER%との性行為にも慣れ始めた頃、%CALLNAME:TARGET%はおずおずと切り出した。	PRINTFORMW 习惯了与%CALLNAME:MASTER%的性行为后，%CALLNAME:TARGET%提心吊胆地说出。
PRINTFORMW 「その……%CNAME("一人称", "どもり")%のおちんちんなんですけど、できれば弄らないでもらえたらなーって……」	PRINTFORMW 「那个……%CNAME("一人称", "口吃")%的那个虽然是小气鬼，但是可以的话请不要玩弄就好了。」
PRINTFORMW 初めて会ったときには既に自分で扱いていたのに、今さら何故？	PRINTFORMW 初次见面的时候已经自己处理了，事到如今为什么？
PRINTFORMW ストレートにそう聞くと、%CALLNAME:TARGET%は顔を真っ赤にしながら手を振った。	PRINTFORMW 被直接这么问到，%CALLNAME:TARGET%涨红脸的同时也挥挥手。
PRINTFORMW 「とと、とにかくダメなものはダメなんですっ」	PRINTFORMW 「总之，不行就是不行的。」
PRINTFORMW そうは言っても、ペニスを責めたときの%CALLNAME:TARGET%の反応が良いのは間違いないのだが……	PRINTFORMW 话是这样说，但玩弄阴茎时的%CALLNAME:TARGET%，反应肯定很可爱。
PRINTFORMW 「うう……もうダメ……」	PRINTFORMW 「嗯~啊……已经不行了……」
PRINTFORMW 突然泣きそうな顔になる%CALLNAME:TARGET%にどうしたのかと尋ねると、堪えきれないかのように声を絞り出した。	PRINTFORMW 到我问她怎么了时，%CALLNAME:TARGET%挤出了个快哭出来的声音。
PRINTFORMW 「我慢しようとするほど、お、おちんちんを弄りたくて仕方ないんですっ」	PRINTFORMW 「越是想忍耐，就越想玩弄它。」
PRINTFORMW 「もうこんなもの忘れて、普通の子に戻って、普通に生きようって思ってたのに……」	PRINTFORMW 「我已经想忘记这些东西了，我想做个普通的孩子，正常地生活下去……」
PRINTFORMW 「気がついたら自分で擦ってて……どうしても堪えられなくって……」	PRINTFORMW 「注意到的话会自己玩弄……怎么也忍不下去……」
PRINTFORMW 「%CNAME("一人称")%、どうしたらいいの……？」	PRINTFORMW 「%CNAME("一人称")%，怎么办才好呢……？」
PRINTFORMW ――%CALLNAME:TARGET%さんのことは見なかったことにして、赤の他人に戻るか――	PRINTFORMW ――是没见到%CALLNAME:TARGET%的事，返回陌生人？――
PRINTFORMW ――それとも、%CALLNAME:TARGET%さんの業を受け入れるか――	PRINTFORMW ――还是接受%CALLNAME:TARGET%的工作？――
PRINTFORMW %CALLNAME:MASTER%はそっと%CALLNAME:TARGET%の体を抱き寄せた……	PRINTFORMW %CALLNAME:MASTER%轻轻地抱住%CALLNAME:TARGET%的身体。
PRINTFORMW 「……%CNAME("二人称", "かな")%……」	PRINTFORMW 「……%CNAME("二人称", "吗？")%……」
PRINTFORMW %CALLNAME:MASTER%の抱擁に応えるように、%CALLNAME:TARGET%は%CALLNAME:MASTER%に体を預けた……	PRINTFORMW 为了回报%CALLNAME:MASTER%的拥抱，%CALLNAME:TARGET%将身体托付给了%CALLNAME:MASTER%。
CALL PRINT_STR, @"「ふふっ……%CNAME("二人称")%_H_」_W"	CALL PRINT_STR, @"「嗯……%CNAME("二人称")%_H_」_W"
PRINTFORMW %CALLNAME:TARGET%は%CALLNAME:MASTER%に何か言われるより前に、%CALLNAME:MASTER%に見せつけるようにゆっくりと服を脱ぎ捨てていく。	PRINTFORMW %CALLNAME:TARGET%在%CALLNAME:MASTER%想说着什么之前，像是让%CALLNAME:MASTER%看到那样，一件一件脱下衣服。
CALL SETFLAG, "ハダカにする", TARGET	CALL SETFLAG, "变成裸体", TARGET
CALL ADD_STATE, TARGET, "具現"	CALL ADD_STATE, TARGET, "具现"
PRINTFORMW その下からは、既に具現化して反り返っている%CALLNAME:TARGET%のペニスが姿を表していた。	PRINTFORMW 从下面开始，已经具体化并弯曲的%CALLNAME:TARGET%的阴茎就展露出来。
PRINTFORMW 「%CNAME("二人称")%って、まだ誰ともしてないんですよね……」	PRINTFORMW 「%CNAME("二人称")%和谁都没做吧？」
PRINTFORMW 反り返ったモノを揺らしながら、%CALLNAME:MASTER%の元へゆっくりと近付く%CALLNAME:TARGET%。	PRINTFORMW 一边摇晃弯曲的东西，%CALLNAME:TARGET%一边慢慢靠近%CALLNAME:MASTER%的身边。
PRINTFORMW 「ねえ、%CNAME("二人称")%……%CNAME("二人称")%の初めて、%CNAME("一人称")%にくれませんか……？」	PRINTFORMW 「呃……%CNAME("二人称")%……的……%CNAME("二人称")%的第一次……能不能给%CNAME("一人称")%……？」
PRINTFORMW お願いするような口振りだが、%CALLNAME:TARGET%の顔には嗜虐的な笑みが浮かんでいる。	PRINTFORMW 虽然是请求的语气，但%CALLNAME:TARGET%的脸上浮现出嗜虐的笑容。
PRINTFORMW やがて%CALLNAME:TARGET%は%CALLNAME:MASTER%の下腹部にペニスが当たる距離まで迫ってきた。	PRINTFORMW 不久，%CALLNAME:TARGET%就直逼到%CALLNAME:MASTER%下腹部的位置。
PRINTFORMW 脈打つペニスの鼓動が直に伝わり、%CALLNAME:MASTER%は無意識に唾を飲み込む。	PRINTFORMW 感受着脉搏跳动的阴茎的跳动直接传达的信息，%CALLNAME:MASTER%无意识地咽口水。
PRINTFORMW ――ここまで入ってくるんだ……	PRINTFORMW ――进来这里……
PRINTFORMW 「想像しました？」	PRINTFORMW 「想到了吗？」
PRINTFORMW %CALLNAME:MASTER%の視線がペニスに注がれているのに気付き、%CALLNAME:TARGET%は%CALLNAME:MASTER%のヴァギナの縁をなぞった。	PRINTFORMW 注意到%CALLNAME:MASTER%的视线看着阴茎，%CALLNAME:TARGET%蹭过了%CALLNAME:MASTER%阴道的边缘。
PRINTFORMW 突然の愛撫に%CALLNAME:MASTER%は驚き、まるでスイッチを切られたかのようにあっさりと腰が砕けてしまう。	PRINTFORMW 突如其来的爱抚让%CALLNAME:MASTER%吃惊，就像被关了开关一样轻易地腰就软了。
PRINTFORMW %CALLNAME:MASTER%の狼狽える様子を楽しむように、%CALLNAME:TARGET%は尻餅をついた%CALLNAME:MASTER%の目の前に自らのペニスを近づけた。	PRINTFORMW 就像是在享受%CALLNAME:MASTER%的狼狈样子的同时，%CALLNAME:TARGET%将阴茎靠近屁股后面的%CALLNAME:MASTER%的眼前。
PRINTFORMW 鼻腔に広がる%TEXTS("匂い")%に%CALLNAME:MASTER%の鼓動は高鳴り、今すぐ目の前のモノにしゃぶりつきたい衝動に駆られる。	PRINTFORMW 鼻窦中弥漫的%TEXTS("气味")%让%CALLNAME:MASTER%心跳加速，让人产生了一种想触摸眼前事物的冲动。
PRINTFORMW だが、%CALLNAME:MASTER%が思わず舌を伸ばしかけた瞬間、ふいに%CALLNAME:TARGET%は腰を引いて一歩離れてしまう。	PRINTFORMW 但是，当%CALLNAME:MASTER%不由自主地伸出舌头的瞬间，%CALLNAME:TARGET%却突然弯腰离开一步。
PRINTFORMW 「%CNAME("二人称")%、嫌なら嫌って言ってくださいね？」	PRINTFORMW 「%CNAME("二人称")%、如果你不喜欢，请告诉我哦？」
PRINTFORMW 先ほどまで悪戯な笑みを浮かべていた%CALLNAME:TARGET%は、急に心配そうな顔で気遣うようなことを言い出した。	PRINTFORMW 刚才还带着恶作剧般笑容的%CALLNAME:TARGET%，突然露出担心的表情跟我说。
PRINTFORMW 「%CNAME("二人称")%の大事な初体験を%CNAME("一人称")%の我儘で無理やり奪うなんて、やっぱり良くないことですから」	PRINTFORMW 「%CNAME("二人称")%重要的初体验被%CNAME("一人称")%的任性强行夺走的话，果然是不好的事呢……」
PRINTFORMW 気がつけば息が荒くなっていた%CALLNAME:MASTER%を、%CALLNAME:TARGET%は優しく抱き竦め、ゆっくりと押し倒す。	PRINTFORMW 注意到急促喘息的%CALLNAME:MASTER%，%CALLNAME:TARGET%紧紧地抱住了她，并慢慢推到。
PRINTFORMW 「だから、%CNAME("二人称")%が決めてください」	PRINTFORMW 「所以，请%CNAME("二人称")%做决定……」
PRINTFORMW 耳元で囁かれた彼女の言葉に、%CALLNAME:MASTER%は金縛りをかけられたような感覚を覚える。	PRINTFORMW 听到她在耳边说的话，%CALLNAME:MASTER%有一种被束缚住的感觉。
PRINTFORMW %CALLNAME:MASTER%の股には%CALLNAME:TARGET%の熱いモノが当たり、%CALLNAME:MASTER%の愛液を得て緩やかな動きで擦り付けられていた。	PRINTFORMW %CALLNAME:MASTER%的胯下感受着%CALLNAME:TARGET%滚烫的东西，%CALLNAME:MASTER%流出爱液后，以缓慢的动作摩擦着。
CALL PRINT_STR, @"「どうしますか？　%CNAME("二人称")%……_H_」_W"	CALL PRINT_STR, @"「怎么办？？　%CNAME("二人称")%……_H_」_W"
PRINTFORMW 期待に胸を焦がすようにふらふらと歩み寄ってくる%CALLNAME:TARGET%。	PRINTFORMW 满怀期待，靠近%CALLNAME:TARGET%。
PRINTFORMW そんな彼女の体を%CALLNAME:MASTER%は優しく抱き止め、ビクビクと脈打つペニスに手を添えて扱き始めた。	PRINTFORMW 她的身体被%CALLNAME:MASTER%温柔地抱住，开始用手摸着颤动的阴茎。
CALL PRINT_STR, @"「どうしますか？　%CNAME("二人称")%……_H_」_W"	CALL PRINT_STR, @"「怎么办？　%CNAME("二人称")%……_H_」_W"
PRINTFORMW %CALLNAME:MASTER%の手技に%CALLNAME:TARGET%は腰を震わせ吐息を漏らす。	PRINTFORMW %CALLNAME:MASTER%的手技，让%CALLNAME:TARGET%颤抖着腰部吐气。
PRINTFORMW 鈴口から溢れ出す先走り汁を指に絡めながら、亀頭の先端からカリ裏まで、敏感な部分を遠慮なく刺激していく……	PRINTFORMW 一边把从铃口溢出来的汁液缠在手指上，从龟头的前端到龟头的背面，毫无顾忌地刺激敏感的部分……
CALL PRINT_STR, @"「だ、ダメです、%CNAME("二人称")%っ_H_　もう出ちゃいますからぁっ_H_」_W"	CALL PRINT_STR, @"「不行，不行。%CNAME("二人称")%_H_　我已经要去了。_H_」_W"
PRINTFORMW 恍惚の表情を浮かべる%CALLNAME:TARGET%の表情を見ると、%CALLNAME:MASTER%は悪戯な笑みを浮かべて彼女の耳元でそっと囁いた。	PRINTFORMW 看着那浮现出陶醉表情的%CALLNAME:TARGET%，%CALLNAME:MASTER%带着恶作剧的笑容在她耳边轻轻地说。
PRINTFORMW ――我慢できたら、入れさせてあげる。	PRINTFORMW ――如果能忍耐，就进来吧。
PRINTFORMW 「え……？」	PRINTFORMW 「呃……？」
PRINTFORMW %CALLNAME:TARGET%の顔色が僅かに変わるのを見て、%CALLNAME:MASTER%は楽しそうにカウントダウンを始めた。	PRINTFORMW 看到%CALLNAME:TARGET%的脸色变了，%CALLNAME:MASTER%愉快的开始倒计时。
PRINTFORMW ……じゅーう……きゅーう……	PRINTFORMW ……十~……⑨~……
PRINTFORMW 「ま、待って、待ってくださいっ」	PRINTFORMW 「啊，等一下，请等一下。」
PRINTFORMW 慌てて離れようとする%CALLNAME:TARGET%の腰を片手で捕まえ、%CALLNAME:MASTER%は淡々とカウントを続ける。	PRINTFORMW 一只手抓住正要慌忙离开的%CALLNAME:TARGET%的腰，%CALLNAME:MASTER%淡然地继续计数。
PRINTFORMW ……はーち……なーな……	PRINTFORMW ……八~……七~……
PRINTFORMW 「あっ、やだ、やめて」	PRINTFORMW 「啊，啊，住手！」
PRINTFORMW なんとか腰を引こうとしても、%CALLNAME:MASTER%の手に抑えられて逃げることはできない。	PRINTFORMW 即使想办法拉腰，也被%CALLNAME:MASTER%的手控制不能逃跑。
PRINTFORMW ……ろーく……ごー……	PRINTFORMW ……六~……五~……
PRINTFORMW 「だめ、むりです、むり……」	PRINTFORMW 「不行，没办法，没办法……！」
PRINTFORMW %CALLNAME:TARGET%が瞳を潤ませ嫌々と首を振る姿は、ただただ%CALLNAME:MASTER%を喜ばせる。	PRINTFORMW %CALLNAME:TARGET%湿润双眸厌恶地摇着头，但却让%CALLNAME:MASTER%高兴。
PRINTFORMW ……よーん……さーん……	PRINTFORMW ……四~……三~……
PRINTFORMW %CALLNAME:TARGET%はもはやぎゅっと目を瞑り、祈るように天を仰ぐしかなった。	PRINTFORMW %CALLNAME:TARGET%已经只能紧紧闭上眼睛，祈祷似的仰望天空了。
PRINTFORMW ……にーい……いーち……	PRINTFORMW ……二~……一~……
PRINTFORMW ――どぴゅっ	PRINTFORMW ――零~
PRINTFORMW 「あぁ……ッ」	PRINTFORMW 「啊……！」
PRINTFORMW ついに、彼女は絶頂を迎えてしまった。	PRINTFORMW 终于，她迎来了高潮。
PRINTFORMW %CALLNAME:TARGET%の放った精子は虚しく宙を舞い、行き場の無いままに落ちて床を汚した。	PRINTFORMW %CALLNAME:TARGET%射出的精子虚无缥缈地在空中飞舞，落在无处可去的地方弄脏了地板。
PRINTFORMW %CALLNAME:MASTER%がそっと手を離すと、%CALLNAME:TARGET%は支えを失いその場にへたり込む。	PRINTFORMW 当%CALLNAME:MASTER%轻轻放手时，%CALLNAME:TARGET%就会失去支撑而陷入原地。
PRINTFORMW 泣きそうな顔の%CALLNAME:TARGET%が、未だ物足りなさそうに勃起しているペニスを持て余しながら%CALLNAME:MASTER%を見上げている。	PRINTFORMW 带着快要哭出来表情的%CALLNAME:TARGET%，一边拿着好像还不够的勃起的阴茎，一边抬头看着%CALLNAME:MASTER%。
PRINTFORMW しかし%CALLNAME:MASTER%は、ただ冷たく首を横に振るのみ。	PRINTFORMW 但是%CALLNAME:MASTER%，只是冷冷地摇摇头。
PRINTFORMW 「やぁ、やです、%CNAME("二人称", "かな")%、まってぇ」	PRINTFORMW 「啊……是，是啊，%CNAME("二人称", "かな")%，真是的！」
PRINTFORMW ついに%CALLNAME:TARGET%は形振り構わず、情けない声を出しながら%CALLNAME:MASTER%の脚に縋り付いた。	PRINTFORMW 终于，%CALLNAME:TARGET%不顾形象，发出凄惨的声音，紧紧抱住了%CALLNAME:MASTER%的腿。
PRINTFORMW %CALLNAME:MASTER%は呆れたような表情で溜め息をつきつつも、心の底で大いに興奮している。	PRINTFORMW %CALLNAME:MASTER%虽然带着无可奈何的表情叹气，但内心却很兴奋。
PRINTFORMW ――それなら、ちゃんとおねだりをしなさい。	PRINTFORMW ――既然这样，就好好睡一觉吧。
PRINTFORMW そう命令を下すと、%CALLNAME:TARGET%は一も二もなく%CALLNAME:MASTER%の言葉に従った。	PRINTFORMW 当她这样下命令时，%CALLNAME:TARGET%就按照%CALLNAME:MASTER%的说法。
CALL PRINT_STR, @"「く、くださいっ_H_　%CNAME("二人称")%のおまんこっ_H_　%CNAME("一人称")%のちんぽでハメさせてぇっ_H_」_W"	CALL PRINT_STR, @"「请，请_H_　%CNAME("二人称")%的阴茎_H_　%CNAME("一人称")%让我用阴茎给你看_H_」_W"
PRINTFORMW 腰を突き出し、自らのペニスを揺らしながら浅ましく%CALLNAME:MASTER%を求めるその姿は、%CALLNAME:MASTER%に嗜虐的な快楽を与えた……	PRINTFORMW 挺着腰，摇晃着自己的阴茎，追求%CALLNAME:MASTER%的姿态，给了%CALLNAME:MASTER%以嗜虐的快乐……
PRINTFORMW 蠱惑的な笑みを浮かべながらゆらゆらとペニスを揺らす%CALLNAME:TARGET%の姿に、%CALLNAME:MASTER%の子宮がキュンと疼く。	PRINTFORMW 看着一边浮现出迷人的笑容一边摇晃着阴茎的%CALLNAME:TARGET%的身姿，让%CALLNAME:MASTER%的子宫怦然而痛。
PRINTFORMW そのまま二人はどちらからともなく歩み寄り、互いに抱き合い口づけを交わした。	PRINTFORMW 就这样，两人不约而同地走近对方，互相拥抱亲吻。
CALL PRINT_STR, "「んっ、んふ……あんっ_H_」_W"	CALL PRINT_STR, "「嗯~哈~……啊……_H_」_W"
PRINTFORMW そして互いに腰を擦り付け合い、性感を高め合う。	PRINTFORMW 互相摩擦着腰部，刺激性感带。
PRINTFORMW %CALLNAME:MASTER%の愛液と%CALLNAME:TARGET%の先走り汁が混ざり合い、二人の性器は卑猥な音を奏でていた。	PRINTFORMW %CALLNAME:MASTER%的爱液和%CALLNAME:TARGET%的汁液混合在一起，两人的性器官发出猥亵的声音。
CALL PRINT_STR, @"「あは_H_　いいっ_H_　いいです、%CNAME("二人称", "かな")%っ_H_」_W"	CALL PRINT_STR, @"「啊_H_　嗯_H_　可以。%CNAME("二人称", "かな")%_H_」_W"
PRINTFORMW 早くも腰が砕けそうになる二人は、互いに倒れてしまわないよう抱き合う手の力を強める。	PRINTFORMW 腰快软掉的两人，为了不让对方倒下，紧紧抱住对方的手。
PRINTFORMW やがて限界が近付いた頃、二人は腰の動きを止め、色情に塗れた顔で見つめ合った。	PRINTFORMW 在接近极限的时候，两人停止了腰部的动作，用充满色情的表情相互凝视。。
PRINTFORMW 「%CNAME("二人称", "かな")%……あなたが、ほしいです……」	PRINTFORMW 「%CNAME("二人称", "かな")%……我想要你……」
PRINTFORMW %CALLNAME:MASTER%を求める潤んだ瞳に吸い込まれるように、再び唇を重ね合った……	PRINTFORMW 仿佛被吸入%CALLNAME:MASTER%湿润的瞳孔里，两人再次相吻。
PRINTFORMW やがて下着まで脱いでその裸体を顕にすると、%CALLNAME:TARGET%は%CALLNAME:MASTER%に抱きついて猫撫で声を出してきた。	PRINTFORMW 不久，将内衣也脱下，露出裸体的%CALLNAME:TARGET%紧紧抱住%CALLNAME:MASTER%的身体，猫抚似的发出声音。
PRINTFORMW 「%CNAME("二人称")%、ずっと%CNAME("一人称")%のココを避けてましたよね……？」	PRINTFORMW 「%CNAME("二人称")%……%CNAME("一人称")%のココを避けてましたよね……？」
PRINTFORMW %CALLNAME:TARGET%が自らの秘所をなぞると、指に透明な糸を引いて、既に興奮していることを示していた。	PRINTFORMW %CALLNAME:TARGET%的手指划过秘缝，在她的手指上缠绕着泛着淫荡光芒的线，我知道自己已经兴奋起来了。
PRINTFORMW 「%CNAME("一人称")%、もう我慢できないんです。%CNAME("一人称")%の初めて、%CNAME("二人称")%にもらって欲しいんです」	PRINTFORMW 「%CNAME("一人称")%已经忍不住了。%CNAME("一人称")%的第一次，想让%CNAME("二人称")%得到。」
PRINTFORMW 「……それとも」	PRINTFORMW 「……还是」
PRINTFORMW %CALLNAME:TARGET%は妖艶な笑みを浮かべ、%CALLNAME:MASTER%の胸に手を当てて押し倒した。	PRINTFORMW %CALLNAME:TARGET%露出妖艳的笑容，用手按住%CALLNAME:MASTER%的胸部。
PRINTFORMW 「こういう方がお好みですか？」	PRINTFORMW 「你喜欢这样的人吗？」
PRINTFORM %CALLNAME:MASTER%の上に跨ると、%CALLNAME:TARGET%は	PRINTFORM 当跨到%CALLNAME:MASTER%上的时候，%CALLNAME:TARGET%问。
CALL ADD_STATE, MASTER, "具現"	CALL ADD_STATE, MASTER, "具现"
PRINTFORM %CALLNAME:MASTER%の秘所に撫でるように触れてペニスを生やした後、	PRINTFORM %CALLNAME:MASTER%的秘处在被抚摸后不久，长出了阴茎。
PRINTFORMW 自らの秘所を指で開いて見せつけてきた。	PRINTFORMW 她用手指打开了自己的秘处。
PRINTFORMW そしてゆっくりを腰を降ろし……%CALLNAME:MASTER%に触れる直前で止まった。	PRINTFORMW 然后慢慢地坐下……触到%CALLNAME:MASTER%之前停止。
PRINTFORMW しとどに濡れた割れ目から溢れた愛液は、%CALLNAME:MASTER%の上にぽたぽたと垂れ落ちてくる……	PRINTFORMW 从淅淅沥沥的裂缝中溢出的爱液，滴滴答答地落在%CALLNAME:MASTER%上……
CALL PRINT_STR, "「ふふっ_H_　どうですか？　入れたくなっちゃいました？」_W"	CALL PRINT_STR, "「哼哼_H_　怎么样？想进去吗~」_W"
PRINTFORMW %CALLNAME:TARGET%は楽しそうに笑いながら、素股をするような動きで、しかしペニスに触れないように腰を軽く揺する。	PRINTFORMW %CALLNAME:TARGET%一边开心地笑着，一边做着像劈腿一样的动作，但是为了不碰到阴茎，轻轻摇晃腰部。
PRINTFORMW %CALLNAME:MASTER%のペニスはビクンビクンと脈打ち、まるで%CALLNAME:TARGET%の秘所を欲して手を伸ばしているように見えた。	PRINTFORMW %CALLNAME:MASTER%的阴茎跳动着，好像想要抓住%CALLNAME:TARGET%的秘处而伸手。
CALL PRINT_STR, "「大丈夫ですよ_H_　すぐに食べてあげますからね……_H_」_W"	CALL PRINT_STR, "「没关系的_H_　马上就让你吃~_H_」_W"
PRINTFORMW 艶やかな微笑みを湛え、%CALLNAME:TARGET%は%CALLNAME:MASTER%を愛しい目で見下していた……	PRINTFORMW 充满娇艳的笑容，%CALLNAME:TARGET%用可爱的目光俯视%CALLNAME:MASTER%
PRINTFORMW %CALLNAME:TARGET%の言葉に%CALLNAME:MASTER%はにやりと口角を上げ、彼女の手首を掴んだ。	PRINTFORMW %CALLNAME:TARGET%的话语加上%CALLNAME:MASTER%微微上扬的嘴角，抓住了她的手腕。
PRINTFORMW 「あっ……」	PRINTFORMW 「啊……」
PRINTFORMW そして%CALLNAME:TARGET%の耳元に口を寄せ、なんてはしたないことを言うのだと言葉責めを聞かせると、彼女は顔を赤らめ身じろぎする。	PRINTFORMW 然后把嘴凑到%CALLNAME:TARGET%的耳边，说着什么卑鄙的话的责备，她红着脸动一动。
PRINTFORMW 「やぁ……いじわる言わないでください……」	PRINTFORMW 「啊……请不要坏心眼地说……」
PRINTFORMW 期待通りの反応をする%CALLNAME:TARGET%に気を良くし、%CALLNAME:MASTER%は自分の膝を彼女の股に押し当てる。	PRINTFORMW %CALLNAME:TARGET%注意到你的反应，%CALLNAME:MASTER%1经自己的膝盖贴在她的大腿上。
PRINTFORMW すると%CALLNAME:TARGET%は自ら秘所を擦り付け、必死に快感を貪り始めた。	PRINTFORMW 于是%CALLNAME:TARGET%开始主动摩擦，秘处，拼命地贪图享受快感。
PRINTFORMW 「んっ、はぁ……%CNAME("二人称", "かな")%……」	PRINTFORMW 「嗯~，啊~……%CNAME("二人称", "かな")%……」
PRINTFORMW しかし%CALLNAME:TARGET%は切なさを募らせるばかりで、%CALLNAME:MASTER%の軽い拘束され振り解けずに潤んだ瞳で慈悲を乞う。	PRINTFORMW 但是%CALLNAME:TARGET%只会越来越难过，不能解开%CALLNAME:MASTER%的拘束的她，用湿润的眼睛乞求慈悲。
PRINTFORMW 「やだぁ、焦らさないでぇ……もうおかしくなっちゃう……」	PRINTFORMW 「啊，别着急啊……已经疯了……」
PRINTFORMW 彼女の哀願を聞き入れ、%CALLNAME:MASTER%は%CALLNAME:TARGET%の耳元にそっと囁いた。	PRINTFORMW 听着她的哀求，%CALLNAME:MASTER%在%CALLNAME:TARGET%的耳边轻轻说。
PRINTFORMW ちゃんとおねだりできたら望み通りにしよう、と。	PRINTFORMW 如果能好好睡一觉的话，就按自己的愿望去吧。
PRINTFORMW パッと手を離してやると、%CALLNAME:TARGET%は息を荒くしながらその場に屈み込んで脚を開き、腰を突き出し両手で秘所を開いて見せつけてきた。	PRINTFORMW 突然松开手，%CALLNAME:TARGET%一边喘着气一边蹲在原地伸腿，伸出腰，用双手打开秘处展示出来。
CALL PRINT_STR, @"「お願いします……%CNAME("二人称")%のおちんちんを、%CNAME("一人称")%のおまんこにハメてください……_H_」_W"	CALL PRINT_STR, @"「拜托了，请把%CNAME("二人称")%のおちんちんを、%CNAME("一人称")%のおまんこにハメてください……_H_」_W"
PRINTFORMW 愛液に塗れた%CALLNAME:TARGET%の秘所はぬらぬらと照り返し、%CALLNAME:MASTER%の到来を待ちわびるようにわなないていた……	PRINTFORMW 涂抹在爱液上的%CALLNAME:TARGET%的秘处温热地回射，仿佛在等待%CALLNAME:MASTER%的到来……
PRINTFORMW 大胆な告白と共に上目遣いに迫る%CALLNAME:TARGET%を、%CALLNAME:MASTER%は口づけと共に抱きしめた。	PRINTFORMW 伴随着大胆的告白，%CALLNAME:TARGET%与%CALLNAME:MASTER%亲吻并拥抱。
CALL PRINT_STR, "「ん……ちゅ……はぁ、あっ_H_」_W"	CALL PRINT_STR, "「嗯~……啾~……嗯~啊……_H_」_W"
PRINTFORMW 同時に、二人は互いの性器に触れ合い、部屋中に淫らな音を響かせる。	PRINTFORMW 同时，两人互相触碰对方的性器官，使房间发出淫荡的声音。
PRINTFORMW 幾度の口づけの後、%CALLNAME:TARGET%は力の抜けた体を%CALLNAME:MASTER%に預け、熱っぽい吐息を吹きかけてきた。	PRINTFORMW 几次亲吻后，%CALLNAME:TARGET%把无力的身体托给%CALLNAME:MASTER%，呼出了一口气。
PRINTFORMW 「%CNAME("二人称")%……%CNAME("一人称")%を、あなたのものにしてください……」	PRINTFORMW 「%CNAME("二人称")%……请把%CNAME("一人称")%变成你的东西……」
PRINTFORMW 脚を絡ませ擦り付けられる%CALLNAME:TARGET%の股は、ただひたすらに%CALLNAME:MASTER%を待ち望んでいることを訴えていた……	PRINTFORMW 被缠着的腿蹭着%CALLNAME:TARGET%的胯下，只是在一味诉说地说着并盼望着%CALLNAME:MASTER%
PRINTFORMW 「酷い人です、%CNAME("二人称")%……今までずっと我慢しようとしてきたのに……」	PRINTFORMW 「糟糕的人……%CNAME("二人称")%……我一直想要忍耐……」
PRINTFORMW 「%CNAME("一人称")%のことを犯して、めちゃくちゃにして、お前は淫らな女なんだってずっと教え込まれ続けて……んっ」	PRINTFORMW 「%CNAME("一人称")%把事情弄得乱七八糟的，我一直被教导说你是个淫荡的女人……我！」
PRINTFORMW 自分の体を撫でながら、%CALLNAME:TARGET%は吐息混じりに言葉を紡ぐ。	PRINTFORMW 一边抚摸着自己的身体，%CALLNAME:TARGET%一边吞吐着。
PRINTFORMW 「ねえ、%CNAME("二人称")%……もっと色んなこと、教えてください」	PRINTFORMW 「嗯……%CNAME("二人称")%请告诉我更多这样的事……」
PRINTFORMW 「%CNAME("一人称")%、もう%CNAME("二人称")%のこと、忘れられないんです……」	PRINTFORMW 「%CNAME("一人称")%忘不了%CNAME("二人称")%的事情……」
PRINTFORMW 切ない声で%CALLNAME:MASTER%を求める%CALLNAME:TARGET%に、%CALLNAME:MASTER%は柔らかな愛撫で応えた。	PRINTFORMW 哀婉的声音中，%CALLNAME:MASTER%寻求%CALLNAME:TARGET%， %CALLNAME:MASTER%用温柔的爱抚回应。
CALL PRINT_STR, "「あっ……_H_」_W"	CALL PRINT_STR, "「啊~……_H_」_W"
PRINTFORMW 力を込めず、性感帯を避けるように撫でる%CALLNAME:MASTER%の手つきは、%CALLNAME:TARGET%の体をじっくりと焦らし、彼女の中に劣情を募らせてゆく……	PRINTFORMW %CALLNAME:MASTER%的手不用力，避开了性感带的抚摸，慢慢地烧灼着%CALLNAME:TARGET%的身体，使她的劣情越来越严重。
CALL PRINT_STR, "「ん……ふぅ……はぁ……_H_」_W"	CALL PRINT_STR, "「嗯~……呃……啊~……_H_」_W"
PRINTFORMW あくまでソフトタッチな%CALLNAME:MASTER%の責めに、それでも%CALLNAME:TARGET%は体をくねらせ、歓喜に喘ぐ。	PRINTFORMW 尽管如此，%CALLNAME:TARGET%还是被软触的%CALLNAME:MASTER%的责备扭弯了身体，被喜悦压得喘不过气来。
PRINTFORMW もはや彼女は、%CALLNAME:MASTER%のもたらす快楽の虜であった……	PRINTFORMW 现在的她，已经被%CALLNAME:MASTER%所带来的快乐俘虏了……
CALL PRINT_STR, @"「%CNAME("二人称", "かな")%_H_　……えへへ」_W"	CALL PRINT_STR, @"「%CNAME("二人称", "かな")%_H_……嘿嘿」_W"
PRINTFORMW 彼女が部活にやってきてから幾らかの時が経った。	PRINTFORMW 她来参加社团活动已经有一段时间了。
PRINTFORMW あれから%CALLNAME:TARGET%の控えめな性質は鳴りを潜め、明るい表情を見せるようになってきた。	PRINTFORMW 从那以后%CALLNAME:TARGET%保守的隐藏声音，露出了明朗的表情。
PRINTFORMW %CALLNAME:MASTER%がそのことを何気無く指摘してみると、%CALLNAME:TARGET%は少し気まずそうに目を逸らしながら話した。	PRINTFORMW %CALLNAME:MASTER%若无其事地指出这件事，%CALLNAME:TARGET%有点尴尬地转移视线说。
PRINTFORMW 「まあ、正直に言うと……%CNAME("二人称")%がっていうより、この部活って怖いところだなって思ってました」	PRINTFORMW 「嗯，老实说……比起%CNAME("二人称")%，这个社团更可怕。」
PRINTFORMW 「なんか普通じゃない人とかが当たり前のように居るし、人に言えないような秘密がいっぱい増えてっちゃうし。できれば距離を置きたい所だと思ってたんですけど」	PRINTFORMW 「不普通的人理所当然地在，不能对人说的秘密也增加了很多。如果可以的话，我想我们应该保持距离。」
PRINTFORMW 「逆、だったんですね」	PRINTFORMW 「相反，是这样的。」
PRINTFORMW %CALLNAME:TARGET%は気恥ずかしそうに首を傾げて笑った。	PRINTFORMW %CALLNAME:TARGET%羞涩地歪着头笑了
PRINTFORMW 「ここから離れれば離れるほど不安になってることに気付いて。ここなら%CNAME("一人称")%のアレを隠す心配とかしなくても良いし」	PRINTFORMW 「注意到我越离开这里就越不安，在这里就不用隐藏%CNAME("一人称")%下面的那个东西了。」
PRINTFORMW 「ああ、ここもちゃんとした%CNAME("一人称")%の居場所なんだなーって。……これも一種のストックホルム症候群ですかね？」	PRINTFORMW 「啊，这里也是%CNAME("一人称")%的住所啊。……这也是一种斯德哥尔摩综合症吗？」
PRINTFORMW 微妙に痛いところを突かれて苦笑いする%CALLNAME:MASTER%に、%CALLNAME:TARGET%も釣られて笑う。	PRINTFORMW 被击中微妙的痛处而苦笑的%CALLNAME:MASTER%，被钓到%CALLNAME:TARGET%而笑。
PRINTFORMW 「ね。そんなことより……そろそろ始めませんか？」	PRINTFORMW 「啊。比起那种事……差不多开始吧？」
PRINTFORMW 「今日はどっちにします？　%CNAME("一人称")%からするか、%CNAME("二人称")%からするか……」	PRINTFORMW 「今天选哪个？是%CNAME("一人称")%还是%CNAME("二人称")%呢……」
CALL PRINT_STR, @"「%CNAME("二人称")%の好きなようにしてください。%CNAME("一人称")%、頑張っちゃいますから_H_」_W"	CALL PRINT_STR, @"「%CNAME("二人称")%请随心所欲，%CNAME("一人称")%我会加油_H_」_W"
CALL PRINT_STR, @"イエロー_%CALLNAME:TARGET%は[内気]を失いました。_W_"	CALL PRINT_STR, @"_%CALLNAME:TARGET%失去了羞涩。_W_"
CALL PRINT_STR, @"イエロー_%CALLNAME:TARGET%は[恥じらい]を失いました。_W_"	CALL PRINT_STR, @"_%CALLNAME:TARGET%失去了羞耻。_W_"
PRINTFORMW 「男の人が苦手になった理由ですか？」	PRINTFORMW 「不喜欢男人的理由吗？」
PRINTFORMW そういえば今まで聞いたことが無かったなと、ふと気になった%CALLNAME:MASTER%は%CALLNAME:TARGET%に訊ねてみた。	PRINTFORMW 这么说来，我从来没听说过。突然在意的%CALLNAME:MASTER%试着问了%CALLNAME:TARGET%
PRINTFORMW 「あぁ……まあ、大したことじゃないんですけど」	PRINTFORMW 「啊……嗯，没什么大不了的。」
PRINTFORMW 「ほら、%CNAME("一人称")%の名前って、望む木に真って書くじゃないですか」	PRINTFORMW 「你看，%CNAME("一人称")%的名字不是写在期望的树上吗？」
PRINTFORMW 「小学校の頃、%CNAME("一人称")%の名前を見た男の子が、覗き魔だーとか言って」	PRINTFORMW 「小学的时候，有一个男生看了%CNAME("一人称")%的名字后，说我是偷窥魔。」
PRINTFORMW 「それからプールの授業がある日なんかは決まって『覗き魔が来るぞ』なんて言われて、学年中に定着までして……卒業までずっとですよ？」	PRINTFORMW 「每当有游泳池的课的时候，他们就会说‘偷窥魔来了’。一直……一直到毕业哦？」
PRINTFORMW 「で、こっちに転校してからもなんとなく、男子とは関わり辛いなーって思ってたときに……ね」	PRINTFORMW 「然后，转校到这边之后，想着和男生有什么关系也很痛苦的时候……啊」
PRINTFORMW %CALLNAME:TARGET%の視線に釣られて、%CALLNAME:MASTER%は彼女の懐に視線を落とす。	PRINTFORMW 被%CALLNAME:TARGET%所吸引，%CALLNAME:MASTER%的视线落到了她的怀中。
PRINTFORMW 「本当に偶然、学校の中庭で変な羊皮紙拾っちゃって。書いてあることを冗談で試してみたら、なんかとんでもないモノが生えてきて」	PRINTFORMW 「真的事偶然，在学校的中庭捡到了奇怪的羊皮纸，写着什么玩笑,我就试一试,荒唐的东西就长了出来」
PRINTFORMW 「あの時は本気で泣きましたね……すぐに戻ったから良かったんですけど」	PRINTFORMW 「那时候真的哭了呢……我马上就回来了，太好了。」
PRINTFORMW 「いや、戻るとわかっちゃったのがいけなかったのかもなぁ……」	PRINTFORMW 「不，我一回来就知道了，可能是不太好吧……」
PRINTFORMW %CALLNAME:TARGET%は当時を懐かしむように天井を仰ぐ。	PRINTFORMW %CALLNAME:TARGET%像怀念当时一样仰望天花板。
PRINTFORMW 「戻ってからしばらくは、二度とこんな力使うまいって思ってたんですけど……」	PRINTFORMW 「回来后的一段时间，我想我会再使用这种力量……」
PRINTFORMW 「やっぱり思春期じゃないですか。試しに触ってみたりとか、色々してるうちに」	PRINTFORMW 「果然是青春期啊。试着摸一摸，在做各种各样的时候」
PRINTFORMW 「そのぅ……精通、をね。まあ、しちゃって。ははは」	PRINTFORMW 「那个……要精通。啊，搞砸了。哈哈哈」
PRINTFORMW 恥ずかしさを誤魔化すように、%CALLNAME:TARGET%は乾いた笑いを漏らした。	PRINTFORMW 为了掩饰羞涩，%CALLNAME:TARGET%发出干涩的笑声。
PRINTFORMW 「そんなのが性の目覚めになったもんですからもうね。絶対誰にも見せられないし、クラスの娘を見る目も変わっちゃうし、なんとなく皆と距離を取るようになって……」	PRINTFORMW 「那样的事成为性的觉醒了。我对谁也不能表现出来。所以班上的女孩们的眼光也改变了,总觉得我和大家故意保持距离……」
PRINTFORMW 「ま、なるようになりましたね。あっはっは」	PRINTFORMW 「啊，变成这样了呢。哈哈哈」
PRINTFORMW 「あっ、別にずっと女の子の尻を付け回したりなんかしませんでしたよ！　こう見えても、優しい男の人と恋ができたらなーとか、そういう憧れもあったんです！」	PRINTFORMW 「啊，我一直都没给女孩子扭屁股呢！虽然看起来是这样，但是如果能和温柔的男人恋爱的话就好了，这样的憧憬也是有的。」
PRINTFORMW 「……え、%CNAME("二人称")%が優しいか？　……まあ、そうですね……なんとも」	PRINTFORMW 「……呃……%CNAME("二人称")%很温柔吗？嗯……是啊，确实……」
PRINTFORMW 「……ま、結果はなんか良くわかんないことになっちゃいましたけどね」	PRINTFORMW 「……嗯，结果还不是很清楚呢。」
PRINTFORMW 「……ま、結局行き着くとこまで来ちゃった感じですけど」	PRINTFORMW 「……啊，感觉终于走到尽头了。」
PRINTFORMW 含みのある言い方に、%CALLNAME:MASTER%は不服そうな体で彼女に掴みかかった。	PRINTFORMW 对于这种用含蓄的说法，%CALLNAME:MASTER%不服气地抓住了她。
PRINTFORMW 「やぁん、違いますってばぁ。もぉ～」	PRINTFORMW 「啊，如果不是的话。啊～」
PRINTFORMW 戯れるように絡み合いながら、%CALLNAME:MASTER%は彼女を優しく押し倒した。	PRINTFORMW 一边戏谑地纠缠着，%CALLNAME:MASTER%温柔地推倒了她。
PRINTFORMW %CALLNAME:MASTER%を見上げる%CALLNAME:TARGET%の表情は柔らかく、愛しい目で微笑んでいた。	PRINTFORMW %CALLNAME:MASTER%看向%CALLNAME:TARGET%那温柔的表情，用可爱的眼睛微笑着。
PRINTFORMW 「……%CNAME("一人称")%、今とっても幸せですから」	PRINTFORMW 「……%CNAME("一人称")%，我现在很幸福……」
PRINTFORMW 「今日はどうしますか、%CNAME("二人称")%？」	PRINTFORMW 「今天怎么办？%CNAME("二人称")%？」
PRINTFORMW %CALLNAME:TARGET%は期待の眼差しで%CALLNAME:MASTER%を待っている……	PRINTFORMW %CALLNAME:TARGET%用期待的眼光等待着%CALLNAME:MASTER%……
CALL PRINT_STR, @"「待ってましたよ、%CNAME("二人称")%_H_」_W"	CALL PRINT_STR, @"「我一直在等你，%CNAME("二人称")%_H_」_W"
PRINTFORMW %CALLNAME:TARGET%の顔は既に上気しており、内股からはぬらぬらした液体が伝い落ちている……	PRINTFORMW %CALLNAME:TARGET%露出一副已经好了的表情，大腿内侧流出一股滑润的液体……
PRINTFORMW 「%CNAME("二人称")%っ」	PRINTFORMW 「%CNAME("二人称")%~」
PRINTFORMW %CALLNAME:TARGET%は%CALLNAME:MASTER%の体に飛びつき、こちらを上目遣いで覗き込んできた。	PRINTFORMW %CALLNAME:TARGET%扑进了%CALLNAME:MASTER%的怀中，向上看了看。
PRINTFORMW 「今日は%CNAME("一人称")%に任せてくださいっ。ちゃんと気持ちよくしますからっ」	PRINTFORMW 「今天就交给%CNAME("一人称")%了嘛~。我会好好干的~」
PRINTFORMW 「うう……きょ、今日もするんですか……」	PRINTFORMW 「嗯……今天也要去吗？」
PRINTFORMW 口では嫌がっている%CALLNAME:TARGET%だが、%CALLNAME:MASTER%との性行為を拒否する様子はない……	PRINTFORMW 虽然嘴上讨厌%CALLNAME:TARGET%，但却没有拒绝与%CALLNAME:MASTER%发生性行为的样子……
PRINTFORMW %CALLNAME:TARGET%はチラチラと%CALLNAME:MASTER%の体を見ている。	PRINTFORMW %CALLNAME:TARGET%紧盯着%CALLNAME:MASTER%的身体。
PRINTFORMW が、%CALLNAME:MASTER%の視線に気付くと慌てて目を逸らした。	PRINTFORMW 注意到%CALLNAME:MASTER%的视线后，慌忙移开自己的视线
PRINTFORMW 「な、なんでもないですから……」	PRINTFORMW 「什么事都没有……」
PRINTFORMW %CALLNAME:TARGET%もだいぶ性行為に慣れてきたが、警戒心はより強まったような気がする……	PRINTFORMW 虽然%CALLNAME:TARGET%也习惯了做爱，但戒心似乎更强了……
PRINTFORMW 「よろしくお願いします、%CNAME("二人称")%……」	PRINTFORMW 「请多关照咯~%CNAME("二人称")%……」
PRINTFORMW %CALLNAME:TARGET%は微かな笑みを見せており、だいぶ心を許してくれているようだ。	PRINTFORMW %CALLNAME:TARGET%露出了微笑，好像已经原谅了我的心。
CALL PRINT_STR, @"「あれぇ？　もう疲れちゃったんですか、%CNAME("二人称")%？　……ふふっ_H_」_W"	CALL PRINT_STR, @"「诶?你已经累了吗?%CNAME("二人称")%？　……呼_H_」_W"
PRINTFORMW 疲れ切った%CALLNAME:MASTER%の上に跨る%CALLNAME:TARGET%は、軽く腰を揺すって膣内の余韻を楽しんでいる。	PRINTFORMW 精疲力尽地%CALLNAME:MASTER%跨在%CALLNAME:TARGET%上，轻轻摇动腰部享受阴道内的余韵。
PRINTFORMW 「%CNAME("一人称")%の膣内、よっぽど気持ちよかったみたいですね」	PRINTFORMW 「%CNAME("一人称")%的阴道内，感觉十分舒服啊~」
CALL PRINT_STR, @"「またいつでも使ってくださいね、%CNAME("二人称")%_H_」_W"	CALL PRINT_STR, @"「请随时使用，%CNAME("二人称")%_H_」_W"
CALL PRINT_STR, "「ん……はぁっ_H_」_W"	CALL PRINT_STR, "「我……哈~_H_」_W"
PRINTFORMW %CALLNAME:TARGET%は腰を上げてペニスを解放すると、恍惚の吐息を漏らした……	PRINTFORMW %CALLNAME:TARGET%起身把阴茎释放出来，发出陶醉的叹息。
PRINTFORMW 「ふふっ……まさかこんなになるまでしちゃうなんて……」	PRINTFORMW 「呼……没想到会弄成这样……」
CALL PRINT_STR, @"「%CNAME("一人称")%のお尻、そんなに良かったですか？　%CNAME("二人称")%_H_」_W"	CALL PRINT_STR, @"「%CNAME("一人称")%的屁股，有那么好吗？%CNAME("二人称")%_H_」_W"
PRINTFORMW ゆっくりとペニスが引き抜かれ、%CALLNAME:TARGET%の尻から精液が溢れ出し、ぽたぽたと垂れ落ちてきた。	PRINTFORMW 伴随着阴茎慢慢地抽出，精液从%CALLNAME:TARGET%的臀部溢出，滴滴答答地流下来。
CALL PRINT_STR, @"「あはぁ_H_ %CNAME("一人称")%、もう戻れないかも……_H_」_W"	CALL PRINT_STR, @"「啊，啊_H_ %CNAME("一人称")%，可能已经回不去了……_H_」_W"
CALL PRINT_STR, "「ふふっ……ふふふ……_H_」_W"	CALL PRINT_STR, "「呼……呵呵……_H_」_W"
PRINTFORMW 気がつけば%CALLNAME:MASTER%は%CALLNAME:TARGET%の下に組み敷かれ、彼女のペニスによって膣内を撹拌され続けていた。	PRINTFORMW 仔细看的话，会发现%CALLNAME:MASTER%被卡在%CALLNAME:TARGET%的下面，被她阴茎在阴道内不停地搅拌。
PRINTFORMW %CALLNAME:MASTER%が何度限界を訴えても止める気配は無く、絶え間無く喘がされ、仰け反らされ続ける。	PRINTFORMW %CALLNAME:MASTER%无论多少次诉说多少次到达极限了，都没有停止的迹象，只能不断地喘着气，仰着头继续。
CALL PRINT_STR, @"「ああ……%CNAME("二人称")%……もっと、もっと見せてください……%CNAME("二人称")%……_H_」_W"	CALL PRINT_STR, @"「啊……%CNAME("二人称")%……请再多给我看看。……%CNAME("二人称")%……_H_」_W"
PRINTFORMW 危険な色を含んだ視線が、快楽によって力無く跳ねる%CALLNAME:MASTER%の体中に注がれる。	PRINTFORMW 那些带着危险颜色的东西，注入到了被快乐给灌满的%CALLNAME:MASTER%的体内
PRINTFORMW やがて幾度目かの射精を子宮に受けた感覚を最後に、%CALLNAME:MASTER%の意識は絶頂と共に沈んでいった……	PRINTFORMW 不久在感受几次射精在子宫里的快感后，%CALLNAME:MASTER%的意识与绝顶一起下沉了……
PRINTFORMW 「%CNAME("二人称")%？　大丈夫ですかー？」	PRINTFORMW 「%CNAME("二人称")%？没关系吗？」
PRINTFORMW %CALLNAME:TARGET%は腰を振り続けたまま、うつ伏せに倒れている%CALLNAME:MASTER%の顔を覗く。	PRINTFORMW %CALLNAME:TARGET%继续扭动着腰，看向倒在地上的%CALLNAME:MASTER%的脸。
PRINTFORMW 「すっかり変態さんになっちゃいましたね、%CNAME("二人称")%」	PRINTFORMW 「完全变成变态主人了呢，%CNAME("二人称")%」
CALL PRINT_STR, "「\@ TALENT:MASTER:オトコ ? 男なのに # \@こんなにお尻で良くなっちゃうなんて……ふふふ_H_」_W"	CALL PRINT_STR, "「\@ TALENT:MASTER:男人 ? 男人的…… # \@这样屁股就会变好……呼_H_」_W"
PRINTFORMW %CALLNAME:MASTER%の尻穴からは泡立つ物が溢れ出し、行為の激しさを物語っている。	PRINTFORMW %CALLNAME:MASTER%的臀孔溢出白浊泡沫，诉说着刚才行为的激烈。
PRINTFORMW 「もうちょっと続けても良いですか？　%CNAME("一人称")%、まだ満足してませんから♪」	PRINTFORMW 「可以再坚持一下吗？%CNAME("第一人称")%还不满足呢♪」
PRINTFORMW %CALLNAME:TARGET%は%CALLNAME:MASTER%の背に覆い被さると更に腰を激しく揺らし、%CALLNAME:MASTER%の体を貪るように味わうのだった……	PRINTFORMW %CALLNAME:TARGET%盖在%CALLNAME:MASTER%的背上更加激烈地摇晃腰部，贪婪地品味%CALLNAME:MASTER%的身体……
PRINTFORMW 「ふふーん、%CNAME("二人称")%に勝っちゃった」	PRINTFORMW 「嗯哼，赢了%CNAME("二人称")%呢~」
PRINTFORMW 「もしかしたら%CNAME("一人称")%、普通の人相手ならもう負けないのかも」	PRINTFORMW 「如果%CNAME("一人称")%是普通的对手，也许不会输」
PRINTFORMW 「ねえねえ、どう思います？　%CNAME("二人称")%♪」	PRINTFORMW 「喂，你觉得呢？%CNAME("二人称")%♪」
PRINTFORMW 息を切らした%CALLNAME:MASTER%に、%CALLNAME:TARGET%は妖艶な笑みで迫ってきた。	PRINTFORMW 看着呼吸急促的%CALLNAME:MASTER%，%CALLNAME:TARGET%用妖艳的笑容逼近。
CALL PRINT_STR, "「ふぅ……はぁ……ふふっ_H_」_W"	CALL PRINT_STR, "「啊……嗯……嗯哈~_H_」_W"
PRINTFORMW 精力を使い果たし、ぐったりと倒れる%CALLNAME:MASTER%を見下ろして、%CALLNAME:TARGET%は不敵な笑みを浮かべる。	PRINTFORMW 看着耗尽精力，筋疲力尽地倒下的%CALLNAME:MASTER%，%CALLNAME:TARGET%露出可怕的笑容。
PRINTFORMW 「%CNAME("二人称")%、起きてますか～？」	PRINTFORMW 「%CNAME("二人称")%，还醒着吗~~~？」
PRINTFORMW %CALLNAME:MASTER%が動けないのをいいことに、%CALLNAME:TARGET%は%CALLNAME:MASTER%の体に手を這わせる。	PRINTFORMW 以%CALLNAME:MASTER%不能动为目的，%CALLNAME:TARGET%把手爬上%CALLNAME:MASTER%的身体。
PRINTFORMW 「起きないとやめませんからね……」	PRINTFORMW 「不起床就不停止啊……」
PRINTFORMW 乳首や性器に触れる度に力無く喘ぎ、僅かに抵抗を試みる%CALLNAME:MASTER%の姿を見て、%CALLNAME:TARGET%の表情は喜色に満ちた狩人へと変貌する。	PRINTFORMW 每当碰到乳头或性器官时，她就会喘着粗气，试图进行抵抗。看到%CALLNAME:MASTER%的样子，%CALLNAME:TARGET%的神情又变回了那如同猎人发现猎物般的喜悦。
CALL PRINT_STR, @"「ふふふ……%CNAME("二人称")%、可愛い……_H_」_W"	CALL PRINT_STR, @"「呼……%CNAME("二人称")%，好可爱……_H_」_W"
PRINTFORMW やがて我慢の限界を迎えた%CALLNAME:TARGET%は、%CALLNAME:MASTER%に覆い被さり体を擦り付けながら、酸素を求めて喘ぐ%CALLNAME:MASTER%の唇を幾度も塞いだ……	PRINTFORMW 不久就到了忍耐极限的%CALLNAME:TARGET%，一边用身体蹭着%CALLNAME:MASTER%，一边寻求氧气似的将%CALLNAME:MASTER%的嘴唇堵住了好几次……
PRINTFORMW 「あわわ、%CNAME("二人称", "どもり")%！？　だだ、大丈夫ですかっ？」	PRINTFORMW 「啊……%CNAME("二人称", "どもり")%！？不要紧吧……」
PRINTFORMW 「お、驚かせないでくださいよぅ……まさかこんなになるまでやるなんて」	PRINTFORMW 「哦，请不要惊讶哦……居然干到这种地步……」
PRINTFORMW 「はぁ……はぁ……」	PRINTFORMW 「啊……啊……」
PRINTFORMW %CALLNAME:MASTER%と繋がったまま体を預け、荒い息を繰り返す%CALLNAME:TARGET%。	PRINTFORMW 将身体托着与%CALLNAME:MASTER%相连，反复喘粗气的%CALLNAME:TARGET%。
PRINTFORMW 「ん……%CNAME("二人称", "かな")%……」	PRINTFORMW 「啊……%CNAME("二人称", "かな")%……」
PRINTFORMW 彼女の頭をそっと撫でてやると、穏やかな顔で%CALLNAME:MASTER%の胸に顔を埋めた……	PRINTFORMW 轻轻抚摸着她的透，平静的表情埋在了%CALLNAME:MASTER%的胸口……
PRINTFORMW 「あぁ……%CNAME("一人称")%、こんなに汚されて……」	PRINTFORMW 「啊……%CNAME("一人称")%弄得这么脏……」
PRINTFORMW 自らの犯された痕跡を目にし、疲れ果てた%CALLNAME:TARGET%の顔に恍惚の色が滲む。	PRINTFORMW 看着被自己侵犯的痕迹，疲惫不堪的%CALLNAME:TARGET%的脸上充满了陶醉。
PRINTFORMW どうやら精液に塗れた自分の姿に興奮してしまっているようだ……	PRINTFORMW 好像为自己涂抹在精液上的样子而兴奋……
PRINTFORMW 「も、もうだめです、%CNAME("二人称", "かな")%……」	PRINTFORMW 「已经不行了……%CNAME("二人称","かな")%……」
PRINTFORMW %CALLNAME:TARGET%は体をビクビクと震わせ、ひたすら荒い呼吸を繰り返していた……	PRINTFORMW %CALLNAME:TARGET%身体颤动着，一个劲地重复着急促的呼吸……
CALL PRINT_STR, @"「あぁ……今日もいっぱい\@ ABL:MASTER:サドっ気 >= 5 && ABL:MASTER:マゾっ気 <= 4 ? 虐められ # 愛され \@ちゃいました……_H_」_W"	CALL PRINT_STR, @"「啊……今天也满了\@ ABL:MASTER:サドっ気 >= 5 && ABL:MASTER:マゾっ気 <= 4 ? 虐められ # 愛され \@ちゃいました……_H_」_W"
PRINTFORMW %CALLNAME:MASTER%の腕の中で惚けた顔で微笑む%CALLNAME:TARGET%。	PRINTFORMW 在%CALLNAME:MASTER%的臂中露出迷人微笑的%CALLNAME:TARGET%。
PRINTFORMW どちらからともなく顔を寄せ合い、何も言わずにそっと口づけを交わし合う。	PRINTFORMW 不知从哪边凑过来的脸，亲吻在一起。
PRINTFORMW 「……しあわせですね……」	PRINTFORMW 「……好幸福啊……」
PRINTFORMW 尊い時間を噛み締めるように、%CALLNAME:TARGET%は強く%CALLNAME:MASTER%を抱きしめた。	PRINTFORMW 为了咬住宝贵的时间，%CALLNAME:TARGET%用力抱紧%CALLNAME:MASTER%。
PRINTFORMW %CALLNAME:MASTER%を見つめる彼女の瞳には、秘められた強い感情が見えていた。	PRINTFORMW %CALLNAME:MASTER%凝视着她的眼睛，里面藏着强烈的情感。
PRINTFORMW 「えー、もう終わりですか？　もっとしましょうよー」	PRINTFORMW 「啊,已经结束了吗？再多做点吧~」
PRINTFORMW %CALLNAME:MASTER%が否を告げると、%CALLNAME:TARGET%は子供のように頬を膨らませる。	PRINTFORMW 当%CALLNAME:MASTER%表示不同意时，%CALLNAME:TARGET%像孩子一样鼓起脸颊。
PRINTFORMW 「ぶー。%CNAME("二人称")%のいけずー」	PRINTFORMW 「嗯……%CNAME("二人称")%，糟了……」
PRINTFORMW しばらく抗議の姿勢を見せていたが、%CALLNAME:MASTER%の気が変わらないのを悟ると、%CALLNAME:TARGET%は%CALLNAME:MASTER%の胸に体を預けた。	PRINTFORMW 虽然有一段时间表现出抗议的态度，但当发现%CALLNAME:MASTER%的想法没有改变时，%CALLNAME:TARGET%把身体寄托在%CALLNAME:MASTER%的胸前。
PRINTFORMW 「……せめて、これくらいは許してください……」	PRINTFORMW 「……至少，请原谅我……」
PRINTFORMW 「%TEXTR("お……終わりました……？/うう……恥ずかしいです")%」	PRINTFORMW 「%TEXTR("啊……结束了……？/呜……不好意思")%」
PRINTFORMW %CALLNAME:TARGET%は顔を真っ赤にして俯いている……	PRINTFORMW %CALLNAME:TARGET%满脸通红低着头……
PRINTFORMW 「%TEXTR("はっ、はぁ……ふぅ……/んっ……お疲れ様、です")%」	PRINTFORMW 「%TEXTR("哈，哈……不……/嗯……辛苦了。")%」
PRINTFORMW %CALLNAME:TARGET%は%TEXTR("息を整え、冷静さを取り戻そうとしている/快楽を押し隠し、平静を装っている")%……	PRINTFORMW %CALLNAME:TARGET%は%TEXTR("调整呼吸，试图恢复冷静/隐藏快乐，假装平静")%……
PRINTFORMW 「その……%TEXTR("つ、次は……あ、なんでもないです！/き、気持ちよかった、です")%」	PRINTFORMW 「那个……%TEXTR("下一个……啊，没什么！/嗯，心情很好。")%」
PRINTFORMW %CALLNAME:TARGET%は%TEXTR("横を向いて、はにかんだ笑顔を隠そうとした/目を泳がせながらも、どこか嬉しそうだ")%。	PRINTFORMW %CALLNAME:TARGET%は%TEXTR("侧视，试图掩饰羞涩的笑容/眼睛游移，但好像很开心")%。
PRINTFORMW 「ひゃっ……」	PRINTFORMW 「啊……」
PRINTFORMW 自分以外の者に体を弄られる初めての体験に、%CALLNAME:TARGET%は過敏な反応を見せた。	PRINTFORMW 第一次被自己以外的人玩弄身体的体验，%CALLNAME:TARGET%表现出过敏的反应。
PRINTFORMW （%CNAME("一人称", "どもり")%、本当に触られてるんだ……）	PRINTFORMW （%CNAME("一人称", "どもり")%，真的被人摸了……）
CALL PRINT_STR, @"「%TEXTR(@"あはっ_H_　良いですよ%CNAME("二人称")%、もっと触ってください\/あんっ_H_　そこっ_H_　気持ちいいですっ\/んっ_H_　%CNAME("一人称")%の弱いところ、バレちゃってますね……_H_")%_H_」_W"	CALL PRINT_STR, @"「%TEXTR(@"啊……哈_H_　好啊。%CNAME("二人称")%、请再摸一摸。\/啊_H_　そこっ_H_　心情舒畅\/嗯~_H_　%CNAME("一人称")%软弱的地方，暴露出来了。……_H_")%_H_」_W"
PRINTFORMW %TEXTR("「ん、んん……あんっ……」/「はっ、あっ……だめ……」/（どうしよう……声、出ちゃうよぉ……）")%	PRINTFORMW %TEXTR("「嗯，嗯……啊~……」/「啊，啊……不行……」/（怎么办……发出声音了……）")%
PRINTFORMW 「あっ、あんっ、あぁっ……」	PRINTFORMW 「啊……嗯啊~……」
PRINTFORMW （ど、どうしよう……！　%CNAME("一人称")%、凄いことしちゃってるよぉ……！）	PRINTFORMW （怎，怎么办！%CNAME("一人称")%做了奇怪的事情！）
PRINTFORMW 「やっ、%CNAME("二人称")%、待って……ひゃっ」	PRINTFORMW 「喂……%CNAME("二人称")%等一等，啊……」
PRINTFORMW （な、舐められちゃってる……%CNAME("一人称")%の大事なとこ……）	PRINTFORMW （啊，被舔了……%CNAME("一人称")%重要的地方……）
CALL PRINT_STR, "「ひんっ_H_」_W"	CALL PRINT_STR, "「嗯~_H_」_W"
PRINTFORMW （あ、あれ……%CNAME("一人称")%、いま……）	PRINTFORMW （啊，那个……%CNAME("一人称")%现在……）
PRINTFORMW 思わぬ快感に%CALLNAME:TARGET%は戸惑っているようだ……	PRINTFORMW 意想不到的快感让%CALLNAME:TARGET%不知所措……
PRINTFORMW 「やぁっ、ダメですっ！　待ってくださいっ」	PRINTFORMW 「啊，不行啦！请等一下。」
PRINTFORMW 「そんなとこで気持ち良くなるわけ……あっ、やめてぇっ」	PRINTFORMW 「在那样的地方心情会变好……啊，住手！」
PRINTFORMW 「んっ、はっ、はぁっ……あぁっ」	PRINTFORMW 「嗯，哈哈……啊~」
PRINTFORMW （見られてる……%CNAME("一人称")%のオナニー、見られちゃってる……）	PRINTFORMW （被看见了……%CNAME("一人称")%的手淫，被其他人看到了……）
PRINTFORMW （ずっと隠してたのに……誰にも見られないようにしてたのにっ……）	PRINTFORMW （一直隐藏着……不想让任何人看见……）
PRINTFORMW 「はぁ……はぁ……んっ……」	PRINTFORMW 「啊……啊……嗯……」
PRINTFORMW （どうしよう……普段はおちんちんを生やしてやってるから、なんだか上手くいかない……）	PRINTFORMW （怎么办，因为平常一直留着……感觉做的不错……）
PRINTFORMW （でも、だからっておちんちんでオナニーさせてなんて、恥ずかしくて言えない……）	PRINTFORMW （但是，让我用这个自慰什么的，我会害羞得说不出话来的呀……）
PRINTFORMW 「はっ、はぁっ……」	PRINTFORMW 「哈，哈，嗯~……」
PRINTFORMW （%CNAME("一人称", "どもり")%、こんな乱暴なことして……）	PRINTFORMW （%CNAME("一人称", "どもり")%做出这种粗暴的行为……）
PRINTFORMW （凄く……興奮してる……）	PRINTFORMW （好厉害……很兴奋……）
PRINTFORMW 「ふぇっ！？　%CNAME("二人称", "どもり")%、何してるんですか！？」	PRINTFORMW 「啊！？　%CNAME("二人称", "どもり")%你在干什么？！？」
PRINTFORMW 「男の人なのに、お、おちんちんしゃぶったりなんかして……あぁっ」	PRINTFORMW 「明明是男人，却一直抠抠抠……啊~」
PRINTFORMW 「だ、ダメですよこんなの、絶対おかしいです……」	PRINTFORMW 「不行，这样的，绝对很奇怪。……」
PRINTFORMW 「やぁっ、%CNAME("二人称", "どもり")%、ちょっと待って」	PRINTFORMW 「啊，%CNAME("二人称", "どもり")%请等一下！」
PRINTFORMW 「そこ、敏感です、からっ、そんないきなり」	PRINTFORMW 「那里，很敏感的……突然间……」
PRINTFORMW 襲いかかる快感にあたふたする%CALLNAME:TARGET%を上目遣いに見上げながら、%CALLNAME:PLAYER%は鈴口を勢い良く吸い上げた。	PRINTFORMW 一边抬眼看着被袭来的快感弄得慌慌的%CALLNAME:TARGET%，%CALLNAME:PLAYER%一边用力地吸吮着铃口。
PRINTFORMW 「ひあぁぁ！？　ま、まってぇぇ……っ」	PRINTFORMW 「啊~~！？啊，等一下啊……！」
PRINTFORMW 「もっと頑張ってくださいよ～、%CNAME("二人称")%。満足しないとやめてあげませんよ？」	PRINTFORMW 「请再努力一点哦~%CNAME("二人称")%。不满足的话就不给你了哟~？」
PRINTFORMW 「ふふ……それとも、もっと続けたいんですか？」	PRINTFORMW 「呵呵……还是想继续做下去？」
CALL PRINT_STR, @"「こうやってっ_H_　押し倒されて、無理やり口に突っ込まれるのが、好きなんですかっ、%CNAME("二人称")%はっ_H_」_W"	CALL PRINT_STR, @"「这样做啊_H_喜欢被推倒，被硬塞进嘴里，%CNAME("二人称")%！_H_」_W"
PRINTFORMW 「%CNAME("二人称",)%っ、楽しんでますか？　楽しんでますよね？」	PRINTFORMW 「%CNAME("二人称",)%啊，开心吗？我很享受？」
CALL PRINT_STR, @"「%CNAME("一人称", "かな")%も、%CNAME("二人称")%の苦しそうな顔、見てると……んんっ_H_」_W"	CALL PRINT_STR, @"「%CNAME("一人称", "かな")%，%CNAME("二人称")%的痛苦的表情,看……恩恩_H_」_W"
CALL PRINT_STR, "「すごく、興奮しますっ_H_」_W"	CALL PRINT_STR, "「太兴奋了。_H_」_W"
CALL PRINT_STR, @"「はぁ～_H_　%CNAME("二人称")%のおくち、気持ち良いです_H_」_W"	CALL PRINT_STR, @"「啊~_H_　%CNAME("二人称")%心情真好~_H_」_W"
CALL PRINT_STR, @"「もうすぐ出ちゃいますから、んっ、じっとしててくださいね_H_」_W"	CALL PRINT_STR, @"「马上就要出门了，嗯，请不要动。_H_」_W"
PRINTFORMW 「んっ、あぁ……%CNAME("二人称")%、ごめんなさいね？」	PRINTFORMW 「嗯，啊……%CNAME("二人称")%，对不起吧？」
PRINTFORMW 「もう%CNAME("一人称")%、我慢できませんからっ……」	PRINTFORMW 「因为%CNAME("一人称")%无法忍受……」
PRINTFORMW %CALLNAME:PLAYER%の頭を手で抑え、%CALLNAME:TARGET%は腰の動きを更に激しくする……	PRINTFORMW %CALLNAME:PLAYER%用手按住头部，%CALLNAME:TARGET%的腰晃动得更厉害了。
PRINTFORMW 「ごめんなさい%CNAME("二人称")%、我慢っ、できなくてっ」	PRINTFORMW 「对不起，%CNAME("二人称")%，忍，忍不住了！」
PRINTFORMW 「はぁっ……すみません、もう%CNAME("一人称")%、止められない……！」	PRINTFORMW 「哈……对不起……%CNAME("一人称")%停不下来了！」
PRINTFORMW 「んー……%CNAME("二人称")%ったら焦れったいです、よっ！」	PRINTFORMW 「嗯……%CNAME("二人称")%，我不耐烦了，啊！」
PRINTFORMW %CALLNAME:TARGET%は突然、%CALLNAME:PLAYER%の頭を掴んで引き寄せ、自らのペニスを無理やり口内に押し込めた！	PRINTFORMW %CALLNAME:TARGET%突然把%CALLNAME:PLAYER%的头拉了过来，硬是把自己的阴茎塞进嘴里！
CALL PRINT_STR, @"「あはっ_H_　こうして涙目になってる%CNAME("二人称")%の顔、好きだなぁ_H_」_W"	CALL PRINT_STR, @"「啊……_H_　就这样泪目了，%CNAME("二人称")%的脸好好看_H_」_W"
CALL PRINT_STR, @"「はぁぁっ_H_　だめっ_H_　ダメです%CNAME("二人称")%っ_H_」_W"	CALL PRINT_STR, @"「哈~ ~_H_　だめっ_H_%CNAME("二人称")%，不行。_H_」_W"
CALL PRINT_STR, @"「%CNAME("一人称", "かな")%っ、もう、我慢できませんからぁ_H_　」_W"	CALL PRINT_STR, @"「%CNAME("一人称", "かな")%啊，我已经忍不下去了。_H_　」_W"
CALL PRINT_STR, @"「あっ_H_　いいっ_H_　いいです_H_　もっとしてください、%CNAME("二人称")%っ_H_」_W"	CALL PRINT_STR, @"「啊_H_　嗯……_H_　可以。_H_　请再做一点，%CNAME("二人称")%_H_」_W"
CALL PRINT_STR, @"「んふっ……%CNAME("二人称")%が%CNAME("一人称")%のを舐めてくれる顔、好きです……_H_」_W"	CALL PRINT_STR, @"「哈，呼……%CNAME("二人称")%在舔我的脸，%CNAME("一人称")%好喜欢……_H_」_W"
PRINTFORMW 「あっ、はぁっ……%CNAME("二人称")%、あんまり激しくしないで……うあっ！」	PRINTFORMW 「啊，是啊……%CNAME("二人称")%不要太激烈了……呜啊！」
PRINTFORMW 「もっと優しくしてくださ……あぁっ！　我慢、できない……！」	PRINTFORMW 「请更温柔一点。啊~ ！忍受不住了……！」
PRINTFORMW 「%CNAME("一人称", "どもり")%の胸なんか触っても、楽しくないですよ……」	PRINTFORMW 「%CNAME("一人称", "どもり")%，摸胸什么的……一点也不好玩……」
PRINTFORMW 「んんっ……！」	PRINTFORMW 「啊……！」
PRINTFORMW （%CNAME("一人称", "どもり")%、こんな形でファーストキスしちゃった……！）	PRINTFORMW （%CNAME("一人称", "どもり")%以这样的形式初吻了……！）
PRINTFORMW 「んっ……！」	PRINTFORMW 「嗯啊……！」
PRINTFORMW （あぁ……しちゃったんだ……ファーストキス……）	PRINTFORMW （啊……搞砸了……初吻……）
CALL PRINT_STR, @"（ああ……%CNAME("一人称")%、すっかりハマっちゃってるなぁ……_H_）_W"	CALL PRINT_STR, @"（啊……%CNAME("一人称")%完全入迷了啊。……_H_）_W"
CALL KOJO_RAND_K34("キス")	CALL KOJO_RAND_K34("接吻")
PRINTFORMW （%TEXTR(@"どうしよう……自分でも止められないっ……\/%CNAME("一人称")%、自分でも信じられないことしてる……")%）	PRINTFORMW （%TEXTR(@"怎么办……自己也不能阻止……\/%CNAME("一人称")%，做着连自己都不敢相信的事。……")%）
CALL PRINT_STR, @"「んっ……_H_　%TEXTR(@"%CNAME("一人称")%、このキス大好きです……_H_\/それじゃあ、始めましょうか？")%」_W"	CALL PRINT_STR, @"「啊……_H_　%TEXTR(@"%CNAME("一人称")%很喜欢这个吻。……_H_\/那开始吧？？")%」_W"
PRINTFORMW %TEXTR("「んっ……な、なんかドキドキします……」/（あぁ……始まっちゃうんだなぁ、今日も……）")%	PRINTFORMW %TEXTR("「嗯……啊，有什么心跳的感觉……」/（啊……开始啊，今天也是……）")%
CALL PRINT_STR, @"（はぁ……%TEXTR("頭とろけちゃいそう/このまま倒れちゃいそう")%……_H_）_W"	CALL PRINT_STR, @"（啊……%TEXTR("头快要融化了/好想就这样倒下了")%……_H_）_W"
PRINTFORMW 「%TEXTR("んっ、んっ……っ/やっ、んん……っ/んっ、ぁふっ、あ……っ")%」	PRINTFORMW 「%TEXTR("嗯，嗯……嗯，嗯……啊，啊，啊……！")%」
PRINTFORMW 「ひゃあっ！」	PRINTFORMW 「咿啊！」
PRINTFORMW 「す、すみません、ビックリしちゃって……」	PRINTFORMW 「对不起，我吓了一跳……」
PRINTFORMW 「んっ、ふっ……はぁっ」	PRINTFORMW 「嗯，呼……哈~」
PRINTFORMW （なにやってるの%CNAME("一人称")%……他人の頭の上に乗って、自分のお尻舐めさせてるなんて……）	PRINTFORMW （%CNAME("一人称")%在做什么呢……骑在别人的头上，让别人舔屁股……）
PRINTFORMW 「う、うそ……そこっ、お尻の穴でっ」	PRINTFORMW 「嗯，骗人……那里啊，屁股上的洞……」
PRINTFORMW 「やだ、ダメですよ、こんなことしちゃ……やぁっ！」	PRINTFORMW 「和,不行啊,这种事可……啊！」
PRINTFORMW 「ひゃん！？」	PRINTFORMW 「嗯啊！？」
PRINTFORMW 「あの、ご、ごめんなさい、敏感ですから……ゆっくりお願いできませんか……？」	PRINTFORMW 「那个，对不起，我很敏感……能拜托您慢点吗？」
PRINTFORMW 「わ、わっ、%CNAME("二人称")%っ。何を……！」	PRINTFORMW 「哇，哇啊！%CNAME("二人称")%，什么……！」
PRINTFORMW （信じられない……%CNAME("一人称")%、パイズリされてるんだ……！）	PRINTFORMW （难以置信……%CNAME("一人称")%，我被欺骗了！）
PRINTFORMW 「ああ……%CNAME("二人称")%の胸、凄いです……」	PRINTFORMW 「啊啊……%CNAME("二人称")%的胸，好厉害……」
PRINTFORMW 「%CNAME("一人称")%のがすっぽりと埋もれちゃって……」	PRINTFORMW 「%CNAME("一人称")%完全被埋没了……」
PRINTFORMW 「んっ、良いですねコレ。気持ち良い……」	PRINTFORMW 「嗯，不错啊，这个。心情很好……」
PRINTFORMW どことなく慣れた様子が気になって、使った経験があるのか訊いてみた。	PRINTFORMW 总觉得很熟悉的样子，就问有没有使用过。
PRINTFORMW 「……な、なな、ないですないです！　何言ってるんですかいきなり！」	PRINTFORMW 「……什么，什么，没有没有！你在说什么？！」
PRINTFORMW %CALLNAME:TARGET%の目は泳いでいる……	PRINTFORMW %CALLNAME:TARGET%的眼睛漂浮不定。
CALL PRINT_STR, "「あぁ……っ_H_」_W"	CALL PRINT_STR, "「啊……_H_」_W"
CALL PRINT_STR, @"「とうとうこの時が来たんですね……んんっ_H_　%CNAME("二人称")%の、すごく熱い……_H_」_W"	CALL PRINT_STR, @"「终于到了这个时候……恩恩_H_　%CNAME("二人称")%非常热……_H_」_W"
PRINTFORMW 「……ね、%CNAME("二人称")%。今の%CNAME("一人称")%、痛みで動けそうにありませんから」	PRINTFORMW 「……呃……%CNAME("二人称")%。我觉得现在的%CNAME("一人称")%不能动弹……」
PRINTFORMW 「いま%CNAME("二人称")%に無理やり動かれたら、抵抗できませんよ……？」	PRINTFORMW 「现在被%CNAME("二人称")%强行移动的话，也抵抗不了哦……？」
CALL PRINT_STR, "「ん、はぁっ……_H_」_W"	CALL PRINT_STR, "「嗯，哈~_H_」_W"
CALL PRINT_STR, @"「あぁ、どうしよう……%CNAME("一人称")%、ニセモノで処女を奪われて、凄く喜んじゃってる……_H_」_W"	CALL PRINT_STR, @"「啊啊……怎么办？……%CNAME("一人称")%被冒牌抢走处女，非常高兴。……_H_」_W"
CALL PRINT_STR, @"「%CNAME("一人称")%、やっぱり変態なんですかね……_H_」_W"	CALL PRINT_STR, @"「%CNAME("一人称")%果然是变态吗？……_H_」_W"
PRINTFORMW 「ん……んんっ……！」	PRINTFORMW 「嗯……嗯啊~……！」
PRINTFORMW （ああ……%CNAME("一人称")%、いま処女じゃなくなったんだ……）	PRINTFORMW （啊……%CNAME("一人称")%已经不是处女了……）
PRINTFORMW （本当に男の人とセックスしてるんだ……なんか信じられないな……）	PRINTFORMW （真的在和男人做爱……真不敢相信……）
PRINTFORMW 「はぁぁ……っ！　はっ……！」	PRINTFORMW 「哈……！哈……！」
PRINTFORMW （ゆ、夢じゃない……%CNAME("一人称")%の初めて、女の人のおちんちんで奪われちゃった……！）	PRINTFORMW （啊……不是在做梦。%CNAME("一人称")%的处女，被女人的阴茎夺走了！）
PRINTFORMW 「はっ……あっ……！」	PRINTFORMW 「啊！……啊……！」
PRINTFORMW （挿入ってる……%CNAME("一人称")%、ペニバンで処女盗られちゃってる……）	PRINTFORMW （%CNAME("一人称")%被插入了呢……处女被拿走了）
PRINTFORMW （なのに、なんでだろう……嫌な気分じゃない、凄くドキドキしてて……）	PRINTFORMW （为什么呢？竟然不是讨厌的心情，而是非常激动……）
PRINTFORMW （%CNAME("一人称")%……興奮してるの……？）	PRINTFORMW （%CNAME("一人称")%难道……很兴奋呢？）
CALL PRINT_STR, "「あぁ……挿入っちゃいましたね……_H_」_W"	CALL PRINT_STR, "「啊，插进去了……_H_」_W"
PRINTFORMW 「%CNAME("二人称")%ったら酷いですよね……今までずっとおちんちんだけは挿入れてくれなくて……」	PRINTFORMW 「%CNAME("二人称")%就太过分了吧……到现在为止一直都没有给我插入小穴……」
PRINTFORMW 「%CNAME("一人称")%、ずっと待ってたんですよ……？」	PRINTFORMW 「%CNAME("一人称")%，一直在等着哦……？」
CALL PRINT_STR, @"「はぁぁ……_H_　挿入りましたよ、%CNAME("二人称")%……」_W"	CALL PRINT_STR, @"「哈~……_H_　插入了啊，%CNAME("二人称")%……」_W"
CALL PRINT_STR, @"「ふふっ_H_　%CNAME("一人称")%と%CNAME("二人称")%の、初めてのセックスですね_H_」_W"	CALL PRINT_STR, @"「呼~_H_　%CNAME("一人称")%和%CNAME("二人称")%第一次做爱。_H_」_W"
PRINTFORMW 「……良かったんですか？　ペニバンの方で」	PRINTFORMW 「太好了？　ペニバンの方で」
PRINTFORMW 「%CNAME("二人称")%さえ良ければ、本物の方でも構わなかったのに……」	PRINTFORMW 「只要%CNAME("二人称")%好，即使是真的也没关系。」
PRINTFORMW 「……操を立ててる人でもいるんですか？」	PRINTFORMW 「……也有很有节操的人吗？」
PRINTFORMW 「――ふふっ、ごめんなさい。失礼でしたよね、変なこと訊いちゃって」	PRINTFORMW 「呵……呵，对不起。对不起，我问了一个奇怪的问题。」
PRINTFORMW 「さ、続きをしましょう？　ちょっとくらい乱暴にしても全然構いませんからね♪」	PRINTFORMW 「那么，继续吧？稍微粗暴一点也没关系哟♪」
CALL PRINT_STR, @"「%CNAME("一人称")%のこと、好きなようにして良いんですよ……%CNAME("二人称")%_H_」_W"	CALL PRINT_STR, @"「%CNAME("一人称")%，可以随心所欲……%CNAME("二人称")%_H_」_W"
CALL PRINT_STR, @"「ずっと玩具で躾けられてばっかりで……%CNAME("一人称")%のこと、どうするつもりなんですか_H_」_W"	CALL PRINT_STR, @"「总是被玩具教育……%CNAME("一人称")%……你打算怎么做？_H_」_W"
CALL PRINT_STR, @"「後戻り出来なくなったら責任取ってくださいね、%CNAME("二人称")%_H_」_W"	CALL PRINT_STR, @"「如果不能回头的话，请负起责任，%CNAME("二人称")%_H_」_W"
PRINTFORMW 「はぁ……っ……」	PRINTFORMW 「啊……嗯……」
PRINTFORMW （とうとう挿入れられちゃった……男の人のおちんちん）	PRINTFORMW （终于被插入了……男人的阴茎……）
PRINTFORMW （こんなことになるなんて思いもしなかったなぁ……）	PRINTFORMW （没想到会变成这样……）
PRINTFORMW 「んんっ……ほ、本当に挿入ってるんですよね、%CNAME("二人称")%の……」	PRINTFORMW 「呼……终于插入了呢，%CNAME("二人称")%的……」
PRINTFORMW %CALLNAME:TARGET%は膣を軽く締め、ペニスの感触を確かめている。	PRINTFORMW %CALLNAME:TARGET%轻轻地掐着阴道，确认阴茎的触感。
PRINTFORMW （や、やっぱり本物だ……）	PRINTFORMW （啊，果然是真的……）
PRINTFORMW 「あぁっ……はぁ……」	PRINTFORMW 「啊……啊……」
PRINTFORMW （なんでだろう……ペニバンを挿入れられた途端、凄くいけないことしてる気分になって……）	PRINTFORMW （为什么呢……被插入的瞬间，感觉做了非常不好的事……）
PRINTFORMW （ああ……%CNAME("一人称")%、興奮してるんだな……）	PRINTFORMW （啊……%CNAME("一人称")%，好兴奋啊……）
PRINTFORMW 「んふふ……%CNAME("一人称")%の手をご所望ですね？」	PRINTFORMW 「呵呵……%CNAME("一人称")%想要我的手，对吧？」
PRINTFORMW 「わかりました。では失礼して」	PRINTFORMW 「明白了。那么失礼了」
PRINTFORMW %CALLNAME:TARGET%は得意気な様子で%CALLNAME:PLAYER%のペニスに手を絡めている……	PRINTFORMW %CALLNAME:TARGET%得意的样子，用手缠着%CALLNAME:PLAYER%的阴茎。
PRINTFORMW 「そ、それじゃその。失礼します……」	PRINTFORMW 「那,那这。失礼了……」
PRINTFORMW 遠慮がちな態度とは裏腹に、%CALLNAME:TARGET%の手つきは慣れたものだった。	PRINTFORMW 与顾虑的态度相反，%CALLNAME:TARGET%的手势是习惯的。
PRINTFORMW 「どうします？　我慢します？　それともこのまま出しちゃいます？」	PRINTFORMW 「怎么做？忍耐吗？还是就这样拿出来？」
PRINTFORMW 「ほら、早く決めないと出ちゃいますよー」	PRINTFORMW 「看，不快点决定的话就出去了。」
PRINTFORMW 「そろそろイッちゃうかなぁ……？」	PRINTFORMW 「差不多的生气了吧……？」
PRINTFORMW 「……さーん、にーい、いーち……」	PRINTFORMW 「……三，二，一……」
PRINTFORMW 「い、イヤって言うまで続けちゃいますよ……」	PRINTFORMW 「是的，直到我说讨厌为止，我还是会继续的。」
PRINTFORMW 「……イヤじゃないですか？」	PRINTFORMW 「……不讨厌吗？」
PRINTFORMW 「ビクビクしてますね、%CNAME("二人称")%の……」	PRINTFORMW 「好害怕啊，%CNAME("二人称")%的……」
PRINTFORMW 「……抵抗しないんですか？」	PRINTFORMW 「……不抵抗吗？」
PRINTFORMW 「どうですか？　気持ちいいでしょ？」	PRINTFORMW 「怎么样？很舒服吧？」
PRINTFORMW 「%CNAME("一人称")%、コレの扱いなら並の女の子に負ける気しませんから」	PRINTFORMW 「因为%CNAME("一人称")%这个的待遇不会输给普通的女孩子。」
CALL PRINT_STR, "「ふふふ……_H_」_W"	CALL PRINT_STR, "「哈……_H_」_W"
PRINTFORMW %CALLNAME:TARGET%は%CALLNAME:PLAYER%の感じている顔をじっと見つめている……	PRINTFORMW %CALLNAME:TARGET%一直看着%CALLNAME:PLAYER%的脸
PRINTFORMW 「あの、痛かったりしたら言ってくださいね……」	PRINTFORMW 「那个，如果疼的话请告诉我……」
PRINTFORMW （うぅ……やっぱり他人のモノって抵抗あるなぁ……）	PRINTFORMW （嗯……果然还是对别人的东西有抵触啊……）
PRINTFORMW 「もっと強くしても大丈夫そうですね……」	PRINTFORMW 「再加强一点好像也没关系……」
PRINTFORMW （%CNAME("一人称")%のが敏感過ぎるのかなぁ……）	PRINTFORMW （%CNAME("一人称")%是不是太敏感了？……）
PRINTFORMW 「あーむっ♪」	PRINTFORMW 「啊啊啊啊♪」
PRINTFORMW 嬉々として%CALLNAME:PLAYER%のペニスを咥えた%CALLNAME:TARGET%は、上目遣いに%CALLNAME:PLAYER%の表情を窺いながら遠慮なく亀頭に舌を這わせた。	PRINTFORMW 高兴地舔着%CALLNAME:PLAYER%的龟头的%CALLNAME:TARGET%一边偷窥%CALLNAME:PLAYER%的表情，一边让舌头爬上龟头。
PRINTFORMW （初めておちんちん咥えるのに、自分でもビックリするくらいノリノリだなぁ）	PRINTFORMW （第一次口交，连自己都吓一跳的兴致勃勃啊。）
CALL PRINT_STR, "（でも仕方ないよね……_H_ ずっとこうしたくてウズウズしてたんだから……_H_）_W"	CALL PRINT_STR, "（但是没办法啊……因为我一直想这么做，所以一直很烦……_H_）_W"
PRINTFORMW 「……ッ」	PRINTFORMW 「……」
PRINTFORMW （い、今さら躊躇うな%CNAME("一人称")%！　押し倒すまで行っておいて、ここで怖気づくなんて道理は通らないんだから！）	PRINTFORMW （好吧，事到如今不要犹豫！%CNAME("一人称")%！到推倒为止，在这里胆怯，这是没有道理的！）
PRINTFORMW 「はむっ！」	PRINTFORMW 「没有！」
PRINTFORMW あわや食い千切られるのではという勢いで%CALLNAME:PLAYER%のペニスを口に含んだかと思えば、%CALLNAME:TARGET%はそこで固まってしまった。	PRINTFORMW 本以为自己会被迅速的吃掉，把%CALLNAME:PLAYER%的阴茎含在嘴里，没想到%CALLNAME:TARGET%就这样僵住了。
PRINTFORMW （や、やっちゃった……）	PRINTFORMW （啊，搞砸了……）
PRINTFORMW しばし動く気配の無かった%CALLNAME:TARGET%だが、%CALLNAME:PLAYER%の視線に気付くと躊躇いがちにゆっくり動き始めた。	PRINTFORMW 暂时没有动作的迹象的%CALLNAME:TARGET%，但是注意到%CALLNAME:PLAYER%的视线后就犹豫着慢慢地开始。
PRINTFORMW 「ふー……ふーっ……」	PRINTFORMW 「哈……哈っ……」
PRINTFORMW 押し倒した%CALLNAME:PLAYER%のそそり勃つモノを前に、%CALLNAME:TARGET%は息を荒くする。	PRINTFORMW 面对推倒的%CALLNAME:PLAYER%的阴茎，%CALLNAME:TARGET%呼吸急促着。
PRINTFORMW 意を決した%CALLNAME:TARGET%は恐る恐る%CALLNAME:PLAYER%のペニスに近づき、そのまま口の中に含んだ。	PRINTFORMW 下定决心的%CALLNAME:TARGET%战战兢兢地靠近%CALLNAME:PLAYER%的阴茎，就那样含在嘴里。
PRINTFORMW （――た、食べちゃった。女の人のおちんちん……本物だ……）	PRINTFORMW （——嗯，吃了。女人的阴茎……真的……）
PRINTFORMW 「そういえば、こうしてフェラするのって初めてでしたね」	PRINTFORMW 「说起来，这样口交还是第一次。」
PRINTFORMW 「実は前々から興味があったりして」	PRINTFORMW 「其实……，嗯……我早就有兴趣」
PRINTFORMW %CALLNAME:PLAYER%のペニスを愛おしそうに撫でると、%CALLNAME:TARGET%は吐息混じりの口でゆっくり咥えた。	PRINTFORMW 一般爱抚着%CALLNAME:PLAYER%的阴茎。%CALLNAME:TARGET%用混杂着声音的嘴巴慢慢含住。
PRINTFORMW 「んふ♪」	PRINTFORMW 「哈♪」
PRINTFORMW %CALLNAME:TARGET%は嬉しそうな表情を見せながら舌を這わせていく……	PRINTFORMW %CALLNAME:TARGET%一边显出高兴的表情一边让舌头爬行……
PRINTFORMW %CALLNAME:PLAYER%のペニスを前に逡巡を見せる%CALLNAME:TARGET%。	PRINTFORMW 面对%CALLNAME:PLAYER%的阴茎，%CALLNAME:TARGET%犹豫不决。
PRINTFORMW やがて少しづつ、恐る恐る口を近付けていき、とうとう%CALLNAME:PLAYER%のペニスに口をつけた。	PRINTFORMW 不久，她慢慢地，战战兢兢地把嘴靠近，终于把嘴放到了%CALLNAME:PLAYER%的阴茎上。
PRINTFORMW （……ここまで来たんだな、%CNAME("一人称")%）	PRINTFORMW （……到这里来了，%CNAME("一人称")%）
PRINTFORMW ペニスを咥えたまま鼻で一呼吸すると、%CALLNAME:TARGET%はゆっくりと口を動かし始めた。	PRINTFORMW 含着阴茎用鼻子呼吸了一下，%CALLNAME:TARGET%慢慢地开始动嘴。
CALL PRINT_STR, @"「あぁっ……_H_　%CNAME("一人称")%、ついに%CNAME("二人称")%の膣内に……_H_」_W"	CALL PRINT_STR, @"「嗯……_H_　%CNAME("一人称")%，终于在%CNAME("二人称")%的阴道内……_H_」_W"
PRINTFORMW %CALLNAME:TARGET%は歓喜と興奮に満ちた表情で腰を揺り動かした。	PRINTFORMW %CALLNAME:TARGET%用充满欢喜和兴奋的表情晃了晃腰。
CALL PRINT_STR, @"「%CNAME("二人称")%、%CNAME("二人称")%……_H_」_W"	CALL PRINT_STR, @"「%CNAME("二人称")%，%CNAME("二人称")%……_H_」_W"
CALL PRINT_STR, "「はーい、処女卒業おめでとうございます_H_」_W"	CALL PRINT_STR, "「啊，恭喜处女毕业。_H_」_W"
PRINTFORMW 「わざわざペニバンでだなんて、%CNAME("二人称")%も物好きですねぇ」	PRINTFORMW 「特意在pinebang，%CNAME("二人称")%也很喜欢呢。」
CALL PRINT_STR, "「でも、こういう趣向も爛れた感じで興奮しますね_H_」_W"	CALL PRINT_STR, "「但是，这种取向也会给人一种溃烂的感觉。_H_」_W"
PRINTFORMW （……まあ、初めてくらいは自分のモノで頂きたかったのが本音だけど……）	PRINTFORMW （……啊，第一次吃自己的东西是真心话……）
PRINTFORMW 「はっ、はっ……」	PRINTFORMW 「哈哈！……」
PRINTFORMW （%CNAME("一人称", "どもり")%、やったんだ……他人の処女を……！）	PRINTFORMW （%CNAME("一人称", "どもり")%搞砸了……别人的处女……！）
PRINTFORMW %CALLNAME:TARGET%は危険な目つきをしている……	PRINTFORMW %CALLNAME:TARGET%带着危险的眼神……
PRINTFORMW （わ……本当にやっちゃった……）	PRINTFORMW （我……真的搞砸了……）
PRINTFORMW （ペニバン使ってるせいかな……%CNAME("一人称")%がやったことなのに、なんだかちょっと他人事みたい。不思議な感じ……）	PRINTFORMW （是因为使用了盘尼芬吧……%CNAME("一人称")%做的事，总觉得有点事不关己。不可思议的感觉……）
CALL PRINT_STR, @"「あぁ……_H_　やっと%CNAME("二人称")%とセックスできた……_H_　この時をずっと待ってたんです……_H_」_W"	CALL PRINT_STR, @"「啊……_H_　终于和%CNAME("二人称")%做爱了……_H_我一直在等待这个时候……_H_」_W"
CALL PRINT_STR, @"「動いても良いですか？　%CNAME("一人称")%、もう我慢できません……_H_」_W"	CALL PRINT_STR, @"「可以动吗？%CNAME("一人称")%，我已经无法忍受了。……_H_」_W"
CALL PRINT_STR, @"「んっ……挿入りましたよ、%CNAME("二人称")%_H_」_W"	CALL PRINT_STR, @"「嗯……插入了啊，%CNAME("二人称")%_H_」_W"
PRINTFORMW 「痛かったりしたら言ってくださいね？　感覚無くて勝手がわかりませんから」	PRINTFORMW 「如果痛的话请告诉我吧？没有感觉，不知道自己的感受。」
PRINTFORMW 「う、あぁ……っ！」	PRINTFORMW 「嗯，啊……！」
PRINTFORMW （これが女の人のナカの感触……！　これがセックスなんだ……！）	PRINTFORMW （这就是女人的感觉……！这就是性！）
PRINTFORMW 「あっ……あの、挿入りました……」	PRINTFORMW 「啊……那个，插入了……」
PRINTFORMW （わあ……すっごくイケないことしてる気分になる……）	PRINTFORMW （哇……感觉自己做了一件很酷的事……）
PRINTFORMW 「あ、あんまり見ないでください……こうやって人に見られるの、初めてなんです……」	PRINTFORMW 「啊，请不要看太多……这样被人看，还是第一次……」
PRINTFORMW %CALLNAME:PLAYER%の視線に晒されたソレはピクピクと震え、つるりとした綺麗なピンク色の亀頭の先端からは、既に透明な液体が垂れ始めていた……	PRINTFORMW 被%CALLNAME:PLAYER%的视线所暴露的索来微微颤抖，光溜溜的粉红色龟头的顶端，已经开始滴下透明的液体……
CALL PRINT_STR, @"「%TEXTR("準備は良いですか/期待しても良いですよね")%、%CNAME("主人")%_H_」_W"	CALL PRINT_STR, @"「%TEXTR("准备好了吗？ /可以期待。")%、%CNAME("主人")%_H_」_W"
PRINTFORMW 「%TEXTR("い、いいんですか……？　や、その、なんていうか/は、恥ずかしいなぁ、もう")%……」	PRINTFORMW 「%TEXTR("嗯，可以吗？？啊，那个，怎么说呢，真不好意思啊，已经")%……」
PRINTFORMW %CALLNAME:TARGET%は%TEXTR("自分のモノを手で隠している/内心期待しているように見える")%……	PRINTFORMW %CALLNAME:TARGET%は%TEXTR("用手遮住自己的东西/内心看起来期待着")%……
PRINTFORMW 「あれっ？」	PRINTFORMW 「咦？？」
PRINTFORMW 「あ、いえ、その。なんでもないです……」	PRINTFORMW 「啊，不，那个。没什么……」
PRINTFORMW 何やら呆気にとられた反応をされたが、すぐに取り繕われた。	PRINTFORMW 虽然她的反应有点愣住了，但很快又补上了。
PRINTFORMW （……個人差なのかな）	PRINTFORMW （……是个人差异吗？）
PRINTFORMW 今、彼女の心の声が聞こえた気がした……	PRINTFORMW 现在，我仿佛听到了她的心声……
PRINTFORMW （うーん、こういうものなのかなぁ）	PRINTFORMW （嗯，原来是这样啊。）
PRINTFORMW %CALLNAME:TARGET%はどことなく浮かない表情だ……	PRINTFORMW %CALLNAME:TARGET%总觉得是闷闷不乐的表情……
PRINTFORMW 「わあ……%CNAME("一人称")%、こうやって他の人の具現化を見るの初めてです……」	PRINTFORMW 「哇……%CNAME("一人称")%这样看别人的具体化是第一次……」
PRINTFORMW 「わあ……」	PRINTFORMW 「哇……」
PRINTFORMW %CALLNAME:TARGET%は顔を赤らめながら、%CALLNAME:MASTER%のペニスをまじまじと見つめていた。	PRINTFORMW %CALLNAME:TARGET%红着脸，目不转睛地盯着%CALLNAME:MASTER%的阴茎。
PRINTFORMW 「わ……おっきい……」	PRINTFORMW 「我……好大……」
PRINTFORMW 「あ、いえ！　珍しいものを見たので、つい……あ、具現のことですよ？」	PRINTFORMW 「啊，不！因为看到了新奇的东西，不由得……啊，是具现的事哟？」
PRINTFORMW %CALLNAME:TARGET%は慌てて視線を逸らすも、チラチラと%CALLNAME:MASTER%のペニスを覗いていた。	PRINTFORMW %CALLNAME:TARGET%慌忙移开视线，又瞥了一眼%CALLNAME:MASTER%的阴茎。
PRINTFORMW 「わわっ！」	PRINTFORMW 「哇！」
PRINTFORMW 普通とは思えない大きさのモノが現れ、%CALLNAME:TARGET%は思わず仰け反った。	PRINTFORMW 出现了不寻常的大小的东西，%CALLNAME:TARGET%不由得仰起了头。
PRINTFORMW 「ごご、ごめんなさい、お、驚いちゃって」	PRINTFORMW 「对不起，我吓了一跳。」
PRINTFORMW 「その……ず、ずいぶん大きいんですね、%CNAME("二人称")%。はは、ははは」	PRINTFORMW 「这……好大啊……%CNAME("二人称")%的。哈哈，哈哈哈……」
PRINTFORMW %CALLNAME:MASTER%のペニスに陵辱される自分の姿を思い描いてしまい、%CALLNAME:TARGET%の額から脂汗が流れた。	PRINTFORMW 想着自己被%CALLNAME:MASTER%的阴茎凌辱的样子，%CALLNAME:TARGET%的额头上流下汗水。
PRINTFORMW 「ひゃあ！？」	PRINTFORMW 「啊！！？」
PRINTFORMW 予想だにしなかったモノが飛び出し、%CALLNAME:TARGET%は腰を抜かしてしまう。	PRINTFORMW 没有预料到的东西跑出来，%CALLNAME:TARGET%会被吓到。
PRINTFORMW 「え……じょ、冗談、ですよね……？」	PRINTFORMW 「呃……开玩笑的，是吧……？」
PRINTFORMW %CALLNAME:TARGET%の怯えた様子に嗜虐心をくすぐられた%CALLNAME:MASTER%は、第三の魔の手をゆらゆらと揺らしながら、彼女との距離をゆっくりと詰めていく。	PRINTFORMW 被%CALLNAME:TARGET%胆怯样子勾引起嗜虐心得%CALLNAME:MASTER%摇晃着第三只魔手，慢慢地缩短与她的距离。
PRINTFORMW 「ひぃぃ！　まま、待ってください！　待って」	PRINTFORMW 「嗯！就这样，请等待！等等」
PRINTFORMW 「ゆ、許してください！　何でもしますから、それだけはやめてぇ……！」	PRINTFORMW 「请原谅我！什么都做，就这么算了吧……！」
PRINTFORMW 涙目の表情と命??いのような彼女の懇願に、%CALLNAME:MASTER%の口角は三日月のように釣り上がっていた……	PRINTFORMW 流泪的表情和她的哀求，让%CALLNAME:MASTER%的嘴角像月牙一样翘起来……
PRINTFORMW 恐る恐る問いかけられ、%CALLNAME:MASTER%が含みの有る笑顔を見せると、%CALLNAME:TARGET%の顔がみるみると青ざめていくのがわかった。	PRINTFORMW 当战战兢兢地问道，%CALLNAME:MASTER%露出笑容时，发现%CALLNAME:TARGET%的脸眼看着就发青了。
PRINTFORMW 「えっ」	PRINTFORMW 「诶」
PRINTFORMW 突然目の前に飛び出してきた異形の??物に、%CALLNAME:TARGET%は文字通り言葉を失った。	PRINTFORMW 对于突然出现在眼前的异状物体，%CALLNAME:TARGET%简直是无语。
PRINTFORMW そのまま陸に打ち上げられた怪魚の生死でも確認するかのように、しばしペニスを指で突かれたり触られるなどした。	PRINTFORMW 就像确认被打到陆地上的怪鱼的生死一样，她的阴茎被手指戳了一下，又被摸了一下。
PRINTFORMW 「マジですか？」	PRINTFORMW 「真的吗？」
PRINTFORMW どういう意味の問いなのかわからなかったが、とりあえず頷いてみると、%CALLNAME:TARGET%は感心したような溜め息をついた。	PRINTFORMW 虽然不知道这是什么意思，但先点了点头，%CALLNAME:TARGET%佩服地叹了口气。
PRINTFORMW 「はああ……これが入るようになるんですねえ……」	PRINTFORMW 「啊……这个就能放进去了呢……」
PRINTFORMW どうやら恐怖を通り越して、来る未来に思いを馳せているようだ……	PRINTFORMW 仿佛越过了恐惧，想起了即将到来的未来……
PRINTFORMW 「%TEXTR("うんうん、今日も元気ですね/ふふっ……いつでも良いですよ")%♪」	PRINTFORMW 「%TEXTR("嗯嗯，今天也很好呢。随时都可以。")%♪」
PRINTFORMW 「あの、%TEXTR("やっぱり……？/お手柔らかにお願いします……")%」	PRINTFORMW 「那个，%TEXTR("果然……？/请您手下留情。……")%」
PRINTFORMW %CALLNAME:TARGET%は%TEXTR(@"%CALLNAME:MASTER%の体に生えたペニスから目が離せない\/これから起こる出来事を想像し、唾を飲み込んだ")%……	PRINTFORMW %CALLNAME:TARGET%は%TEXTR(@"%CALLNAME:MASTER%的眼睛无法离开长在身体上的阴茎\/想象着即将发生的事情，咽了一口口水")%……
CALL PRINT_STR, @"「で、これから何を始める気ですか？　%CNAME("二人称")%_H_」_W"	CALL PRINT_STR, @"「那么，你打算接下来开始做什么呢？%CNAME("二人称")%_H_」_W"
PRINTFORMW 「あの……何をするつもりなんです？」	PRINTFORMW 「那个……你打算做什么？」



//EVENT_K34_SHOP.ERB


PRINTFORMW 「あ、はい。何かご用ですか、%CNAME("二人称")%？」	PRINTFORMW 「啊，是。有什么事吗？%CNAME("二人称")%？」
PRINTFORMW 「は、はいっ！　なんでしょうか……？」	PRINTFORMW 「是啊！是什么呢……？」
PRINTFORMW 「……%CNAME("一人称")%も……」	PRINTFORMW 「……%CNAME("一人称")%也……」
PRINTFORMW 「%CNAME("一人称")%も、%CNAME("二人称")%が好きです」	PRINTFORMW 「%CNAME("一人称")%也喜欢%CNAME("二人称")%」
PRINTFORMW 「男でも、女でも……どんな姿でも関係ありません！」	PRINTFORMW 「男人也好，女人也好……什么样子都没关系！」
PRINTFORMW 「%CNAME("二人称")%なら……%CNAME("一人称")%は、%CNAME("二人称")%だから好きなんですっ！」	PRINTFORMW 「%CNAME("二人称")%的话……%CNAME("一人称")%就是喜欢%CNAME("二人称")%！」
PRINTFORMW 「ずっとずっと、男の人が苦手で……こ、怖かったけど……」	PRINTFORMW 「一直以来，我都很怕男人……这个，虽然很可怕……」
PRINTFORMW 「こんなに誰かを好きになれたの、%CNAME("二人称")%が初めてなんですっ！」	PRINTFORMW 「喜欢上一样一个人，%CNAME("二人称")%是第一次说！」
PRINTFORMW 「女の人同士でそんなのおかしいって……ずっとそう思ってました」	PRINTFORMW 「女人之间的那种恋情奇怪……我一直这么想。」
PRINTFORMW 「でも、良いんですよね？　%CNAME("一人称")%、%CNAME("二人称")%のこと好きになって良いんですよね！？」	PRINTFORMW 「但是，好吧。%CNAME("一人称")%就是喜欢%CNAME("二人称")%这个人啊！？」
PRINTFORMW 内に秘めた想いを曝け出し、%CALLNAME:TARGET%は%CALLNAME:MASTER%の胸に飛び込んだ。	PRINTFORMW 将内心的秘密暴露出来后，%CALLNAME:TARGET%扑进了%CALLNAME:MASTER%的怀里
PRINTFORMW 「……うれしいです、%CNAME("二人称", "かな")%……」	PRINTFORMW 「很高兴，%CNAME("二人称", "大概")%……」
PRINTFORMW %CALLNAME:TARGET%は堪えきれず、歓喜の涙を零していた……	PRINTFORMW %CALLNAME:TARGET%忍不住流下开心的泪水……
PRINTFORMW 「……ご、ごめんなさい」	PRINTFORMW 「……对不起，对不起。」
PRINTFORMW 「%CNAME("二人称")%のこと、どう思えば良いのか……よくわからないんです……」	PRINTFORMW 「%CNAME("二人称")%怎么想才好呢……不太明白……」
PRINTFORMW 「%CNAME("一人称")%、男の人と……こ、恋人になるなんて、まだ考えられなくて……」	PRINTFORMW 「%CNAME("一人称")%和男人……这个，还没想过要成为恋人……」
PRINTFORMW 「お気持ちは嬉しいんですけど……やっぱり、女の人同士で恋人になるのはおかしいと思うから……」	PRINTFORMW 「虽然心情很高兴……果然，我觉得女人之间成为恋人很奇怪……」
PRINTFORMW 「え、あの、ごめんなさい。今ちょっと都合が付かないっていうか」	PRINTFORMW 「啊，对不起。你说现在有点不方便吗？」
PRINTFORMW 「うぅ、わかってくださいよぅ……」	PRINTFORMW 「嗯，请大家理解……」
PRINTFORMW 「……え」	PRINTFORMW 「……呃」
PRINTFORMW 「いや、あの、無理です。無理ですから。ほんと」	PRINTFORMW 「不，那个，不行。因为不行。真的」
PRINTFORMW 「なんでって、そんなの……ねえ？」	PRINTFORMW 「为什么呢？哎？」
PRINTFORMW 何やら怪しい反応をしている……	PRINTFORMW 不知在做什么的可疑反应……
PRINTFORMW 「ぱ、ぱんつ……ですか。本気で言ってますか、%CNAME("二人称")%」	PRINTFORMW 「呵，呵。是吗……。认真的说吗，%CNAME("二人称")%？」
PRINTFORMW 「……わ、我明白了。ちょっと待ってください」	PRINTFORMW 「……我明白了。请稍等一下」
PRINTFORMW （うわぁ、何やってるの%CNAME("一人称")%……なんで断らないの……）	PRINTFORMW （哇，搞什么呢，%CNAME("一人称")%为什么不拒绝呢……）
PRINTFORMW 「飽きませんねえ、%CNAME("二人称")%も……%CNAME("一人称")%のパンツってそんなに魅力あるんですか？」	PRINTFORMW 「不会腻的，%CNAME("二人称")%も……%CNAME("一人称")%的胖次有那么大的魅力吗？」
PRINTFORMW 「好きですねえ、パンツ……魂を売ってるって噂も本当みたいだし」	PRINTFORMW 「我喜欢胖次……关于出卖灵魂的传闻也好像是真的。」
PRINTFORMW 「%CNAME("一人称")%のパンツに値段付いても買います？　なーんて」	PRINTFORMW 「%CNAME("一人称")%的胖次即使有价格也会买？什么？」
PRINTFORMW 「……あ、いや、冗談です。忘れてください。値段付けられたら、それはそれで困ります……」	PRINTFORMW 「……啊，不，是开玩笑。请忘记。如果定价的话，那就麻烦了……」
PRINTFORMW 「なっ、ちょ、いきなり何言い出してるんですかっ」	PRINTFORMW 「啊，等等，突然说什么？」
PRINTFORMW %CALLNAME:TARGET%は小声で捲し立てる。	PRINTFORMW %CALLNAME:TARGET%小声地说。
PRINTFORMW 「少しは人目を気にしてくださいよ、も～っ」	PRINTFORMW 「请稍微也注意一下别人的眼光哦……」
PRINTFORMW 「パン――な、な、なに言ってるんですか！　困りますよそんなのっ」	PRINTFORMW 「面包——你、你在说什么？我很为难。」
PRINTFORMW %CALLNAME:TARGET%は真っ赤な顔で俯いている……	PRINTFORMW %CALLNAME:TARGET%满脸通红地低着头……
PRINTFORMW 「……今さらですね。初めて会ったときにはもう、%CNAME("一人称")%のオナニーだって見られてるのに」	PRINTFORMW 「……事到如今，第一次看到%CNAME("一人称")%的自慰……」
PRINTFORMW 「わかりました。ちょっと待っててくださいね」	PRINTFORMW 「我明白了。请稍等一下。」
PRINTFORMW 「……わかりました」	PRINTFORMW 「……明白了」
PRINTFORMW （駄目だ。%CNAME("一人称")%、ハマっちゃってる……こうして脱ぐのを見られて、息荒げちゃってる……）	PRINTFORMW （不行，%CNAME("一人称")%……就这样被看着脱掉的话，气都快喘不过来了）
PRINTFORMW 「そんなに良いんですか？　その、%CNAME("一人称")%の……はだか」	PRINTFORMW 「有那么好吗？%CNAME("一人称")%赤裸裸的……」
PRINTFORMW 「……む、無理です。今は、その……」」	PRINTFORMW 「……嗯，不行。现在，那个……」
PRINTFORMW %CALLNAME:TARGET%は縋るような目で機会を改めてくれるよう願った。	PRINTFORMW %CALLNAME:TARGET%她用哀求的眼神希望机会能再来一次。
PRINTFORMW %CALLNAME:TARGET%は真っ赤な顔を俯かせ、一言だけ絞り出した。	PRINTFORMW %CALLNAME:TARGET%她低着红透的脸，只挤出一句话。
PRINTFORMW 「……無理、です」	PRINTFORMW 「……不可能。」
PRINTFORMW 「どッ……！？」	PRINTFORMW 「啊……！？」
PRINTFORMW 「むむむ、ムリですムリです！」	PRINTFORMW 「嗯嗯，不行不行！」
PRINTFORMW 「もちろん良いですよ♪　すぐ準備しますからね」	PRINTFORMW 「当然好，我马上准备。」
PRINTFORMW 「……は」	PRINTFORMW 「……在」
PRINTFORMW 「はい、よ、よろしく、お、お、おねがいします……」	PRINTFORMW 「是啊，请多关照，请多关照，请多关照……」
PRINTFORMW 「えっ、い、いいんですかっ？」	PRINTFORMW 「诶，什么，说什么？」
PRINTFORMW 「あの、あの、よろしくおねがいしますっ！」	PRINTFORMW 「那个，那个，拜托了！」
PRINTFORMW 明らかに緊張している……	PRINTFORMW 明显紧张……
PRINTFORMW 「う～ん……ごめんなさい。ちょっと無理ですね」	PRINTFORMW 「嗯……对不起。有点不行」
PRINTFORMW 「え？　また……ですか？」	PRINTFORMW 「呃？又……是吗？」
PRINTFORMW 「あ、いやいや！　駄目じゃないです！　任せてください！」	PRINTFORMW 「啊，不不不！不是不行吗！交给我吧！」
PRINTFORMW （そっか……%CNAME("一人称")%の料理って他人に喜んでもらえるんだ）	PRINTFORMW （这样啊……%CNAME("一人称")%的料理会让别人开心。）
PRINTFORMW （ちょっと自信ついたかも……）	PRINTFORMW （可能有点自信了……）
PRINTFORMW （ほ、ほんとに女の子受けした……！　%CNAME("一人称")%の努力って無駄じゃなかったんだ……！）	PRINTFORMW （真，真的接受了女孩子……！%CNAME("一人称")%的努力没有白费啊！）
PRINTFORMW （よーし……ちょっと本気で頑張っちゃお）	PRINTFORMW （好嘞……稍微认真努力一下吧）
PRINTFORMW %CALLNAME:MASTER%に弁当を食べてもらったことで自信がついたようだ……	PRINTFORMW 让%CALLNAME:MASTER%吃了便当好像有了自信……
PRINTFORMW %CALLNAME:TARGET%は[料理上手Ⅱ]を得ました。	PRINTFORMW %CALLNAME:TARGET%获得了[料理擅长Ⅱ]。
PRINTFORMW 「%TEXTR("お、気に入ってもらえましたか？/任せてください！　今度は何が食べたいですか？")%」	PRINTFORMW 「%TEXTR("哦，你喜欢吗？/交给我吧！这次想吃什么？")%」
PRINTFORMW 「はい、良いですよ。食べられないものがあったら言ってくださいね」	PRINTFORMW 「是，好啊。如果有不能吃的东西，请告诉我。」
PRINTFORMW 思ったよりあっさりした返答だった……	PRINTFORMW 比想象中的回答更加干脆……
PRINTPRINTFORMW 「え、お弁当ですか？」	PRINTFORMW 「啊，便当是吗？」
PRINTFORMW 「まあ、構いませんけど……何かリクエストとかあります？」	PRINTFORMW 「嗯，没关系……有什么要求吗？」
PRINTFORMW %CALLNAME:TARGET%は真面目な顔で献立を考えている……	PRINTFORMW %CALLNAME:TARGET%一副认真的表情考虑着菜单……
PRINTFORMW 「……ふふーん、良いでしょう。楽しみにしててください」	PRINTFORMW 「……嗯嗯，好吧。敬请期待」
PRINTFORMW 珍しく自信満々だ……！	PRINTFORMW 难得的自信……！
PRINTFORMW 「えーっと、ちょっと勘弁してもらえませんか」	PRINTFORMW 「嗯，请原谅我一下好吗？」
PRINTFORMW 「これ以上変なものが増えると困っちゃいます……」	PRINTFORMW 「再多奇怪的东西就麻烦了……」
PRINTFORMW 「シール……ですか？」	PRINTFORMW 「贴纸……是吗？」
PRINTFORMW 「まあ、それくらいなら大丈夫……なのかな」	PRINTFORMW 「嗯，这样就没问题了……是吗？」
PRINTFORMW 「えっ、またアレを貼りたいんですか？」	PRINTFORMW 「诶，还想贴那个吗？」
PRINTFORMW 「ま、まあ別に良いですけど。特に害も無いし。うん」	PRINTFORMW 「嗯，还可以。也没什么特别的危害。嗯。」
PRINTFORMW 「……あれ。特になんともないですね……本当に効果有るんですか？」	PRINTFORMW 「……诶。没什么特别的……真的有效果吗？」
PRINTFORMW 「どれどれ……ひゃあ！？」	PRINTFORMW 「哪个哪个……啊！？」
PRINTFORMW どうやら問題はなさそうだ……	PRINTFORMW 看来没什么问题……
PRINTFORMW 「えへへ……本当にまた貼っちゃいましたね……」	PRINTFORMW 「诶嘿嘿……真的又贴上了呢……」
PRINTFORMW %CALLNAME:TARGET%は複雑な笑みを浮かべている……	PRINTFORMW %CALLNAME:TARGET%露出了复杂的笑容……
PRINTFORMW 「あ、あれですよね。描いたら体が感じやすくなったりとかしちゃうんですよね……」	PRINTFORMW 「啊，是那个吧。画了之后，身体会觉得很舒服，也会觉得不舒服。……」
PRINTFORMW %CALLNAME:TARGET%は静かに息を呑むと、ゆっくりと頷いた。	PRINTFORMW %CALLNAME:TARGET%安静地吸了一口气，慢慢地点头。
PRINTFORMW 「……良いですよ。やってみてください」	PRINTFORMW 「……很好哦。请试试看」
PRINTFORMW 「……正直言うと、怖いです。%CNAME("一人称")%の体、ほんとにおかしくなってるのがわかって」	PRINTFORMW 「实话实说，我很害怕……%CNAME("一人称")%的身体。我知道我真的很奇怪」
PRINTFORMW %CALLNAME:TARGET%は視線を落としながらもじもじしている……	PRINTFORMW %CALLNAME:TARGET%一边低下视线一边扭捏着……
PRINTFORMW 「でも、この先に興味があるのも嘘じゃないです。やっぱり変態ですね、%CNAME("一人称")%」	PRINTFORMW 「但是，对未来感兴趣也不是骗人的。%CNAME("一人称")%果然是变态啊！」
PRINTFORMW 「……やってください、%CNAME("二人称")%。お願いします」	PRINTFORMW 「……请做，%CNAME("二人称")%……拜托了」
PRINTFORMW %CALLNAME:MASTER%の言葉を聞いた%CALLNAME:TARGET%は、答えるよりも早く自らの淫紋を晒した。	PRINTFORMW 听了%CALLNAME:MASTER%的话后，%CALLNAME:TARGET%比回答更快地将淫纹给展示出来。
PRINTFORMW 「待ってたんですよ、%CNAME("二人称")%」	PRINTFORMW 「我一直在等着，%CNAME("二人称")%」
PRINTFORMW 「ずっと焦らされてる感じがして、我慢できないんです。まだ先が残ってるかと思うと……だから、お願いです」	PRINTFORMW 「一直有身体被烧焦的感觉，我已经无法忍受了。还以为有下一步……所以，拜托了。」
PRINTFORMW 「堕としてください。%CNAME("二人称")%の手で、%CNAME("一人称")%にとどめを刺して」	PRINTFORMW 「请把它消掉吧。用%CNAME("二人称")%的手，帮%CNAME("一人称")%画上句号」
PRINTFORMW 「っ……これ、ホントにホンモノなんですね……なんか変な感じ……」	PRINTFORMW 「买……这个，真的是真的东西啊……感觉怪怪的……」
PRINTFORMW 「下腹部が熱くて……少し、ぼーっとします……」	PRINTFORMW 「下腹部热得太厉害……」
PRINTFORMW %CALLNAME:TARGET%は潤んだ瞳で%CALLNAME:MASTER%の顔を見上げている……	PRINTFORMW %CALLNAME:TARGET%用湿润的眼睛仰望%CALLNAME:MASTER%的脸。
PRINTFORMW （あぁ……何これ……%CNAME("一人称")%の体、%CNAME("二人称")%を欲しがってる……っ）	PRINTFORMW （啊！……这是什么，想要……%CNAME("一人称")%想要%CNAME("二人称")%的身体……）
PRINTFORMW 淫紋のもたらす快感に息を荒げる%CALLNAME:TARGET%は、%CALLNAME:MASTER%を求めるように腕を伸ばしている。	PRINTFORMW 被淫纹带来的快感弄得喘不过气来的%CALLNAME:TARGET%伸出手去寻求%CALLNAME:MASTER%。
PRINTFORMW %CALLNAME:MASTER%がそっと手を伸ばすと、%CALLNAME:TARGET%は躊躇いなく手を引いて%CALLNAME:MASTER%を抱きしめた……	PRINTFORMW %CALLNAME:MASTER%悄悄地把手伸了出去，%CALLNAME:TARGET%毫不犹豫地抱住了%CALLNAME:MASTER%……
PRINTFORMW 事を終え、真っ赤な顔で荒い呼吸を繰り返す%CALLNAME:TARGET%。	PRINTFORMW 事情结束后，%CALLNAME:TARGET%满脸通红地重复着急促的呼吸
PRINTFORMW 無防備に晒された淫靡な下腹部を撫でると、彼女の吐息はますます切なくなる。	PRINTFORMW 抚摸着毫无防备的淫靡的下腹部，她的呼吸越来越难受。
PRINTFORMW そのままどちらからともなく手を伸ばし、互いに強く抱き合った……	PRINTFORMW 不管从哪里伸出手，互相用力抱在一起……
PRINTFORMW 「へっ？　性、処理……？」	PRINTFORMW 「诶？性，性处理……？」
PRINTFORMW %CALLNAME:TARGET%は%CALLNAME:MASTER%の手に握られた黒いチョーカーを見ると、密かに唾を飲み込んだ。	PRINTFORMW %CALLNAME:TARGET%看了一眼%CALLNAME:MASTER%手中握着的黑色项链，偷偷咽了一口唾沫。
PRINTFORMW 「……何をすれば良いんですか？」	PRINTFORMW 「……我应该做什么呢？」
PRINTFORMW 「え、あ……はい。良いですよ」	PRINTFORMW 「啊，啊……是。好啊。」
PRINTFORMW （いけない……いま%CNAME("一人称")%、笑いかけてた……）	PRINTFORMW （不好……现在%CNAME("一人称")%，笑了……）
PRINTFORMW 「え……もう良いんですか？」	PRINTFORMW 「呃……已经好了吗？」
PRINTFORMW 「わかりました。じゃあ、えっと……これ、お返ししますね」	PRINTFORMW 「我明白了。那么，什么……这个要还给你。」
PRINTFORMW %CALLNAME:TARGET%は身に着けていた黒いチョーカーを名残惜しそうに外した……	PRINTFORMW %CALLNAME:TARGET%恋恋不舍地离开了黑色的项链。
PRINTFORMW 「そうですか……わかりました」	PRINTFORMW 「是这样吗……我明白了」
PRINTFORMW 「あの……また、いつでも使ってくださいね」	PRINTFORMW 「那个……另外，请随时使用。」
PRINTFORMW 「ふぇっ！？　せ、性処理……！？」	PRINTFORMW 「啊！？性处理……！？」
PRINTFORMW 「む、無理です、できません！　そんな恥ずかしいこと……」	PRINTFORMW 「唔,不行,不行！这么丢人的事……」
PRINTFORMW 「%CNAME("二人称")%が髪を弄ってくれるんですか？　お手並み拝見ですね」	PRINTFORMW 「%CNAME("二人称")%你会帮我弄头发吗？那就看您的手艺吧」
PRINTFORMW 「お、いいですよ。女の子同士の触れ合いですね」	PRINTFORMW 「哦，可以哦。女孩之间的互动~」
PRINTFORMW 「切り揃えるだけでしょ？　って思ってみると、意外とバリエーションがあるんですよね」	PRINTFORMW 「只是剪齐了吧？这样想的话，意外地有变化呢。」
PRINTFORMW 「いろんな意味で難しい髪型と言うか……%CNAME("一人称")%のコレ、似合ってます？」	PRINTFORMW 「从各种意义上说很难的发型……%CNAME("一人称")%真的适合这个吗？」
PRINTFORMW 「こうして整えてみると、元よりも結構綺麗に見えるものですね」	PRINTFORMW 「这样整理的话，看起来就比原来漂亮多了。」
PRINTFORMW 「%CNAME("一人称")%がそれほど髪に気を遣ってないのがバレたとも言えますけど。あはは」	PRINTFORMW 「%CNAME("一人称")%对头发没那么在意的事实也可以说是暴露了。哈哈……」
PRINTFORMW 「髪は性格を表しますよねぇ。明るさだったり社交性だったりとか……」	PRINTFORMW 「头发代表性格。或开朗，或善于交际……」
PRINTFORMW 「ようはコレ、%CNAME("一人称")%のイメージじゃないってことですよ！　恥ずかしいんですけど！」	PRINTFORMW 「就是这个，不是%CNAME("一人称")%的印象哦！虽然很不好意思！」
PRINTFORMW 「ポニテ協会があればツインテ協会もあるのは自明の理と言いますか……」	PRINTFORMW 「有ponte协会就有tinte协会，这是不言自明的道理吗？」
PRINTFORMW 「アニメとかでも一時期よく持ち上げられてた気がします。金髪、ツンデレと三種の神器ですね」	PRINTFORMW 「动画之类的也有一段时期经常被提起的感觉。金发、傲娇和三种神器。」
PRINTFORMW 「ポニーテール協会っていうのがあったって知ってます？　今はもう活動してないみたいですけど」	PRINTFORMW 「有马尾辫协会的你知道吗？我现在好像已经不活动了」
PRINTFORMW 「一昔前の深夜アニメにもポニテが好きな主人公いたっけなぁ……結構支持率高い髪型ですよね」	PRINTFORMW 「很久以前的深夜动画里也有喜欢ponte的主人公呢……这是一个高支持率的发型。」
PRINTFORMW 「そういえば昔、水を被ると女の子になっちゃうっていうキャラクターがいましたよね」	PRINTFORMW 「这么说来的话，以前，有一个角色，只要一碰到水就会变成女孩子呢」
PRINTFORMW 「%CNAME("一人称")%も性別ごと変わるようだったらどうなってただろうなぁ……」	PRINTFORMW 「%CNAME("一人称")%也随着性别而变化的话会怎么样呢……」
PRINTFORMW 「そこのところ、どうなんです？　%CNAME("二人称")%」	PRINTFORMW 「那里怎么样？%CNAME("二人称")%」
PRINTFORMW 「良いですよね、こうやって編み込むの。かわいらしくて、見てて好きなんです」	PRINTFORMW 「好啊，这样编进去。很可爱，看着很喜欢。」
PRINTFORMW 「……%CNAME("一人称")%、かわいいですか？」	PRINTFORMW 「……%CNAME("一人称")%……可爱吗？」
PRINTFORMW 「お団子って聞くと、どうしてもゲームとかのチャイナ娘キャラみたいなの想像しちゃいますよね」	PRINTFORMW 「一听说丸子头，就会联想到游戏中，中国姑娘的角色。」
PRINTFORMW 「ほら、あの格闘ゲームのとか。昔はあのキャラの技でみんなスタートボタン押しまくってたらしいですよ」	PRINTFORMW 「看，那个格斗游戏之类的。听说以前那个角色的技能都是按开始按钮的。」
PRINTFORMW 「%TEXTR(@"どうです？　似合ってますか？/なんだか新鮮ですね……%CNAME("一人称")%じゃないみたい")%」	PRINTFORMW 「%TEXTR(@"怎么样？合适吗？/总觉得很新鲜呢……%CNAME("一人称")%好像不是那样")%」
PRINTFORMW 「え……うーん、ちょっと遠慮させてもらえませんか」	PRINTFORMW 「呃……嗯，能让我客气一下吗？」
PRINTFORMW 「えっ！　い、いいんですか？」	PRINTFORMW 「诶！嗯，可以吗？」
PRINTFORMW 「い、いや別に嬉しくはないですよ！　女の子なのにそんなの気にするわけないじゃないですかぁ」	PRINTFORMW 「不，不，我并不高兴！明明是女孩子，怎么可能在意这种事呢。」
PRINTFORMW %CALLNAME:TARGET%の顔は綻んでいる……	PRINTFORMW %CALLNAME:TARGET%脸上带着微笑的表情。
PRINTFORMW 「えっ？　おっきくするんですか？　%CNAME("一人称")%のを？」	PRINTFORMW 「诶？你懒得做吗？%CNAME("一人称")%的？」
PRINTFORMW 「……ま、まあ、構いませんけど。ちょっとは興味ありますし……」	PRINTFORMW 「……唉,算了,没关系。。我有点兴趣……」
PRINTFORMW %CALLNAME:TARGET%はそわそわしている……	PRINTFORMW %CALLNAME:TARGET%心神不定的样子……
PRINTFORMW 「ええっ？　今より大きくするんですか？」	PRINTFORMW 「诶？要比现在大吗？」
PRINTFORMW 「……え？　本気ですか、%CNAME("二人称")%？」	PRINTFORMW 「……呃？你是认真的吗？%CNAME("二人称")%？」
PRINTFORMW 「あの、これ以上は洒落にならなくなっちゃいますよ？」	PRINTFORMW 「那个……不能再洒脱了哦。」
PRINTFORMW 「うん、まあ、好きにしてください……」	PRINTFORMW 「嗯，请随便……」
PRINTFORMW 「い、いきなり何言い出すんですか！　ほっといてくださいよ！」	PRINTFORMW 「嗯，突然说什么啊！别管我吧！」
PRINTFORMW 突如別れを切り出された恋人のような顔をした%CALLNAME:TARGET%は、紡ぐべき言葉を探して視線を彷徨わせた後、悲しそうな顔で俯いた。	PRINTFORMW 像突然被提出分手的恋人那样的表情的%CALLNAME:TARGET%，在露出寻找应该编织的语言的视线彷徨之后，悲哀地低下了头。
PRINTFORMW 「あれっ、小さくしちゃうんですか？」	PRINTFORMW 「诶，要变小吗？」
PRINTFORMW 「まあ、どうしてもって言うなら仕方ないですけど……なんかちょっと残念だなぁ……」	PRINTFORMW 「嗯，为什么要说的话也是没办法的……总觉得有点遗憾啊……」
PRINTFORMW 「いやいやいや、何を言ってるんだ%CNAME("一人称")%は……女だぞ%CNAME("一人称")%は……」	PRINTFORMW 「不不不！你在说什么呢……%CNAME("一人称")%……%CNAME("一人称")%は是，是女的。」
PRINTFORMW 「も、もしかしておっきいの駄目でした？　それだったらあの、しょうがないですけど」	PRINTFORMW 「难道是大个子也不行吗？那我也没办法。」
PRINTFORMW 「あらら、小さくしちゃうんですか？　構いませんけど……」	PRINTFORMW 「哎呀，要变小吗？没关系……」
PRINTFORMW 「意外と貴重な体験だったなーなんて。えへへ」	PRINTFORMW 「意外宝贵的体验呢。嘿嘿」
PRINTFORMW 「あ、良かった……やっと小さくできるんですね」	PRINTFORMW 「啊，太好了……它终于可以变小了。」
PRINTFORMW 「正直どうしたものかって持て余してましたよ……」	PRINTFORMW 「说实话我一直在担心到底是怎么回事呢……」
PRINTFORMW 「……ほおー。女の身分とはいえ、小さくしろと言われると考えるものがありますねぇ」	PRINTFORMW 「……哎。虽说是女人的身体，但也有被要求变小的意愿。」
PRINTFORMW 珍しく怒気の籠もった笑顔をしている……	PRINTFORMW 罕见地带着怒气的笑容……
PRINTFORMW 「あぁ～……やっぱりこっちの方が落ち着きます」	PRINTFORMW 「啊~……还是这边比较稳」
PRINTFORMW 「もしバレたらどうしようって気が気じゃないんですからね」	PRINTFORMW 「如果被发现了怎么办呢，我可是很介意的哦。」
PRINTFORMW 「うあぁ……なんかどっと疲れたような気がします」	PRINTFORMW 「啊啊啊……什么的不知疲惫的感觉。」
PRINTFORMW 「授業とか全然集中できないし……成績落ちてるんじゃないかなぁ、%CNAME("一人称")%」	PRINTFORMW 「上课什么的完全不能集中……%CNAME("一人称")%成绩下降了吧」
PRINTFORMW 「え。出しっ放しにしてほしいってことですか？」	PRINTFORMW 「呃。是想让我放出来吗？」
PRINTFORMW 「誰かに見つかったりしたら大変じゃないです？　それにその、敏感だし……どうしても？」	PRINTFORMW 「要是被谁发现了不就麻烦了吗？而且，还很敏感……无论如何？」
PRINTFORMW 「ぐぬぬ……わ、わかりました……」	PRINTFORMW 「滑头……我明白了……」
PRINTFORMW 「……%CNAME("二人称")%、もしかして%CNAME("一人称")%で遊んでます？」	PRINTFORMW 「……%CNAME("二人称")%，莫非你在戏弄%CNAME("一人称")%？」
PRINTFORMW 「んも～！　バイブやローターがバレるのとは訳が違うんですからね！」	PRINTFORMW 「嗯~ ！这就是震动棒和跳蛋不同的原因！」
PRINTFORMW 「……あの、今の発言ナシにしてください……」	PRINTFORMW 「……那个，请放弃刚才的发言……」
PRINTFORMW 「えっ……あだ名ですか？」	PRINTFORMW 「诶……是绰号吗？」
PRINTFORMW 「……まあ、構いませんけど」	PRINTFORMW 「……嗯，没关系。」
PRINTFORMW %CALLNAME:TARGET%は何と呼ばれるか警戒している……	PRINTFORMW %CALLNAME:TARGET%警惕着被叫做什么呢？
PRINTFORMW 「～～～～ッ」	PRINTFORMW 「~~~~」
PRINTFORMW 「%TEXTR(@"%CNAME("二人称")%の馬鹿ーーっ！！/ぜっったい、嫌ですっ！！")%」	PRINTFORMW 「%TEXTR(@"%CNAME("二人称")%是笨蛋！！/真讨厌！！")%」
PRINTFORMW 涙目ながらに断られてしまった……	PRINTFORMW 含泪拒绝了……
PRINTFORMW 「……ほっ」	PRINTFORMW 「……哈哈」
PRINTFORMW %CALLNAME:TARGET%は安堵の息を漏らした。	PRINTFORMW %CALLNAME:TARGET%松了一口气。
PRINTFORMW 「わかりました。大丈夫ですよ」	PRINTFORMW 「我明白了。没关系的。」
PRINTFORMW 「あれ、やめるんですか？」	PRINTFORMW 「诶，要放弃吗？」
PRINTFORMW 「それならまあ、良かったです……」	PRINTFORMW 「那就好了。」
PRINTFORMW 「はあ。いいですけど、なんて呼べばいいんですか？」	PRINTFORMW 「哦。可以，但是怎么称呼才好呢？」
PRINTFORMW 「えぇ……なんで……？」	PRINTFORMW 「诶……为什么……？」
PRINTFORMW 露骨に顔を顰められてしまった……	PRINTFORMW 被露骨地皱起了脸……
PRINTFORMW 「本当にそれで呼んで欲しいならそうしますけど……いいんですか？」	PRINTFORMW 「如果真的想用它来呼唤我的话，我会这么做的。可以吗？」
CALL PRINT_SELECT, "呼んでもらう/やめてもらう"	CALL PRINT_SELECT, "请叫我/不要叫我"
PRINTFORMW 「わかりました。今後ともよろしく、%CNAME("二人称")%」	PRINTFORMW 「哦……我明白了。那个，今后也请多多关照……」
PRINTFORMW まだ微妙に納得していない様子で頭を下げられた。	PRINTFORMW 以还没明白的样子被低下了头。
PRINTFORMW 「じゃあなんでそんなこと言い出すんですかぁ、んもぉ～」	PRINTFORMW 「那为什么要说出那样的话呢，嗯~」
PRINTFORMW %CALLNAME:TARGET%は呆れた顔で天を仰いだ。	PRINTFORMW %CALLNAME:TARGET%一副无可奈何的表情仰天长叹。
PRINTFORMW 「わかりました。今後ともよろしく、%CNAME("二人称")%」	PRINTFORMW 「我明白了。今后也请多多关照，%CNAME("二人称")%」
PRINTFORMW 「あれ、やめちゃうんですか」	PRINTFORMW 「啊，要放弃吗？」
PRINTFORMW 「それじゃあ、決まったらまた言ってくださいね」	PRINTFORMW 「那么，决定了的话请再说吧。」
PRINTFORMW 「あ、あの、ごめんなさい……無理、です……」	PRINTFORMW 「啊，对不起……不行，不行……」
PRINTFORMW 「わ、わかりました。良いですよ」	PRINTFORMW 「我明白了。好啊。」

//EVENT_K34_DAILY.ERB

PRINTFORMW 「はぁ……ふぅ……」	PRINTFORMW 「啊……不……」
PRINTFORMW %CALLNAME:ARG%は精を吐き出した%CALLNAME:MASTER%のペニスをぼうっと見つめている。	PRINTFORMW %CALLNAME:ARG%把精液吐了出来，看向了%CALLNAME:MASTER%的阴茎。
PRINTFORMW 「ちょっと、このまま休憩させてください……」	PRINTFORMW 「请让我就这样休息一下吧……」
PRINTFORMW 「ふふっ、おはようございます、%CNAMET(ARG, "二人称")%」	PRINTFORMW 「呵呵，早上好%CNAMET(ARG, "二人称")%」
PRINTFORMW 「その……お、おはようございます」	PRINTFORMW 「那个……哦，早上好。」
PRINTFORMW 「あ……%CNAMET(ARG, "二人称")%だけ、なんですね……えへへ」	PRINTFORMW 「啊……%CNAMET(ARG, "二人称")%只是……什么啊，嘿嘿」
PRINTFORMW 「あ、あれっ？　他の人は……いない、んですか？」	PRINTFORMW 「啊，那个啊？其他人……没有，是吗？」
PRINTFORMW 「ふぇ！？　あの、もしかして、ふ、二人きりですか？」	PRINTFORMW 「呼！？那个，难道只有两个人吗？」
PRINTFORMW 「ただいま、%CNAMET(ARG, "二人称")%♪」	PRINTFORMW 「我回来了！%CNAMET(ARG, "二人称")%♪」
PRINTFORMW 「あ、あのー……ただいま帰りましたー……」	PRINTFORMW 「啊，那个……我回来了……」
PRINTFORMW 「あっ%CNAMET(ARG, "二人称")%！　た、ただいま帰りましたっ」	PRINTFORMW 「啊！%CNAMET(ARG, "二人称")%！　我回来了。」
PRINTFORMW 「あっ！　%CNAMET(ARG, "二人称")%、お帰りなさい♪」	PRINTFORMW 「啊！　%CNAMET(ARG, "二人称")%回来了♪」
PRINTFORMW 「あっ……そ、その、お帰りなさい」	PRINTFORMW 「啊……那个，你回来了。」
PRINTFORMW 「あっ%CNAMET(ARG, "二人称")%！　お、お帰りなさいっ！」	PRINTFORMW 「啊！%CNAMET(ARG, "二人称")%别回来了！」
PRINTFORMW 「待ってましたよ、%CNAMET(ARG, "二人称")%♪」	PRINTFORMW 「我一直在等着%CNAMET(ARG, "二人称")%♪」
PRINTFORMW 「わっ、%CNAMET(ARG, "二人称")%！　あ、いやその……すみません、お邪魔してます」	PRINTFORMW 「啊！打搅%CNAMET(ARG, "二人称")%了！啊，不，那个……对不起」
PRINTFORMW 「あ、その、お邪魔してます%CNAMET(ARG, "二人称")%！」	PRINTFORMW 「啊，那个，打扰%CNAMET(ARG, "二人称")%了！」
PRINTFORMW 「――はっ！？　ご、ごめんなさい、まじまじと見ちゃって。し、失礼ですよね……」	PRINTFORMW 「——啊！？对不起，我看得太仔细了。太失礼了吧……」
PRINTFORMW %CALLNAME:ARG%は慌てて目を逸らし、顔を赤らめている……	PRINTFORMW %CALLNAME:ARG%慌忙移开视线，满脸通红……
PRINTFORMW 「お待たせしましたー……」	PRINTFORMW 「让您久等了……」
PRINTFORMW 「%TEXTR("すみません、遅れちゃいました……/わ、みんなもう来てるんですね")%」	PRINTFORMW 「%TEXTR("对不起，我迟到了……/哇，大家都来了。")%」
PRINTFORMW 「失礼しまーす……」	PRINTFORMW 「失礼了……」
PRINTFORMW 『せ、先生！　お、お疲れさまです……』	PRINTFORMW 『老，老师！啊，真是个疲倦的大人……』
PRINTFORMW 『あ、お、遅かったですね？』	PRINTFORMW 『啊，太迟了吧？』
PRINTFORMW 『あ……ど、どうも』	PRINTFORMW 『啊……不过呢，谢谢』
PRINTFORMW 「おまたせしましたー！　どうぞ！」	PRINTFORMW 「让您久等了！请！」
PRINTFORM 珍しく自信有りげな%CALLNAME:ARG%が差し出した弁当は、	PRINTFORM 难得有自信的%CALLNAME:ARG%把便当递了过来，
PRINTFORMW 蓋を開けると、中から沢山のおにぎりと色とりどりのおかずが、ほのかな香りを漂わせる。	PRINTFORMW 打开盖子，里面有很多饭团和各种各样的菜，散发着淡淡的香味。
PRINTFORMW 唐揚げ、ハンバーグ、だし巻き卵、ナポリタン、エビフライ、アスパラ巻き、ピーマンの肉詰め……	PRINTFORMW 唐油煎包、汉堡肉、高汤卷、那不勒斯汤、炸虾、芦笋卷、青椒肉……
PRINTFORMW 量も種類も、明らかに手間がかかっているお弁当だった	PRINTFORMW 无论是数量还是种类，都明显是费时费力做出的便当。
PRINTFORMW 「いえ、別に大したことはないですよ。お父さんのお弁当を作るついでだし」	PRINTFORMW 「不，没什么大不了的。顺便给父亲做个便签」
PRINTFORMW 「%CNAMET(ARG, "二人称")%も育ち盛りなわけですし、そのぅ……イロイロと大変だから、沢山食べるのかなって思って」	PRINTFORMW 「%CNAMET(ARG, "二人称")%也正处于成长时期，那个……因为胃口也变大了，所以想要吃很多」
PRINTFORMW 「あっ、口に合わなかったり多かったりしたら、全然残してくれて構わないですよ！」	PRINTFORMW 「啊，如果不合口味或太多的话，全部留下也没关系哦！！！」
PRINTFORMW 「%CNAMET(ARG, "二人称")%の見た目を考えると、やっぱりちょっと多い気はしてましたから……」	PRINTFORMW 「一看到%CNAMET(ARG, "二人称")%的外表，果然还是觉得有点多……」
PRINTFORMW %CALLNAME:ARG%はそう言うが、%CALLNAME:MASTER%の箸は止まることはなかった。	PRINTFORMW %CALLNAME:ARG%虽然这么说，%CALLNAME:MASTER%的筷子也没有停过。
PRINTFORMW とても可愛らしいものだった。	PRINTFORMW 非常可爱。
PRINTFORMW 一口サイズのサンドイッチをメインに、花形の卵焼きやドーナツ型のハンバーグ、	PRINTFORMW 以一口大小的三明治为主，花型的煎鸡蛋和甜甜圈型的汉堡肉
PRINTFORMW 飾り切りのりんごやウインナーなど、すべてのおかずが普段と違った姿を見せる。	PRINTFORMW 苹果、香肠等所有菜肴都与平时不同。
PRINTFORMW 「えへへ……私、お料理にはちょっとだけ自信があるんですよ」	PRINTFORMW 「诶嘿嘿……我对料理还是有一点自信的。」
PRINTFORMW 「こういうお弁当持ってれば、女の子から声をかけられやすいかなーって……」	PRINTFORMW 「如果带着这样的便当的话，会不会容易被女孩子搭话呢……」
PRINTFORMW 「って、そんなのどうでもいいですよね！　ほら、さっさと食べちゃってください！」	PRINTFORMW 「这样子怎么样都无所谓吧！喂，快点吃掉吧！」
PRINTFORMW 下心を誤魔化す%CALLNAME:ARG%に呆れながらも、%CALLNAME:MASTER%は至福のひとときを過ごした。	PRINTFORMW 虽然被欺骗的%CALLNAME:ARG%惊呆了，但%CALLNAME:MASTER%却度过了最幸福的时光。
PRINTFORMW 「お待たせしました、%CNAMET(ARG, "二人称")%！」	PRINTFORMW 「让您久等了，%CNAMET(ARG, "二人称")%！」
PRINTFORMW %CALLNAME:ARG%の持ってきた弁当は、今日も手間がかかっているものだった。	PRINTFORMW %CALLNAME:ARG%带来的便当，看起来今天也花了不少功夫呢。
PRINTFORMW 例によって凝った弁当を見て、いつも大変じゃないかと聞いてみた。	PRINTFORMW 看了看那精致的便当，我问了她是否很辛苦。
PRINTFORMW 「いえ、別に？」	PRINTFORMW 「不，没什么？」
PRINTFORMW ……何も取り繕う物のない、素の発言だった。	PRINTFORMW ……是毫无掩饰的，纯粹的发言。
PRINTFORML 「あっ、えっと、%NAME:TARGET%です！　よよ、よろしくお願いします！」	PRINTFORML 「啊，什么？是%NAME:TARGET%啊！哟哟，拜托了！」
PRINTFORML 部屋に入るなりぼーっとしていたかと思えば、%CALLNAME:TARGET%は慌てて我に返り頭を下げた。	PRINTFORML 从刚一进入房间就开始发呆，%CALLNAME:TARGET%慌忙回过神来低下了头。
PRINTFORML 「あ……っつい……」	PRINTFORML 「好……热啊……」
PRINTFORML %CALLNAME:TARGET%は天井を仰ぎながら汗を拭っている。	PRINTFORML %CALLNAME:TARGET%一边仰望天花板一边擦着汗
PRINTFORML %CALLNAME:TARGET%はタオルで顔の汗を拭いている	PRINTFORML %CALLNAME:TARGET%在用毛巾擦脸上的汗
PRINTFORML ……ように見せかけて、他の人の姿をひっそり覗いているようだ。	PRINTFORML ……似乎是在假装，悄悄地窥视着别人的身影。
PRINTFORML 「あ……%CNAME("二人称")%……♪」	PRINTFORML 「啊……%CNAME("二人称")%……♪」
PRINTFORML %CALLNAME:TARGET%は寝惚けた様子で%CALLNAME:MASTER%に抱きついた。	PRINTFORML %CALLNAME:TARGET%睡眼松弛地抱住了%CALLNAME:MASTER%。
PRINTFORML 「う～ん……%CNAME("二人称", "かな")%？　いま何時です？」	PRINTFORML 「嗯~……%CNAME("二人称", "かな")%？　现在是几点？」
PRINTFORML 目の前の%CALLNAME:MASTER%の姿に気付きながら、%CALLNAME:TARGET%は暢気に欠伸をしている。	PRINTFORML 注意到眼前%CALLNAME:MASTER%身影的同时、%CALLNAME:TARGET%正在畅快的打着哈欠。
PRINTFORML 「あの、ごめんなさい。みっともないとこ見せちゃって……」	PRINTFORML 「对不起，对不起。让你看到了不好的地方……」
PRINTFORML %CALLNAME:TARGET%は涙を拭い、照れくさそうに笑っている。	PRINTFORML %CALLNAME:TARGET%擦去眼泪，羞涩地笑着。
PRINTFORML 「えへへ……」	PRINTFORML 「诶嘿嘿……」
PRINTFORML %CALLNAME:TARGET%はベッドに腰掛けてもじもじしながら、嬉しそうな顔をしている。	PRINTFORML %CALLNAME:TARGET%坐在地板上扭扭捏捏的同时，脸上带着一副高兴的表情。
PRINTFORML 「お、お邪魔し、します……」	PRINTFORML 「打扰了，打扰了……」
PRINTFORML 男性の部屋に連れ込まれたことを意識しているのか、%CALLNAME:TARGET%はやや腰が引けている……	PRINTFORML 可能是意识到自己被带进了男性的房间，%CALLNAME:TARGET%的腰有点弯……
PRINTFORML 「あの、す、座っても大丈夫です？」	PRINTFORML 「嗯，可以坐吗？」
PRINTFORML %CALLNAME:TARGET%はそわそわしていて落ち着きがない……	PRINTFORML %CALLNAME:TARGET%心浮气躁……
PRINTFORML 「えっと、適当に座ってもらって大丈夫ですので」	PRINTFORML 「嗯，随便坐一下没关系。」
PRINTFORML %CALLNAME:TARGET%は%CALLNAME:MASTER%の動向を気にしているようだ。	PRINTFORML %CALLNAME:TARGET%似乎很在意%CALLNAME:MASTER%的动向。
PRINTFORML 「あっ、今日はお二人ですか？」	PRINTFORML 「啊，今天两位吗？」
PRINTFORML %CALLNAME:TARGET%は%CALLNAME:MASTER%達を笑顔で迎えた。	PRINTFORML %CALLNAME:TARGET%笑着迎接%CALLNAME:MASTER%们。
PRINTFORML 「へっ？　な、な、なんですかっ？」	PRINTFORML 「诶？什么，什么？为什么要这样？」
PRINTFORML 突然の来訪者達に%CALLNAME:TARGET%は面食らっている。	PRINTFORML 对于突然来访的客人，%CALLNAME:TARGET%感到不知所措。
PRINTFORML 「あ……いらっしゃい、%CNAME("二人称")%」	PRINTFORML 「啊……欢迎光临、%CNAME("二人称")%」
PRINTFORML %CALLNAME:TARGET%は%CALLNAME:MASTER%にはにかんだ笑顔を見せた。	PRINTFORML %CALLNAME:TARGET%对%CALLNAME:MASTER%露出了羞涩的笑容。
PRINTFORML 「へぇッ！？　ちょちょ、ちょっと待ってください！」	PRINTFORML 「诶！？等，等等！请等一下！」
PRINTFORML %CALLNAME:TARGET%は突然の来訪者に慌て、部屋中に視線を飛ばした。	PRINTFORML %CALLNAME:TARGET%对突然来访的客人感到惊慌，将视线投向整个房间。
PRINTFORML ……特に、ベッドや本棚の方を気にしていたような気がする……	PRINTFORML ……特别是看向地板和书架……
PRINTFORML 「%TEXTR("わわっ、/へっ？/")%も、もしかして見ましたっ？」	PRINTFORML 「%TEXTR("哇，/诶？/")%难道你看到了吗？」
PRINTFORML 「ふふっ……待ちましたか？　%CNAME("二人称")%」	PRINTFORML 「呼……等了吗？　%CNAME("二人称")%」
PRINTFORML 「うう……ここに来るまですっごくドキドキしました……」	PRINTFORML 「嗯……我来到这里之前就非常激动……」
PRINTFORML 「こうして呼び出されるのも、なんだか興奮しますね」	PRINTFORML 「被这样叫出来，总觉得很兴奋呢。」
PRINTFORML 「さっきまでクラスのみんなと普通に過ごしてたのに……ふふっ」	PRINTFORML 「刚才还和班上的同学一起过着普通的生活……呼」
PRINTFORML 「あの……き、来ました……」	PRINTFORML 「那个……来，来了……」
PRINTFORML どうやらガチガチに緊張しているようだ……	PRINTFORML 好像紧张得要命……
PRINTFORML 「家で普段なにをしてるかですか？　……その、パソコンでゲームしたり、映画見たりとか……」	PRINTFORML 「你平时在家做什么吗？……那个，用电脑玩游戏，看电影什么的……」
PRINTFORML 何故か%CALLNAME:TARGET%の目は泳ぎ、言葉も歯切れが悪い……	PRINTFORML 不知道为什么%CALLNAME:TARGET%的眼睛游离不定，说话也不利索……
PRINTFORML 「じょ、女性のどこが好きか？　もちろん可愛いから……え、もっと細かく？」	PRINTFORML 「你喜欢女性的哪里吗？当然是因为可爱……诶，再仔细一点？」
PRINTFORML 「……き、気持ちよくなってるときに弓なりになってる姿とか～」	PRINTFORML 「……来，心情变好的时候变成弓的身姿啦~」
PRINTFORML 「……やっぱダメです。勘弁してください……」	PRINTFORML 「……果然不行……请原谅我……」
PRINTFORML %CALLNAME:TARGET%は冷蔵庫の中身を真剣な顔で確認している。	PRINTFORML %CALLNAME:TARGET%用认真的表情确认着冰箱里的东西。
PRINTFORML 「……%TEXTR("あっ/んっ/えっ")%、%TEXTR("ちょ/この/あれ")%……」	PRINTFORML 「……%TEXTR("啊/什么/什么")%、%TEXTR("等等/这个/那个")%……」
PRINTFORML %CALLNAME:TARGET%はゲームに没頭しているようだ。	PRINTFORML %CALLNAME:TARGET%似乎在沉迷于游戏。
PRINTFORML %CALLNAME:TARGET%はスマホに集中している。	PRINTFORML %CALLNAME:TARGET%注意力集中在手机上。
PRINTFORML ……たまに、にやっとした笑いを抑えているのが気になる……	PRINTFORML ……偶尔，我很在意自己，终于控制住了笑容……
PRINTFORML 美女の集う空間を満喫しているのか、%CALLNAME:TARGET%の顔は綻んでいる……	PRINTFORML 也许是在享受美女云集的空间，%CALLNAME:TARGET%的脸上绽放着微笑……
PRINTFORM %CALLNAME:TARGET%はスマホを弄りながらチラチラと	PRINTFORM %CALLNAME:TARGET%一边玩手机一边瞥了一眼
PRINTFORML 他の人を見ている。	PRINTFORML 看着别人。
PRINTFORML %CALLNAME:FIND_COND("現在存在")%を見ている。	PRINTFORML 看%CALLNAME:FIND_COND("現在存在")%。
PRINTFORML %CALLNAME:MASTER%を見ている。	PRINTFORML 看着%CALLNAME:MASTER%
PRINTFORML %CALLNAME:TARGET%は教科書を開いて予習をしている。	PRINTFORML %CALLNAME:TARGET%打开教科书预习着。
PRINTFORML ……が、他人の姿が気になって集中できていないようだ。	PRINTFORML ……但是，好像是因为在意别人的样子而无法集中注意力。
PRINTFORML ……が、%CALLNAME:MASTER%の姿が気になって集中できていないようだ。	PRINTFORML ……但是，好像很在意%CALLNAME:MASTER%的样子而无法集中注意力。
PRINTFORML 「%TEXTR("すぅ/んぅ/むぅ")%……」	PRINTFORML 「%TEXTR("嗯……/嗯……")%……」
PRINTFORML 「えへへ……%TEXTR("せんせぇ/せんぱい")%……」	PRINTFORML 「嘿嘿……%TEXTR("老师/前輩")%……」
PRINTFORML ……誰かの艶姿の夢を見ているようだ。	PRINTFORML ……好像在梦见谁的艳姿。
PRINTFORML 「ん……んんっ……」	PRINTFORML 「我……嗯……」
PRINTFORML %CALLNAME:TARGET%は手を股に挟んで、切ない声を漏らしている。	PRINTFORML %CALLNAME:TARGET%夹着一只手，发出难过的声音。
PRINTFORMW 『わかりました。待っててくださいね♪』	PRINTFORMW 『我明白了,等着吧！』
PRINTFORMW %CALLNAME:MASTER%の誘いを待ちかねていたのか、嬉しそうな声をしていた……	PRINTFORMW 可能是等不敌%CALLNAME:MASTER%的邀请，发出了高兴的声音……
PRINTFORMW 『い、今からですかっ？』	PRINTFORMW 『嗯，从现在开始可以吗？』
PRINTFORMW 『……わかりました。すぐに行きますから……』	PRINTFORMW 『……我明白了。我马上就去……』
PRINTFORMW 『すぐ行きますね』	PRINTFORMW 『马上就去吧』
PRINTFORMW 一言そう告げると、通話はあっさりと切れた。	PRINTFORMW 只说了一句，通话就轻松结束了。
PRINTFORMW 『えっ……あ、その……』	PRINTFORMW 『诶……啊，那个……』
PRINTFORMW 『……ちょっとだけ、待っててください』	PRINTFORMW 『……稍微等一下。い』
GREETING = こんばんは	GREETING = 晚上好！
GREETING = こんにちは	GREETING = 你好！
GREETING = おはようございます	GREETING = 早上好
PRINTFORMW 「はい、%GREETING%♪」	PRINTFORMW 「是、%GREETING%♪」
PRINTFORMW 「は、はい……%GREETING%」	PRINTFORMW 「在，是……%GREETING%」
PRINTFORMW 「はっ、はい！　%GREETING%！」	PRINTFORMW 「啊！是！　%GREETING%！」
PRINTFORMW 「%GREETING%、%CNAME("二人称")%♪」	PRINTFORMW 「%GREETING%、%CNAME("二人称")%♪」
PRINTFORMW 「その……%GREETING%、%CNAME("二人称")%」	PRINTFORMW 「那个……%GREETING%、%CNAME("二人称")%」
PRINTFORMW 「え、えっと、%CNAME("二人称")%！　%GREETING%！」	PRINTFORMW 「啊，什么？%CNAME("二人称")%！　%GREETING%！」
PRINTFORMW 「ふっへへへ、%CNAME("二人称", "かな")%～」	PRINTFORMW 「呵呵，%CNAME("二人称", "かな")%～」
PRINTFORMW %CALLNAME:TARGET%は顔を真っ赤にして少女らしからぬ笑い声で迫り、%CALLNAME:MASTER%の背後から抱きつき胸を触ってきた！	PRINTFORMW %CALLNAME:TARGET%的脸涨得通红，少女们笑着慢慢接近，从%CALLNAME:MASTER%的背后抓住了胸部开始揉了起来。
PRINTFORMW 「あぁ～この大きさ、たまらないですねぇ……えへへへへ……」	PRINTFORMW 「啊~这个尺寸~嘿嘿嘿，不得了啊~」
PRINTFORMW 「ん～、可愛らしいんだからもぉ……んっふふふ……」	PRINTFORMW 「嗯~因为很可爱啊~呵呵……」
PRINTFORMW が、そこで力尽きたのか、腕をだらんと落として寝息を立てはじめた。	PRINTFORMW 但是，她好像筋疲力尽了，垂下胳膊，开始喘息。
PRINTFORMW 「あ、ダメ。もうダメです私。はははははははは」	PRINTFORMW 「啊，不行。我已经不行了。哈哈哈哈哈哈哈哈」
PRINTFORMW 見るからに限界な%CALLNAME:TARGET%は乾いた笑いと共にその場に突っ伏した。	PRINTFORMW 看着忍耐到极限的%CALLNAME:TARGET%，伴着干涩的笑声，趴在了地上。
PRINTFORMW %CALLNAME:MASTER%は呆れながらも%CALLNAME:TARGET%を部屋まで運んだ……	PRINTFORMW %CALLNAME:MASTER%无可奈何地把%CALLNAME:TARGET%搬回到房间里……
PRINTFORMW 「%TEXTR("え、えへへ……ありがとうございます/べ、別にそんな大したことは……")%」	PRINTFORMW 「%TEXTR("诶，诶……谢谢你/别没什么了不起的……")%」
PRINTFORMW %CALLNAME:TARGET%は%TEXTR("褒められるのに慣れてないようだ/照れているが、嬉しそうだ")%	PRINTFORMW %CALLNAME:TARGET% %TEXTR("不习惯被夸奖/虽然害羞,但看起来很开心")%
PRINTFORMW 「も、もう……%CNAME("二人称")%……♪」	PRINTFORMW 「也，已经……%CNAME("二人称")%……♪」
PRINTFORMW 「な、なに言ってるんですか、もうっ」	PRINTFORMW 「你在说什么呢？」
PRINTFORMW 「はぁ……お上手ですね、%CNAME("二人称")%」	PRINTFORMW 「啊……您请啊，%CNAME("二人称")%」
PRINTFORMW 「というか%CNAME("二人称")%。%CNAME("一人称")%、気付いてしまったんですけど」	PRINTFORMW 「%CNAME("第二人称")%注意到%CNAME("第一人称")%了」
PRINTFORMW 「%CNAME("一人称")%のプロフィール、他の部員の方に比べて酷くありません？」	PRINTFORMW 「%CNAME("第一人称")%的简介，没有比其他部员更厉害吗？」
PRINTFORMW 「なんですか廊下でオナバレした竿付き女子高生って。意味わかんないんですけど」	PRINTFORMW 「在走廊上，女高中生的手淫暴露了。我不知道这是什么意思」
PRINTFORM 「それに比べて	PRINTFORM 「相比之下
PRINTFORMW %CALLNAME:ACTOR%先輩なんて、悪魔でメイドなんていう如何にも人気出そうなキャラなのに！」	PRINTFORMW 「%CALLNAME:ACTOR%前辈，明明是恶魔和女仆的人气角色啊！」
PRINTFORMW %CALLNAME:ACTOR%先輩なんて、黒髪ロングの狐っ娘お姉さんじゃないですか！　日本人にド刺さりしてんですよ！」	PRINTFORMW 「%CALLNAME:ACTOR%前辈，不是黑长直的狐娘大姐吗！对日本人来说是致命的啊！」
PRINTFORMW %CALLNAME:ACTOR%先輩を見てくださいよ、あのモノホンの天才魔道士を！　絶対レイブンクローですよ！」	PRINTFORMW 「%CALLNAME:ACTOR%前辈请看，那个东西的天才魔道士！绝对是流水线哦！」
PRINTFORMW %CALLNAME:ACTOR%先生を見てくださいよ！　エッチな保健室の先生が自分の通う学校に実在してるんですよ！」	PRINTFORMW 「%CALLNAME:ACTOR%大师请看看！色情的保健室的老医生在自己上的学校实际存在哟！」
PRINTFORMW %CALLNAME:ACTOR%ちゃんはロリババアの蛇神様ですって？　どこで攫ってきたんですか%CNAME("二人称")%！」	PRINTFORMW 「什么？%CALLNAME:ACTOR%酱是萝莉老太婆的蛇神？　你在哪拐走的%CNAME("二人称")%！」
PRINTFORMW %CALLNAME:ACTOR%ちゃんなんて本当にかわいい妹で……ズルいですよ%CNAME("二人称")%！　%CNAME("一人称")%の妹になってほしいくらいです！　同い年だけど！」	PRINTFORMW 「%CALLNAME:ACTOR%酱真是个可爱的妹妹……%CNAME("第二人称")% ！甚至想成为%CNAME("第一人称")%的妹妹！虽然是同年！」
PRINTFORMW %CALLNAME:ACTOR%ちゃんとか……ほぼほぼワンちゃんじゃないですか！　ペットなんてお母さん許しませんよ！」	PRINTFORMW 「%CALLNAME:ACTOR%酱啦……几乎都是汪酱！宠物妈妈桑不会原谅的！」
PRINTFORMW %CALLNAME:ACTOR%先輩なんてあんな破廉恥な娘で、しかも鬼ですって？　なーんて野蛮だこと！」	PRINTFORMW 「%CALLNAME:ACTOR%前辈是那种不知廉耻的姑娘，而且还是鬼？什么野蛮的事！」
PRINTFORMW %CALLNAME:ACTOR%先輩なんて大変です！　ヤリサー所属のシスターとかタダじゃ済まないですよ！」	PRINTFORMW 「%CALLNAME:ACTOR%前辈们真是不得了！yariser所属的修女啦免费的哟！」
PRINTFORMW %CALLNAME:ACTOR%先生とかどういうことですか！　あんな情熱を秘めた肉体の持ち主がお母さんですって！？　嘘だっ！　%CNAME("二人称")%流の強がりだ！」	PRINTFORMW 「%CALLNAME:ACTOR%老师什么意思！　隐藏那样热情的肉体的主人是母亲桑！？　骗人的吧！　%CNAME("二人称")%是个逞强的人！」
PRINTFORMW %CALLNAME:ACTOR%先生なんて精霊という名の淫魔じゃないですか！　図書室では静かにしなさい！」	PRINTFORMW 「%CALLNAME:ACTOR%老师这不是叫精灵的淫魔吗？！　图书室里要安静！」
PRINTFORMW %CALLNAME:ACTOR%先輩なんて%CNAME("一人称")%と同じ竿持ちなのに、絵に描いたような文武両道の委員長で……%CNAME("一人称")%の立つ瀬が無いんですけど！」	PRINTFORMW 「%CALLNAME:ACTOR%前輩，和%CNAME("一人称")%一样地竿持者、像画一般的文武两道的委员长……%CNAME("一人称")%没有立足之地！」
PRINTFORMW %CALLNAME:ACTOR%先輩は猫娘ですってェ？　まさに王道を征く属性の持ち主が発情期にニャンニャン……」	PRINTFORMW 「%CALLNAME:ACTOR%前輩你是猫娘吗？正是征王道属性的主人在发情期喵喵……」
PRINTFORMW %CALLNAME:ACTOR%先輩は元オトコの吸血鬼ですよ？　これがどれだけ危険な需要の持ち主かって……もう劇薬ですよ！」	PRINTFORMW 「%CALLNAME:ACTOR%前輩你是吸血鬼吗？这是多么危险的需求啊……已经是剧毒了！」
PRINTFORMW %CALLNAME:ACTOR%ちゃんは言葉の通じない魔界人ですよ？　大丈夫ですか%CNAME("二人称")%？　間違った異文化教え込んでませんか%CNAME("二人称")%？　国際問題ですよ%CNAME("二人称")%？」	PRINTFORMW 「%CALLNAME:ACTOR%酱，是语言不通的魔界人哦？没关系吗%CNAME("二人称")%？错误的异文化教育吗%CNAME("二人称")%？是国际问题？%CNAME("二人称")%？」
PRINTFORMW %CALLNAME:ACTOR%先輩はえーっと、旧友？　幼馴染？　らしいじゃないですか。その、良いんですか%CNAME("二人称")%！　心痛みませんか%CNAME("二人称")%！」	PRINTFORMW 「%CALLNAME:ACTOR%前輩，嗯，老朋友？青梅竹马？好像不是吗？那个，好吗%CNAME("二人称")%！没有痛心吗！%CNAME("二人称")%！」
PRINTFORMW %CALLNAME:ACTOR%ちゃんなんて学校の備品なのに！　いい歳こいて人形遊びたぁとんだ不良生徒ですね、ええ？　なんて呼ばせてんだ自分のことぉ！」	PRINTFORMW 「%CALLNAME:ACTOR%酱明明是学校的必备品！好娃娃玩耍的不良学生ぁとんだ，嗯？　什么叫我叫我自己啊！」
PRINTFORMW %CALLNAME:ACTOR%先生なんて、あんな、あんな無防備な人妻……だ、だめです。ヤバすぎて立てません……！」	PRINTFORMW 「%CALLNAME:ACTOR%老师,那种，那种毫无防备的人妻……不行，不行。太糟糕了站不起来……！」
PRINTFORMW %CALLNAME:ACTOR%さんなんて、あんな、あんな、胸……あは、あはははは！　今までどーやって処女守ってきたんですか！」	PRINTFORMW 「%CALLNAME:ACTOR%桑什么，那种，那种，胸……啊哈哈，哈哈哈！一直以来都是处女守护吗！」
PRINTFORMW %CALLNAME:ACTOR%先輩は良いですよねぇ……小柄だけど凛々しくて、面白い人で……ええ、正直好みですよ！　悪いですか！」	PRINTFORMW 「%CALLNAME:ACTOR%前輩很好啊……虽然娇小，但很严肃，是个有趣的人……嗯，说实话我很喜欢。不好吗！」
PRINTFORMW %CALLNAME:ACTOR%先輩は凄いですよね……見た目以上に色気があって、まさにセンシティブな人で……誤用してる？　知りませんよ！」	PRINTFORMW 「%CALLNAME:ACTOR%前輩好厉害啊……比外表更有魅力，简直是性感的人……误用了吗？我不知道！」
PRINTFORMW %CALLNAME:ACTOR%さんは良い意味のギャップというものをわかっていらっしゃる！　さすがにドラゴンは格が違った！」	PRINTFORMW 「%CALLNAME:ACTOR%桑我知道什么是好的反差！不愧是龙的样子，就是不一样！！」
PRINTFORMW %CALLNAME:ACTOR%先輩なんて、ほら、ほうおうちょうたいまとくむしっこう……TYPE-M○○Nかよ！　なんぼガチャ注ぎ込んだら出るんですかこの☆5聖女様はぁ！」	PRINTFORMW 「%CALLNAME:ACTOR%前輩什么啊，看，你的家庭情况……TYPE-M〇〇N吗！注入了这么多的水之后会出来吗？这个~ 5圣女啊！」
PRINTFORMW %CALLNAME:ACTOR%先輩なんて……ほら、なんていうかその、本物ですよね。比較するとますます%CNAME("一人称")%がちっぽけに見えますよ。ははは……」	PRINTFORMW 「%CALLNAME:ACTOR%前輩什么……看，怎么说呢，那是真的吧。相比之下，%CNAME("一人称")%显得越来越小，哈哈哈……」
PRINTFORMW %CALLNAME:ACTOR%くんなんて、ウチのクラスでも大評判の彼が、堕天使で、この部活に入っていて……おお、なんと罪深いことか！」	PRINTFORMW 「%CALLNAME:ACTOR%君在我们班也大受好评的他，就是堕天使，加入了这个社团。啊，多么罪孽深重啊！」
PRINTFORMW %CALLNAME:ACTOR%ちゃんは学園の平和を守る裏でエッチな魔力補充を……あれれー？　前にそんなゲーム遊んだ気がするぞぉ？　あはははは」	PRINTFORMW 「%CALLNAME:ACTOR%酱在守护学园和平的背后补充色情的魔力……你——？之前好像玩过那样的游戏吧？哈哈哈哈哈哈」
PRINTFORMW %CALLNAME:ACTOR%先輩は新鮮ですよ。あのような口調の雪女さんにお目にかかれるなんて……そもそも普通会えませんけどね！　全くこの部活はおかしいなぁ！」	PRINTFORMW 「%CALLNAME:ACTOR%前輩很新鲜哦。雪女桑的语气是那样的……本来就不能见面呢！这个社团真奇怪啊！」
PRINTFORMW %CALLNAME:ACTOR%先輩とか普通に強キャラじゃないですか。どうやってゲットしたんですか%CNAME("二人称")%。しかも博多弁て！」	PRINTFORMW 「%CALLNAME:ACTOR%前輩不是一般的强角色吗？怎么拿到的%CNAME("二人称")%。而且还会说博多方言诶！」
PRINTFORMW %CALLNAME:ACTOR%さんなんてお貴族様で美人で聡明でエッチで優しくて――」	PRINTFORMW 「%CALLNAME:ACTOR%桑多么像贵族啊，又漂亮又聪明，又性感又温柔……」
PRINTFORMW ｯｽｰｰｰｰ……	PRINTFORMW ……
PRINTFORMW 「勝てるわけないだろーーーーッ！！」	PRINTFORMW 「怎么可能赢呢！ ！！」
PRINTFORMW %CALLNAME:ACTOR%先輩は猫耳生えちゃった系少女ですよ。%CNAME("一人称")%だったら文字通り猫可愛がりしますね！　少なくともちんちん生やして自慰に耽る娘よりは断然可愛いでしょうよ！」	PRINTFORMW 「%CALLNAME:ACTOR%前辈是长着猫耳朵系的美少女哟！%CNAME("一人称")%就像文字一样的猫，很可爱呢！至少那些抠着小嘴自慰的姑娘可爱多了吧！」
PRINTFORMW %CALLNAME:ACTOR%ちゃんは……%CALLNAME:ACTOR%ちゃんは……」	PRINTFORMW 「%CALLNAME:ACTOR%酱……%CALLNAME:ACTOR%酱……」
PRINTFORMW %CALLNAME:TARGET%は突然%CALLNAME:MASTER%の肩を掴み、真剣な顔をした。	PRINTFORMW %CALLNAME:TARGET%突然抓住%CALLNAME:MASTER%的肩膀，露出认真的表情
PRINTFORMW 「……何かあったら%CNAME("一人称")%一人で逃げますんで、そこんとこよろしく」	PRINTFORMW 「……如果有什么事，%CNAME("第一人称")%一个人逃走，请多关照」
PRINTFORMW %CALLNAME:ACTOR%先輩とかホントに凄いじゃないですか。魅力的というか意欲的というか……ちょっとあのノリはついていけませんけど……でも良いカラダしてるんだよなぁ……」	PRINTFORMW 「%CALLNAME:ACTOR%前輩什么的真的很厉害不是吗？是有魅力还是热情呢……虽然有点跟不上那个节奏……但是身材很好啊……」
PRINTFORMW %CALLNAME:ACTOR%先輩ですよ……はぁ……まさか年下狩りの先輩が実在したなんて……なんで男に生まれなかったんだ%CNAME("一人称")%は……」	PRINTFORMW 「%CALLNAME:ACTOR%前輩是啊……啊……难道真的存在捕猎年下的前辈……为什么不是男人？%CNAME("一人称")%啊……」
PRINTFORMW %CALLNAME:ACTOR%先輩ですよ……%CNAME("一人称")%より小柄なのに、落ち着いた素敵な女性じゃないですか。見れば見るほど自分が情けなくなってくるんですけど！」	PRINTFORMW 「%CALLNAME:ACTOR%前輩,是啊……是比%CNAME("一人称")%小只的，沉着的极好的女性不是吗。越看越觉得自己无情！」
PRINTFORMW %CALLNAME:ACTOR%ちゃんはもう……良いですよね、マジで……%CNAME("二人称")%の前で言うのも失礼ですけど……%CNAME("一人称")%だったら耐えられなくなって……んっふふ」	PRINTFORMW 「%CALLNAME:ACTOR%酱，苍蝇……好吧。真的……在%CNAME("二人称")%的面前说也很失礼……%CNAME("一人称")%就受不了了。豆腐豆腐」
PRINTFORMW ……酷く酔っているようだ。	PRINTFORMW ……好像醉得很厉害。
PRINTFORMW 「困った事にクラスの女の子と話が合わないんですよね……」	PRINTFORMW 「让人困扰的是，和班里的女生说话时，我会不合拍啊……」
PRINTFORMW 「それどころか、聞こえてくる男子の会話に内心頷いちゃう自分がいて」	PRINTFORMW 「不仅如此，我内心也会对男生的对话点头。」
PRINTFORMW 「我ながらちょっとショックです……」	PRINTFORMW 「我也觉得有点震惊……」
PRINTFORMW 「ここ最近は寝不足なんですよね……ゲームとかばっかりしてて」	PRINTFORMW 「最近睡眠不足吧……大概是玩游戏的原因。」
PRINTFORMW 「え、なんのゲームをしてるかですか？」	PRINTFORMW 「诶，在玩什么游戏吗？」
PRINTFORMW 「……ま、マ○オとか、ゼ○ダとか……」	PRINTFORMW 「……啊，马〇o啦，z〇da啦……」
PRINTFORMW 無難なタイトルで誤魔化しているのがありありと伝わってくる……	PRINTFORMW 用无可非议的标题误导的事情历历在目……
PRINTFORMW 「私も悪魔に魂を売り渡せば、%CNAME("二人称")%みたいにモテますか？」	PRINTFORMW 「如果我把我的灵魂卖给恶魔的话，也会像%CNAME("二人称")%一样受欢迎吗？」
PRINTFORMW 冗談めいた言葉に曖昧な答えを返すと、%CALLNAME:TARGET%はいきなり立ち上がった。	PRINTFORMW 当我对这一句玩笑话的回答含糊不清时，%CALLNAME:TARGET%站了起来。
PRINTFORMW ホンキだ……！！	PRINTFORMW 真棒……！ ！
PRINTFORMW %CALLNAME:MASTER%は慌てて%CALLNAME:TARGET%を止めた。	PRINTFORMW %CALLNAME:MASTER%慌忙地制止了%CALLNAME:TARGET%。
PRINTFORMW %CALLNAME:TARGET%は体を楽にし、されるがままになっている。	PRINTFORMW %CALLNAME:TARGET%保持身体舒适,任凭摆布。
PRINTFORMW 「その……好きなようにしてください。乱暴でなければ平気ですから」	PRINTFORMW 「那个……请按照喜欢的方式做。只要不粗鲁就没关系。」
PRINTFORMW %CALLNAME:MASTER%は彼女の提案を受け入れた……	PRINTFORMW %CALLNAME:MASTER%接受了她的建议……
PRINTFORMW 体を強張らせる%CALLNAME:TARGET%のことが気になり、%CALLNAME:MASTER%は肩の力を抜くよう伝えた。	PRINTFORMW 注意到了身体强壮的%CALLNAME:TARGET%，%CALLNAME:MASTER%跟她说要放松肩膀。
PRINTFORMW 「あっ……す、すみません」	PRINTFORMW 「啊……对不起，对不起。」
PRINTFORMW %CALLNAME:TARGET%はどうしても男性に触れられていることを意識してしまい、硬くなったままだ……	PRINTFORMW %CALLNAME:TARGET%无论如何也会意识到被男性触碰，一直保持着僵硬的状态……
PRINTFORMW %CALLNAME:TARGET%は鼓動の高鳴りを抑えきれない……	PRINTFORMW %CALLNAME:TARGET%心跳无法控制地狂跳不止
PRINTFORMW %CALLNAME:TARGET%は含みのある笑みを見せただけで、特に何も言わなかった。	PRINTFORMW %CALLNAME:TARGET%只是露出含蓄的笑容，并没有多说什么。
PRINTFORMW %CALLNAME:TARGET%は困ったような表情を見せたが、特に何も言わなかった。	PRINTFORMW %CALLNAME:TARGET%她露出为难的表情，但没有说什么。
PRINTFORMW 「あ、%CNAME("二人称")%。お湯いただきました」	PRINTFORMW 「啊，%CNAME("二人称")%。热水开了。」
PRINTFORMW %CALLNAME:TARGET%はシャンプーの爽やかな香りを漂わせながら、こちらに笑みを向けた。	PRINTFORMW %CALLNAME:TARGET%在散发着洗发水的清爽香味的同时，将笑容转向这边。
PRINTFORMW 「あ、ど、どうもっ。いただいてますっ」	PRINTFORMW 「啊，怎么了？您收下了吗？」
PRINTFORMW 湯上がりの%CALLNAME:TARGET%の顔は茹で上がったように真っ赤だった……	PRINTFORMW 浴后%CALLNAME:TARGET%的脸像煮熟了一样通红……
PRINTFORMW 「どうですか、%CNAME("二人称")%？」	PRINTFORMW 「怎么样？%CNAME("二人称")%？」
PRINTFORMW 仄かに顔を赤らめた%CALLNAME:TARGET%は、%CALLNAME:MASTER%に向けて手を広げながら微笑んだ。	PRINTFORMW 隐约脸红的%CALLNAME:TARGET%向%CALLNAME:MASTER%微微一笑。
PRINTFORMW %CALLNAME:TARGET%は何も言わず手近な椅子に座り、真っ赤な顔を伏せて縮こまった。	PRINTFORMW %CALLNAME:TARGET%一言不发地坐在手边的椅子上，垂下通红的脸缩成一团。
PRINTFORMW 「お待たせしました、%CNAME("二人称")%♪」	PRINTFORMW 「让您久等了~%CNAME("二人称")%♪」
PRINTFORMW %CALLNAME:TARGET%の横に腰を下ろすと、%CALLNAME:MASTER%は蠱惑的な笑みを見せた。	PRINTFORMW 坐在%CALLNAME:TARGET%的旁边，%CALLNAME:MASTER%露出迷人的微笑。
PRINTFORMW 「こうしてると、そういうお店みたいですよね……」	PRINTFORMW 「这样做的话，好像是这样的店吧……」
PRINTFORMW 「……%TEXTR("全然似合ってないですよ、コレ/新手のイジメですかね")%」	PRINTFORMW 「……%TEXTR("完全不适合哟，是这个/新型的的作弄吗？")%」
PRINTFORMW 照れ隠しに僅かな悪態をつき、%CALLNAME:TARGET%は身を隠すように縮こまった。	PRINTFORMW 因为遮羞而稍微说了些恶语，%CALLNAME:TARGET%就像隐身一样缩成一团。
PRINTFORMW 「……いや、無理ですから。ほんと」	PRINTFORMW 「……不，我不去。真的」
PRINTFORMW 絞り出すような声で答え、%CALLNAME:TARGET%は目を逸らした。	PRINTFORMW 用咄咄逼人的声音回答，%CALLNAME:TARGET%移开了目光。
PRINTFORMW 「%TEXTR("……そんなに？/はぁ……")%」	PRINTFORMW 「%TEXTR("……那么？/啊……")%」
PRINTFORMW %CALLNAME:TARGET%は自分の体を見ながら考え込んでいる……	PRINTFORMW %CALLNAME:TARGET%看着自己的身体陷入沉思……
PRINTFORMW などと断っていた%CALLNAME:TARGET%も、気付けば既に酔っ払い始めていた……	PRINTFORMW 等拒绝了%CALLNAME:TARGET%但是，注意到已经醉酒了……
PRINTFORMW 「ダメっ、これ以上はホントにダメですっ」	PRINTFORMW 「不行，不能再这样下去了。」
PRINTFORMW 羞恥に堪えきれなくなり、%CALLNAME:TARGET%は飛び退いてしまった。	PRINTFORMW 忍受不了羞耻，%CALLNAME:TARGET%跳了下来。
PRINTFORMW 「だ、ダメダメ！　何やってるんですか！」	PRINTFORMW 「不，不行！你在干什么？」
PRINTFORMW %CALLNAME:TARGET%は慌ててスカートを抑え、%CALLNAME:MASTER%から遠ざかった。	PRINTFORMW %CALLNAME:TARGET%慌忙地把裙子压住，离%CALLNAME:MASTER%远点了。
PRINTFORMW 「あの、%TEXTR("どうですか/変じゃないですか")%……？」	PRINTFORMW 「那个，%TEXTR("怎么样？ /是不是很奇怪？")%……？」
PRINTFORMW 「もう……%CNAME("一人称")%のなんか見たって……」	PRINTFORMW 「啊……看%CNAME("一人称")%什么……」
PRINTFORMW %CALLNAME:MASTER%の視線に気付き、%CALLNAME:TARGET%は脚をもじもじさせている……	PRINTFORMW 注意到了%CALLNAME:MASTER%的视线，%CALLNAME:TARGET%扭捏着脚
PRINTFORMW 「あの……そんなに面白いものじゃないですから……」	PRINTFORMW 「那个……这样不是那么有趣的东西……」
PRINTFORMW 「ちょちょ、ちょ、ちょ……ちょ」	PRINTFORMW 「等、等、等……等」
PRINTFORMW 「ひゃあ！？　ななな、何を……！？」	PRINTFORMW 「呀！？什么的,什么……！？」
PRINTFORMW 「わわっ、いきなりはダメですって！」	PRINTFORMW 「哇，突然说不行！」
PRINTFORMW 「あっ、%TEXTR("ちょ/待っ/ダメ")%――」	PRINTFORMW 「啊，%TEXTR("等/等/不行")%――」
PRINTFORMW 「あの、%CNAME("二人称")%……今度の週末、暇だったりしません？」	PRINTFORMW 「那个，%CNAME("二人称")%……这个周末有空吗？」
PRINTFORMW 「ああ、良かった。それじゃあ週末、よろしくお願いしますね」	PRINTFORMW 「啊，太好了。那么周末就拜托你了。」
PRINTFORMW %CALLNAME:TARGET%は嬉しそうに鼻歌を歌っている……	PRINTFORMW %CALLNAME:TARGET%开心哼着小曲……
PRINTFORMW 「え、ほ、ほんとですかっ？」	PRINTFORMW 「诶，呵呵，真的很好？」
PRINTFORMW 「わわ、わかりました！　それじゃあの、よろしくお願いします！」	PRINTFORMW 「我明白了！那么那个，拜托了！」
PRINTFORMW 振り返った%CALLNAME:TARGET%が小さくガッツポーズするのが見えた。	PRINTFORMW 回过头的%CALLNAME:TARGET%，我看到她微微摆着姿势。
PRINTFORMW 「あうー……仕方ないですね。また都合の良いときがあったら教えてください」	PRINTFORMW 「……没办法啊。如果还有方便的时候请告诉我」
PRINTFORMW 少しだけ残念そうな顔をしたが、%CALLNAME:TARGET%はサッと引いてくれた。	PRINTFORMW 虽然表情有点遗憾，但是%CALLNAME:TARGET%很快就给把拉过来了。
PRINTFORMW 「あ……そ、そうですか。いえ、良いんです。失礼しました……」	PRINTFORMW 「啊……是这样啊。不……可以了。失礼了……」
PRINTFORMW %CALLNAME:TARGET%はホッとしたような残念そうな、複雑な表情をしていた。	PRINTFORMW %CALLNAME:TARGET%带着一种复杂的表情，又像是松了一口气似的遗憾。
PRINTFORMW 「で、でで、デートっ？」	PRINTFORMW 「约约约约约会？！」
PRINTFORMW 人生で初めての男性からのお誘いに、%CALLNAME:TARGET%は声が裏返っていた。	PRINTFORMW 对于人生中第一次收到的男性邀请，%CALLNAME:TARGET%的声音是相反的。
PRINTFORMW 「わ、わわ、わかりました。い、行きます……」	PRINTFORMW 「哇，哇……我明白了。嗯，我去……」
PRINTFORMW 目を白黒させながらも、 %CALLNAME:TARGET%は%CALLNAME:MASTER%の誘いを受けた……	PRINTFORMW 虽然%CALLNAME:TARGET%目瞪口呆，但还是接受了%CALLNAME:MASTER%的邀请。
PRINTFORMW 「い、行きます行きます！　もちろんです！」	PRINTFORMW 「是的，我去！当然啦！」
PRINTFORMW %CALLNAME:TARGET%は身を乗り出し、%CALLNAME:MASTER%の手を取った。	PRINTFORMW %CALLNAME:TARGET%探出身子，拉起%CALLNAME:MASTER%的手。
PRINTFORMW 「はいっ！　楽しみに待ってますね♪」	PRINTFORMW 「是！期待着吧♪」
PRINTFORMW 「えっと、その……い、行きます」	PRINTFORMW 「那个……嗯，我去」
PRINTFORMW 躊躇いがちに頷いた%CALLNAME:TARGET%の顔は、ほんのり嬉しそうに見えた。	PRINTFORMW 踌躇地点头的%CALLNAME:TARGET%的脸，看起很开心。
PRINTFORMW 「い、良いんですかっ？」	PRINTFORMW 「嗯，很好吗？」
PRINTFORMW %CALLNAME:TARGET%は反射的に腰を浮かせていた。	PRINTFORMW %CALLNAME:TARGET%条件反射地站了起来。
PRINTFORMW 『へっ？』	PRINTFORMW 『诶？』
PRINTFORMW 向こうで電話を取り落とす音が聞こえた。	PRINTFORMW 我听到了对方掉下电话的声音。
PRINTFORMW 『ご、ごめんなさいごめんなさい！　いきなりでちょっと驚いちゃって！』	PRINTFORMW 『对不起，对不起！突然有点吃惊！』
PRINTFORMW 『あの、すぐに行きますから待っててくださいっ』	PRINTFORMW 『那个，我马上就去，你等着吧』
PRINTFORMW 『え、今からですかっ？』	PRINTFORMW 『啊，现在就完了？』
PRINTFORMW 『あの、ちょっとだけ準備しますから、待っててもらえますか？』	PRINTFORMW 『那个，我只准备一下，你能等一下吗？』
PRINTFORMW 「え？」	PRINTFORMW 「呃？」
PRINTFORMW %CALLNAME:MASTER%の突然の誘いに、%CALLNAME:TARGET%は目を丸くした。	PRINTFORMW 对于%CALLNAME:MASTER%突然地邀请，%CALLNAME:TARGET%瞪圆了双眼。
PRINTFORMW 「えっと、えっと……わかりました。じゃあ、準備しますね」	PRINTFORMW 「啊，啊……我明白了。那我准备一下。」
PRINTFORMW 「えっ、ホントですか？」	PRINTFORMW 「诶，真的吗？」
PRINTFORMW 「じゃあ、少しだけ待っててくれますか？　すぐ準備しますから♪」	PRINTFORMW 「那么，能稍微等一下吗？马上准备吧！」
PRINTFORMW 「え、あ……それじゃあ、ちょっとだけ時間をくれませんか？」	PRINTFORMW 「啊，啊……那么，能给我一点时间吗？」
PRINTFORMW 「い、今からですかっ？」	PRINTFORMW 「嗯，从现在开始可以吗？」
PRINTFORMW 「はいっ！　あのっ、すぐ準備してきますから！」	PRINTFORMW 「是！那个,我马上就准备！」
PRINTFORMW 「すみません、時間掛けちゃって。早く行きましょう？」	PRINTFORMW 「对不起，占用了时间。早点去吧？」
PRINTFORMW 「ご、ごめんなさいバタバタしちゃって！　行きましょっか！」	PRINTFORMW 「对不起，对不起！去吧！」
PRINTFORMW 「お待たせしました、%CNAME("二人称")%。今日はどこに行きます？」	PRINTFORMW 「让您久等了，%CNAME("二人称")%今天去哪里？」
PRINTFORMW 「ご、ごめんなさいっ、待たせちゃいましたか？」	PRINTFORMW 「对不起，让你久等了吗？」
PRINTFORMW 「あ、%CNAME("二人称")%が選んでくれるんですか？　楽しみですね……ふふっ」	PRINTFORMW 「啊，%CNAME("二人称")%可以帮我选吗？很期待呢……呼呼~」
PRINTFORMW 「えっ……%CNAME("二人称", "どもり")%が水着を選ぶんですか？　本当に？」	PRINTFORMW 「诶……%CNAME("二人称", "どもり")%选的泳装吗？真的吗？」
PRINTFORMW 「あっ、い、良いですね水着選び！　%CNAME("一人称")%、そういうことする機会めったに無いですし」	PRINTFORMW 「啊，你选的泳装很好啊！%CNAME("一人称")%，我很少有这样的机会」
PRINTFORMW 「へえ……良いですね、たまにはそういうのも。エスコートしてもらえますか、%CNAME("二人称")%？」	PRINTFORMW 「诶……好啊，偶尔也有这样的。%CNAME("二人称")%能帮我护送一下吗？」
PRINTFORMW 「さ、さんぽ……ですか。じゃあその、よろしくお願いします」	PRINTFORMW 「啊，……是吗？那就拜托了。」
PRINTFORMW 「お、賛成です！　揚げ物とか焼き物系を探しに行きましょう！」	PRINTFORMW 「哦，我赞成！去找油炸食品和烧烤类吧！」
PRINTFORMW 「あぁ～、良いですね！　甘い物とか……えっと、今は何が流行ってるんだっけ……」	PRINTFORMW 「啊~，好啊！甜菜什么的……啊，现在流行什么来着……」
PRINTFORMW 「へえ、ショッピングですか？　%CNAME("二人称")%ってどういうお買い物するのか、興味がありますね」	PRINTFORMW 「哦，是购物吗？　%CNAME("二人称")%对买东西有什么兴趣呢？」
PRINTFORMW 「あぁ、ショッピング……えっと、何を買えば良いんですかね……？」	PRINTFORMW 「啊，购物……嗯，买什么好呢？」
PRINTFORMW 「あ、%CNAME("一人称")%カワウソ見たかったんです！　あとペンギンも！」	PRINTFORMW 「啊，%CNAME("一人称")%想看水獭！还有企鹅！」
PRINTFORMW 「水族館かぁ……イルカショーとかあるんですよね？　そういうの縁がなくて……」	PRINTFORMW 「水族馆啊……有海豚表演吗？我没有那种缘分……」
PRINTFORMW 「遊園地！　良いですね、楽しみです！　……%CNAME("一人称")%の体力が持つか心配ですけど。えへへ」	PRINTFORMW 「游乐场！很好呢，很期待！……%CNAME("一人称")%担心我的体力是否撑得住呢。嘿嘿~」
PRINTFORMW 「うぐ、遊園地ですか……手加減してくださいね。%CNAME("一人称")%、酔うのも怖いのも自信無いです。絶叫系なんて言わずもがな……」	PRINTFORMW 「是游乐场吗？请手下留情吧。%CNAME("一人称")%不管是喝醉还是害怕都没有自信。尖叫系什么的就不用说了……」
PRINTFORMW 「図書館！　最近%TEXTR("モナ・リザ盗難事件/イギリスの食品偽装/フェルマーの最終定理に挑んだ人達")%の話をネットで見て、ちょうど気になってたんですよねぇ」	PRINTFORMW 「图书馆！最近%TEXTR("蒙娜丽莎失窃案/英国食品造假/挑战费马大定理的人们")%我在网上看到了这个故事，正好很在意呢。」
PRINTFORMW 「図書館かぁ……なんか漫画喫茶みたいな過ごし方になっちゃいそうですけど、大丈夫ですかね」	PRINTFORMW 「图书馆啊……好像会过得像漫画咖啡店一样，没问题吧？」
PRINTFORMW 「そう言うと思って、予め場所の目星をつけておきました！　急ぎましょう、%CNAME("二人称")%！」	PRINTFORMW 「想着这么说，我就事先给地点定了个目标！%CNAME("二人称")%快点吧 ！」
PRINTFORMW 「あ、あぁ……もうそんな時期でしたね。場所空いてますかね？」	PRINTFORMW 「啊，啊……已经是这个时候了呢。地方空着吗？」
PRINTFORMW 「良いですね！　%CNAME("一人称")%、%CNAME("二人称")%と泳ぎに行くの大好きです♪」	PRINTFORMW 好啊！%CNAME("一人称")%最喜欢和%CNAME("二人称")%去游泳了♪」
PRINTFORMW 「お、泳ぎに……ですか。その……ちょっと、恥ずかしいですけど……良いですよ」	PRINTFORMW 「哦，去游泳……是吗？那个……有点不好意思……好啊。」
PRINTFORMW 「あ、あぁ～！　良いんじゃないですかね！　%CNAME("二人称")%と一緒に泳げるなんて、その、嬉しいです！」	PRINTFORMW 「啊，啊~ ！不是很好吗！和%CNAME("第二人称")%一起游泳。那个，我很开心！」
PRINTFORMW 「山ですかぁ……あぁいけない、休憩中のお弁当を食べる時の想像ばかりしちゃう……」	PRINTFORMW 「山啊……啊不行啊，只会想象休息时吃便当的情景……」
PRINTFORMW 「や、山ッ！　……もし%CNAME("一人称")%が力尽きたら、故郷に届けてくださいね……」	PRINTFORMW 「啊，山！……如果%CNAME("第一人称")%筋疲力尽的话，请把它送回故乡。」
PRINTFORMW 「良いですね！　どこに行きます？　紅葉狩りスポットって意外と混むらしいから急がないと」	PRINTFORMW 「好啊！去哪里？不快点的话，赏红叶的地方可是异常的拥挤呢！」
PRINTFORMW 「紅葉狩り……ははぁ、そんな風流なイベントを。%CNAME("一人称")%、専ら食欲と睡眠の秋でしたから……」	PRINTFORMW 「观赏红叶……哈哈，这么有特色的活动。%CNAME("第一人称")%，因为是食欲和睡眠的秋天……」
PRINTFORMW 「スケート、ですか……あの、絶対離れないでくださいね。%CNAME("一人称")%、怪我をする自信だけありますから」	PRINTFORMW 「滑冰吗？那个，请一定不要离开哦。因为%CNAME("一人称")%有信心会受伤。」
PRINTFORMW 「す、スケート？　%CNAME("一人称")%、全然経験ないんですけど……大丈夫かな……」	PRINTFORMW 「啊？滑冰？%CNAME("一人称")%完全没有经验，应该没问题吧。」
PRINTFORMW 「……今日はイジワルですね……」	PRINTFORMW 「……今天真是倒霉啊……」
PRINTFORMW （な、なんか……気まずいような気がする……）	PRINTFORMW （什么，什么……感觉有点尴尬……）
PRINTFORMW 「えーっと……できるだけ手加減してくださいね？」	PRINTFORMW 「嗯……请尽量手下留情吧？」
PRINTFORMW 「わぁ……圧倒されますねぇ。こんなに色とりどりの水着が……」	PRINTFORMW 「哇……被压倒了呢。这么五颜六色的泳装……」
PRINTFORMW 「リクエストとかあります？　%CNAME("二人称")%のセンスにお任せしますよ」	PRINTFORMW 「有要求之类的？就交给%CNAME("二人称")%了。」
PRINTFORMW 「%CNAME("一人称")%にマイクロビキニなんて着せたがる人、%CNAME("二人称")%以外にいないでしょうね……もう」	PRINTFORMW 「想让%CNAME("一人称")%穿上微型比基尼的人，除了%CNAME("二人称")%以外应该没有了……吧。」
PRINTFORMW 「大丈夫かなぁ……%CNAME("一人称")%、お腹周りとか自信無いんですけど……」	PRINTFORMW 「没问题吧……%CNAME("一人称")%对肚子周边没什么自信」
PRINTFORMW 「いつも学校で着てる水着ですけど……改めて遊びに行くものとして選ぶと、ちょっと違う気分になりますね」	PRINTFORMW 「这总是在学校穿。再去玩耍穿的话作为一个选择，心情会不太一样吧！」
PRINTFORMW 「エグいですね、これ……恥ずかしいのベクトルもなんか他と違うっていうか……」	PRINTFORMW 「嗯，这个……害羞的矢量也和其他的不一样……」
PRINTFORMW 「無難で良いかなと思ってたけど、ワンピースって意外に個性が出ますね……ちゃんと似合ってます？」	PRINTFORMW 「然而我想应该没问题吧，但是连衣裙出乎意料的有个性。和我很配吗？」
PRINTFORMW 「ど、どうです？　みっともなくないですか？　この辺、とか」	PRINTFORMW 「怎么样？不好看吗？这一带，等等」
PRINTFORMW 「これ、恥ずかしいというかもう……%CNAME("一人称")%なんかが着て図々しいと思われないか心配になるくらいですよ……」	PRINTFORMW 「这……怎么可能好意思呢……%CNAME("一人称")%甚至担心穿起来会被人觉得是不是脸皮厚……」
PRINTFORMW 「あのぅ……か、かわいい、ですか？」	PRINTFORMW 「那个……可爱吗？」
PRINTFORMW 「お待たせしました！　さっそく泳ぎます？　それともちょっと遊びましょうか？」	PRINTFORMW 「让您久等了！马上去游泳吗？还是先玩一会吧？」
PRINTFORMW 「……%TEXTR("エッチ/スケベ/変態")%」	PRINTFORMW 「……%TEXTR("色情/色情/变态")%」
PRINTFORMW 「%TEXTR("え、こ、こんなところで……？/ちょ、ちょっと、ここじゃバレちゃいますよ……")%」	PRINTFORMW 「%TEXTR("啊，在这里……？/等一下，这里就暴露了。")%」
PRINTFORMW 「今日は楽しかったですね、%CNAME("二人称")%♪」	PRINTFORMW 「%CNAME("二人称")%今天很开心呢♪」
PRINTFORMW %CALLNAME:TARGET%は微笑みながら、%CALLNAME:MASTER%の手を優しく握っている。	PRINTFORMW %CALLNAME:TARGET%温柔地握着%CALLNAME:MASTER%的手，微笑着站在一起。
PRINTFORMW 「あ、あの……今日は、楽しかったです……」	PRINTFORMW 「啊，那个……今天很开心……」
PRINTFORMW %CALLNAME:TARGET%は手を握ったまま、真っ赤な顔を伏せている。	PRINTFORMW %CALLNAME:TARGET%握着手，垂下通红的脸。
PRINTFORMW 彼女は%CALLNAME:MASTER%の言葉を待っている……	PRINTFORMW 她在等待%CALLNAME:MASTER%的话。
PRINTFORMW %CALLNAME:MASTER%の誘いを聞くなり%CALLNAME:TARGET%は腕を絡ませてきた。	PRINTFORMW 一听到%CALLNAME:MASTER%的邀请，%CALLNAME:TARGET%立马把手臂缠了上来。
PRINTFORMW 「喜んで」	PRINTFORMW 「很开心」
PRINTFORMW ただ一言、絞り出すように返事をした%CALLNAME:TARGET%は、支えを求めるように%CALLNAME:MASTER%の手を強く握った。	PRINTFORMW 只说了一句话，像是要挤出来回复似的%CALLNAME:TARGET%，仿佛在寻求支撑一样地用力握住了%CALLNAME:MASTER%的手。
PRINTFORMW 「……わかりました。また一緒に遊びに行きましょうね」	PRINTFORMW 「……我明白了。另外一起去玩耍吧！」
PRINTFORMW %CALLNAME:MASTER%の胸にそっと体を預け、%CALLNAME:TARGET%は小さな声で呟いた。	PRINTFORMW 将身体交给%CALLNAME:MASTER%的胸前，%CALLNAME:TARGET%小声嘀咕着。
PRINTFORMW 「――次は、誘ってください」	PRINTFORMW 「——下次，请邀请我。」
PRINTFORMW 「は、はい……それじゃ、また」	PRINTFORMW 「是……那么，再见」
PRINTFORMW %CALLNAME:TARGET%は激しい鼓動を隠すように、胸に手を当てていた。	PRINTFORMW %CALLNAME:TARGET%用手捂着胸口，以掩饰激烈的心跳。

//EVENT_K34_真_汎用喘ぎ声関数.ERB

LOCALS = %TEXTR("ちゅっ/んちゅっ/んっ/んんっ")%%UNICODE(0x2661)%　%LOCALS%	LOCALS = %TEXTR("啾/啾~嗯/嗯~/嗯啊~")%%UNICODE(0x2661)%　%LOCALS%
LOCALS = %LOCALS%%TEXTR(@"%CNAME("二人称", "甘え")%……/%CNAME("二人称")%、")%%TEXTR(@"好きです/大好きです/もっと……っ/%CNAME("二人称", "甘え")%……っ")%%UNICODE(0x2661)%	LOCALS = %LOCALS%%TEXTR(@"%CNAME("二人称", "甘え")%……/%CNAME("二人称")%、")%%TEXTR(@"喜欢/非常喜欢/最喜欢/%CNAME("二人称", "甘え")%……っ")%%UNICODE(0x2661)%　
LOCALS = %LOCALS%%TEXTR("ちゅっ、ちゅっ……/ちゅ……ちゅ……っ/ちゅっ……、ちゅ……/ちゅっ、ちゅっ……ちゅっ/ちゅぅ……ちゅっ/んちゅっ、ちゅ……っ")%	LOCALS = %LOCALS%%TEXTR("啾！呜！/哈……哈……/哈！啊！/呼！……啊！/唔~啊！/呀！啊！……")%
LOCALS = %LOCALS%%TEXTR("んっ、んっ……っ/んっ、ちゅ、んん……っ/んっ、んん……っ/んん……っ、ん……っ/ん、んんっ、ん……っ/んっ、ぁふっ、ん……っ/んっ、んっ、ちゅ……っ")%	LOCALS = %LOCALS%%TEXTR("嗯~、嗯~……/嗯~哈~呼~……/嗯~、呼~……/呼~……啊/嗯，嗯~、……/嗯~、呜！……/嗯~、嗯~……")%
LOCALS = %TEXTR("んぐっ/んむっ/んっ/んんっ")%%UNICODE(0x2661)%　%LOCALS%	LOCALS = %TEXTR("呜！/啊！/嗯~/嗯~！")%%UNICODE(0x2661)%　%LOCALS%
LOCALS = %LOCALS%%TEXTR(@"%CNAME("二人称", "甘え")%……/%CNAME("二人称")%、")%%TEXTR(@"気持ちいいですか/びくびくしてますね……/すごく脈打ってる……/こんなに熱く……/%CALLNAME%の舌、気に入ってくれましたか/%CNAME("二人称", "甘え")%……っ")%%UNICODE(0x2661)%	LOCALS = %LOCALS%%TEXTR(@"%CNAME("二人称", "甘え")%……/%CNAME("二人称")%、")%%TEXTR(@"心情好吗/好害怕啊……/脉搏跳动得厉害……/这么热……/%CALLNAME%你喜欢我的舌头吗？/%CNAME("二人称", "甘え")%……")%%UNICODE(0x2661)%　
LOCALS = %LOCALS%%TEXTR("んっ、れろ……/れろ……ぁむ……んっ/んっ……、れろ……/ちゅっ、れろっ……ちゅぷっ/んんっ……れろ……/れろ、はむ……んっ")%	LOCALS = %LOCALS%%TEXTR("嗯~、啊……/啊……嗯~/嗯~……啊，呜~……/呼~哈~呜！嗯~……/啊！嗯~")%
LOCALS = %LOCALS%%TEXTR("んっ、んぐっ……/んん……んぅ……っ/んっ……、んん……/んぐっ、んっ……んっ/んむっ……んっ/んむっ、んん……っ")%	LOCALS = %LOCALS%%TEXTR("嗯~哈~/呼~……嗯~/嗯~……、呼~……/呼~嗯~……嗯~/啊~……嗯~/嗯，呼~……っ")%
LOCALS = %LOCALS%%TEXTR("んっ、んっ……っ/んっ、ちゅ、んん……っ/んっ、んん……っ/んん……っ、ん……っ/ん、んんっ、ん……っ/んっ、ぷはっ、ん……っ/んっ、んっ、ちゅ……っ")%	LOCALS = %LOCALS%%TEXTR("嗯~、嗯~……/嗯~啊，呼~……/嗯~呼~……/呼~……哈/哈呼~，嗯/嗯~，哈~，嗯啊~/嗯~，嗯~，呼~")%
LOCALS = %TEXTR("むぐっ/むぐぅっ/ん゛ん゛っ/んぶぅっ")%%UNICODE(0x2661)%　%LOCALS%	LOCALS = %TEXTR("呃嗯~/啊嗯~/呀~~呼·~/咿，哈~")%%UNICODE(0x2661)%　%LOCALS%
LOCALS = %LOCALS%%TEXTR("んんっ/んむ゛っ/んぐぅっ/ぐぶぅっ")%%UNICODE(0x2661)%	LOCALS = %LOCALS%%TEXTR("嗯~/呼~哈，嗯/嗯，啊~/啊~嗯，哈~")%%UNICODE(0x2661)%　
LOCALS = %LOCALS%%TEXTR("んっ、むぐぅっ……/んんっ……んむぅ……っ/んん゛っ……、ぶぐ、ぅ……/ん゛んっ、っ……ぐぶっ/んむ゛っ……っ/ぐむぅっ、ん゛ん……っ")%	LOCALS = %LOCALS%%TEXTR("嗯~呜~，……/嗯~啊/呼~呜……呀~/呼，嗯~啊~/嗯！啊~/咿！呜~")%
LOCALS = %LOCALS%%TEXTR("んっ、んっ……っ/んっ、んぐ……っ/んっ、ぐむ……っ/んん……っ、んぐ……っ/んっ、んんぅ゛っ/んっ、んぐむ……っ/んっ、んっ、ごぇぇ……っ")%	LOCALS = %LOCALS%%TEXTR("嗯~嗯~……/嗯~啊~……/嗯~呼哈~……/嗯……嗯，嗯……！/嗯呼~/嗯~啊~哈/嗯~、嗯~、啊~")%
