
//EVENT_K35_灯.ERB

人をからかう事と女装が趣味の男子生徒	喜欢捉弄人和女装的男学生
何らかのきっかけで魔法の実在を知り、この部活にまで辿り着いた	因为某种契机知道了魔法的実际存在、从而来到了社团活动之中
悪魔の取引に興味があるらしく、自らの欲望を叶えるために%CALLNAME:MASTER%に近付くことに	好像对悪魔的交易有興趣、为了实现自己的欲望而接近%CALLNAME:MASTER%
PRINTFORMW ある日、部室のドアから聞き慣れないノックが響いた。	PRINTFORMW 某日、部室的门響起了陌生的敲门声。
PRINTFORMW %CALLNAME:MASTER%が予定の無い来客に首を傾げながらドアを開くと、そこには見覚えのない美少女の姿があった。	PRINTFORMW %CALLNAME:MASTER%歪着脑袋、给这位不请自来的客人打開了门、发现门外站着的是一位没见过的美少女。
PRINTFORMW 「あっ、部長さんですか？　私、%CALLNAME:FINDCHARA(NO, 1)%さんの友達なんですけど」	PRINTFORMW 「啊、是部長吗？　我是%CALLNAME:FINDCHARA(NO, 1)%的朋友」
PRINTFORMW 「大事なお話があって来たんです……ここでなら相談を聞いてくれるって」	PRINTFORMW 「有很重要的事情所以来这里了……听说这里可以商量一些事情？」
PRINTFORMW ワケ有りかと尋ねると、少女は悩ましげに頬を赤らめて頷いた。	PRINTFORMW 在询问是不是有怪癖的时候、少女悩羞地红着脸点了点头。
PRINTFORMW 「その……わ、私の体に、変なモノができて……%CALLNAME:FINDCHARA(NO, 1)%さんは治せるって言ってくれたんですけど……」	PRINTFORMW 「那个……我、我的身体上、长了奇怪的东西……%CALLNAME:FINDCHARA(NO, 1)%说这里可以治好……」
PRINTFORMW しきりに下腹部の前で両手を握り直しながらもじもじする姿を見て、%CALLNAME:MASTER%は何となく事情を察することができた。	PRINTFORMW 看到她在下腹前不停地扭捏握着双手的样子、%CALLNAME:MASTER%大致猜到了事情的原委。
PRINTFORMW とりあえず部屋に入るように促すと、少女は期待するように伏せていた顔を上げる。	PRINTFORMW 总而言之告诉对方先进屋、少女抬起了满是期待的脸。
PRINTFORMW 「も、もしかして、本当に治してくれるんですか！？」	PRINTFORMW 「难、难道说、真的可以治好吗！？」
PRINTFORMW %CALLNAME:FINDCHARA(NO, 1)%がそう言ったのなら、きっと大丈夫だろう。	PRINTFORMW 既然是%CALLNAME:FINDCHARA(NO, 1)%说的、那就一定可以。
PRINTFORMW そう答えると、少女は満足そうな笑みを浮かべた。	PRINTFORMW 这么回答着、少女的脸上浮现了満足的微笑。
PRINTFORMW 「ふーん……噂は本当か」	PRINTFORMW 「嗯——……原来传闻是真的啊」
PRINTFORMW 一瞬、誰の声か分からなかった。	PRINTFORMW 一瞬、差点没能明白是誰的声音。
PRINTFORMW 少女はピシャリとドアを閉めたかと思うと、つかつかと%CALLNAME:MASTER%の横を通り過ぎ、空いた椅子にどかっと腰を降ろした。	PRINTFORMW 正打算把少女关在门外的时候、反倒被抓住了机会从%CALLNAME:MASTER%的旁边钻了过去、找了把空的椅子坐了上去。
PRINTFORMW 呆気に取られたまま立ち尽くす%CALLNAME:MASTER%に、少女――らしき客人は愉快そうな笑みを向ける。	PRINTFORMW 对着呆站在原地的%CALLNAME:MASTER%、看上去像是少女的客人露出了愉快的笑容。
PRINTFORMW 「なに呆けてんだよ。噂になってんぜ？　怪しい連中が魔法使ってるいかがわしい部活があるって」	PRINTFORMW 「发什么呆啊。早就变成传闻了？　有可疑的像是魔法使的人的社团什么的」
PRINTFORMW そんな噂が広まっていたのか。思わず%CALLNAME:MASTER%が言葉を漏らしたのを、客人は聞き逃さなかった。	PRINTFORMW 流传出了这样的传闻吗。%CALLNAME:MASTER%下意识说出的话、没有逃过客人的耳朵。
PRINTFORMW 「ま、嘘だけど。その様子じゃちんこをどうにかする程度の魔法はマジであるってことなんだな」	PRINTFORMW 「嘛、虽然是在诈你就是了。不过看様子有类似程度的魔法应该是确有其事啊」
PRINTFORMW 「あ、勿論%CALLNAME:FINDCHARA(NO, 1)%さんの友達ってのも嘘な」	PRINTFORMW 「啊、当然、和%CALLNAME:FINDCHARA(NO, 1)%是朋友也是骗你的」
PRINTFORMW 容易くカマかけに引っかかってしまい狼狽える%CALLNAME:MASTER%の姿を見て、客人はくつくつと笑っていた。	PRINTFORMW 看到因为掉进了简单的陷阱而狼狽不堪的%CALLNAME:MASTER%、客人呵呵的笑了起来。
PRINTFORMW 「自己紹介が遅れました。私、２年の望木灯です。花も恥じらう男の娘ですわ」	PRINTFORMW 「忘了自己介紹了。我、２年的望木灯。连花儿都会为之逊色的男の娘」
PRINTFORMW 「どうぞよろしくお願いしますね、部長さん♪」	PRINTFORMW 「今后请多指教了、部長桑♪」
PRINTFORMW さっきまで低い声色だった彼は、打って変わってわざとらしく綺麗な声と笑顔で愛嬌を振りまいてみせた。	PRINTFORMW 刚才声音还很低沉的他、突然改变了声线、假惺惺地用动听的声音和笑脸撒了个嬌。


PRINTFORMW 悪魔の存在や魂の取り引きのことを知った%CALLNAME:TARGET%は、迷わず入部を決意した。	PRINTFORMW %CALLNAME:TARGET%知道了恶魔的存在以及灵魂的交易这样的事情、毫不犹豫地决定加入迷之社团。
PRINTFORMW どうやら叶えたい願いでも持っているようだが、それには代価となる魂が必要だ。	PRINTFORMW 好像有着想要实现的愿望、想要实现的话需要付出一定灵魂作为代价。
PRINTFORMW そこで%CALLNAME:TARGET%は、%CALLNAME:MASTER%の魂を自分の体で買う契約を提案してきた――	PRINTFORMW 所以%CALLNAME:TARGET%向%CALLNAME:MASTER%提出了用自己的身体来购买灵魂这样的契约――
PRINTFORMW 「何じっと見てんだよ」	PRINTFORMW 「你在看什么呢」
PRINTFORMW 座って楽にしている%CALLNAME:TARGET%から声を投げかけられる。	PRINTFORMW 正舒服地坐在椅子上的%CALLNAME:TARGET%问道。
PRINTFORMW 随分と慣れた様子なのが気になっているのだろうと察し、%CALLNAME:TARGET%は密かに鼻で笑った。	PRINTFORMW 大概是察觉到自己对他熟练的样子感到诧异、%CALLNAME:TARGET%从鼻子中发出了一声冷笑。
PRINTFORMW 「まさか%CNAME("一人称")%が経験無いとか思ってるわけ無いよな？」	PRINTFORMW 「你该不会以为%CNAME("一人称")%没有这方面的経験吧？」
PRINTFORMW 「逆に%CNAME("二人称")%は大丈夫なわけ？　タダ同然とはいえ魂でオトコ買ってんだぜ」	PRINTFORMW 「倒不如反过来说、%CNAME("二人称")%这边没问题吗？　虽然说不花钱但你是在花魂来买一个男人的春的喔」
PRINTFORMW 足を組み、値踏みする目付きで%CALLNAME:MASTER%の様子を観察する%CALLNAME:TARGET%。	PRINTFORMW %CALLNAME:TARGET%翘着二郎腿，带着讨价还价的眼神观察着%CALLNAME:MASTER%。
PRINTFORMW 「それにどう見たって童貞だし。初体験はもっと大事にした方がいいぞ？」	PRINTFORMW 「不管怎么看都是个童贞嘛。初体验这种事情还是更加珍惜一点比较好哦？」
PRINTFORMW 容易く童貞を見透かしてきた%CALLNAME:TARGET%は、ニヤけた表情を隠そうともしなかった。	PRINTFORMW %CALLNAME:TARGET%轻松的看透了童贞的事实、脸上露出了毫不掩饰的笑容。
PRINTFORMW 「ま、男のケツはノーカンって言うならそれでもいいけどな。くっく……」	PRINTFORMW 「嘛、如果觉得男生的屁股也可以的话我也没什么多说的。呼呼……」
PRINTFORMW 「見た感じ、オトコ同士は初めてだろ？　前から興味でもあったのか、それとも……」	PRINTFORMW 「看起来、和男生做还是第一次？　是突然产生了这种兴趣呢、还是说……」
PRINTFORMW 口角を吊り上げ、上目遣いに%CALLNAME:MASTER%の顔を覗き込む%CALLNAME:TARGET%。	PRINTFORMW 嘴角微微上扬、%CALLNAME:TARGET%就这样看着把目光移开不敢与之对视的%CALLNAME:MASTER%。
PRINTFORMW 「よっぽど%CNAME("一人称")%の見た目が気に入ったとか。もしそうなら男の娘冥利に尽きるね」	PRINTFORMW 「不过%CNAME("一人称")%的长相你应该还是挺喜欢的。就让你体验一下伪娘的无穷魅力吧」
PRINTFORMW 「別に相手を選べないような立場でもないと思うけどなぁ、%CNAME("二人称")%……」	PRINTFORMW 「嗯、我觉得也不是不可以由我来调教%CNAME("二人称")%哦……」
PRINTFORMW 「ま、売り込んだのはこっちだしありがたいんだけど。まさかOK貰えるとはビックリだよ」	PRINTFORMW 「嘛、本来你能接受这种交易我就已经很感激了。现在看来也是真没想到你会答应啊」
PRINTFORMW 「まあ%CNAME("一人称")%もなんだかんだ言って、可愛い相手は嫌いじゃないけどさ」	PRINTFORMW 「嘛、%CNAME("一人称")%也不用说什么了、我并不讨厌你这样可爱的人哦」
PRINTFORMW 「同じ穴の狢っつーことで。仲良くしようぜ、部長さん」	PRINTFORMW 「看来我们是一穴之貉呢。那让我们来搞好关系吧、部长先生」
PRINTFORMW 「……まあいいや。互いに慣れてる分には面倒も無いし」	PRINTFORMW 「……嘛，算了。等到彼此习惯了再这样也就不觉得麻烦了」
PRINTFORMW %CALLNAME:TARGET%は組んでいた脚を綺麗に揃えると、膝をぽんぽんと叩いて%CALLNAME:MASTER%を誘った……	PRINTFORMW %CALLNAME:TARGET%把翘着的腿放下，并拢在一起摆成漂亮的造型、轻轻拍了拍膝盖开始邀请%CALLNAME:MASTER%……
PRINTFORMW 「そろそろ始めようか？」	PRINTFORMW 「那么准备开始吧？」
PRINTFORMW 「こうして呼ばれ続けてるってことは、ひとまず気に入ってもらえたってことで良いんだよな？」	PRINTFORMW 「这样继续称呼我也可以、如果你觉得喜欢就更好了哦？」
PRINTFORMW %CALLNAME:MASTER%の隣で、%CALLNAME:TARGET%はニヤついた笑みを見せていた。	PRINTFORMW %CALLNAME:TARGET%轻轻低靠在%CALLNAME:MASTER%的旁边，脸上露出了笑容。
PRINTFORMW 「いやー、助かったぜ。折角売り込んだのにやっぱ合わねえとか言われたら商売あがったりだからなぁ」	PRINTFORMW 「咿呀ー、得救了。虽然也算是临时起意，但这样的交易还是需要双方也都能接受彼此啊」
PRINTFORMW 「今後ともよろしく頼むぜ、%CNAME("主人")%さんよ」	PRINTFORMW 「今后也拜托了哦、%CNAME("主人")%哟」
PRINTFORMW 「なんつーか、上手いよな。%CNAME("二人称")%」	PRINTFORMW 「什么嘛、很熟练了嘛。%CNAME("二人称")%」
PRINTFORMW ふと、始める前に%CALLNAME:TARGET%がそんなことを呟いた。	PRINTFORMW 在开始之前、%CALLNAME:TARGET%突然间说了那样的话。
PRINTFORMW 「いや、マジで。たぶん今まで%CNAME("一人称")%が会った奴の中でも一番」	PRINTFORMW 「不不、我是认真的。你大概是%CNAME("一人称")%至今为止遇到的人里面最好的」
PRINTFORMW 「どうやって覚えたんだよ。やっぱりそれも悪魔の力なわけ？」	PRINTFORMW 「你是怎么学会这些的。果然是依靠着恶魔的力量吗？」
PRINTFORMW 無遠慮に頬をつついてきたので、%CALLNAME:MASTER%はその手を取って引き倒してやった。	PRINTFORMW 毫不顾忌的戳了戳我的脸、%CALLNAME:MASTER%也立马握住了对方的手，将对方推倒了。
PRINTFORMW 「おい、なんだよ実技か？ お手柔らかに頼むぜ」	PRINTFORMW 「哦一、又要开始了吗？ 要手下留情哦」
PRINTFORMW 「負けた」	PRINTFORMW 「我输了」
PRINTFORMW いきなり%CALLNAME:MASTER%の胸に倒れ込んだかと思うと、不満そうに%CALLNAME:TARGET%がぼやいた。	PRINTFORMW %CALLNAME:TARGET%突然间扑倒在了%CALLNAME:MASTER%的怀里、不满地发出了牢骚。
PRINTFORMW 「負けだよ負け。%CNAME("主人")%様には勝てませーん」	PRINTFORMW 「我输了我输了。是%CNAME("主人")%大人赢了」
PRINTFORMW 「あーあ。手玉に取って言うこと聞かそうと思ったのになー」	PRINTFORMW 「啊ー啊。本来是想把这种事情拿出去爆料的、或者用来问你要点什么东西也不错ー」
PRINTFORMW 胸元に頭をぐりぐり押し付けてくる%CALLNAME:TARGET%を抱き竦めると、%CALLNAME:TARGET%の体から力が抜けた。	PRINTFORMW %CALLNAME:TARGET%仿佛失去了力气一般，紧紧的抱住了%CALLNAME:MASTER%，把头埋在了%CALLNAME:MASTER%的胸里。
PRINTFORMW 「……悔しいなぁ」	PRINTFORMW 「……好不甘心啊」
PRINTFORMW ますますふてくされる%CALLNAME:TARGET%の顎をくいと持ち上げ、そっと顔を近付ける。	PRINTFORMW 看着怀中不高兴的%CALLNAME:TARGET%，轻轻地拖着%CALLNAME:TARGET%的下巴把头抬了起来，缓缓地将自己的脸贴近。
PRINTFORMW %CALLNAME:TARGET%はむすっとしながらも目を閉じ、%CALLNAME:MASTER%の唇を受け入れた……	PRINTFORMW %CALLNAME:TARGET%虽然吓了一跳，但随后便闭上了眼睛、吻上了%CALLNAME:MASTER%的嘴唇……
PRINTFORMW このところ、%CALLNAME:TARGET%の様子がおかしい。	PRINTFORMW 最近、%CALLNAME:TARGET%的样子有一点奇怪。
PRINTFORMW 何故か会う度に目を逸らされ、話しかけても会話をしてくれない。	PRINTFORMW 也不知道为什么，每次见面的时候都会把目光移开、即使去搭话也总是不搭理自己。
PRINTFORMW こうして情事の誘いには乗ってくれたものの、いつもの調子でないことは明らかだ。	PRINTFORMW 保持着这样的状态接受了我的邀请、这个样子很明显和平常完全不一样。
PRINTFORMW 「……なんだよ」	PRINTFORMW 「……干什么嘛」
PRINTFORMW 訝しむような視線に気付き、%CALLNAME:TARGET%は僅かにだけ顔を上げた。その頬は微かに赤い。	PRINTFORMW 似乎是注意到了自己惊讶的视线、%CALLNAME:TARGET%稍稍抬起了头。脸上染上了一抹红晕。
PRINTFORMW 熱でもあるのかと手を伸ばすと、%CALLNAME:TARGET%は弾かれたように慌てて%CALLNAME:MASTER%の手を払った。	PRINTFORMW 伸出手轻轻地按在头上，询问是否是发烧的时候、%CALLNAME:TARGET%像是受到了惊吓一样飞快地把%CALLNAME:MASTER%的手推开了。
PRINTFORMW 「っ……なんでもねえよ！　やるならさっさと――」	PRINTFORMW 「什……什么事也没有哦！　要做什么就赶紧做啦――」
PRINTFORMW ――まるで支えでも失ったかのように、%CALLNAME:TARGET%は呆気なく姿勢を崩した。	PRINTFORMW ――就像是失去了支撑一样、%CALLNAME:TARGET%摆出了一个相当崩坏的姿势。
PRINTFORMW 見れば何かを堪えているような顔で、何か言おうにもうまく喋れない様子だ。	PRINTFORMW 一看就知道是在忍耐着什么、但感觉不管说什么都说不好的样子，不知道如何问出口。
PRINTFORMW 「……悪い。なんか%CNAME("一人称")%、やっぱりおかしいみたいだ」	PRINTFORMW 「……抱歉。现在的%CNAME("一人称")%、果然感觉很奇怪吧」
PRINTFORMW やっぱりやめるかと聞いてみると、%CALLNAME:TARGET%は首を横に振った。	PRINTFORMW 询问是不是这次还是就这样结束比较好、%CALLNAME:TARGET%摇了摇头。
PRINTFORMW 「やめなくていい。やめないで……」	PRINTFORMW 「不..不用就这么结束。不要就这样结束啊……」
PRINTFORMW %CALLNAME:TARGET%は弱々しく、%CALLNAME:MASTER%に体を預けた。	PRINTFORMW %CALLNAME:TARGET%十分虚弱地把身体靠在了%CALLNAME:MASTER%的身上，仿佛将一切都托付给了%CALLNAME:MASTER%。
PRINTFORMW そうしている%CALLNAME:TARGET%の姿は、紛れもなく少女だった。	PRINTFORMW 摆出这样姿态的%CALLNAME:TARGET%、就像一个不折不扣的少女。
PRINTFORMW 「なあ、頼むよ。%CNAME("二人称")%からしてくれ。いつもみたいにできる気しないんだ」	PRINTFORMW 「呐、拜托了哦。全都靠%CNAME("二人称")%了。我不想再这样下去了」
PRINTFORMW 「おねがい」	PRINTFORMW 「求你了..」
CALL PRINT_STR, @"イエロー_%CALLNAME:TARGET%は[貞操無頓着]を失いました。_W_"	CALL PRINT_STR, @"イエロー_%CALLNAME:TARGET%失去了[貞操無頓着]。_W_"
PRINTFORMW 「よう、色\@ TALENT:MASTER:オトコ ? 男 # 女 \@」	PRINTFORMW 「よう、色\@ TALENT:MASTER:オトコ ? 狼 # 女 \@」
PRINTFORMW 相対するなり抱きつかれ、唇を奪われる。	PRINTFORMW 两个人紧紧的拥抱在了一起、嘴唇也被轻易的夺去。
PRINTFORMW したり顔の%CALLNAME:TARGET%は心の底から嬉しそうで、まさに恋する乙女のようだ。	PRINTFORMW %CALLNAME:TARGET%的脸上充满着开心和得意、可以看出是从心底里感到高兴、完全就是一位恋爱中的少女。
PRINTFORMW 「こんなに人を好きになったの、%CNAME("二人称")%が初めてだよ」	PRINTFORMW 「我喜欢过的这么多人里面、像喜欢%CNAME("二人称")%到这种程度的可还是第一次哟」
PRINTFORMW 「何が良かったのかねぇ？　顔かな？　テクかな？　そ・れ・と・も」	PRINTFORMW 「你到底有什么吸引我的地方呢？　是容貌吗？　又或者是技术？　还・是・说・」
PRINTFORMW %CALLNAME:TARGET%は%CALLNAME:MASTER%の股下にするりと脚を割り込ませ、膝で軽く擦ってきた。	PRINTFORMW %CALLNAME:TARGET%把腿顶在了%CALLNAME:MASTER%の的双腿之间、用膝盖轻轻地摩擦着。
PRINTFORMW 「やっぱりココかなぁ？　ふふっ……悪魔のご主人様は一味違うな」	PRINTFORMW 「果然还是这里吗？　呼呼……恶魔的主人就是与众不同呢」
PRINTFORMW いつになく嬉しそうな%CALLNAME:TARGET%から唇を奪い返してやると、途端に力が抜けたように目を閉じ、体を預けてきた。	PRINTFORMW 吻上了看起来比任何时候都高兴的%CALLNAME:TARGET%的嘴唇、%CALLNAME:TARGET%就把眼睛闭了起来、放松身心、将一切托付给了你。
PRINTFORMW 「あぁ……ヤバい奴と取り引きしちまったなぁ。今さらやめらんないしさ……ほんと魔性の\@ TALENT:MASTER:オトコ ? 男 # 女 \@だよ、%CNAME("二人称")%」	PRINTFORMW 「啊啊……真是和一个不妙的家伙做了交易呢。不过事到如今我也无法放弃了……%CNAME("二人称")%可真是个有魔性的\@ TALENT:MASTER:オトコ ? 男 # 女 \@啊」
PRINTFORMW 指を絡ませ、覗き込むように%CALLNAME:MASTER%を見上げ、%CALLNAME:TARGET%は刺すように囁く。	PRINTFORMW 两个人的手紧紧握住、将十指交叉在一起、%CALLNAME:TARGET%抬起头看着也在看着自己的%CALLNAME:MASTER%、用很小的声音说道。
PRINTFORMW 「もし%CNAME("一人称")%のこと捨てたら、マジで女みたいに泣いてやる」	PRINTFORMW 「如果%CNAME("一人称")%现在被你抛弃的话、我会真的像一个女孩子一样痛哭流泪的」
PRINTFORMW その姿は妖艶な美女のようでいて、儚い少女のようにも感じられた……	PRINTFORMW 那个姿像一个妖艳的美少女、有一种仿佛是在梦中才会遇到的梦幻般的少女的感觉……
PRINTFORMW 「お、おう……お待たせ」	PRINTFORMW 「哦、哦……久等了」
PRINTFORMW %CALLNAME:TARGET%は落ち着かない様子で、しばし遅れて%CALLNAME:MASTER%の前に現れた。	PRINTFORMW %CALLNAME:TARGET%晚了一会才在%CALLNAME:MASTER%的面前出现、一幅心神不宁的样子。
PRINTFORMW 「いやぁ……なんだな。やっぱり女の体って違うな。自分で触ってみても明らかに柔らかくなってんのがわかんの」	PRINTFORMW 「不……怎么说呢。果然女孩子的身体就是会不一样啊。我自己摸了摸发现各个地方明显都软了好多」
PRINTFORMW 「胸も膨らんでるし、ちんこもねえし。股触るとつるつるしててさ……見ろよ、これ」	PRINTFORMW 「胸部也鼓鼓的、本来可是一点都没有的。下面摸起来也滑溜溜的……你看、这里」
PRINTFORMW そう言って%CALLNAME:TARGET%は、隠していた自らの秘所を晒した。	PRINTFORMW 那样说着的%CALLNAME:TARGET%、把自己隐蔽的秘处亮了出来。
PRINTFORMW 既にそこは愛液によって濡れており、淫らに淡く光を照り返している……	PRINTFORMW 那里已经完全被爱液浸湿了、在光线的照射下淫乱地反射出淡淡的光……
PRINTFORMW 「はは……笑うなよ。ただちょっと表面なぞったりしてみただけなんだ。なのにもう濡れちゃってさ……」	PRINTFORMW 「啊啊……别笑了啦。我只是有点好奇、稍微在表面摸了几下。结果就已经湿成这个样子了……」
PRINTFORMW 「手先がぬるぬるになってんのがわかって、それでまた興奮して……もう、止まらないんだ」	PRINTFORMW 「然后我发现我的手指就有点变得黏黏的、接着我就兴奋了……最后就停不下来了」
PRINTFORMW そこまで話してとうとう耐えられなくなったのか、%CALLNAME:TARGET%はその場にへたり込んでしまった。	PRINTFORMW 说到这个时候终于是忍不住了、%CALLNAME:TARGET%当场就瘫坐在地上。
PRINTFORMW 「なあ、助けてくれよ……%CNAME("一人称")%、女の体がこんなにヤバいなんて思わなかった……」	PRINTFORMW 「呐、帮帮我吧%CNAME("一人称")%……我没想到女孩子的身体居然会这么糟糕……」
PRINTFORMW 「何とかしてくれ……たのむよ……」	PRINTFORMW 「快做点什么吧……求求你了……」
CALL PRINT_STR, @"イエロー_%CALLNAME:TARGET%は[濡れやすい]を獲得しました。_W_"	CALL PRINT_STR, @"イエロー_%CALLNAME:TARGET%獲得了[濡れやすい]。_W_"


//EVENT_K35_SELECT.ERB

PRINTFORMW 「あれ、戻すのか？」	PRINTFORMW 「啊咧、还会变回去吗？」
PRINTFORMW 「そっか……なーんか複雑な気分だな。結構気に入ってたかも」	PRINTFORMW 「这样啊……心情有些复杂呢。不过我可能会很喜欢吧」
PRINTFORMW 「あいあい、了解。……いやー、すっかり玩具にされてないか%CNAME("一人称")%」	PRINTFORMW 「啊啊、了解。……不ー、这不是完全被当做玩具了吗%CNAME("一人称")%」
PRINTFORMW 「今はいいけど、いつかはどっちかに決めるか、頻度落としてくれな。調子狂っちまう」	PRINTFORMW 「这样就好了、什么时候决定好是哪一个啊、降低一下变换的频率啊。真是要疯了」
PRINTFORMW %CALLNAME:PLAYER%の魂と引き換えに、%CALLNAME:TARGET%はオトコに戻った。	PRINTFORMW 与%CALLNAME:PLAYER%进行了灵魂的交易、%CALLNAME:TARGET%变成了男人。
PRINTFORMW 魂-1.00（あなた）	PRINTFORMW 魂-1.00（你）
PRINTFORMW 「女に？」	PRINTFORMW 「女生吗？」
PRINTFORMW 「……そうだな。うん、いいよ。やっても」	PRINTFORMW 「……这样啊。唔、好吧。要变了哦」
PRINTFORMW 「可愛くしてくれよ？」	PRINTFORMW 「给我变的可爱点哦？」
PRINTFORMW 「お、また女になれってか。いいよ、オッケー」	PRINTFORMW 「哦、又想当女孩子了吗。好啊、OK」
PRINTFORMW 「……オッケーとか気軽に言えるのがすげえよな。手術然としてねえから抵抗が無い」	PRINTFORMW 「……OK什么的真是很轻松就说出来了啊。是因为没有手术就没有抵抗这样吗」
PRINTFORMW %CALLNAME:PLAYER%の魂と引き換えに、%CALLNAME:TARGET%はオンナになった。	PRINTFORMW 与%CALLNAME:PLAYER%进行了灵魂的交易、%CALLNAME:TARGET%变成了女生。
PRINTFORMW 「……そう、だな。ちょっと考えさせてほしい」	PRINTFORMW 「……这、这样啊。让我稍微考虑一下」
PRINTFORMW 「別に興味がないわけじゃないけど……ほら、%CNAME("一人称")%も男だからウケてるって面もあるし？」	PRINTFORMW 「也不是完全没有变成女孩子的兴趣啦……不过你看、%CNAME("一人称")%不就有作为男孩子还受欢迎的地方吗？」
PRINTFORMW 「それになんていうか……覚悟がいるよ。やっぱ」	PRINTFORMW 「我在说什么啊……嘛，我做好觉悟了。来吧」
PRINTFORMW ……%CALLNAME:TARGET%に断られてしまった。	PRINTFORMW ……被%CALLNAME:TARGET%拒绝了。
PRINTFORMW %CALLNAME:TARGET%が心変わりした後ならあるいは……	PRINTFORMW 不知道%CALLNAME:TARGET%会改变主意呢……
CALL PRINT_STR, "イエロー_(※女性化してもらうには、相手が[恋慕]or[屈服刻印LV3]or[信頼LV5]の必要があります)_W_"	CALL PRINT_STR, "イエロー_(※想要进行女性化、需要对方持有[恋慕]or[屈服刻印LV3]or[信頼LV5]属性)_W_"


//EVENT_K35_SHOP.ERB

PRINTFORMW 「お。取引か？」	PRINTFORMW 「哦。要买东西吗？」
PRINTFORMW %CALLNAME:TARGET%は不満そうな顔で、突然%CALLNAME:MASTER%の胸ぐらを掴んだ。	PRINTFORMW %CALLNAME:TARGET%一幅不满的表情、突然间抓住了%CALLNAME:MASTER%的衣襟。
PRINTFORMW 「ちったぁロケーション考えろよ、てめぇ」	PRINTFORMW 「考虑一下这种事的场所啊、你这家伙」
PRINTFORMW 今にも襲いかかってきそうな気迫の%CALLNAME:TARGET%に、%CALLNAME:MASTER%はぐいと体を引っ張られる。	PRINTFORMW %CALLNAME:TARGET%带着现在就要袭来的气魄、把%CALLNAME:MASTER%的身体一下子拉扯了过去。
PRINTFORMW 抵抗する間もないまま、気付けば%CALLNAME:MASTER%は乱暴に唇を奪われた……	PRINTFORMW 完全没有抵抗的时间、%CALLNAME:MASTER%感觉被粗暴的夺走了嘴唇……
PRINTFORMW 「……一失点だ。ちゃんと返せよ。……絶対だぞ」	PRINTFORMW 「……扣你一分。要好好的还给我哦。……绝对要」
PRINTFORMW 「――言ったな、てめぇ」	PRINTFORMW 「我告诉过你、你这家伙」
PRINTFORMW %CALLNAME:MASTER%の言葉を聞いた%CALLNAME:TARGET%は突然詰め寄り、%CALLNAME:MASTER%を壁際にまで追い詰めた。	PRINTFORMW %CALLNAME:TARGET%听到了%CALLNAME:MASTER%的话、突然间靠了过来、把%CALLNAME:MASTER%逼到了墙边。
PRINTFORMW その表情は固く、いつになく真剣な眼差しだ……	PRINTFORMW 他的表情十分严肃，但是眼神非常认真……
PRINTFORMW 「吐いたツバ飲み込むなよ。冗談にしたら許さない」	PRINTFORMW 「说出来的话可不能再收回去。我可不允许你开这种玩笑」
PRINTFORMW 「……%CNAME("二人称")%が本気にさせたんだからな……」	PRINTFORMW 「……我会让%CNAME("二人称")%当真的……」
PRINTFORMW そう言って%CALLNAME:TARGET%は%CALLNAME:MASTER%と長い時間、唇を重ね合った……	PRINTFORMW 一边说着，%CALLNAME:TARGET%吻上了%CALLNAME:MASTER%的嘴唇，长时间的深吻着……
PRINTFORMW 「なんだ、すっかり惚れちゃったかー？」	PRINTFORMW 「什么啊、完全被迷住了不是吗？」
PRINTFORMW 「悪いけどそんなにがっつかれても困るぜ」	PRINTFORMW 「不好意思呢，你要是这么想我也很难办」
PRINTFORMW 「おいおい、本気で言ってんのか？」	PRINTFORMW 「喂喂、你是认真说出来的嘛？」
PRINTFORMW 「ちょっと落ち着いて考え直した方がいいぞ」	PRINTFORMW 「你应该重新冷静下来考虑一下比较好」
PRINTFORMW 「……別に%CNAME("一人称")%ら、そんなんじゃないだろ」	PRINTFORMW 「……%CNAME("一人称")%不是这样的人吧」
PRINTFORMW 「あっそ。ありがとなー」	PRINTFORMW 「啊对了。谢谢ー」
PRINTFORMW 「マジで！？　待ってました！　やろうぜ早く今すぐに――」	PRINTFORMW 「真的吗！？　我做好准备了！　就现在开始吧！现在马上！」
PRINTFORMW 『はい、そこまでです。申し訳ありませんが、その願いは承諾しかねます』	PRINTFORMW 『好、就到此为止了。不好意思、这个愿望我不可能答应』
PRINTFORMW 『今の私はご主人様にお仕えする身。ご主人様が一方的に損をする取り引きは見過ごせません』	PRINTFORMW 『现在的我，身体是用来服侍主人的。不能单方面的无视主人一方的损失』
PRINTFORMW 「えぇ？　別に損なんて無いじゃんかよー。幾らでも増える魂なんだからさぁ」	PRINTFORMW 「诶诶？　并没有什么别的损失ー。因为主人有一个不断增长的灵魂？」
PRINTFORMW 『%CALLNAME:TARGET%さんがそう言っているうちはいけません。もう少しお互いの時間を過ごしてからお考え直しくださいね』	PRINTFORMW 『就算%CALLNAME:TARGET%你这样说我也不会答应，先不要再说了。请再过一段时间再考虑吧』
PRINTFORMW 「ちょっと待ってよ～！　これ叶えてくれたらもうワガママ言わないからさぁ～！」	PRINTFORMW 「请等一下～！　如果真的可以实现的话，那我也就不会再多说什么了～！」
PRINTFORMW 『駄目です。先生は認められません』	PRINTFORMW 『不行哦。老师是不会认可的』
PRINTFORMW 『生徒の、ましてや自分の子供の魂を軽々しく使われるのを見過ごせるわけが無いでしょう』	PRINTFORMW 『学生的灵魂是如此、更不用说自己的孩子的灵魂了、我们可不能忽视他们的灵魂的消耗啊。』
PRINTFORMW 「なんだよ先生～、悪魔なのにそんな固いこと言わなくたってさぁ」	PRINTFORMW 「什么呀老师～、虽然我也是恶魔，但也不用这样严肃的说吧」
PRINTFORMW 『駄目なものは駄目です！　二人がちゃんと仲良くなったら認めてあげますから。それまでは我慢なさい』	PRINTFORMW 『我说了不行的事情就是不行！　如果两个人好好相处的话，我说不定会同意吧。但是在那之前，还请好好忍耐一下吧』
PRINTFORMW 「頼むよ先生～！　一生のお願いだからさぁ～！」	PRINTFORMW 「拜托了哦老师～！　这可是我毕生的愿望啊～！一定要帮我实现啊！」
PRINTFORMW 『はい神宣発動します』	PRINTFORMW 『好，神宣发动』
PRINTFORMW 「は？　かみせん？」	PRINTFORMW 「哈？　神明大人？」
PRINTFORMW 『残念ですが、今の%CALLNAME:TARGET%さまがその願いを叶えることは認められません』	PRINTFORMW 『真是遗憾、现在的神明%CALLNAME:TARGET%大人我不允许你的愿望实现』
PRINTFORMW 『お二人がもっと仲良くなってから、もう一度ご提案ください』	PRINTFORMW 『等到两个人的关系再好一些的时候、再提出这个建议吧』
PRINTFORMW 「はぁ？　何それ意味が――」	PRINTFORMW 「哈？？　那又是什么意思――」
PRINTFORMW 『強制脱出装置を発動し、ターンエンドです。では、さようなら』	PRINTFORMW 『强制脱出装置发动、回合结束。那么、再见了』
PRINTFORMW 「おぉい！　ちょ待てよ！」	PRINTFORMW 「喂喂！　等一下啊！！」
PRINTFORMW 『ストップです。残念ですが%CALLNAME:TARGET%さん、現時点でその願いは叶えてあげられません』	PRINTFORMW 『请停一下。非常抱歉%CALLNAME:TARGET%桑、现在的我可不能帮你实现这个愿望』
PRINTFORMW 『生徒会として、天使として、愛も無くそんな淫らな取り引きをするのはいけませんよ？』	PRINTFORMW 『不管是作为学生会、还是作为一名天使、在没有爱的情况下怎么可能会进行这种淫乱的交易？』
PRINTFORMW 「そこをなんとか……ね？　ノノちゃんお願い？」	PRINTFORMW 「别那样说嘛……呐？　乃乃酱~拜托你了啦~」
PRINTFORMW 『かわいらしい猫撫で声出してもダメです』	PRINTFORMW 『就算你发出这种猫才会发出的可爱声音也是不行的！』
PRINTFORMW 「ズルいー！　自分は好きに変えられるクセにー！　大体なにが天使だよ、堕天使だろー！？」	PRINTFORMW 「好狡猾ー！　明明自己就可以把自己变成喜欢的样子ー！　你这样哪里是天使啦、是堕天使吧ー！？」
PRINTFORMW 『いや……悪いがそなたの願いを叶えてやることはできない』	PRINTFORMW 『不要……我不会实现你这种不好的愿望的』
PRINTFORMW 『他人の財産を利用することだけ考え、自らの欲を叶えようとするなど、妾は看過できぬ』	PRINTFORMW 『只考虑利用他人的财产、来实现自己的欲望所带来的愿望、这种事情妾身可不能忽视』
PRINTFORMW 「えぇ～？ 悪魔のお貴族様ともあろうものが、そんなお固いこと言わなくっても……」	PRINTFORMW 「诶诶～？ 可能是恶魔中的贵族什么的、不要那么生硬的说啦……」
PRINTFORMW 『それなりの対価を用意せよと言っておるのだ。それまでこの取り引きは無効だ』	PRINTFORMW 『那就请准备好对应的价格。在这之前这个交易是绝对不会生效的』
PRINTFORMW 「対価って何よ？　ちょっとオスカーさ～ん……」	PRINTFORMW 「什么代价啊？　等等啦 奥~丝~卡~桑……」
PRINTFORMW 「――っつーわけで、誠に遺憾ながらこの話はナシな」	PRINTFORMW 「――正是如此、实在很遗憾，这句话并没有什么意义」
PRINTFORMW 「ん？　あぁ……別に困ってないしなぁ」	PRINTFORMW 「嗯？　啊啊……并没有什么难处啦」
PRINTFORMW 「それに職業柄……って言い方も変だけど、あんまりデカいほうが困るかもしんないし」	PRINTFORMW 「再加上职业性质……这么说也不对、总之再大一些的话可能会有困扰吧」
PRINTFORMW 「は？」	PRINTFORMW 「哈？」
PRINTFORMW 「あー、ムリムリ。考え直してくれ」	PRINTFORMW 「啊ー、不行不行。还请重新考虑一下啊」
PRINTFORMW 「んー……よし、オッケー。構わないぞ」	PRINTFORMW 「嗯ー……好、OKー。没什么关系的」



//EVENT_K35_DAILY.ERB

PRINTFORMW 「目ぇ覚めたか？　んじゃ、ちょっと洗面台借りるから」	PRINTFORMW 「你醒啦？嗯，洗漱台我先借用一下。」
PRINTFORMW 「よし、ちょっと……手ぇ貸せ。立てねぇから」	PRINTFORMW 「哦、稍微...帮我一下。有点站不稳啊..」
PRINTFORMW 「%TEXTR("おら、気張れ。今日は体育だぞ/きょう体育だってよ。だりー……")%」	PRINTFORMW 「%TEXTR("哦呀，要加油哦。今天是体育课呢。/听说今天是体育课哦亲爱的。")%」
PRINTFORMW 「%TEXTR("ん、おはよ/ほら、起きた起きた")%」	PRINTFORMW 「%TEXTR("啊，早上好/起床啦起床啦~")%」
PRINTFORMW 「%TEXTR("なんだ、他の奴いないのか……/ん……二人っきりか")%」	PRINTFORMW 「%TEXTR("什么啊，没有其他人啊.../嗯..只有我们两个人呢。")%」
PRINTFORMW 「ただいまー。%TEXTR("あー、疲れた……/なあ、なんか遊ぼうぜー")%」	PRINTFORMW 「我回来了。%TEXTR("啊~好累啊。/呐，来玩点什么吧~")%」
PRINTFORMW 「%TEXTR("なんだよ、遅かったじゃん/お、おかえりー。いま暇か？")%」	PRINTFORMW 「%TEXTR("什么嘛、太迟了哦。/欢迎回来~现在有空吗？")%」
PRINTFORMW 「%TEXTR("よっ。先に来てるぜ/おつかれ。今日は何する？")%」	PRINTFORMW 「%TEXTR("哟，你先来啦。/辛苦了，今天要做点什么呢？")%」
PRINTFORMW 「お待たせ、待った？ ……%TEXTR("なーんて/とかいって")%」	PRINTFORMW 「久等啦，难道说等了很久 ……%TEXTR("什么的/之类的")%」
PRINTFORMW 「%TEXTR("おい、もうおっ始めてんのかよ。ったく/ああ？ なんだよ、勝手に楽しみやがって")%」	PRINTFORMW 「%TEXTR("哦、已经开始了呀/啊啊？什么嘛，让我好好享受一下吧。")%」
PRINTFORMW 「お？ やってんねぇ」	PRINTFORMW 「哦？做的不错嘛」
PRINTFORMW 「%TEXTR("お邪魔しまーす/うーっす。来てるか？")%」	PRINTFORMW 「%TEXTR("打扰了/唔，来了吗？")%」
PRINTFORMW 「%TEXTR("あー、遅れた遅れた……/おー、もうみんな来てんじゃん")%」	PRINTFORMW 「%TEXTR("啊~迟到了迟到了.../哦，大家都已经来了呀。")%」
PRINTFORMW 「%TEXTR("お待たせ/来たぞ")%ー」	PRINTFORMW 「%TEXTR("久等了/我来了")%ー」
PRINTFORMW 「%TEXTR("どもー/うっす")%」	PRINTFORMW 「%TEXTR("你们好/各位好啊")%」
PRINTFORMW 『どうもー、先生』	PRINTFORMW 『老师好啊』
PRINTFORMW 『ずいぶん遅かったな%CNAMET(ARG, "二人称")%。何してたん？』	PRINTFORMW 『来的好晚啊~%CNAMET(ARG, "二人称")%。去做什么了呢？』
PRINTFORMW 『よ。遅かったな』	PRINTFORMW 『哟，真晚啊。』
PRINTFORMW 『ん、なんだ%CNAMET(ARG, "二人称")%か』	PRINTFORMW 『嗯，什么嘛%CNAMET(ARG, "二人称")%啊』
PRINTFORMW 『%TEXTR("どもー/おつかれー/うーす")%』	PRINTFORMW 『%TEXTR("你好~/辛苦啦~/唔，你来啦")%』
PRINTFORMW 「ほれ」	PRINTFORMW 「给你，尝尝看吧」
PRINTFORMW ぶっきらぼうに弁当箱を差し出した%CALLNAME:ARG%の顔は、珍しく緊張の色が見て取れた。	PRINTFORMW 在强硬地把饭盒递出来的%CALLNAME:ARG%的脸上、难得看到了紧张的神色。
PRINTFORMW 「なんだよ、早く食えよ」	PRINTFORMW 「干什么，快点吃啦！」
PRINTFORMW 不機嫌そうに急かされつつ弁当箱の蓋を開けると、思ったより整ったお弁当の姿が現れた。	PRINTFORMW 不高兴地打开了便当盒的盖子、出现了比想象中更整齐的便当的样子。
PRINTFORMW 試しに一口食べてみるが、味も申し分ない。	PRINTFORMW 尝试着吃了一口、味道无可挑剔。
PRINTFORMW 「……うまいか？」	PRINTFORMW 「...好吃吗？」
PRINTFORMW 躊躇いなく頷きを返すと、%CALLNAME:ARG%は溜め息を漏らした。	PRINTFORMW 毫不犹豫地点了点头、%CALLNAME:ARG%叹了一口气。
PRINTFORMW 「ったく、無茶振りしやがって……」	PRINTFORMW 「真是的，还装模作样的」
PRINTFORMW 悪態をつく口は、ほんの僅かにニヤけていた。	PRINTFORMW 虽然说着语气不佳的话，但嘴角却露出一丝微笑。
PRINTFORMW 「物好きだよなぁ、%CNAMET(ARG, "二人称")%」	PRINTFORMW 「给，都是你喜欢吃的东西、%CNAMET(ARG, "二人称")%」
PRINTFORMW 自分の手料理を満足そうに食べる%CALLNAME:MASTER%の横顔を、%CALLNAME:ARG%はぼーっと眺めていた。	PRINTFORMW %CALLNAME:ARG%一直看着心满意足地吃着自己手中的料理的%CALLNAME:MASTER%的脸。
PRINTFORML 「%NAME:TARGET%です♪ よろしくお願いしまーす♪」	PRINTFORML 「我是%NAME:TARGET%♪ 还请多多指教哦♪」
PRINTFORML %CALLNAME:TARGET%はわざとらしく白々しい笑顔で挨拶した。	PRINTFORML %CALLNAME:TARGET%假惺惺地用着天真地笑容打着招呼。
PRINTFORML 「%TEXTR(@"おーい、拭いてくれよー……/%CNAME("主人")%ー、アイス食べたいー")%」	PRINTFORML 「%TEXTR(@"喂~给我擦一下吧……/%CNAME("主人")%~好想吃冰淇淋呀~")%」
PRINTFORML %CALLNAME:TARGET%は脱力しきった様子で%CALLNAME:MASTER%を呼んでいる……	PRINTFORML %CALLNAME:TARGET%浑身无力地呼喊着%CALLNAME:MASTER%
PRINTFORML 「%TEXTR("あっちー……ほんっと夏嫌いだわ……/汗っ……！ マジくそ……")%」	PRINTFORML 「%TEXTR("阿——嚏！……真的好讨厌夏天啊……/又出汗了……！ 真的可恶……")%」
PRINTFORML %CALLNAME:TARGET%は見るからに不機嫌そうだ……	PRINTFORML %CALLNAME:TARGET%看起来非常不高兴的样子……
PRINTFORML 「……%TEXTR("あ/なに/何時")%？」	PRINTFORML 「……%TEXTR("啊/什么/什么时候")%？」
PRINTFORML %CALLNAME:TARGET%はそっぽを向き、落ち着かない様子で足をブラブラさせている……	PRINTFORML %CALLNAME:TARGET%转过身去、一幅心神不宁的样子，腿都有些哆嗦……
PRINTFORML %CALLNAME:TARGET%は先んじて%CALLNAME:MASTER%のベッドに腰掛けた。	PRINTFORML %CALLNAME:TARGET%比%CALLNAME:MASTER%更快一步的坐在了床上。
PRINTFORML 「……%TEXTR("で、何する？/期待して良いんだよな？/ふふっ")%」	PRINTFORML 「……%TEXTR("那么、要做什么？/你在期待着做些什么吗？/呼呼")%」
PRINTFORML 「%TEXTR("よっこらしょ、と/なんか漫画とかある？ ゲームは？/どれどれ、ベッドの下は、と……")%」	PRINTFORML 「%TEXTR("有书可以看呢/有漫画什么的嘛？ 游戏呢？/嗯嗯？床底下有什么呢？嗯……")%」
PRINTFORML %CALLNAME:TARGET%は早くも寛いでいる……	PRINTFORML %CALLNAME:TARGET%早早地放松了下来……
PRINTFORML 「%TEXTR("いらっしゃーい。さっそく始めるか？/棚ん中とか荒らすなよ。衣装とか入ってっから/漫画とかその辺にあるから。適当に戻すなよー/ゲームするときはそっちの余ったモニター使えな")%」	PRINTFORML 「%TEXTR("欢迎~赶快开始吧？/不要乱翻我的柜子哦，衣服什么的都在里面放着/漫画的话就在那一边。都是有顺序摆放的，不要随随便便地放进去哦/玩游戏的话可以用那边多出来的显示器")%」
PRINTFORML 「%TEXTR(@"おーい、見んなよぉー/うっわ、男のパンチラなんか見やがったコイツ/好きだよなぁ、%CNAME("二人称")%も")%」	PRINTFORML 「%TEXTR(@"喂——不要偷看哦/唔哇、想看看男人的内裤呢/好喜欢啊、%CNAME("二人称")%も")%」
PRINTFORML %CALLNAME:TARGET%は恥ずかしげもなく笑っている。	PRINTFORML %CALLNAME:TARGET%毫不羞涩地笑着。
PRINTFORML 「%TEXTR("おっと、流石に女のパンチラは訳が違うぞ。マジで/うわ、ちょ……いかんなぁこりゃ")%」	PRINTFORML 「%TEXTR("哦呀，广告上面女人的名字翻译错了呢，真的/唔哇，真是糟糕啊..")%」
PRINTFORML %CALLNAME:TARGET%は苦笑いをしている。	PRINTFORML %CALLNAME:TARGET%只能苦笑着。
PRINTFORML 「今まで何人付き合ってきたか？ いやー、数えてねえなぁ」	PRINTFORML 「到现在为止和多少人交往过？ 不，没有数过呢」
PRINTFORML はぐらかすように%CALLNAME:TARGET%は明後日の方向を向いた。	PRINTFORML %CALLNAME:TARGET%转过身去，看向了窗外
PRINTFORML 「普段の下着？ 普通に男物だけど」	PRINTFORML 「平常穿着的内衣？ 普通的男式内衣啊」
PRINTFORML 「ま、%CNAME("二人称")%に見せる機会も無いと思うけどな。今はいわゆる営業時間だ」	PRINTFORML 「嘛、反正平常也没什么机会展示。现在就是所谓的营业时间啦。」
PRINTFORML 「そういや男物の下着が見事に箪笥で腐ってんだよなぁ」	PRINTFORML 「男人的衣服都烂在柜子里啦」
PRINTFORML 「服の方はまあ……ここで察せ」	PRINTFORML 「还完好的衣服就在这里了」
PRINTFORML %CALLNAME:TARGET%は自分の胸をつついてみせた。	PRINTFORML %CALLNAME:TARGET%指了指自己的胸部
PRINTFORML %CALLNAME:TARGET%はスナックをつまみながらスマホを眺めている……	PRINTFORML %CALLNAME:TARGET%一边吃着零食，一边玩着手机
PRINTFORML 不意にカメラの撮影音が響いた。	PRINTFORML 突然间响起了照相的拍摄声。
PRINTFORML %CALLNAME:TARGET%が自撮りをしているようだ……	PRINTFORML %CALLNAME:TARGET%好像在玩自拍……
PRINTFORML %CALLNAME:TARGET%は%CALLNAME:MASTER%そっちのけで他人との会話を楽しんでいる……	PRINTFORML %CALLNAME:TARGET%把%CALLNAME:MASTER%晾在一旁自顾自地和别人开心地聊着天。……
PRINTFORML %CALLNAME:TARGET%は%CALLNAME:MASTER%の所作をじっと眺めている……	PRINTFORML %CALLNAME:TARGET%一直在注意着%CALLNAME:MASTER%的行动
PRINTFORML 「……なんかしねえの？」	PRINTFORML 「……什么也不做吗？」
PRINTFORML %CALLNAME:TARGET%は%CALLNAME:MASTER%に微笑みかけている……	PRINTFORML %CALLNAME:TARGET%对着%CALLNAME:MASTER%微笑着……
PRINTFORML %CALLNAME:TARGET%は%CALLNAME:MASTER%の視線を意に介さず寛いでいる……	PRINTFORML %CALLNAME:TARGET%并没有在意%CALLNAME:MASTER%的视线，独自放松着……
PRINTFORML 「なーにジロジロ見てんだよ」	PRINTFORML 「看我看到入迷了吗？」
PRINTFORML %CALLNAME:TARGET%は得意げな様子だ。	PRINTFORML %CALLNAME:TARGET%非常得意的样子。
PRINTFORML %CALLNAME:TARGET%は意外なほど静かに寝入っている……	PRINTFORML %CALLNAME:TARGET%意外安静地睡着了……
PRINTFORML %CALLNAME:TARGET%はそっと寝返りを打った……	PRINTFORML %CALLNAME:TARGET%轻轻地翻了个身……
PRINTFORML %CALLNAME:TARGET%は無意識に自分の服の袖を掴んだ。	PRINTFORML %CALLNAME:TARGET%无意识地握紧了自己的袖子。
PRINTFORMW 『おう。ちょいと準備するから待っててくれな』	PRINTFORMW 『我。我稍微准备一下，你等等哦』
PRINTFORMW 『今ぁ？』	PRINTFORMW 『现在吗？』
PRINTFORMW 『わかったわかった、行くよ』	PRINTFORMW 『我知道了我知道了，走吧』
GREETING = こんばんは	GREETING = 晚上好
GREETING = どうも	GREETING = 喔
GREETING = こんちわ	GREETING = 你好
GREETING = ちわ	GREETING = 好
GREETING = おはよ	GREETING = 早上好
PRINTFORMW 「%TEXTR(@"おおう、こりゃどうも/海外の出か？ %CNAME("二人称")%")%」	PRINTFORMW 「%TEXTR(@"哦哦、谢谢/这是外国的打招呼方式吗？ %CNAME("二人称")%")%」
PRINTFORMW 「ん……%TEXTR("オトコの唇なんて嬉しいか？/躊躇の無い奴……")%」	PRINTFORMW 「ん……%TEXTR("亲着男人的嘴唇高兴吗？/毫不犹豫的家伙……")%」
PRINTFORMW 「ん……%TEXTR(@"いいね、%CNAME("主人")%/%CNAME("二人称")%もなかなかやり手だよな")%」	PRINTFORMW 「唔……%TEXTR(@"不错嘛、%CNAME("主人")%/%CNAME("二人称")%真是有办法呢")%」
PRINTFORMW 「%TEXTR(@"っ、おいおいマジかよ。筋金入りだな%CNAME("二人称")%……/おわっ……%CNAME("二人称")%、マジで変態だな……")%」	PRINTFORMW 「%TEXTR(@"嘶——喂喂，不是真的吧。各种方面来说真是厉害啊%CNAME("二人称")%……/唔哇……%CNAME("二人称")%、真是变态呢……")%」
PRINTFORMW 「%TEXTR(@"おおう……好き者だな、%CNAME("二人称")%/うぉ……やるねぇ……")%」	PRINTFORMW 「%TEXTR(@"哦哦——我就喜欢你这样、%CNAME("二人称")%/唔……继续继续……")%」
PRINTFORMW 「%TEXTR("ちょ、今は駄目だって……/ふぁ……この、変態め")%」	PRINTFORMW 「%TEXTR("等下，现在还不行……/唔唔……你这个、变态！")%」
PRINTFORMW 「ん？ あぁ、%GREETING%」	PRINTFORMW 「嗯？ 啊啊、%GREETING%」
PRINTFORMW 「%TEXTR("おう/よう")%」	PRINTFORMW 「%TEXTR("哦/哟")%」
PRINTFORMW 「んん～……ねみぃ～～……」	PRINTFORMW 「嗯嗯～……呐～～……」
PRINTFORMW その場に突っ伏す%CALLNAME:TARGET%を見かね、部屋に戻るよう勧めた。	PRINTFORMW 看到%CALLNAME:TARGET%回到家就当场趴下了、连忙劝他回自己的房间。
PRINTFORMW 「むぅ～りぃ～、つーれーてーけー」	PRINTFORMW 「不～要～、带ー我ー去ー啦ー」
PRINTFORMW 動こうとする気配もないので、仕方なく%CALLNAME:MASTER%は%CALLNAME:TARGET%を部屋まで運んでやった……	PRINTFORMW 随后就没有了动静、没有办法、%CALLNAME:MASTER%艰难地把%CALLNAME:TARGET%背进了屋里
PRINTFORMW 「%TEXTR("おぉ～、きもちぃ～/熱籠もるんだよスカート……ふぅ～")%」	PRINTFORMW 「%TEXTR("哦哦～、好舒服～/裙底好热啊……呼～")%」
PRINTFORMW 「%TEXTR("ああ、どうも/ん、毎度")%」	PRINTFORMW 「%TEXTR("啊、谢谢/嗯、谢谢")%」
PRINTFORMW 「%TEXTR("ふふっ……相変わらずだな/まぁた調子良いこと言いやがって……")%」	PRINTFORMW 「%TEXTR("呼呼……还是老样子呢/还在说这些好听的话……")%」
PRINTFORMW 「……ふぅん？　なかなか上手じゃん」	PRINTFORMW 「……嗯？　真是熟练呢~」
PRINTFORMW 「くっく……言うねぇ。面白いよ%CNAME("二人称")%」	PRINTFORMW 「唔嗯……别说了。%CNAME("二人称")%真有趣」
PRINTFORMW 「ん……そういやそろそろコミケの時期か……」	PRINTFORMW 「嗯……说起来差不多到了约会的时期了呢……」
PRINTFORMW 「行くのかって？ いやぁ、別にそんな気はないけどなぁ」	PRINTFORMW 「要不要约会呢？ 不、我并没有这种想法」
PRINTFORMW 「何度か行ったことあるけど……あ、客としてな。なんにせよあの環境キツいわ」	PRINTFORMW 「我其实去过几次啦……啊、作为客人来说。那个环境并不是很好呢」
PRINTFORMW 「普段の格好？ あぁ、普通に男物着るぞ。昔よりはまあ着なくなったけど」	PRINTFORMW 「平时的样子？ 啊啊、就穿着普通的男性的衣服啊。不过比起以前来说现在不怎么穿了」
PRINTFORMW 「男の娘の何が得って、何着ても大概ユニセックスなことだからな」	PRINTFORMW 「伪娘的好处的话、不管穿着什么种类的衣服，从性别上来说都是适合自己的」
PRINTFORMW 「他に付き合ってる奴？ ……さてなぁ。どうだと思う？」	PRINTFORMW 「和别人在交往的家伙？ ……谁知道呢。你怎么想的？」
PRINTFORMW 「%TEXTR("マジ？ 助かるー。頼むわー/おー。変なとこ触るなよー")%」	PRINTFORMW 「%TEXTR("真的吗？ 得救啦——。那就拜托咯——/哦——不要摸奇怪的地方哦")%」
PRINTFORMW %CALLNAME:TARGET%は無防備にだらけきった体を%CALLNAME:MASTER%に任せた……	PRINTFORMW %CALLNAME:TARGET%让自己毫无防备地靠近了%CALLNAME:MASTER%了……
PRINTFORMW ……%CALLNAME:TARGET%は鼻で笑うだけだった。	PRINTFORMW ……%CALLNAME:TARGET%从鼻子里发出了笑声，算是回应。
PRINTFORMW 「お、なんだ来てたのか。勝手に借りてるぜ」	PRINTFORMW 「哦、你怎么来了。我随便借来用的。」
PRINTFORMW 「バッキャロ、これ以上は無しだ」	PRINTFORMW 「笨蛋、不会给你这种机会的」
PRINTFORMW %CALLNAME:TARGET%は%CALLNAME:MASTER%の頭を手でぐいと押して遠ざけた。	PRINTFORMW %CALLNAME:TARGET%用手把%CALLNAME:MASTER%的头推开了。
PRINTFORMW 「男の股座なんかじろじろ見てて楽しいのかねぇ」	PRINTFORMW 「盯着男人的胯部一直看也会感到开心啊」
PRINTFORMW 「楽しいか？ 楽しいだろうなぁ。文字通り自分の女にしてやった相手の股座だもんなぁ」	PRINTFORMW 「开心吗？ 楽很开心吧。就像你看到的那样，是给自己的女人锁看的对方的胯部呢。」
PRINTFORMW 「なっ、おいテメっ……なに勝手に見てんだよ」	PRINTFORMW 「什、、喂！你这家伙……在随便看些什么？！」
PRINTFORMW %CALLNAME:TARGET%は足を振り回し、%CALLNAME:MASTER%を追い払った。	PRINTFORMW %CALLNAME:TARGET%不断摆动着双腿、把%CALLNAME:MASTER%赶走了。
PRINTFORMW 「どーよ。ちゃんと女\@ TALENT:オトコ ? 物 # の子 \@だろ？」	PRINTFORMW 「怎样。来好好看看女\@ TALENT:オトコ ? 孩子的东西 # 孩子 \@だろ？」
PRINTFORMW 「……おーい、いつまで楽しんでんだよ」	PRINTFORMW 「……喂、要一直享受到什么时候啊」
PRINTFORMW %CALLNAME:MASTER%の視線に堪えきれなくなってきたのか、%CALLNAME:TARGET%は目を逸らした。	PRINTFORMW 无法继续忍受%CALLNAME:MASTER%的视线、%CALLNAME:TARGET%把目光移开了。
PRINTFORMW 「ん～？ %CNAME("一人称")%になんか用か？」	PRINTFORMW 「嗯～？ %CNAME("一人称")%有什么需要我的地方吗？」
PRINTFORMW %CALLNAME:TARGET%はニヤニヤと笑っている……	PRINTFORMW %CALLNAME:TARGET%轻轻的笑着……
PRINTFORMW 「ほーれ。これで満足か？」	PRINTFORMW 「吼吼。这样就满足了吗？」
PRINTFORMW 「%TEXTR(@"飽きないねえ、%CNAME("二人称")%……/うん……ま、気に入ってくれてんのは結構だけど")%」	PRINTFORMW 「%TEXTR(@"不会厌倦的吗、%CNAME("二人称")%……/唔……嘛、虽然我不讨厌你这样")%」
PRINTFORMW 「んん……」	PRINTFORMW 「嗯嗯……」
PRINTFORMW %CALLNAME:TARGET%は力無く手を振って抗議の意思を示している。	PRINTFORMW %CALLNAME:TARGET%无力地挥动着手臂表示抗议。
PRINTFORMW 「おおっ？ 何しやがんだこのヤロー」	PRINTFORMW 「哦哦？ 这是要做什么？」
PRINTFORMW 咄嗟に手を払われたが、当人は笑っている……	PRINTFORMW 虽然马上就被甩开了手，但是当事人却在笑着……
PRINTFORMW 「おまっ……なかなかご挨拶じゃねえか」	PRINTFORMW 「你这家伙……不准备打个招呼吗」
PRINTFORMW 「ばッ……」	PRINTFORMW 「叭……」
PRINTFORMW 文字通り無防備な様を見られ、%CALLNAME:TARGET%はしばし硬直したかと思うと、顔を赤くして目を逸らした。	PRINTFORMW %CALLNAME:TARGET%就像你看到的那样毫无防备、身体僵硬着思考了一下、红着脸移开了视线。
PRINTFORMW 「……こっちのタイミングってもんがあるだろうが」	PRINTFORMW 「……这就是所谓的时机吗」
PRINTFORMW 「%TEXTR("わ、やりやがったなてめぇ/まーた始まったよコイツめ")%」	PRINTFORMW 「%TEXTR("哇、你真的想干啊/这才刚刚开始哦")%」
PRINTFORMW 「おーい、今度ヒマか？ デートしようぜ、デート」	PRINTFORMW 「喂————、现在有空吗？ 来一起约会吧、约会」
PRINTFORMW 「やりぃ！ じゃ、日曜な。寝坊すんなよ？」	PRINTFORMW 「好啊！！ 那么、星期天约会吧。可别睡过头了哦？」
PRINTFORMW 「なんだよ、ヒマなくせに」	PRINTFORMW 「什么嘛、明明闲得很嘛」
PRINTFORMW 「ふぅん……%CNAME("一人称")%以外の奴を優先するんだ……」	PRINTFORMW 「呼呼……%CNAME("一人称")%以外的家伙优先和我约会哦……」
PRINTFORMW 「なーんつって。それじゃまた今度な」	PRINTFORMW 「那么下次再见咯」
PRINTFORMW 「%TEXTR("ああ、いいぜ/デート？ いいけど")%」	PRINTFORMW 「%TEXTR("啊啊、好啊/约会？ 可以是可以")%」
PRINTFORMW ……二つ返事だった。	PRINTFORMW ……回答了两次呢。
PRINTFORMW 「%TEXTR("え、ちょ、弁当？ マジで？/げっ、マジかよ……外食ダメ？")%」	PRINTFORMW 「%TEXTR("诶、等下、便当？ 真的吗？/咳、不会是真的吧……不能在外面吃饭吗？")%」
PRINTFORMW 「あー、わかったわかった。」	PRINTFORMW 「啊ー、我知道了我知道了。」
PRINTFORMW 「あぁ？ デートぉ？」	PRINTFORMW 「啊？ 约会？」
PRINTFORMW 「なんだよ、今日はゆっくりしてようと思ったのに……」	PRINTFORMW 「什么嘛、我今天本来是想休息的……」
PRINTFORMW 口では文句を言いながら、%CALLNAME:TARGET%はいそいそと外出の準備を始めた。	PRINTFORMW 虽然%CALLNAME:TARGET%嘴上还在抱怨着、但已经在兴冲冲地做着外出的准备了。
PRINTFORMW 『デートぉ？ 今から？』	PRINTFORMW 『约会？ 现在吗？』
PRINTFORMW 『まぁいいけどよ……普通に遅れるからな。おとなしく待ってろよ？』	PRINTFORMW 『可以是可以拉……不过我可能会迟到哦。你能乖乖等我一会吗？』
PRINTFORMW 「%TEXTR("やー、楽しかったなぁ。満足まんぞく/もうこんな時間か……早いもんだ")%」	PRINTFORMW 「%TEXTR("呀——、真开心啊。心满意足啦/已经是这个时间了吗……时间过得可真快啊")%」
PRINTFORMW %CALLNAME:TARGET%は笑みを浮かべながら、ちらと流し目を送ってきた……	PRINTFORMW %CALLNAME:TARGET%脸上带着满满的笑容、稍微瞟了我一眼……
PRINTFORMW 「%TEXTR(@"やー終わった終わった。だいぶ疲れちまったなぁ/ふー。結構遊んだなぁ%CNAME("一人称")%たち")%」	PRINTFORMW 「%TEXTR(@"呀——结束了结束了。真是相当的累啊/呼ー。%CNAME("一人称")%你这家伙玩的可真好啊")%」
PRINTFORMW 「どうする？ このまま帰っちまうか？」	PRINTFORMW 「接下来呢？ 就这样回去吗？」
PRINTFORMW %CALLNAME:TARGET%は含みのある表情で%CALLNAME:MASTER%を見ている……	PRINTFORMW %CALLNAME:TARGET%带着含蓄的表情看着%CALLNAME:MASTER%……
PRINTFORMW %CALLNAME:MASTER%の誘いを聞くと、%CALLNAME:TARGET%はにかっと笑って%CALLNAME:MASTER%の手を取った。	PRINTFORMW 听到了%CALLNAME:MASTER%的邀请、%CALLNAME:TARGET%哈哈一笑，握住了%CALLNAME:MASTER%的手。
PRINTFORMW 「そうこなくちゃ」	PRINTFORMW 「当然要来了」
PRINTFORMW 「%TEXTR("仕方ねえなあ……/言うと思ったぜ")%」	PRINTFORMW 「%TEXTR("没办法了呢……/我还想你会说点什么呢")%」
PRINTFORMW %CALLNAME:TARGET%はさっと%CALLNAME:MASTER%に腕を絡ませてきた。	PRINTFORMW %CALLNAME:TARGET%快速地用胳膊缠住了%CALLNAME:MASTER%的手臂。
PRINTFORMW 「行こうか？」	PRINTFORMW 「走吧？」
PRINTFORMW 「ん、%TEXTR("そっか/わかった")%」	PRINTFORMW 「嗯、%TEXTR("这样啊/我明白了")%」
PRINTFORMW 「%TEXTR("あ、そう？ じゃあいいや/ふーん？ まあいいけど")%」	PRINTFORMW 「%TEXTR("啊、这样吗？ 那好吧/呼——嗯？ 嘛也行吧")%」


//EVENT_K35_LONG.ERB
PRINTFORMW ある日の昼下がりのこと。	PRINTFORMW 那是一天下午发生的事情。
PRINTFORMW たまたま%CALLNAME:TARGET%と二人きりになった%CALLNAME:MASTER%は、自分の胸を背もたれに使う%CALLNAME:TARGET%を受け入れ、穏やかな時間を過ごしていた。	PRINTFORMW 刚好那个时候只有%CALLNAME:TARGET%和%CALLNAME:MASTER%两个人在、%CALLNAME:TARGET%从后面抱住了%CALLNAME:MASTER%，贴在了%CALLNAME:MASTER%的背上、两个人就这样度过着平静的时光。
PRINTFORMW 「こうしてると恋人同士みたいだなぁ」	PRINTFORMW 「我们现在这样就像是一对恋人一样啊」
PRINTFORMW 「……恋人同士なのか」	PRINTFORMW 「……一对恋人吗」
PRINTFORMW 自分の言葉にふっと笑い、%CALLNAME:TARGET%は%CALLNAME:MASTER%の腕に寄りかかる。	PRINTFORMW 听了自己说出来的话突然笑了笑、随后%CALLNAME:TARGET%又倚靠在%CALLNAME:MASTER%的手臂上。
PRINTFORMW 「こんなことしたことないから、すっごく新鮮だ」	PRINTFORMW 「我还从来没做过这样的事情、感觉还挺新鲜的」
PRINTFORMW 一度もしたことがないのかと聞き返すと、きっぱりと答えが帰ってきた	PRINTFORMW 我疑惑地反问是否真的一次都没做过、立马就得到了坚定的回答
PRINTFORMW 「なかったよ。一度もなかった」	PRINTFORMW 「没有哦。一次都没有过」
PRINTFORMW 「恋人だと思える奴なんて、今まで一人もいなかったからな。%CNAME("二人称")%が初めてだよ」	PRINTFORMW 「被我当做过恋人的人、到现在都没有过一个。%CNAME("二人称")%是第一位哟」
PRINTFORMW %CALLNAME:TARGET%は僅かにだけ躊躇いを見せると、やがて温度のない言葉を吐き出すように昔話をはじめた。	PRINTFORMW %CALLNAME:TARGET%稍稍犹豫了一下、过了一会儿、开始不带任何感情色彩的讲起了一些话。
PRINTFORMW 「中学の頃にさ、初めて告白されたんだよ。男だった」	PRINTFORMW 「初中的时候、遇到了第一个向我表白的人。是一个男生」
PRINTFORMW 「普通にイケメンだし、いいヤツだったし……女子にも人気あってさ。そいつが%CNAME("一人称")%に話があるって。聞いてみたら告白だったんだ」	PRINTFORMW 「是一个很普通的帅哥呢、也是一个好家伙……在女孩子中也很有人气。突然说有话要和%CNAME("一人称")%说。问了一下才知道是要向我表白」
PRINTFORMW 「勿論断ったよ。男同士とか無理だって。それで話はお終いだったんだけど……マズいことにその告白、他人に聞かれてたんだ」	PRINTFORMW 「我当然是拒绝了。和男人在一起什么的当然是不行的。然后这个事情就到此结束了……但是发生了糟糕的事情、那个告白被别的人听到了」
PRINTFORMW 「なんつーか、そのイケメンに片思いしてた女みたいでさ……ショックだったんだろうな。告白のこと、クラスでいきなり暴露しやがった」	PRINTFORMW 「怎么说呢、我想大概是那个暗恋那位男生的某位女孩子……受到了不小的打击吧。告白这件事、就在班级里传开了」
PRINTFORMW 「おかげで色々言われまくったよ。大体キモいだったけど。前から付き合ってたのかとか、もうキスしたのかとか、散々からかわれた」	PRINTFORMW 「托这个事情的福、我被说了很多。大概像是什么真是恶心啦。之前是不是和别的人交往过啦、难道说之前已经有过接吻的经历了、我是被这些话打了个落花流水呢..」
PRINTFORMW 「%CNAME("一人称")%だけじゃなくて、相手の男の方もさ。特に例の暴露した女が中心になってイジメみたいになって……」	PRINTFORMW 「不仅如此、那个男人也一样。以那个特别暴露的女人为中心，也开始欺凌%CNAME("一人称")%了……」
PRINTFORMW 「今は男の方もかわいそうだと思うけどさ……あの頃はどっちも恨んでた。普通に生きてたつもりなのに、突然人生メチャクチャにされたから」	PRINTFORMW 「现在感觉那个男人也很可怜啊……虽然那个时候我谁都怨恨。本来是想过着普通的生活、结果突然间人生就因为这件事变得一团糟」
PRINTFORMW 「幸いすぐにこっちに転校が決まって、そのまま連中とは切れたんだけど……だからって何もかも元通りになれるわけないだろ？」	PRINTFORMW 「幸运的是我很快就决定了转校、就这样和那里的所有人斩断了关系……但是不是所有东西都能回复原样的吧？」
PRINTFORMW 「特に恋なんてさ……トラウマだよ。この先%CNAME("一人称")%に普通の恋愛ができるのかって、信じられなくなってた」	PRINTFORMW 「特别是恋爱这方面……就像是精神创伤啊。对于之后%CNAME("一人称")%可以谈一场普通的恋爱这件事、我都觉得应该是不可能的了、已经不抱有希望了」
PRINTFORMW 「何が悪かったんだろうって――まあ運なんだけど。あの頃そうとう真面目に悩んで、鏡の前に立ってみてさ。やっぱ顔かなって思ったんだ」	PRINTFORMW 「到底是哪里做的不好呢――我一直以来运气还不错。那个时候真的是非常认真的在苦恼着这个问题、就那样站在镜子前审视着自己。果然还是这张脸吧」
PRINTFORMW 「気になってはいたんだよ。%CNAME("一人称")%って男らしくないなって。男に告白されるレベルだもんなって」	PRINTFORMW 「我一直也很在意这一点。%CNAME("一人称")%是完全没有男子汉气概了。甚至已经到了被男生表白的地步」
PRINTFORMW 「だからってどうもしなかったけどさ。いきなり筋肉達磨になれるほど元気じゃないし」	PRINTFORMW 「话虽如此我也并没有突然拼命锻炼到变成肌肉壮汉这种程度」
PRINTFORMW 「……なれたら笑い話で済んだんだけどな」	PRINTFORMW 「……如果是这样的话、就当笑话结束也不错呢」
PRINTFORMW 「ある日、リビングに女用の制服が放ってあった」	PRINTFORMW 「也是有一天吧、我看到客厅里放着一件女式的制服」
PRINTFORMW 「妹が着替えてそのままにしてた奴だ」	PRINTFORMW 「是我妹妹换下来放在那里的」
PRINTFORMW 「家族はみんな留守にしてた」	PRINTFORMW 「那个时候刚好家人们都不在家」
PRINTFORMW 「魔が差したんだ」	PRINTFORMW 「鬼使神差般的」
PRINTFORMW 「すぐにそれ持って部屋に引っ込んだ」	PRINTFORMW 「我马上就拿着那件衣服回到了自己的房间」
PRINTFORMW 「着替えてみて、鏡で自分の姿を見てみた」	PRINTFORMW 「抱着试一下的心理、我换上了这套衣服、然后看着镜子中自己的样子」
PRINTFORMW 「なんて思ったかわかるか？」	PRINTFORMW 「你知道我是怎么想的吗？」
PRINTFORMW 「きっと軽蔑するぜ、%CNAME("二人称")%」	PRINTFORMW 「说出来%CNAME("二人称")%肯定会鄙视我的吧」
PRINTFORMW 「――あの女より可愛いじゃんって思ったんだ」	PRINTFORMW 「――我这不是比那个女孩子还要可爱的多吗？」
PRINTFORMW 穏やかな鳥の声が、立ち消えるように遠ざかった。	PRINTFORMW 窗外的鸟儿平静的叫声、慢慢的消失了。
PRINTFORMW 暑苦しい蝉の声が、耳鳴りに掻き消されていった。	PRINTFORMW 烦闷的蝉声、开始被耳鸣声掩去了。
PRINTFORMW 囁くような鈴虫の声が、風にさらわれたように消え去った。	PRINTFORMW 小虫子的低声喧闹声、像是随着风一样飞走消失了。
PRINTFORMW 窓を揺らす空っ風の音が、眠りにつくように静まり返った。	PRINTFORMW 吹动着玻璃的风声、像是睡觉了一样安静了下来。
PRINTFORMW 「それから自分の女装姿を、少しずつ他人に見せびらかすようになった。自分の身の回りより遠いところから、少しずつ」	PRINTFORMW 「从那之后我就打扮成女孩子的样子、从离自己在的地方稍远一点的地方开始、渐渐地向别人开始炫耀」
PRINTFORMW 「可愛いって言われる度に愉快で仕方がなかった。あの女に意趣返ししてるみたいに思えてさ」	PRINTFORMW 「每次被人说可爱的时候、我都开心的不得了。就好像是在反击当初的那个女生一样」
PRINTFORMW 「けど、そのうちなんだか白けてきたんだ。結局のところ、みんな他人だから気軽にそう言ってるだけじゃないかって」	PRINTFORMW 「但是、过了一会儿总觉得开始没意思了。归根结底、因为大家都是外人才会这样夸奖我的吧」
PRINTFORMW 「だから試したくなった。本気っぽい奴を見つけて、本当なのか確かめたくなったんだ。……それが%CNAME("一人称")%の初体験」	PRINTFORMW 「所以我想试一试。找到一个人认真的人、确认一下我的真实情况。……这就是%CNAME("一人称")%的初体验」
PRINTFORMW 「終わってからやっと気付いたよ。他人を疑って――ナメてかかって、本気になれてないのは%CNAME("一人称")%の方だって」	PRINTFORMW 「直到最后结束我才发现。怀疑别人――怀疑自己、没有认真起来的其实是%CNAME("一人称")%这一方啊」
PRINTFORMW 「それからも何度か本気になれる相手はいないかって探したけど……誰とも長続きしなかった」	PRINTFORMW 「在那之后我找了很多次、想看有没有能认真对待的人……结果和谁也没能长久下去」
PRINTFORMW 「だから、今回で最後にするつもりだった」	PRINTFORMW 「所以、这次是最后一次了」
PRINTFORMW %CALLNAME:TARGET%がゆっくりと顔をもたげた。	PRINTFORMW %CALLNAME:TARGET%慢慢地抬起了头。
PRINTFORMW 「ごめんな。%CNAME("一人称")%、たぶん取り引きがしたくて%CNAME("二人称")%に会いに来たんじゃないんだ」	PRINTFORMW 「对不起呢。%CNAME("一人称")%啊、本来我是想做个交易才来找%CNAME("二人称")%的。」
PRINTFORMW 「きっと自分をドブに捨てる為にやってきたんだよ」	PRINTFORMW 「但我一定是把自己推向了深渊吧」
PRINTFORMW 「じゃなきゃ悪魔の取り引きなんて怪しい話、軽々しく首を突っ込むわけないもんな」	PRINTFORMW 「不然的话、和恶魔交易这种听起来就可疑的事情、我怎么可以轻易的插手呢」
PRINTFORMW %CALLNAME:TARGET%はそこで言葉を切って、%CALLNAME:MASTER%の腕を弱々しく掴んだ。	PRINTFORMW %CALLNAME:TARGET%突然间停止了发言、轻轻地握住了%CALLNAME:MASTER%的手腕。
PRINTFORMW 「……それでも、%CNAME("一人称")%と恋人でいてくれるか？」	PRINTFORMW 「……就算如此、能请%CNAME("一人称")%做我的恋人吗？」
PRINTFORMW 「もし断られたら――泣くよ、やっぱり。すげぇみっともなく」	PRINTFORMW 「如果被拒绝的话――我会哭的、一定会的。尽管那样会变的很难看」
PRINTFORMW 「たぶんこの先、%CNAME("二人称")%以上の女に会える幸運なんて残ってないから」	PRINTFORMW 「或许在这之后、我再也没有幸运能遇到能比得上%CNAME("二人称")%的女生了」
PRINTFORMW 「%CNAME("二人称")%と一緒にいられるなら、お互いどんな姿だろうと構わないよ」	PRINTFORMW 「如果能和%CNAME("二人称")%在一起、不管你是什么样子，我都没关系」
PRINTFORM ――彼を優しく抱きしめると、遠ざかっていた	PRINTFORM ――我温柔地搂着他、渐渐地走远
PRINTFORM 鳥の声が	PRINTFORM 小鸟的叫声
PRINTFORM 蝉の声が	PRINTFORM 蝉的叫声
PRINTFORM 虫の声が	PRINTFORM 虫鸣声
PRINTFORM 風の音が	PRINTFORM 风的声音
PRINTFORMW 戻ってきたようなような気がした。	PRINTFORMW 感觉好像又回来了。




PRINTFORML 「あなたが%CNAME(CSVNAME_ACTOR)%ですね。%CNAME("一人称")%は%CALLNAME:TARGET%です」	PRINTFORML 「你就是%CNAME(CSVNAME_ACTOR)%对吧。%CNAME("一人称")%叫%CALLNAME:TARGET%」
PRINTFORML 「……あの、一つ聞いていいですか？」	PRINTFORML 「……那个、我可以问一个问题吗？」
PRINTFORML 「%CNAME(CSVNAME_ACTOR)%がいろんな人と……その……エッチしてると聞いたことあるんですが……」	PRINTFORML 「听说%CNAME(CSVNAME_ACTOR)%和各种各样的人……嗯……做了h的事情……」
PRINTFORML 「……本当ですか……」	PRINTFORML 「……是真的吗……」
PRINTFORML 「……分かりました。%CNAME("一人称")%が%CNAME(CSVNAME_ACTOR)%を監視します」	PRINTFORML 「……我明白了。那么%CNAME("一人称")%要对%CNAME(CSVNAME_ACTOR)%进行监视」
PRINTFORML 「他人のこと言えないと言われても否定できないのも確かですが……」	PRINTFORML 「确实、即使对方说不出口、也不能就此否认呢……」
PRINTFORM 「それはともかく、	PRINTFORM 「那个姑且不论、
PRINTFORML 覚悟してくださいよ？」	PRINTFORML 至少从现在开始还请做好觉悟哦？」
PRINTFORML 『これはだな……』	PRINTFORML 『这个是错的啊……』
PRINTFORML 「……ああ！　この答えはこうなんですね！　つまり……」	PRINTFORML 「……啊啊！　这里的答案应该是这样的嘛！　也就是说……」
PRINTFORML 「……あ、このスカートかわいいですね、他にも……」	PRINTFORML 「……啊、这条裙子好可爱啊、其他的也……」
PRINTFORML 『え、い、いきなりどこへ行くつもりだ……』	PRINTFORML 『啊、突、突然想去哪里啊……』
PRINTFORML 「え？ 決まってるじゃないですか、更衣室ですよ。%CNAME(CSVNAME_ACTOR)%に似合う服を探すための」	PRINTFORML 「诶？ 不是已经决定好了吗、要去更衣室哟。要给%CNAME(CSVNAME_ACTOR)%找一件合适的衣服」
PRINTFORML 『ちょっ……！ だ、誰か助けてくれえええええぇぇぇぇぇ……』	PRINTFORML 『等……！ 谁、谁来帮帮我啊啊啊啊啊啊啊……』
PRINTFORML 『うーん……』	PRINTFORML 『唔嗯……』
PRINTFORML 「？ どうしたんですか？」	PRINTFORML 「？ 怎么了？」
PRINTFORML 『いや、化粧が崩れてきてな』	PRINTFORML 『不、只是化的妆掉了呀』
PRINTFORML 『いつもは化粧ポーチも家から持ってくるんだが、今日に限って家に忘れちまって』	PRINTFORML 『平时都会从家里带来化妆包的、只有今天忘在家里了』
PRINTFORML 「なるほど……あ、それなら%CNAME("一人称")%の使いますか？」	PRINTFORML 「原来如此……啊、那么要不要用%CNAME("一人称")%的呢？」
PRINTFORML 「いつも、という訳ではないんですが、たまにお化粧をすることがあるので、そういう時のために持ってきてるんです」	PRINTFORML 「并不是一直都会带着化妆的东西啦、不过偶尔也会有需要化妆的时候、就是为了那种时候所以才偶尔带着啦」
PRINTFORML 『ほー……ならお言葉に甘えて、と……』	PRINTFORML 『好ー……那就恭敬不如从命了、嗯……』
PRINTFORML 『……お！ このアイシャドウ……』	PRINTFORML 『……哦！ 这个眼影……』
PRINTFORML 「え、もしかして%CNAME(CSVNAME_ACTOR)%も使ってるんですか！？」	PRINTFORML 「诶、难道说%CNAME(CSVNAME_ACTOR)%也在用这个吗！？」
PRINTFORML 「これいいですよね！ 安いのに長持ちしますし肌へのダメージも少な目で……」	PRINTFORML 「这个相当不错吧！ 既便宜又耐用、而且对皮肤的伤害也很少呢……」
PRINTFORML 『そうそう！しかも……』	PRINTFORML 『对对！而且……』
PRINTFORML 「あ、試しに%CNAME(CSVNAME_ACTOR)%の化粧ポーチを試させてもらってもいいですか？」	PRINTFORML 「啊、可以稍微用一下%CNAME(CSVNAME_ACTOR)%的化妆包吗？」
PRINTFORML 『おう、いいぞー』	PRINTFORML 『哦哦、好啊ー』
PRINTFORML 「……あ、はい、化粧水です」	PRINTFORML 「……啊、给、这是化妆水」
PRINTFORML 『おう、ありがと……しかしよく分かったな。化粧水切らしたって』	PRINTFORML 『哦、谢谢……但是我知道。化妆水已经用完了』
PRINTFORML 「なんだかいつもより手際が悪い感じでしたから……」	PRINTFORML 「总觉得手法要比平时的差一些啊……」
PRINTFORML 「そういえば、%CNAME(CSVNAME_ACTOR)%ってナチュラルなメイクが多いですよね。服装的にもう少し濃くしても似合いそうですが……」	PRINTFORML 「这么说来、%CNAME(CSVNAME_ACTOR)%っ好像大多数都是这种非常自然的妆容呢。在服装打扮上再稍微浓艳一些也很合适哦……」
PRINTFORML 『ん？ こんぐらいの方が男ウケがいいんだよ』	PRINTFORML 『嗯？ 这种程度的话会更受男人的欢迎哦』
PRINTFORML 「この撮り方をしたいなら、もう少し顔の角度を下げて……」	PRINTFORML 「如果想这样拍照的话、要再把脸的角度稍微放低一点……」
PRINTFORML 『ほうほう……』	PRINTFORML 『哼哼……』
PRINTFORML 「……もう、またそんなことして……」	PRINTFORML 「……真是的、又做了那样的事情……」
PRINTFORML 『別にいーじゃん、減るモンでもないんだし』	PRINTFORML 『没什么关系啦、又不会损失什么东西』
PRINTFORML 「そ、そういう問題じゃありません！ そ、その、いくら何でも不純異性交遊は……」	PRINTFORML 「不、不是这个问题啊！ 那、那个、不管怎么看都是不纯异性交往吧……」
PRINTFORML 『こんなヤリサーに入ってる%CNAMET(ACTOR, "二人称")%が言えることじゃないだろー』	PRINTFORML 『这种有着专利权一样的话不是%CNAMET(ACTOR, "二人称")%能说出来的吧ー』
PRINTFORML 「うっ！ そ、それは……」	PRINTFORML 「唔！ 那、那是……」