
//ERB\EVENT_K\37 グレイス\EVENT_K37_グレイス.ERB

LOCALS = わたくし_わたくし	LOCALS = 我_我
LOCALS = 貴方_あなた	LOCALS = 你_你
LOCALS = 貴女_あなた	LOCALS = 你_你
LOCALS = ご主人様_ごしゅじんさま	LOCALS = 主人_主人大人
LOCALS = %CALLNAME:PLAYER%先生_%CSTR:PLAYER:ふりがな%せんせい	LOCALS = %CALLNAME:PLAYER%老师_%CSTR:PLAYER:ふりがな%老师
LOCALS = %CALLNAME:ASSI%先生_%CSTR:ASSI:ふりがな%せんせい	LOCALS = %CALLNAME:ASSI%老师_%CSTR:ASSI:ふりがな%老师
LOCALS = %CALLNAME:PLAYER%さん_%CSTR:PLAYER:ふりがな%さん	LOCALS = %CALLNAME:PLAYER%同学_%CALLNAME:PLAYER%同学
LOCALS = %CALLNAME:ASSI%さん_%CSTR:ASSI:ふりがな%さん	LOCALS = %CALLNAME:ASSI%同学_%CSTR:ASSI:ふりがな%同学
%CALLNAME:MASTER%の隣のクラスに編入された生徒で、風の精霊の力をその身に宿した少女。	被编入%CALLNAME:MASTER%隔壁班级的学生，是个身体里寄宿着风精灵之力的少女。
見事な色艶の髪と雪のように白い肌、整ったスタイルと容姿の良さが目を引くが、最大の特徴は自信に満ち溢れたお嬢様っぽい独特な口調と、やたら高いテンションである。	光泽艳丽的华美秀发如雪一般洁白的肌肤，端正的身材和美丽的容貌吸引着人们的目光，其最大的特点变是满溢着自信的大小姐风范的独特语气，以及无时不刻高涨的情绪。
見た目と裏腹に明るく活発な性格や妙な懐の深さ、時折見せる奇行や迷言から何だかんだで人気はある…らしい。	与外表正相反，有着活泼开朗的性格和格外广阔的胸怀。偶尔会做出的奇妙言行也迷之有人气…的样子。
PRINTFORMW 「あら、%CNAME("二人称")%は隣のクラスの…お待たせしてごめんなさい」	PRINTFORMW 「啊啦、%CNAME("二人称")%是隔壁班的那个…让你久等了不好意思」
PRINTFORMW 「それで？%CNAME("一人称")%に何の御用かしら？」	PRINTFORMW 「所以？找%CNAME("一人称")%有什么事？」
PRINTFORMW 部室に呼び出された%CALLNAME:ARG%は首を傾げながら屈託の無い笑顔を向けて来る。	PRINTFORMW 被叫到部室来的%CALLNAME:ARG%歪着脑袋，露出了毫无心机的笑容。
PRINTFORML %CALLNAME:MASTER%は自分の体質や、%CALLNAME:ARG%の正体を知っていることなどを話した。	PRINTFORML %CALLNAME:MASTER%坦白了自己的特殊体质，以及自己已经知道了%CALLNAME:ARG%的真实身份这两件事。
PRINTFORMW 「魂を失っても再生する体質ですって！？…やっぱりあの風の噂は本当でしたのね！」	PRINTFORMW 「失去了魂也可以再生的体质！？…果然那个传言是真的啊！」
PRINTFORMW 「それに%CNAME("一人称")%の正体を知っているだなんて…%CNAME("二人称")%、只者ではありませんわね…！」	PRINTFORMW 「而且还知道了%CNAME("一人称")%的真实身份…%CNAME("二人称")%，不是泛泛之辈哇…！」
PRINTFORMW 「ええ、ええッ、皆まで言わなくてもわかりますわ！」	PRINTFORMW 「嗯，嗯，不用大家说%CNAME("一人称")%也知道哇！」
PRINTFORMW 「こんな最ッ高に面白そうな事、ほおっておくわけがないでしょう？！」	PRINTFORMW 「这样超棒超有趣的事情，怎么能够放着不管呢？！」
PRINTFORMW 「良いですわ！何が望みか知りませんがこの%CALLNAME:ARG%、トコトン付き合ってあげますわよ！」	PRINTFORMW 「好的哇！虽然不知道在打什么算盘，但是就由%CALLNAME:ARG%，来奉陪到底哇！」
PRINTFORMW 「と言う訳で、これからよろしくお願いいたしますわッ！！」	PRINTFORMW 「综上所述，今后就请多多关照了哇！！」
PRINTFORMW …全て話し終わる前に%CALLNAME:ARG%は勝手にテンションが上がり勝手に納得してくれたようだ…。	PRINTFORMW …在话还没说完之前%CALLNAME:ARG%就自己突然变得情绪高涨起来，然后随意地就接受了的样子…。
PRINTFORMW 満面の笑みを浮かべた%CALLNAME:ARG%はスベスベした両手で%CALLNAME:MASTER%の手をがっちりと握り力強い握手をしてきた…。	PRINTFORMW 笑容满面的%CALLNAME:ARG%用光洁的双手用力地握住了%CALLNAME:MASTER%的手使劲地上下摇晃…。
PRINTFORMW 「それで、ここでは何をするんですの？」	PRINTFORMW 「说起来、这里是做什么的呢？」
PRINTFORMW 「ゲーム大会？お茶会？何でもドンと来いですわ！」	PRINTFORMW 「游戏大会？茶会？不管是什么都好放马过来吧！」
PRINTFORMW 「えっ？せっくす？…つまりは…ヤリサー…ですの？」	PRINTFORMW 「欸っ？zuoai？…也就是说…是性活动社团…的意思？」
PRINTFORMW 「そ…そ……そっ………それは………」	PRINTFORMW 「这…这……这………这还真是………」
PRINTFORMW 「何だか面白そうですわ！！」	PRINTFORMW 「感觉好有意思啊！！」
PRINTFORMW 「つまり%CNAME("二人称")%や可愛い女性のあーんな姿やこーんな姿が見られるんですのね！」	PRINTFORMW 「也就是说可以看到%CNAME("二人称")%和可爱的女孩子这样那样的样子吗！」
PRINTFORMW 「それに%CNAME("一人称")%もあんな事やこんな事をされて…キャーッ！破廉恥ですわぁ！」	PRINTFORMW 「而且%CNAME("一人称")%也会被做这样那样的事情…咿呀ーッ！真是不知羞耻哇——！」
PRINTFORMW ズッコケる%CALLNAME:MASTER%を尻目に、%CALLNAME:ARG%はほんのり紅く染まった頬に手を当てて一人で照れている…。	PRINTFORMW 一边偷瞄着有些无语的%CALLNAME:MASTER%，%CALLNAME:ARG%用手遮住了微微泛红的脸颊独自一人难为情着…。
;PRINTFORMW %NAME:ARG%は%CALLNAME:MASTER%の"%CSTR:ARG:関係%"として、(昼)の部室に顔を出してくれます。	;PRINTFORMW %NAME:ARG%作为%CALLNAME:MASTER%的"%CSTR:ARG:関係%"，会开始在(昼)の部室里露面了。
PRINTFORML %CALLNAME:ARG%に用意された部屋には、彼女がわざわざ実家から持ってきた家具が多数置かれている。	PRINTFORML 在为%CALLNAME:ARG%提供的房间里、她放置了许多特意从老家带过来的家具。
PRINTFORML その中でも、綺麗に手入れされたティーセットと銀食器がきっちり収められた棚が一際目を引く。	PRINTFORML 其中，保养良好的茶具和收纳有银制餐具的橱架最为引人注目。
PRINTFORML また%CALLNAME:ARG%の力故か、室内にも関わらず常に心地良い風が吹いている。	PRINTFORML 似乎是%CALLNAME:ARG%能力的缘故，虽然是在室内却一直有舒适的清风在轻轻地吹拂着。
PRINTFORMW 「ついに%CNAME("一人称")%も%CNAME("二人称")%の手籠めにされてしまいますのね…」	PRINTFORMW 「最终连%CNAME("一人称")%也没有逃出%CNAME("二人称")%的魔掌呢…」
PRINTFORMW 「あぁ…きっとあ～んなことや、こ～んなことをたくさんされてしまって…」	PRINTFORMW 「啊啊～…肯定会被做很多那～样的事情和，这～样的事情吧…」
PRINTFORMW 「いやぁんっ♪破廉恥ですわぁっ♪」	PRINTFORMW 「讨厌呀～♪真不害臊哇♪」
PRINTFORML 妄想を嵐のように荒れ狂わせ、照れながら頬に手を当てながら身体をくねらせる%CALLNAME:TARGET%に	PRINTFORMW 你看着被狂风暴雨般汹涌的妄想侵袭，一边害羞地用手遮住了脸一边轻扭着身体的%CALLNAME:TARGET%
PRINTFORMW 軽い頭痛を覚えつつも、%CALLNAME:MASTER%は彼女の男好きのする身体をモノにすべくベッドに押し倒した…。	PRINTFORMW 虽然感觉有些头疼，但%CALLNAME:MASTER%为了得到她那足以令男人痴狂的身体，还是将她推倒在了床上…。
PRINTFORMW 「あっ、言い忘れてましたけど%CNAME("一人称")%生娘ですので…優しくしてくださいましっ♪」	PRINTFORMW 「啊——，忘记说了，%CNAME("一人称")%还是处女所以…请对我温柔一些♪」
PRINTFORMW 「あっ、%CNAME("二人称")%！今日の逢瀬の時間ですわね？」	PRINTFORMW 「啊——，%CNAME("二人称")%！到了今天的幽会时间了吗？」
PRINTFORMW 「丁度良いですわ、試したいことがあるので下を脱いでくださいませ。さぁ、早く！」	PRINTFORMW 「正好哇，我有个东西想试一下，请把衣服脱掉吧。来、快点！」
PRINTFORMW 強い語気でせがまれるままに晒された%CALLNAME:MASTER%の性器に、%CALLNAME:TARGET%は真剣な顔で相対する。	PRINTFORMW 被强硬的语气催促在露了出来的%CALLNAME:MASTER%的性器，和%CALLNAME:TARGET%认真的面庞相对着。
PRINTFORMW %CALLNAME:TARGET%は触れるか触れないかの距離で性器に口を寄せたかと思うと、ふぅっ、と息を吹きかけた。	PRINTFORMW %CALLNAME:TARGET%保持着若即若离的距离，当你思考着要不要主动把性器靠近她的嘴边时，%CALLNAME:TARGET%呼——地吹了一口气。
PRINTFORMW すると、吹きかけられた吐息は%CALLNAME:MASTER%の股間全体をまるでフェザータッチするかのように這いまわり始めた！	PRINTFORMW 于是，轻柔的吐息让%CALLNAME:MASTER%的整个股胯之间都开始好像被羽毛触摸着一般！
PRINTFORMW 思いがけない快感に小さく喘ぎを漏らした%CALLNAME:MASTER%に、%CALLNAME:TARGET%は得意げに微笑みかける。	PRINTFORMW 意料之外的快感让%CALLNAME:MASTER%从口中漏出了小小的喘息声，%CALLNAME:TARGET%摆出了一副得意的微笑。
PRINTFORMW 「うふふっ、気持ち良いでしょう？お返事が無くても、その顔を見れば一目瞭然ですわ」	PRINTFORMW 「唔呼呼っ、很舒服对吧？不回答也没关系、你的表情让人看了就一目了然呢」
PRINTFORMW 「%CNAME("二人称")%に教えられたことを元に、%CNAME("一人称")%なりに練習しましたのよ♪」	PRINTFORMW 「以%CNAME("二人称")%教给我的东西为基础，按照%CNAME("一人称")%自己的方式练习了一下哟♪」
PRINTFORMW 「これからは今までよりもばっちり！しっかり気持ち良くなってもらいますわよ！」	PRINTFORMW 「现在开始会比之前还要棒！我会让你好好的舒服起来哟！」
PRINTFORMW 「…はぁ…」	PRINTFORMW 「…哈啊…」
PRINTFORMW …%CALLNAME:TARGET%をベッドに誘ってみたが、反応が薄く上の空だ。	PRINTFORMW …试着邀请%CALLNAME:TARGET%去床上，却发现她有些心不在焉。
PRINTFORMW %CALLNAME:MASTER%が軽く肩を揺すってやると驚いたのか、%CALLNAME:TARGET%が肩を跳ねさせるのと同時に勢いよく風が吹き荒れた…。	PRINTFORMW 仅仅是被%CALLNAME:MASTER%轻轻的晃了晃肩，%CALLNAME:TARGET%却好像被吓了一大跳一样，肩膀剧烈地震了一下的同时唤出一阵极强的风吹向了你…。
PRINTFORMW 「キャッ！？ご、ごめんなさい！おっ、逢瀬ですわね？！」	PRINTFORMW 「咿呀！？十，十分抱歉！啊！是要幽会了吗？！」
PRINTFORMW 「だ、大丈夫ですわ、ちょっと考え事をしていただけですので…今から準備いたしますわっ！」	PRINTFORMW 「没、没关系的哇、只是在想一些事情…现在马上就过去——！」
PRINTFORMW そう言っていそいそとベッドに向かう%CALLNAME:TARGET%はいつも以上に乙女らしく見えた…。	PRINTFORMW 这样说着便有些欢欣雀跃地跑向床的%CALLNAME:TARGET%看起来比平时更有少女的感觉…。
PRINTFORMW （…はぁ、どうしてしまったのかしら、%CNAME("一人称")%…）	PRINTFORMW （…哈啊，%CNAME("一人称")%，究竟是怎么了呢…）
PRINTFORMW （%CALLNAME:MASTER%といるだけ、顔を見るだけでと身体が…心が熱くなるなんて…）	PRINTFORMW （只要一想到%CALLNAME:MASTER%，只要一看见那张脸的话我的身体…还有心里都会变得好热好热…）
PRINTFORMW 「ねぇ、%CNAME("二人称")%…少しよろしいかしら？」	PRINTFORMW 「我说啊，%CNAME("二人称")%…可以占用你一些时间吗？」
PRINTFORMW いつものように逢瀬に誘われた%CALLNAME:TARGET%は、いつになく真剣な面持ちで%CALLNAME:MASTER%に話しかけてきた。	PRINTFORMW 像往常一样被邀请去幽会的%CALLNAME:TARGET%，用一种前所未有过的认真神色向着%CALLNAME:MASTER%搭了话。
PRINTFORMW %CALLNAME:MASTER%が向き直ると、%CALLNAME:TARGET%は意を決したように口を開いた。	PRINTFORMW 等%CALLNAME:MASTER%一转过身来、%CALLNAME:TARGET%便向下定了什么决心似的开了口。
PRINTFORMW 「%CNAME("一人称")%…%CNAME("二人称")%の事を好きになってしまったみたいですの」	PRINTFORMW 「%CNAME("一人称")%…好像喜欢上%CNAME("二人称")%了」
PRINTFORMW 「えぇ、お友達としてではなく異性として…一人の女として%CNAME("二人称")%の事を愛していますわ」	PRINTFORMW 「嗯——，不是作为朋友而是异性间的喜欢…作为一名女性爱上了%CNAME("二人称")%」
PRINTFORMW 突然の告白に固まる%CALLNAME:MASTER%を見て、%CALLNAME:TARGET%は自嘲するように笑う。	PRINTFORMW 看着被突然的告白给惊呆的%CALLNAME:MASTER%，%CALLNAME:TARGET%自嘲似的笑了笑。
PRINTFORMW 「…分かっていますわ、いきなりこんな話をされても戸惑うばかりだというのは」	PRINTFORMW 「…我明白的哇，突然被说了这种话肯定只会让人不知所措的吧」
PRINTFORMW 「ただ、%CNAME("一人称")%が自分の心と気持ちに整理をつけたかった…それだけの事ですわ」	PRINTFORMW 「但是，%CNAME("一人称")%想好好整理一下自己的内心和感情…仅此而已啊」
PRINTFORMW 「今すぐ%CNAME("二人称")%のものになりたいだとか…ましてや%CNAME("一人称")%以外を愛するな、などとは言いません」	PRINTFORMW 「真想立刻马上成为%CNAME("二人称")%的所有物什么的…又或是不可以爱着%CNAME("一人称")%之外的人什么的，我不会说这种话」
PRINTFORMW 「でも…でももし%CNAME("二人称")%が%CNAME("一人称")%を心から愛してくださると言うのならば、その時は…」	PRINTFORMW 「但是…但是如果有一天%CNAME("二人称")%也真心深爱着%CNAME("一人称")%的话、那个时候…」
PRINTFORMW そこで言葉を切った%CALLNAME:TARGET%はしばらく沈黙した後、吹っ切れたようにいつもの快活な笑顔を向けてきた。	PRINTFORMW 话说到这里就停住了，%CALLNAME:TARGET%在短暂地沉默过后，好像放下了心事似的向你露出了平时那副快活开朗的笑颜。
PRINTFORMW 「はい、重たぁ～いお話は終わりですわ！さぁさっ、今回も%CNAME("一人称")%のことをたっぷり可愛がってくださいまし♪」	PRINTFORMW 「好啦、沉重的话题就到此为止哇！来吧来吧，这次也请好好地疼爱%CNAME("一人称")%哦♪」
PRINTFORMW 「やぁん♪まだシャワーも浴びてませんのに、しょうがない方…♪」	PRINTFORMW 「呀啊♪明明还没洗澡呢，真拿你没办法…♪」
PRINTFORMW 「でも、待ちきれないのは%CNAME("一人称")%も同じですわ…うふふ♪」	PRINTFORMW 「不过，要说已经等不及的话%CNAME("一人称")%其实也一样哇…唔呼呼♪」
PRINTFORMW ベッドに押し倒された%CALLNAME:TARGET%はくすくすと笑いながら%CALLNAME:MASTER%を抱きしめてきた…。	PRINTFORMW 被推倒在床上的%CALLNAME:TARGET%一边小声偷笑着一边紧紧抱住了%CALLNAME:MASTER%…。
PRINTFORMW 「いつもとは違う所での逢瀬…うふふ、いつもよりドキドキしますわ」	PRINTFORMW 「在和平常不一样的地方幽会…唔呵呵，感觉比平时更加小鹿乱撞呢」
PRINTFORMW 薄明りに照らされ、%CALLNAME:MASTER%に向かって両手を広げる%CALLNAME:TARGET%は、普段より妖艶な雰囲気を醸し出している…。	PRINTFORMW 被昏暗的光笼罩着，向着%CALLNAME:MASTER%伸开了双臂的%CALLNAME:TARGET%，营造出来一种比平时更加妖媚的氛围…。
PRINTFORMW 「さぁ、いつも以上に%CNAME("一人称")%を可愛がってくださいませ、%CNAME("二人称")%♪」	PRINTFORMW 「来，比平常%CNAME("一人称")%更加激烈地宠爱我吧，%CNAME("二人称")%♪」
PRINTFORMW 「あら、抱いてくださるのね？待ってましたわっ♪」	PRINTFORMW 「啊呀、要抱我吗？请等一下哦♪」
PRINTFORMW %CALLNAME:TARGET%はベッドの上で三つ指をつくと、深々と頭を下げる。	PRINTFORMW %CALLNAME:TARGET%在床上跪坐着，深深地低下了头，对你行了一个跪坐最敬礼。
PRINTFORMW 「オホン…今回も%CNAME("一人称")%を選んでくださり、ありがとうございます」	PRINTFORMW 「咳咳…这次您也指名了%CNAME("一人称")%，真是不胜感激」
PRINTFORMW 「未だ拙い手技ですが…誠心誠意、ご奉仕させていただきますわ」	PRINTFORMW 「虽然我的技巧还很笨拙…但还请允许我诚心诚意地侍奉您哇」
PRINTFORMW 「…というわけで、色々教えてくださると嬉しいですわっ♪」	PRINTFORMW 「…所以，如果能教我各种东西的话我会很高兴的哇♪」
PRINTFORMW 「風の精霊の力を宿した手技…どうかご堪能くださいませ」	PRINTFORMW 「寄宿着风精灵之力的手技…还请尽情享受」
PRINTFORMW 「…というわけで、たぁっぷり気持ち良くして差し上げますわよっ♪」	PRINTFORMW 「…所以，会让你变得舒服起来的哟っ♪」
PRINTFORMW 「うふふ、こうやって殿方に求められるの…嬉しくなりますわ♪」	PRINTFORMW 「唔呼呼、这样子被先生您所渴求着…真的很高兴哇♪」
PRINTFORMW 「今日も、そしてこれからも色んな事を教えて…%CNAME("一人称")%を手籠めにしてくださいませ♪」	PRINTFORMW 「今天也，还有以后也要教我各种各样的事情啊…请继续把%CNAME("一人称")%束缚在您的手掌心之中吧♪」
PRINTFORMW 屈託の無い笑顔で微笑みかけてくる%CALLNAME:TARGET%をゆっくりと押し倒した…。	PRINTFORMW 你缓缓地把展露出毫无顾虑的微笑的%CALLNAME:TARGET%推倒在床上…。
PRINTFORMW 「んっ…逢瀬の時間ですわね…？」	PRINTFORMW 「嗯…到了幽会的时间了吗…？」
PRINTFORML %CALLNAME:MASTER%にベッドへと誘われ、艶めかしく息をつきながら緩やかに服をはだける%CALLNAME:TARGET%。	PRINTFORML 被%CALLNAME:MASTER%诱到床上，%CALLNAME:TARGET%一边娇媚的轻喘着，一边缓缓地褪下了衣物。
PRINTFORMW いつもとは違う、煽情的で憂いを帯びたような目付きに思わず生唾を飲み込んでしまう…。	PRINTFORMW 那和平时不同的，满目春情之中略带忧郁的眼神让你不由得吞了下口水…。
PRINTFORMW 「うふふ…%CNAME("一人称")%にドキドキしてくださってるのね…♪嬉しいですわ♪」	PRINTFORMW 「唔呼呼…在因为%CNAME("一人称")%而心跳不已呢…♪真高兴哇♪」
PRINTFORMW 嬉しそうに笑う%CALLNAME:TARGET%は、しっとりとした唇を優しく%CALLNAME:MASTER%の頬に重ねてきた…。	PRINTFORMW 高兴地笑着的%CALLNAME:TARGET%，把湿润的嘴唇轻柔的贴在了%CALLNAME:MASTER%的脸颊上…。
PRINTFORMW 「あら…どうしたんですの？顔色が悪いですわよ？」	PRINTFORMW 「啊啦…怎么了吗？脸色看着很差哦？」
PRINTFORMW 「お膝を貸してあげますから、少しお休みになってくださいませ」	PRINTFORMW 「大腿借给你，稍微枕在上面休息会儿吧」
PRINTFORMW 「んっく…ふあぁぁ、はぁぁ…」	PRINTFORMW 「嗯っ咕…呼啊啊——，哈啊…」
PRINTFORMW 「こんなに壊れそうなほど愛されるだなんて…♪」	PRINTFORMW 「被疼爱到感觉自己都要坏掉了什么的…♪」
PRINTFORMW 「はぁん…もう無理…無理ですわ…」	PRINTFORMW 「哈嗯…已经…已经不行了哇…」
PRINTFORMW 「これ以上やったら%CNAME("一人称")%、おバカになってしまいますのぉ…」	PRINTFORMW 「再做下去地话%CNAME("一人称")%，就要变成白痴了呜…」
PRINTFORMW 「たくさん気持ち良くしてもらって…%CNAME("二人称")%の虜になりそうですわ♪」	PRINTFORMW 「被做了好多好多舒服的事情…%CNAME("二人称")%都要变成你的俘虏了呢♪」
PRINTFORMW 「次もよろしくお願いいたしますわねっ♪」	PRINTFORMW 「下次也请你多多关照哇っ♪」
PRINTFORMW 「今回は終わりですの？お疲れ様ですわ」	PRINTFORMW 「这次就到这里吗？辛苦了哇」
PRINTFORMW 「次もたぁっぷり可愛がってくださいませ♪」	PRINTFORMW 「下次也请好好地疼爱我呀♪」
PRINTFORMW 「あら？もうおしまいですの？…%CNAME("一人称")%の身体を労わってくださってる？」	PRINTFORMW 「啊啦？已经结束了吗？…是%CNAME("一人称")%为了照顾我的体力吗？」
PRINTFORMW 「もしそうでしたら遠慮は要りませんわ。もう少し激しくても良いですわよ」	PRINTFORMW 「如果是这样的话其实不必多虑。再稍微激烈一些也是可以的哟」
PRINTFORMW 「今回は終わりですのね」	PRINTFORMW 「这次就到此为止吗」
PRINTFORMW 「ん～、次はもっともっと愛してくださいまし」	PRINTFORMW 「嗯～、下次请更多更多地疼爱我哦」
PRINTFORMW 「うふふ、殿方にえっちな触り方をされるのは初めてでしてよ？」	PRINTFORMW 「唔呵呵，这还是第一次被您用这么色情的手法抚摸着哟？」
PRINTFORMW 「優しくお願いいたしますわ…んっ♪」	PRINTFORMW 「请温柔一些哇…嗯——♪」
PRINTFORMW 「%CNAME("二人称")%は凄く真剣に%CNAME("一人称")%の肌を撫でてくださるのね？」	PRINTFORMW 「%CNAME("二人称")%还真是非常认真地抚弄着%CNAME("一人称")%的肌肤呢？」
PRINTFORMW 「後でしっかりお返しして、%CNAME("二人称")%にも気持ち良くなってもらいたくなりますわ♪」	PRINTFORMW 「之后我会好好回报的，会让%CNAME("二人称")%也变得舒服起来哇♪」
PRINTFORMW 「んっ、ぁん…今なでなでされた所、気持ち良かったですわ…♪」	PRINTFORMW 「嗯——、呃啊…现在被弄得痒痒的部位那里、好舒服哇…♪」
PRINTFORMW %CALLNAME:TARGET%は目を閉じ、大人しく%CALLNAME:PLAYER%の手に身を委ねている。	PRINTFORMW %CALLNAME:TARGET%闭上了双眼、乖乖地把自己的身体交给%CALLNAME:PLAYER%的手。
PRINTFORMW 「うふふ、%CNAME("一人称")%の触り心地はいかがかしら？」	PRINTFORMW 「唔呵呵、%CNAME("一人称")%摸起来的感觉怎么样啊？」
PRINTFORMW 「毎日しっかりばっちり、ケアを欠かさない努力の賜物ですわよっ♪」	PRINTFORMW 「这是每天都有好好精心护理的结果哟♪」
PRINTFORMW 「くんに？…言いますと？」	PRINTFORMW 「骑舔？…是什么意思？」
PRINTFORMW 「…ふんふん、%CNAME("二人称")%の顔に跨って…腰を降ろす…こうですぅうぅ？！」	PRINTFORMW 「…嗯～嗯～，跨在%CNAME("二人称")%的脸上…把腰沉下去…是这样吗—呜呜呜——？！」
PRINTFORMW 秘所を一舐めされた%CALLNAME:TARGET%は素っ頓狂な声と共にあなたの顔面に尻もちをついてきた…。	PRINTFORMW 秘处被舔着的%CALLNAME:TARGET%发出了近乎癫狂的悲鸣的同时把屁股重重贴在了你的脸上…。
PRINTFORMW 「あら、ご、ごめんなさい！びっくりして足の力が…お鼻は折れてませんこと？」	PRINTFORMW 「啊呀，对，对不起！被吓了一跳所以脚没使上力气…您的鼻子没事吧？」
PRINTFORMW 「…ええと、足を開いて楽にしていればよろしぃひゃあっ？！」	PRINTFORMW 「…那个，如果把腿张开写能更尽兴的话咿呀啊啊っ？！」
PRINTFORMW 「あひんっ、どっ、どこ舐めてっ、くすぐったあぁっ！？」	PRINTFORMW 「咿呃っ、你在，在舔哪里啊，酥酥麻麻的呜啊——っ！？」
PRINTFORMW 初めての感覚に身悶えする%CALLNAME:TARGET%を抑え込み、クンニの快楽を教え込んだ…。	PRINTFORMW 你死死按住了因为初次品尝到的快感而挣扎着的%CALLNAME:TARGET%，向她灌输着舔阴的快乐…。
PRINTFORMW 「綺麗にしてくださるの？ありがとうございますわ♪」	PRINTFORMW 「帮我清理干净了啊？非常感谢♪」
PRINTFORMW 「舌で後処理までやってくださるなんて…何だか申し訳ないですわね…」	PRINTFORMW 「居然是用舌头帮我进行清扫处理…总觉得很抱歉呢…」
PRINTFORMW 「%TEXTR("ふぅぅ、あっ、いっ、イイっ/あぁぁっ…んっ、ひぅっ/んんっ…あっ…そ、そこぉ")%♪」	PRINTFORMW 「%TEXTR("呼呜呜，啊っ，咿っ，噫咿っ/啊呃呃っ…嗯っ，咻っ/嗯嗯っ…啊っ…那、那里咿")%♪」
PRINTFORMW 「もうっ、そうやって舌で%TEXTR("入口/膣口/中")%をほじられたら…すぐにイってしまいますわっ♪」	PRINTFORMW 「真是的，像那样用舌头掘弄%TEXTR("入口/穴口/里面")%的话…不一会儿就会去了哇っ♪」
PRINTFORMW 「お腹と胸の奥がきゅんきゅんして♪%TEXTR("えっちなお/はしたないお/マン")%汁が止まりませんわっ♪」	PRINTFORMW 「小腹和内心深处都啾——啾——地抽动着，♪%TEXTR("色情的汁液/下流的汁液/爱液")%流得停不下来哇っ♪」
PRINTFORMW 「頭%TEXTR("がぼんやり/がふわふわ")%して…%TEXTR("アソコ/おマンコ")%と一緒に舐め溶かされちゃってますのぉ♪」	PRINTFORMW 「脑袋%TEXTR("晕乎乎的/轻飘飘的")%…感觉和被舔着的%TEXTR("那里/小穴")%一样都要溶化了呢♪」
PRINTFORMW 「もっと、もっとそこ…%TEXTR("おマメさん/クリトリス/割れ目/おまんこの入り口")%を舐めてくださいませ♪」	PRINTFORMW 「请再继续，请多舔一舔…%TEXTR("小豆豆/阴蒂/我的裂缝/小穴的入口")%吧♪」
PRINTFORMW 「…%TEXTR("んひっ/きゃっ/ぁん")%♪」	PRINTFORMW 「…%TEXTR("呃噫っ/咿呀っ/啊呃")%♪」
PRINTFORMW 「い、今、お腹の奥がきゅんってなりましたわ…！」	PRINTFORMW 「现，现在，感觉肚子里面啾啾的…！」
PRINTFORMW 「んん…イヤな感じはしませんけど…違和感が強いですわね…」	PRINTFORMW 「嗯…虽然没有讨厌的感觉…但还是感觉怪怪的呢…」
PRINTFORMW 「%TEXTR("むしろ匂いがしないかとか、その辺り気になりますわ/これ、本当に気持ち良くなりますの…？")%」	PRINTFORMW 「%TEXTR("我倒是很在意那附近会不会有什么味道哇/这样，真的会变得舒服吗…？")%」
PRINTFORMW 「うふ、ふひひっ、%TEXTR("い、息がかかって/しっ、舌、舌が入って")%くすぐったいですわ…ッ」	PRINTFORMW 「唔呼，呼咿っ，%TEXTR("呼，呼吸打在那里/sh，舌，舌头进去了")%——感觉痒痒的哇…ッ」
PRINTFORMW %CALLNAME:TARGET%から快楽を引き出すのはまだまだのようだ…。	PRINTFORMW 看来想用这种方法把%CALLNAME:TARGET%的快感引出来还需要很久…。
PRINTFORMW 「じい？…あぁ、オナニーのことですわね！」	PRINTFORMW 「自己摸？…啊啊，您是说自慰吧！」
PRINTFORMW 「いつもやっているように、って…%CNAME("一人称")%、そんなはしたない女に見えるのかしら…♪」	PRINTFORMW 「居然说像平常自慰的时候一样就好…%CNAME("一人称")%，看起来是那么下流的女孩子吗…♪」
PRINTFORMW わざとらしく文句を垂れつつも楽しそうに、%CALLNAME:TARGET%は自らの身体を愛撫し始めた…。	PRINTFORMW %CALLNAME:TARGET%在故作抱怨的同时却看着很开心地开始爱抚起自己的身体来…。
PRINTFORMW 「折角見せてあげているのですから…もっとちゃんと見てくださいまし♪」	PRINTFORMW 「难得让您看我做着这种事的样子…请再仔细多看一会儿啊♪」
PRINTFORMW （とか言ったらこんな食い入るように見つめて…%CNAME("二人称")%ってば可愛いですわね♪）	PRINTFORMW （我说完之后就死死地盯着看…%CNAME("二人称")%还真是可爱呢♪）
PRINTFORMW 「…普段は何をオカズにしているか、ですって？」	PRINTFORMW 「…问我平时会用什么作为自慰的配菜吗？」
PRINTFORMW 「そうですわねぇ…%TEXTR(@"町で見かけた強そうで素敵な殿方/%CNAME("二人称")%のこと/男性向けのちょっとえっちな雑誌")%とか…」	PRINTFORMW 「我想想哦…%TEXTR(@"会想着在街上见过的看起来很强壮很棒的男生/会想着%CNAME("二人称")%的事情/会看着比较色情的男性向杂志")%之类的…」
PRINTFORMW 「んっ…うふふ、%CNAME("一人称")%の感じる%TEXTR("ところ/触り方")%、%CNAME("二人称")%に覚えられてしまいますわね…♪」	PRINTFORMW 「呜嗯っ…唔嘿嘿，这样看着的话，%TEXTR("我最敏感的部位/会让我变得很敏感的爱抚方法")%，都会被%CNAME("二人称")%给记住了哇…♪」
PRINTFORMW 「あら…わたくしの胸、気になりますの？」	PRINTFORMW 「啊啦…我的胸，很在意吗？」
PRINTFORMW 「やっぱり殿方はおっぱいがお好きなのですわね♪」	PRINTFORMW 「果然您很喜欢胸部呢♪」
PRINTFORMW 「うふふ、好きなだけ触ってどうぞ♪」	PRINTFORMW 「欸嘿嘿，请随你喜欢来摸吧♪」
PRINTFORMW 「もうっ、そんなにじっくり舐めて…♪」	PRINTFORMW 「真是的，居然舔得那么仔细…♪」
PRINTFORMW 「おーよちよち…おっきな赤ちゃんですわ♪」	PRINTFORMW 「好ー乖乖乖ー…好像一个小宝宝一样呢♪」
PRINTFORMW 「あんっ♪な、舐めるだけじゃなくて甘噛みまで…ッ♪」	PRINTFORMW 「呜嗯っ♪不、不光舔着居然还轻轻咬住…ッ♪」
PRINTFORMW 「いやですわ、どんどん乳首が勃ってきちゃう♪」	PRINTFORMW 「讨厌哇、乳头渐渐开始勃起了♪」
PRINTFORMW 「もう、%CNAME("一人称")%の%LOCALS%%TEXTR("に触れて/を玩具に出来て")%嬉しいからってそんなにグニグニなさらないでくださいませ♪」	PRINTFORMW 「唔～，虽然%TEXTR("触摸着/当成玩具一样玩弄着")%%CNAME("一人称")%的%LOCALS%很快乐但也不要像捏果冻一样把它弄得一弹一弹的呀♪」
PRINTFORMW 「%CNAME("一人称")%、胸が熱く…気持ち良くなってきちゃいますのぉ♪」	PRINTFORMW 「%CNAME("一人称")%，胸口烫烫的…感觉变得舒服起来了♪」
PRINTFORMW 「%TEXTR("胸/おっぱい")%は殿方に揉んでもらうと大きくなるらしい、って聞きましたわ」	PRINTFORMW 「%TEXTR("胸/胸部")%被男生揉的话会越揉越大的，听说是这样哇」
PRINTFORMW 「もし本当なら%CNAME("一人称")%、%CNAME("二人称")%せいでもーっと大きな%TEXTR("胸/おっぱい")%になっちゃいますわね♪」	PRINTFORMW 「如果是真的话，那%CNAME("一人称")%的%TEXTR("胸/胸部")%变得更大的话就都怪%CNAME("二人称")%哦♪」
PRINTFORMW 「んふふっ…優しいけどしっかりと力の籠った手付き…♪素敵ですわ♪」	PRINTFORMW 「欸嘿嘿っ…在用明明不小但却很温柔的力度抓揉着呢…♪感觉真棒哇♪」
PRINTFORMW 「%CNAME("二人称")%に出会わなかったら、きっと%LOCALS%でこんなに気持ち良くなれるなんて知らなかったでしょうね…♪」	PRINTFORMW 「如果没有和%CNAME("二人称")%相识的话，%LOCALS%也可以变得这么有快感什么的我肯定不会知道呢…♪」
PRINTFORMW 「うふっ…うふふふふっ…♪逃がしませんわよ…！」	PRINTFORMW 「哎嘿っ…哎嘿嘿嘿っ…♪不会让你逃掉哟…！」
PRINTFORMW 「さぁっ、%CNAME("一人称")%のファーストキス、受け取ってくださいませッ♪」	PRINTFORMW 「来吧，%CNAME("一人称")%的初吻，请好好收下吧ー♪」
PRINTFORMW 「ちゅ………あぁ、%CNAME("一人称" ,"どもり")%のファーストキスが…」	PRINTFORMW 「啾ー………哈啊，%CNAME("一人称" ,"どもり")%的初吻…」
PRINTFORMW 「こ、これは…%CNAME("二人称")%に責任取ってもらうより他ないですわッ♪」	PRINTFORMW 「这，这样…只能让%CNAME("二人称")%对我负起责任来了哇ッ♪」
PRINTFORMW 「というわけでもっとキスしましょう！ちゅぅ～～～ッ♪」	PRINTFORMW 「所以就来多亲几次吧！啾ー～～～ッ♪」
PRINTFORMW 「キ、キスが始まりの合図だなんて…こんなのドキドキが止まらなくなっちゃいますわ♪」	PRINTFORMW 「用亲，亲吻作为开始的信号什么的…这样心会嘣嘣跳地停不下来哇♪」
PRINTFORMW 「うふふ…ムードが出て良い感じ…♪流石%CNAME("二人称")%、ですわね♪」	PRINTFORMW 「呜呵呵…感觉气氛被调起来了，心情高涨呢…♪真不愧是%CNAME("二人称")%呢♪」
PRINTFORMW 「%KOJO_RAND_K37("キス")%」	PRINTFORMW 「%KOJO_RAND_K37("キス")%」
PRINTFORMW 「…ゃん、逃げないでくださいませぇ…%KOJO_RAND_K37("キス")%」	PRINTFORMW 「…呀呃、不会让你逃掉的哦…%KOJO_RAND_K37("キス")%」
PRINTFORMW 「んはぁ、はぁ、はぁ…気持ち良い…%TEXTR("唇がふわふわ/頭がぴりぴり")%しますわ…♪」	PRINTFORMW 「呜哈啊，哈啊，哈啊…好舒服…%TEXTR("嘴唇轻飘飘的/脑袋麻麻的")%哇…♪」
PRINTFORMW 「本当に上手なキスをなさるのね♪%CNAME("二人称")%とのキス以外知りませんけど♪」	PRINTFORMW 「还真是个♪%CNAME("二人称")%とのキス以外知りませんけど♪」
PRINTFORMW 「うふふ、まさか口づけだけでこんなにも心が高鳴るだなんて…思った以上ですわ♪」	PRINTFORMW 「唔嘿嘿、没想到仅仅是接吻就会让我的心悸动得如此强烈…还真是意料之外哇♪」
PRINTFORMW 「もっと…♪もっとしましょう…%CNAME("二人称")%♪」	PRINTFORMW 「还想要…♪还想继续做下去…%CNAME("二人称")%♪」
PRINTFORMW 「んっ…いっ…♪」	PRINTFORMW 「嗯っ…咿っ…♪」
PRINTFORM 「と、殿方の逞しい手で	PRINTFORM 「男，男孩子有力的手指
PRINTFORM 「お、女の子の細い手で	PRINTFORM 「女，女孩子纤细的手指
PRINTFORMW …%CNAME("一人称")%のアソコ、おもちゃにされちゃってますわぁ…♪」	PRINTFORMW …把%CNAME("一人称")%的那里，当成玩具一样玩弄着…♪」
PRINTFORMW 「後処理してくださるの？嬉しいですわ♪」	PRINTFORMW 「要为我做中出后的清理吗？真开心哇♪」
PRINTFORMW 「あっでも、今は敏感になってますから優しくお願いしますわね？」	PRINTFORMW 「——啊不过，现在那里还很敏感所以请温柔一点哦？」
PRINTFORMW 「あっあっ、%TEXTR("く、クリちゃん/お、おマメさん")%つまっ、摘ままれちゃってますわッ」	PRINTFORMW 「啊っ啊っ，%TEXTR("阴，阴蒂那里/小，小豆豆")%被揉，揉捏着哇ッ」
PRINTFORMW 「ひ、引っ張ったりしたら%CNAME("一人称")%、おかしくなっちゃ…んひぃぃぃぃっ♪」	PRINTFORMW 「那、那样拉扯的话%CNAME("一人称")%，要变得奇怪了…嗯咿咿咿啊————っ♪」
PRINTFORMW 「んぎぅっ！ひっ、かっ、あぉ…♪」	PRINTFORMW 「嗯呀っ！噫っ、嘎っ、啊呜…♪」
PRINTFORMW 「%TEXTR("く、クリちゃん/お、おマメさん")%にデコピンだなんて…刺激が強すぎますわっ」	PRINTFORMW 「居然用手指去弹%TEXTR("阴，阴蒂/小，小豆豆")%那里…刺激感强过头了哇っ」
PRINTFORMW 「ひんっ♪う、い、ああっ♪こ、腰っ♪腰が浮いちゃいますわっ♪」	PRINTFORMW 「咿唔っ♪呜，噫，呃那っ♪那里，腰っ♪腰不由自主地弓起来了哇っ♪」
PRINTFORMW 「そ、そこぉ♪そんなに%TEXTR("クリクリし/コリコリし/こねくら")%ないでくださいましぃっ♪」	PRINTFORMW 「那，那个地方呜♪不要那样%TEXTR("咕哩咕哩地/咯哩咯哩地/揉搓着")%玩弄那里哇ぃっ♪」
PRINTFORMW 「わ、ワレメだけスリスリして…もどかしいですわ…」	PRINTFORMW 「光，光是一直咝啦咝啦地玩弄着缝隙附近…让人心焦难耐哇…」
PRINTFORMW （いつオマンコほじほじするのか、期待しちゃいますわね♪）	PRINTFORMW （什么时候才会开始进攻小穴呢，好期待啊♪）
PRINTFORMW 「あ、あぁ…オマンコの浅いところ…いじられちゃってますわ♪」	PRINTFORMW 「啊，啊啊…入口附近浅浅的地方…被欺负着哇♪」
PRINTFORMW 「そんなにカリカリされたら子宮が切なくなっちゃう…♪」	PRINTFORMW 「被那样不停搅弄着子宫会想要地很难受哇…♪」
PRINTFORMW 「あっ…ん、んっ…♪」	PRINTFORMW 「啊っ…嗯，呃っ…♪」
PRINTFORMW 「こ、こんな焦らすような触り方…意地悪ですわ…♪」	PRINTFORMW 「这，这种让人心焦的爱抚方式…真是坏心眼哇…♪」
PRINTFORMW 「あぁ…かったぁいバイブでオマンコズボズボしますのね…♪」	PRINTFORMW 「啊啊…呜硬硬的振动棒在小穴里面滋噜滋噜的…♪」
PRINTFORMW 「んんっ…%CNAME("二人称")%の指、お腹の中で感じますわぁ…♪」	PRINTFORMW 「呜呃っ…%CNAME("二人称")%的手指，在我肚子里的感觉好明显哇…♪」
PRINTFORMW 「入れられただけで気持ち良いのに…動かされたらどうなっちゃうのかしら♪」	PRINTFORMW 「只是塞进去就会这么舒服…动起来的话会变成什么样呢♪」
PRINTFORMW 「ひゃううぅんっ♪そこぉ♪今の場所イイですわっ♪」	PRINTFORMW 「咿呀呜呜ぅ唔呜っ♪那里ぉ♪现在碰着的那个地方好舒服哇っ♪」
PRINTFORMW 「すごいっ、すごいぃっ♪触られるだけであたまちかちかしちゃいますのぉっ♪」	PRINTFORMW 「好厉害っ、好棒呜ぃっ♪只是碰了下就感觉整个脑袋都冒着金星咿咿っ♪」
PRINTFORMW 「んぉお、お゛ぉっ♪やだっ、ゆ、指でマン汁掻き出されちゃってますのぉっ♪」	PRINTFORMW 「嗯呜，啊嗯゛啊呜♪不要っ，手、手指把小穴汁都挖出来了咿呜っ♪」
PRINTFORMW 「ちっちがっ、ちがいますわっ♪おっ、おもらしじゃ…ひぁぁあぁぁっっ♪」	PRINTFORMW 「不っ不对っ、不对呜哇っ♪感っ、感觉要喷出…咿呀呀呀啊啊っっ♪」
PRINTFORMW 「ひぃっ、い゛ぃっ…♪ぁ、ひっ、い、いきがっ♪イきすぎてっ、いき、できなっ、かはっ…」	PRINTFORMW 「呼咿っ、咿゛咿っ…♪啊、咿咿っ，要、要去っ一直不停地去呜っ，已经、已经不っ、不行っ…」
PRINTFORMW 「はぁっ、ぐ…あっ…かっ、はぁぁ…♪しゅごいっ…しゅごいでしゅわぁ…♪」	PRINTFORMW 「哈啊っ、咕唔…哈っ…咕哈っ、哈啊…♪好、好腻害っ…则的好噫害哇啊…♪」
PRINTFORMW 「い…ッ！？な、なんですの、今の…？」	PRINTFORMW 「咿咿…ッ！？怎、怎么回事，这种…？」
PRINTFORMW 「ぅんッ♪ちょ、ちょっと気持ち良かったですわ」	PRINTFORMW 「呜呃ッ♪有、有点太舒服了哇」
PRINTFORMW 「%TEXTR("んぁあ゛っ？！あ゛ぁあ゛あああぁっ/おぉお゛んっ♪おっあ゛っあ゛っあ゛っ/ひゅいっ♪ぎ、あ゛あ゛ああぁぁ")%♪」	PRINTFORMW 「%TEXTR("呃啊啊゛っ？！啊゛哇啊゛啊啊啊っ/哦呜呜゛嗯っ♪哦っ啊゛っ啊゛っ啊゛っ/好激咿っ♪咿、啊゛啊゛啊啊啊啊")%♪」
PRINTFORMW 「かっ、かったぁいのがぁ♪オマンコぞりぞり削ってぇ♪頭バカになっちゃいましゅのぉっ♪」	PRINTFORMW 「好っ、好っ硬的东西ぁ♪在我的里面滋噜滋噜地刮着ぇ♪脑袋都变得不清醒了呜っ♪」
PRINTFORMW 「しゅっ♪しゅごいっ♪おなかぶるぶるしゅごいでしゅわぁぁっ♪」	PRINTFORMW 「哧っ♪超咿害っ♪在我的肚子里咕噜咕噜动得好腻害呜哦哦っ♪」
PRINTFORMW 「おチンポっ♪%CNAME("二人称")%のおチンポ欲しいのにっ♪おもちゃで満足させられちゃいますわっ♪」	PRINTFORMW 「大鸡巴♪明明还想要%CNAME("二人称")%的大鸡巴的っ♪却被玩具给弄得好満足哇っ♪」
PRINTFORMW 「子宮こねこねダメッ♪深すぎっ♪深しゅぎましゅのぉぉぉ♪」	PRINTFORMW 「不可以ー那样顶着子宮ッ♪太深了っ♪深、深过涂噜呜哇哇ぉぉぉ♪」
PRINTFORMW 「い…ッ、も、もう少し優しくお願いしますわ」	PRINTFORMW 「咿…ッ，请、请再稍微温柔一些哇」
PRINTFORMW 「うぐ…ま、まだちょっとキツい、ですわね…ッ」	PRINTFORMW 「呜咕…还、还是有些太激烈，了呢…ッ」
PRINTFORMW 「%TEXTR("ふぁ…んく、んうっ/ぁあっ、そこ、そこ良いですわっ/ひゃぁんっ♪んひ、ひあっ")%♪」	PRINTFORMW 「%TEXTR("哇啊…呃咕、咕呜っ/啊啊っ、那里、那里好爽啊っ/咿呀呀呃っ♪呃呼、呼哈っ")%♪」
PRINTFORMW 「そんなにっ♪オマンコ%TEXTR("ほじほじ/まぜまぜ")%しないでくださいませぇ♪」	PRINTFORMW 「请不要那么っ♪%TEXTR("啵唧啵唧/呼啦呼啦")%地欺负着小穴♪」
PRINTFORMW 「本当はおチンポ欲しいのに♪指だけで満足させられちゃいそうですのぉっ♪」	PRINTFORMW 「明明真的好想要大鸡鸡♪结果被手指给好好地满足了一番ぉっ♪」
PRINTFORMW 「にちゃにちゃ、ぐちゅぐちゅってえっちな音でぇ♪頭まで蕩けてきましたわぁ…♪」	PRINTFORMW 「啪啾啪啾，咕啾咕啾的，色情的声音♪在脑袋里不停回荡着哇…♪」
PRINTFORMW 「あら…%CNAME("一人称")%の純潔の証を検分したい、と…そうおっしゃるのですわね？」	PRINTFORMW 「啊啦…想检查%CNAME("一人称")%保持着纯洁的证明…您是这么要求的吧？」
PRINTFORMW 「うふふ、女になった%CNAME("一人称")%のアソコが見たいと…」	PRINTFORMW 「唔呼呼，想看一看，已经变成女人的%CNAME("一人称")%的那个地方吗…」
PRINTFORMW 「良いですわよっ♪さぁ、%CNAME("一人称")%のオマンコの中…とくとご覧くださいませ♪」	PRINTFORMW 「当然好哟っ♪来，%CNAME("一人称")%的蜜穴内部…请您仔细观赏吧♪」
PRINTFORMW 「%CNAME("一人称")%の未使用マンコ…綺麗ですわよね？」	PRINTFORMW 「%CNAME("一人称")%还没被使用过的蜜穴…很漂亮吧？」
PRINTFORMW 「しっかり見た感想を聞きたいですわっ♪ほらぁ、ほらぁ♪」	PRINTFORMW 「想听一听您仔细看过之后的感想呢っ♪如何啊，如何啊♪」
PRINTFORMW 「んっ…♪ぁ…見られてるだけで濡れてきてるのが分かりますわ…♪」	PRINTFORMW 「嗯っ…♪啊…只是被看着就变得湿乎乎什么的我也知道哇…♪」
PRINTFORMW 「女にしてもらいたくって%TEXTR("涎を垂らしてしまう/ウズウズしてる")%、はしたないオマンコ…お仕置きしてくださらない？」	PRINTFORMW 「一定是太想要从少女变成女人了所以才%TEXTR("这样子流着口水/变得湿乎乎的")%，还真是个下流的小骚穴呢…要不要惩罚一下呀？」
PRINTFORMW 「うふふ…この通り、処女膜は未だ健在ですわよ」	PRINTFORMW 「唔呵呵…就是这样，处女膜还健在哟」
PRINTFORMW 「あーぁ、どこかの素敵な方が%CNAME("一人称")%%TEXTR("を一人前の女にして/の処女を貰って")%くださらないかしら…？」(ﾁﾗｯﾁﾗｯ)	PRINTFORMW 「啊ー啊，不知道会不会有哪里的好心人愿意把%CNAME("一人称")%%TEXTR("变成大人/的处女取走")%呢…？」(ﾁﾗｯﾁﾗｯ)
PRINTFORMW 「あら…零れてきちゃいましたわね…ん、ちゅ、チュルチュル…」	PRINTFORMW 「啊啦…都溢出来了呢…嗯、啾、啾噜啾噜…」
PRINTFORMW 「…くちゅ、ごっくん…♪うふふ、%TEXTR("もったいないから美味しくいただいちゃいました/精液とマン汁のジュース、美味しいです")%わぁ♪」	PRINTFORMW 「…咕啾、咕嗯…♪唔嘿嘿，%TEXTR("因为放着的话就太可惜了，多谢您美味的款待/精液和爱液混合起来的果汁，真是美味")%哇♪」
PRINTFORMW 「いやっ♪%TEXTR("たくさん恵んで/たっぷり飲ませて/気持ち良く注いで")%くださった精液が漏れちゃいますわ…♪」	PRINTFORMW 「讨厌っ♪%TEXTR("这么多施舍给我的/多到喝不完的/咽下去会感觉很美味的")%精液就这么漏出来了…♪」
PRINTFORMW 「はしたないオマンコでごめんなさい♪罰として飲みきれないほど注いでくださいませ♪」	PRINTFORMW 「我的小穴这么下流真是抱歉呢♪作为惩罚请往里面射到小穴喝不下为止吧♪」
PRINTFORMW 「んっ…ぁん、あはぁ…♪こんなに溢れるほど射精して…っ…♪」	PRINTFORMW 「嗯っ…啊嗯、啊哈啊…♪射精射得多到不停向外溢…っ…♪」
PRINTFORMW 「…でも、何だか足りない感じがしますわ…もっと射精してくださいませんこと？」	PRINTFORMW 「…不过，总觉得还是不满足哇…请再多射一些出来给我吧？」
PRINTFORMW 「どうかしら、%CNAME("一人称")%のオマンコの中は…？」	PRINTFORMW 「感觉如何呢，%CNAME("一人称")%的小穴里面…？」
PRINTFORMW 「…うふふ、聞かなくっても分かりますわね♪オチンポバッキバキに勃ててますもの♪」	PRINTFORMW 「…唔呵呵，就算不说我也能知道呢♪大肉棒硬硬地勃起来了哦♪」
PRINTFORMW 「ぽっかり穴が開いてて少し寂しいと思いません？埋められそうなものが欲しいですわ…♪」	PRINTFORMW 「洞口就这样张开着不觉得很寂寞吗？好像要一些能把它填住的东西哇…♪」
PRINTFORMW 「貫いてもらいたくって%TEXTR("涎を垂らしてしまう/ウズウズしてる")%、はしたないオマンコ…お仕置きしてくださらない？」	PRINTFORMW 「一定是太想被贯穿了才会%TEXTR("这样子流着口水/变得湿乎乎的")%，还真是个下流的小骚穴呢…要不要惩罚一下呀？」
PRINTFORMW 「あら、見るだけで良いのかしら？」	PRINTFORMW 「啊啦，只是看着就好了吗？」
PRINTFORMW 「%TEXTR(@"%CNAME("二人称")%のオチンポはもうやる気マンマンみたいですけど…いかがなさいますの/今すぐにそのガチガチのオチンポでズボズボしてくださっても良いんですのよ")%♪」	PRINTFORMW 「%TEXTR(@"可是%CNAME("二人称")%的大肉棒看起来已经干劲满满了呢…您不想做点什么吗/现在马上就把那个硬梆梆的大肉棒噗嗞噗嗞的插进去也是可以的哟")%♪」
PRINTFORMW 「見るだけ見て何もしない…そういう高度な焦らしプレイもたまにはいいですわね♪」	PRINTFORMW 「能忍住只看着的话就先看着却什么都不做…这种让人特别焦躁的play偶尔也不错呢♪」
PRINTFORMW 「んぎぃっ…！あ゛ぁっ！ぃい゛ッだぁぁい゛っ～～～ッ…！」	PRINTFORMW 「嗯噫咿ぃっ…！啊゛啊っ！咿咿゛ッ呜啊啊咿呜゛っ～～～ッ…！」
PRINTFORMW 「はっ、はぐぅっ、はっ、はあぁ…やっと…やぁぁぁっと♪ようやく♪ついに♪」	PRINTFORMW 「哈啊っ、哈咕っ、哈っ、哈啊——…终～于…终～～于——啊♪最终终于♪终于等到了♪」
PRINTFORMW 「%CNAME("一人称")%の処女を貰ってくださったのね♪待ちわびましたわっ♪」	PRINTFORMW 「是要把%CNAME("一人称")%的处女取走吧♪已经等得急不可耐了哇っ♪」
PRINTFORMW 「この痛み、圧迫感、おチンポの熱さ…きっと、いえ絶対忘れません♪」	PRINTFORMW 「这种痛感，这种圧迫感，肉棒的热度…我肯定，不，绝对不会忘记的♪」
PRINTFORMW 「あなたのオンナにしてくださって…%CNAME("一人称")%、とぉっても幸せですわぁ♪」	PRINTFORMW 「请让我变成你的女人吧…%CNAME("一人称")%，会非常非常幸福的哇♪」
PRINTFORMW 「ぐ、うぅっ、はぁはぁ…は、初めてってかな～り、とっても痛いんですのね…」	PRINTFORMW 「咕、呜呜っ、哈啊哈啊…最、最开始还是相～当、相当痛的呢…」
PRINTFORMW 「この痛み、一生忘れられませんわね…とにかく、初めての相手になってくださってありがとうございますわ」	PRINTFORMW 「这种痛楚、我一生都不会忘记呢…总之、谢谢您愿意做我第一次的对象」
PRINTFORMW 「それと…これを乗り切ったら気持ち良くなるって思うと…何だか濡れてきちゃいますわ♪」	PRINTFORMW 「还有就是…疼痛过去之后就会变得很舒服…不一会儿就湿了呢♪」
PRINTFORMW 「あぁ、こんなに大きく…はちきれそうになって…」	PRINTFORMW 「啊——、这么大的…感觉会被撑得满满的…」
PRINTFORMW 「今回もこれで%CNAME("一人称")%をひいひい泣かせるつもりですのね？ひどい方ですわ♪」	PRINTFORMW 「这次也准备就这样把%CNAME("一人称")%弄到哭出来吗？真是过分的人呢♪」
PRINTFORMW 「血管まで太くて、バキバキで…うふふ、%CNAME("一人称")%の顔ぐらいありますわ♪」	PRINTFORMW 「连血管都这么粗大、吧唧吧唧的感觉好厉害…唔呼呼、都和%CNAME("一人称")%的脸差不多大了呢♪」
PRINTFORMW 「こんな逞しくてぶっといのをぶち込まれたら…虜になっちゃうに決まってます♪」	PRINTFORMW 「被这么强壮粗大的给塞进去的话…肯定变成它的俘虏的♪」
PRINTFORMW 「はぁあ…本当におっきい、素敵なおチンポ…♪」	PRINTFORMW 「哈啊啊…真的好大——、好棒的大鸡巴…♪」
PRINTFORMW 「これでお腹の中を%CNAME("二人称")%の形に広げて…躾けてくださるのね…♪」	PRINTFORMW 「这样一来肚子里都会被撑成%CNAME("二人称")%的形状…会习惯的呢…♪」
PRINTFORMW 「今回は%CNAME("一人称")%が先攻ですのね！」	PRINTFORMW 「这次由%CNAME("一人称")%来先行进攻呢！」
PRINTFORMW 「うふふっ、頑張って搾り取って差し上げますわっ♪」	PRINTFORMW 「唔呵呵——、我会努力榨取出来的哇♪」
PRINTFORMW 「もう、%CNAME("一人称")%に腰を振らせたいだなんて…破廉恥ですわよ♪」	PRINTFORMW 「真是的，居然想让%CNAME("一人称")%主动晃腰什么的…居然这么平静地说出这么羞耻的话哇♪」
PRINTFORMW 「でもお願いされたら…んっ、あっ♪…しょうがないですわね♪」	PRINTFORMW 「但是既然被你拜托了…嗯っ、啊っ♪…就没办法了呢♪」
PRINTFORMW 「うーん、やっぱりこの体位だと%TEXTR(@"%CNAME("二人称")%の感じているお顔を見られ/%CNAME("一人称")%の感じている顔が見せられ")%ませんわね…」	PRINTFORMW 「呜ー嗯，果然这个体位的话就没法看见%TEXTR(@"%CNAME("二人称")%洋溢着快感的脸/%CNAME("一人称")%沉溺于快感的脸")%了呢…」
PRINTFORMW 「だ・け・ど♪その分たっぷり気持ち良くさせていただけるのでOKですわっ♪」	PRINTFORMW 「但・是・呢♪相应的能感受到更多的快感所以也很OK哇っ♪」
PRINTFORMW 「こ、この体位は…き、危険が危ないですわっ」	PRINTFORMW 「这、这个体位…感，感觉很危险哇っ」
PRINTFORMW 「何故って？…オマンコだけじゃなくて%TEXTR(@"クリトリス/クリちゃん")%や%TEXTR(@"乳首/おっぱい")%まで責められて狂ってしまいますから…♪」	PRINTFORMW 「为什么这么说？…不只是小穴就连%TEXTR(@"阴蒂/小豆豆")%和%TEXTR(@"乳头/胸部")%也可以欺负到，感觉会让人发疯呢…♪」
PRINTFORMW 「んんっ…この格好、いつやっても窮屈ですわね」	PRINTFORMW 「嗯嗯っ…这个姿势，不管什么时候都感觉很不自在呢」
PRINTFORMW 「それに目の前で%CNAME("二人称")%と%CNAME("一人称")%が繋がるさまを見せつけられて…恥ずかしいですわ…♪」	PRINTFORMW 「而且%CNAME("二人称")%和%CNAME("一人称")%连在一起的样子会在眼前被看得一清二楚…真是羞人哇…♪」
PRINTFORMW 「ああっ…♪これ、これぇ、奥までずぷずぷされちゃいますの…♪」	PRINTFORMW 「啊啊っ…♪这个、这个呜，到最里面为止都被滋卟滋卟地弄着…♪」
PRINTFORMW 「圧し掛かられて、逃げられないまま…ビューってされちゃいますわぁ…♪」	PRINTFORMW 「被这样压着，完全逃不掉的样子…只能乖乖地被做着各种事情哇…♪」
PRINTFORMW 「やんっ♪お尻を撫でるだけじゃなくて…おチンポ入れてくださいませ♪」	PRINTFORMW 「咿呀っ♪不要只顾着摸我的屁股…请把肉棒也塞进来吧♪」
PRINTFORMW 「早く、早くぅ♪…んはっ、ああぁんっ♪」	PRINTFORMW 「快点、快点呜～♪…嗯哈っ、啊啊啊呃っ♪」
PRINTFORMW 「いきなり後ろからだなんて…ケダモノっ、ケダモノですわぁ♪」	PRINTFORMW 「突然就从后面什么的…禽兽っ、真是禽兽哇♪」
PRINTFORMW 「いやぁ♪襲われちゃうっ♪交尾させられちゃいますのぉっ♪」	PRINTFORMW 「讨厌♪被袭击了呀♪被强制交尾了呢っ♪」
PRINTFORMW 「早くっ♪早く%CNAME("一人称")%を貫いてくださいましっ♪」	PRINTFORMW 「快点っ♪快来把%CNAME("一人称")%贯穿吧っ♪」
PRINTFORMW 「やぁんっ、焦らすなんてっ、%CNAME("二人称")%ってばいけずで…あっあぁんっ♪」	PRINTFORMW 「呀嗯っ、把我弄得这么急不可耐什么的，请快些对%CNAME("二人称")%使坏吧…啊っ啊啊呃っ♪」
PRINTFORMW 「んんぅ、あっあんっ♪%TEXTR("ずぶずぶ/にゅぷにゅぷ")%来ましたわぁ♪」	PRINTFORMW 「呜嗯ぅ、啊っ啊嗯っ♪%TEXTR("滋卟滋卟/啾噗啾噗")%地进来了哇♪」
PRINTFORMW 「今回も%TEXTR("オマンコの中から蕩かされて/おチンポに鳴かされて")%しまいますのね…♪」	PRINTFORMW 「这次也%TEXTR("让小穴里像要被溶化掉一样/被大鸡鸡弄得不断淫叫着")%呢…♪」
PRINTFORMW 「早くっ♪おチンポ早くっ♪イキたくておかしくなっちゃいますからぁっ♪」	PRINTFORMW 「快っ♪大鸡鸡快点っ♪想要高潮想要变得奇怪呀っ♪」
PRINTFORMW 「いやぁっ♪焦らさないでぇ♪おチンポでトドメ刺してくださいませぇっ♪」	PRINTFORMW 「讨厌呀っ♪不要再让我这么焦急了ー♪用大鸡鸡狠狠地捅进来，给我致命一击吧っ♪」
PRINTFORMW 「なんでっ♪なんで止めるんですのぉっ♪いじわるっ、いじわるぅっ♪」	PRINTFORMW 「为什么っ♪为什么停下来了啊ぉっ♪欺负人っ、欺负人——っ♪」
PRINTFORMW 「あぁーっ♪これこれっ、これですわぁ♪やっぱりこの体位が一番オマンコにキくのぉ♪」	PRINTFORMW 「啊啊ーっ♪对对っ，就是这样哇ぁ♪果然这个体位才是对小穴穴最有用的呢♪」
PRINTFORMW 「この格好でおチンポ%TEXTR("ハメハメ/パコパコ/ずぽずぽ")%されるの♪最ッ高に気持ち良いですわぁっ♪」	PRINTFORMW 「这个姿势下被大肉棒%TEXTR("啪唧啪唧/咕啾咕啾/滋啪滋啪")%的搅动着♪真的是超——级舒服哇っ♪」
PRINTFORMW 「あはぁっ♪%CNAME("一人称")%のオマンコ、%CNAME("二人称")%のモノを覚えこまされてますのっ♪」	PRINTFORMW 「啊哈哈っ♪%CNAME("一人称")%的肉穴，被强迫着牢牢记住了%CNAME("二人称")%的大家伙呢っ♪」
PRINTFORMW 「はぁっはぁっ♪んっ、あっ、ひゃんっ♪あっあっあっ…♪」	PRINTFORMW 「哈啊っ哈啊っ♪唔呜っ、啊っ、咿呀っ♪啊っ啊っ啊っ…♪」
PRINTFORMW 「お、オマンコの中でっ♪%CNAME("二人称")%の精液とっ♪%CNAME("一人称")%のオマンコ汁っ♪」	PRINTFORMW 「小、小穴穴里面っ♪%CNAME("二人称")%的精液和っ♪%CNAME("一人称")%的淫水♪」
PRINTFORMW 「えっちな音させてっ♪んひゃあぁっ♪まぜまぜされてますのぉ♪」	PRINTFORMW 「搅和着让它发出了淫荡的声音っ♪嗯咿咿呀啊啊啊っ♪就这样被搅弄着呜——ぉ♪」
PRINTFORMW 「んんっ！だ、大丈夫ですわっ、ちょっと、ちょっと気持ち良かっただけ…♪」	PRINTFORMW 「呃呃っ！没、没关系的哇っ，只是、只是有点舒服过头了…♪」
PRINTFORMW 「だから、だからもっとおチンポくださいませぇ♪」	PRINTFORMW 「所以、所以情继续用大鸡鸡欺负我吧♪」
PRINTFORMW 「うふふっ、お上手…なのかは分かりませんけど…」	PRINTFORMW 「唔呼呼っ、虽然我也…不清楚算不算厉害…」
PRINTFORMW 「でも%CNAME("一人称")%が気持ちいいってことは、きっとお上手なんですわね♪」	PRINTFORMW 「不过让%CNAME("一人称")%这么舒服，一定很厉害呢♪」
PRINTFORMW 「やぁんっ、オマンコ%TEXTR("ぱんぱん/にゅぽにゅぽ/ずぽずぽ")%される度にマン汁おもらししちゃってますわぁっ♪」	PRINTFORMW 「咿呀～っ、小穴每次被%TEXTR("梆梆梆/啾啵啾啵/滋啪滋啪")%的时候爱液就会控制不住的涌出来哇っ♪」
PRINTFORMW 「んっ…あっ、あっ♪あなたのがズブズブってっ♪入ってきましたわぁ…っ♪」	PRINTFORMW 「嗯っ…啊っ、啊っ♪你的东西滋噗滋噗的っ♪进来了哇ぁ…っ♪」
PRINTFORMW 「うふふ、お腹の中から%CNAME("二人称")%のモノにされてますの…♪」	PRINTFORMW 「唔呼呼、从肚子开始都要变成%CNAME("二人称")%的所有物了…♪」
PRINTFORMW 「ぅあぁっ♪あひぃっ♪ひぅぅっ♪待ってっ…激しっ、あぁん♪」	PRINTFORMW 「呜啊啊っ♪啊咿ぃっ♪咿呜呜ぅっ♪等一下っ…太激烈っ,啊啊嗯♪」
PRINTFORMW 「激しすぎてっちょっと怖いですわっ♪手をっ…手を握ってやってくださいましぃっ♪」	PRINTFORMW 「激烈过头了稍微有些害怕呢っ♪手っ…请握住我的手再继续做吧っ♪」
PRINTFORMW 「あぁんっ♪%CNAME("二人称")%のおチンポってばとぉっても元気ですわっ♪」	PRINTFORMW 「啊啊嗯っ♪%CNAME("二人称")%的大肉棒真是非常有精神哇っ♪」
PRINTFORMW 「そんなに%CNAME("一人称")%のオマンコが良かったのなら♪もっと突いてっ♪気持ち良くなってくださいましっ♪」	PRINTFORMW 「%CNAME("一人称")%的小肉穴有那么好的话♪就多多插一插吧っ♪让我变得舒服起来っ♪」
PRINTFORMW 「んぃいぃぃっ♪んあぁぁ…はひぃっ♪」	PRINTFORMW 「呃咿咿咿咿っ♪唔啊啊…哈咿咿っ♪」
PRINTFORMW 「%CNAME("二人称")%のおチンポがぁ♪ごりごりって来てますわぁっ♪」	PRINTFORMW 「%CNAME("二人称")%的大肉棒在ぁ♪咕哩咕哩地进入着っ♪」
PRINTFORMW 「おぉっ…オマンコをおチンポがかき分けて…ミチミチ言ってますわ…ッ♪」	PRINTFORMW 「唔哦っ…我的肉穴在挤压着大肉棒…发出了咪叽咪叽的声音…ッ♪」
PRINTFORMW 「みっ、見えない分、余計に感じちゃいますわね…♪」	PRINTFORMW 「看っ、看不见的部分、反而感觉更强烈呢…♪」
PRINTFORMW 「あっ…こんな…後ろから圧し掛かられて…♪」	PRINTFORMW 「啊っ…这样子…从后面被紧紧压着…♪」
PRINTFORMW 「いやっ…逃げられませんわ…♪このままオマンコいじめ抜かれちゃいますわ…♪」	PRINTFORMW 「讨厌っ…这样就逃不掉了哇…♪这样小穴就会被彻底欺负着哇…♪」
PRINTFORMW 「%TEXTR(@"パンパン/ぱちゅぱちゅ")%って…こんなえっちな音♪%CNAME("一人称")%からしてるなんてぇ♪」	PRINTFORMW 「%TEXTR(@"啪啪啪/啪啾啪啾")%地…这么淫靡的声音♪居然是%CNAME("一人称")%发出来的♪」
PRINTFORMW 「素敵ですわっ♪もっと奏でてくださいませっ♪」	PRINTFORMW 「真是太棒了哇っ♪请更多地奏响我吧っ♪」
PRINTFORMW 「こっ…こんなっ♪盛った%TEXTR(@"犬/動物/ケモノ")%みたいな恰好でまぐわうだなんてっ♪」	PRINTFORMW 「这っ…这么っ♪用这种好像发情的%TEXTR(@"狗/动物/野兽")%交配一样的姿势做爱什么的っ♪」
PRINTFORMW 「よくないっ♪ホントはよくないと思うのにっ♪気持ち良いからもう何でもいいですわっ♪」	PRINTFORMW 「才不要——♪明明原本觉得不能接受的♪但只要舒服的话怎样都好哇っ♪」
PRINTFORMW 「んっ、ふっ…ふぅっ、あ、あぁぁぁ…ッ♪はぁっ、入りっ、ましたわ♪」	PRINTFORMW 「嗯っ、呼っ…呼呜っ、啊、啊啊啊～…ッ♪进っ、进来、了呢♪」
PRINTFORMW 「それでは動いていきますから…%TEXTR(@"%CNAME("二人称")%は休んでいても結構ですわよ/ゆっくり%CNAME("一人称")%の腰使いをお楽しみくださいませ")%♪」	PRINTFORMW 「接下来就该动了…%TEXTR(@"%CNAME("二人称")%只要休息就好了哟/好好用%CNAME("一人称")%的腰来让你尽情享受一番吧")%♪」
PRINTFORMW 「あぁ…%CNAME("一人称")%のオマンコが%CNAME("二人称")%のおチンポを食べてるところ、見られちゃってますわ…♪」	PRINTFORMW 「啊啊…%CNAME("一人称")%的雌穴吞住%CNAME("二人称")%的大肉棒的地方、被看得清清楚楚哇…♪」
PRINTFORMW 「%CNAME("一人称")%と%CNAME("二人称")%が繋がってる証…♪目に焼き付けてくださいまし♪」	PRINTFORMW 「%CNAME("一人称")%和%CNAME("二人称")%结合在一起的证明…♪请好好用眼睛把它刻在心里吧♪」
PRINTFORMW 「うふふ…%CNAME("二人称")%は動かなくって良いんんあぁ？！」	PRINTFORMW 「唔呵呵…%CNAME("二人称")%先不要动如何啊呜啊啊？！」
PRINTFORMW 「もっ、もうっ、動かなくていいって♪言ってますのにぃ♪わからず屋さんですわっ♪」	PRINTFORMW 「真っ、真是的っ、明明说了不要动的♪明明都这么说了♪真是不解风情哇っ♪」
PRINTFORMW 「あっ♪おっ♪あぁぁっ♪気持ち良いっ♪きもちいいぃっ♪」	PRINTFORMW 「啊っ♪唔哦っ♪啊啊啊っ♪好舒服っ♪好苏呼哇っ♪」
PRINTFORMW 「とまんないっ♪おチンポに跨ってっ♪腰を振るのっ♪止まりませんのぉっ♪」	PRINTFORMW 「停不下来っ♪跨坐在鸡鸡上っ♪摆动着腰っ♪完全停不下来呢っ♪」
PRINTFORMW 「んひぃいっ！？ひあああっ！！はっ、ああっ…♪」	PRINTFORMW 「唔咿——咿っ！？咿啊啊啊っ！！哈っ、啊啊っ…♪」
PRINTFORMW 「な、なんですの、今、ビリっとして…それに『見つけた』って…」	PRINTFORMW 「怎、怎么回事，刚刚、哔哩——的触电般的一下子…然后就『到了』…」
PRINTFORMW 「ひぃっ？！またっ、またですわっ♪これっ、頭変になりますのぉっ♪」	PRINTFORMW 「咿——っ？！又来っ、又来了哇っ♪これっ、思维要变得奇怪了っ♪」
PRINTFORMW 「も、もう許してぇっ♪ごめんにゃさいっ♪ゆるしてぇぇっ♪」	PRINTFORMW 「饶、饶了我吧啊啊っ♪十分抱线っ♪饶了我吧呜唉唉っ♪」
PRINTFORMW 「はあぁああぁんッ♪ぃあ゛ぁぁぁあああっーっ♪ひっ、ぐぅぅぅッ♪」	PRINTFORMW 「哈啊啊啊啊呃ッ♪ぃ啊゛啊啊啊啊————っーっ♪咿っ、咕呜呜ッ♪」
PRINTFORMW 「クるっ♪ん゛っ、これぇ、キちゃいますのぉっ♪」	PRINTFORMW 「来了っ♪唔゛っ、这个ぇ、来了呜哇———っ♪」
PRINTFORMW 「もうっ、もうイくっイくイくイ゛くぅ♪イっちゃうぅぅ♪」	PRINTFORMW 「还っ、还在不停地高潮高潮高潮゛高ぅ♪潮っ呜呜呜呜ぅ♪」
PRINTFORMW 「ひあ゛っ♪んぁあああぁぁっ♪ダメッ、ダメダメダメぇっ♪ごりごりダメでしゅのぉっ♪」	PRINTFORMW 「咿啊゛っ♪呃啊啊啊啊っ♪不要ッ、不要不要不要ぇっ♪这样咕哩咕哩的不可以呜哦哦ぉっ♪」
PRINTFORMW 「むりっ、もう無理っ、限界でしゅからぁっ、とめっ…～～～～～ッ♪」	PRINTFORMW 「不幺っ、已经不行了っ、到极限了啊っ、停下っ…～～～～～ッ♪」
PRINTFORMW 「う゛ぁあぁっ！かっ、はぁ、お、奥、にっ、ずん、って…♪」	PRINTFORMW 「呜゛啊啊啊っ！咕っ、哈啊、里、里面、在っ、痉挛、っ着…♪」
PRINTFORMW 「あっ、あっ？なな、なんですの、何かおかしいですわっ、す、スイッチが入ったようなっ、あっ♪」	PRINTFORMW 「啊っ、啊っ？这是、这是怎么，感觉有些奇怪哇っ、就、就像某个神经被触动了一样っ、啊っ♪」
PRINTFORMW 「んあぁぁ、はぁんっ♪身体がっ♪子宮がっ♪きゅんとしてっ♪切ないですわぁっ♪」	PRINTFORMW 「呃啊啊啊、哈呃っ♪身体っ♪还有子宮っ♪啾——地一下っ♪好难受哇啊っ♪」
PRINTFORMW 「んおおぉっ♪ちゅぽちゅぽやめてっ♪おぁ、とめてっ、いやっ、やぁですわぁっ♪」	PRINTFORMW 「呜哦哦哦っ♪啾啵啾啵地快停下啊っ♪呜啊、快停下っ、不要っ、快停下来哇啊啊っ♪」
PRINTFORMW 「子宮口がおチンポ汁飲んでッ♪喜んじゃうっ♪もっと欲しいってわがままになっちゃいますからあっ♪」	PRINTFORMW 「子宮口把肉棒汁全喝掉了ッ♪好高兴啊っ♪感觉开始任性地还想要更多的啊っ♪」
PRINTFORMW 「んんーっ♪あひっ、ぃひぅうぅっ♪ふぅっ、あっあっ♪ああーーーーッ♪」	PRINTFORMW 「呃呃ーっ♪咿啊っ、咿呜呜呜——っ♪呼呜っ、啊っ啊っ♪啊啊啊ーーーーッ♪」
PRINTFORMW 「こんなに奥深くまでっ♪おチンポ%TEXTR(@"突き刺す/暴れさせる")%だなんてぇっ♪こんなのったえられないぃっ♪」	PRINTFORMW 「到了这么深的地方っ♪被大肉棒%TEXTR(@"彻底捅穿/肆意胡闹")%什么的ぇっ♪这样的っ撑不下去啊啊呜っ♪」
PRINTFORMW 「こんな激しくっ♪奥までっ♪ピストンするなんてっ♪ダメですわッ♪」	PRINTFORMW 「这么激烈的っ♪在最里面っ♪不停抽插着っ♪不可以哇ッ♪」
PRINTFORMW 「子宮口%TEXTR(@"トントン/こねこね/グリグリ")%されたらっ♪我慢出来ないっ♪できるわけないですのにぃ～～～っ♪」	PRINTFORMW 「子宮口被不断%TEXTR(@"撞击/冲撞/顶")%着っ♪已经受不住了っ♪不可能受得住呜哦哦哦～～～っ♪」
PRINTFORMW 「あっ、やっ♪%TEXTR(@"ゴツゴツ/こんこん")%って当たってえぇっ♪頭がチカチカしますのぉっ♪」	PRINTFORMW 「啊っ、呀啊っ♪%TEXTR(@"咕滋咕滋/咚咚咚")%地撞击着呃っ♪脑袋晕乎乎的唔っ♪」
PRINTFORMW 「おチンポと子宮のキスっ♪ありえないぐらい気持ちいいですわっ♪」	PRINTFORMW 「肉棒在和和子宫接吻っ♪难以想象的快感在奔涌着哇っ♪」
PRINTFORMW 「ひゃあぁっ♪あついっ♪お腹の中に熱いモノがっ♪ビューって来てますのぉっ♪」	PRINTFORMW 「咿呀啊啊——っ♪好烫啊っ♪肚子里面有烫烫的东西っ♪咻ーっ地进来了呜呜ぉっ♪」
PRINTFORMW 「はぁぁ～…こ、これが…これが膣内射精…中出しですのね…ッ♪」	PRINTFORMW 「哈啊啊～…这、这就是…这就是膣内射精…就是中出吗…ッ♪」
PRINTFORMW 「あぉっ♪うっ、あぁぁっ♪ドクドクって脈打ってますわッ…♪」	PRINTFORMW 「啊嗷っ♪呜っ、啊啊啊っ♪噗噜噗噜地——搏动着哇ッ…♪」
PRINTFORM 「こんなコッテリ精液、子宮に注がれたら…	PRINTFORM 「被如此浓厚的精液、注入到子宫里的话…
PRINTFORMW きっと孕んでしまっていましたわね…♪」	PRINTFORMW 肯定会怀孕的吧…♪」
PRINTFORMW 絶対孕んじゃいますわね…♪」	PRINTFORMW 绝对会怀孕没错呢…♪」
PRINTFORMW 「ひぁあ～～～っ♪きたぁっ♪精子きましたわぁっ♪」	PRINTFORMW 「咿啊啊～～～っ♪来了啊——っ♪精子进来了哇ぁっ♪」
PRINTFORMW 「でも残念ですわねっ♪ゴム一枚のせいでっ♪本懐を遂げることはできませんのよっ♪」	PRINTFORMW 「但是真遗憾呢っ♪还有一个避孕套っ♪让我怀孕的夙愿是没法实现了哟っ♪」
PRINTFORMW 「子作りする気満々のっ♪ピチピチ精子ぃっ♪注がれちゃってますわぁ～ッ♪」	PRINTFORMW 「满心想着让我怀孕的っ♪精力十足的精子ぃっ♪被射进来了哇ぁ～ッ♪」
PRINTFORMW 「んああっ♪すごいっ、すごいぃっ♪」	PRINTFORMW 「呃啊啊っ♪好厉害っ、好厉害啊っ♪」
PRINTFORM 「熱々ぷりぷり精液が奥で暴れてっ♪	PRINTFORM 「热热的新鲜活泼的精液在我的里面横冲直撞っ♪
PRINTFORMW ゴム越しでも%CNAME("一人称")%を孕ませたいって伝わってきますわっ♪」	PRINTFORMW 就算隔着避孕套也能传达出想要让%CNAME("一人称")%怀孕的心情呢っ♪」
PRINTFORMW これが%CNAME("一人称")%を孕ませるのですわねっ♪」	PRINTFORMW 这样会让%CNAME("一人称")%怀孕的吧っ♪」
PRINTFORMW 「ひぅうっ♪あはぁ…すごい、ですわ♪」	PRINTFORMW 「咿呜呜っ♪啊哈啊…好棒、好棒哇♪」
PRINTFORM 「奥でビチャビチャって、あっついザーメンが弾けて…	PRINTFORM 「在里面哔啾哔啾的、热乎乎的精液在向四处喷涌着…
PRINTFORMW ゴムが膨らむのが分かりますわよ♪」	PRINTFORMW 避孕套都涨大了，我感觉到了哟♪」
PRINTFORMW 気持ち良いですわ♪」	PRINTFORMW 真的好舒服哇♪」
PRINTFORMW 「んうっ♪あっ、んっ、んあぁ～～～っ♪」	PRINTFORMW 「呃唔っ♪啊っ、呃っ、呃啊啊～～～っ♪」
PRINTFORMW 「おチンポがビクビクして…ふふ、%CNAME("一人称")%のオマンコも一緒に喜んでますわよっ♪」	PRINTFORMW 「鸡鸡在在抖动着…呼呼、%CNAME("一人称")%的小穴也在一起喜悦着呢っ♪」
PRINTFORMW 「あっ♪ああっ♪出たっ、出ましたわぁっ♪」	PRINTFORMW 「啊っ♪啊啊っ♪出来了っ、出来了哇ぁっ♪」
PRINTFORM 「熱くて重たいのがびゅるびゅるして…	PRINTFORM 「又热又多的喷射着…
PRINTFORMW ゴム越しにでも分かりますわ…♪」	PRINTFORMW 隔着避孕套也能感觉到哇…♪」
PRINTFORMW それでお腹の奥にドロドロって溜まってますわねっ♪」	PRINTFORMW 还在肚子里面黏糊糊地积攒着呢っ♪」
LOCALS = %LOCALS%ん……ちゅ……はふ…	LOCALS = %LOCALS%唔……啾……哈呼…
LOCALS = %LOCALS%はむ、ん、んんぅ……	LOCALS = %LOCALS%哈呜、唔、唔嗯——……
LOCALS = %LOCALS%んふ……んん…♪　ふぁ…ちゅぅ…	LOCALS = %LOCALS%唔呼……唔嗯…♪　呼啊…啾——…
LOCALS = %LOCALS%んちゅ……ぷは、ぁ……ぁむ	LOCALS = %LOCALS%嗯啾……啪哈、啊……啊唔
LOCALS = %LOCALS%ぅん…ちゅ…くちゅ……	LOCALS = %LOCALS%呜唔…啾…咕啾……
LOCALS = %LOCALS%んぁ……ぁむ…ちゅ…	LOCALS = %LOCALS%嗯啊……啊呜…啾…
LOCALS = %LOCALS%んふ…ちゅ…んん…、ぁふ…	LOCALS = %LOCALS%嗯呼…啾…嗯嗯…、啊呼…
LOCALS = %LOCALS%ぁむ…ちゅぅ……、ぷは、ぁ……あふぅ…	LOCALS = %LOCALS%啊唔…啾——……、噗哈、啊……啊呜——…
LOCALS = %LOCALS%んちゅ…ぁ、むぅ……はふ、むちゅ～～…	LOCALS = %LOCALS%嗯啾…啊、呣呜……哈呼、呣啾～～…
LOCALS = %LOCALS%…ぅん…ちゅ…はむ…	LOCALS = %LOCALS%…唔嗯…啾…哈呜…
LOCALS = %LOCALS%んん…ちゅぅ…ぁふ…	LOCALS = %LOCALS%嗯嗯…啾——…啊呼…
LOCALS = %LOCALS%ちゅ……ん、んん……	LOCALS = %LOCALS%啾……嗯、唔嗯……
LOCALS = %LOCALS%…ぅん…ちゅ…くちゅ…	LOCALS = %LOCALS%…唔嗯…啾…咕啾…
LOCALS = %LOCALS%ちゅ…ぁむ……んん♪　ちゅ	LOCALS = %LOCALS%啾…啊呣……嗯嗯♪　啾
LOCALS = %LOCALS%ぁむ…れろ……ん、ちゅぅ…	LOCALS = %LOCALS%啊唔…舔……嗯、啾——…
LOCALS = %LOCALS%ちゅっ、ちゅぅ…ちゅ…	LOCALS = %LOCALS%啾っ、啾～…啾…
LOCALS = %LOCALS%ぁむっ♪　はふ、ちゅ、ちゅぅ～～	LOCALS = %LOCALS%啊呜っ♪　哈呼、啾、啾～～
LOCALS = %LOCALS%んっ♪ちゅっ、ちゅっ、ちゅ	LOCALS = %LOCALS%唔っ♪啾っ、啾っ、啾
LOCALS = %LOCALS%ちゅ～～～～～～	LOCALS = %LOCALS%啾～～～～～～
LOCALS = %LOCALS%ちゅっ♪　ちゅっ♪　ちゅ……	LOCALS = %LOCALS%啾っ♪　啾っ♪　啾……
LOCALS = %LOCALS%あむっ、はふっ♪　くちゅっ、ちゅ	LOCALS = %LOCALS%哈呜っ、哈唔っ♪　咕啾っ、啾
LOCALS = %LOCALS%ちゅ…、ちろちろ、ちゅ	LOCALS = %LOCALS%啾…、舔～舔～、啾
LOCALS = %LOCALS%んっ♪　ちゅっ、つっ、ちゅ…	LOCALS = %LOCALS%嗯っ♪　啾っ、嗞っ、啾…
LOCALS = %LOCALS%ちゅっ、ちゅっちゅるる	LOCALS = %LOCALS%啾っ、啾っ啾噜噜
LOCALS = %LOCALS%ちゅっ、ちゅっ……はむ	LOCALS = %LOCALS%啾っ、啾っ……哈呼
LOCALS = %LOCALS%ちゅう、ちゅぅ～	LOCALS = %LOCALS%啾——、啾——～
LOCALS = %LOCALS%ちゅっ、っちゅ…くちゅっ、ちゅ	LOCALS = %LOCALS%啾っ、っ啾…咕啾っ、啾
LOCALS = %LOCALS%んちゅっ♪　ちゅっ、ちゅくちゅく	LOCALS = %LOCALS%唔啾っ♪　啾っ、啾咕啾咕
LOCALS = %LOCALS%ちゅっ、ちゅく	LOCALS = %LOCALS%啾っ、啾咕
LOCALS = %LOCALS%ちゅっ、ちゅくっ♪　ちゅう～	LOCALS = %LOCALS%啾っ、啾くっ♪　啾——～
LOCALS = %LOCALS%んっ♪　ちゅっ、ちゅ～～	LOCALS = %LOCALS%嗯っ♪　啾っ、啾～～
LOCALS = %LOCALS%はむっ………んふっ、ちゅ	LOCALS = %LOCALS%哈呼っ………嗯呼っ、啾
LOCALS = %LOCALS%あむっ…ちゅっ、チュッ…	LOCALS = %LOCALS%啊呣っ…啾っ、啾ッ…
LOCALS = %LOCALS%っちゅ…ちゅ～～っ、ちゅっ、ちゅ	LOCALS = %LOCALS%っ啾…啾～～っ、啾っ、啾
LOCALS = %LOCALS%はむっ…ん、ちゅっ、ちゅっ	LOCALS = %LOCALS%哈唔っ…ん、啾っ、啾っ
LOCALS = %LOCALS%ちゅく、ちゅく…ちゅるる	LOCALS = %LOCALS%啾咕、啾咕…啾噜噜
LOCALS = %LOCALS%ん～～っ、んっ、ちゅ	LOCALS = %LOCALS%嗯～～っ、嗯っ、啾
LOCALS = %LOCALS%ちゅっ、ちゅう…	LOCALS = %LOCALS%啾っ、啾——…
LOCALS = %LOCALS%ぁむ……んん…んむ…	LOCALS = %LOCALS%啊呣……嗯嗯…嗯唔…
LOCALS = %LOCALS%ん……ちゅ……	LOCALS = %LOCALS%呃……啾……
LOCALS = %LOCALS%はむ、んぅ……	LOCALS = %LOCALS%哈呜、唔呜……
LOCALS = %LOCALS%んふ……んん……ちゅ……	LOCALS = %LOCALS%嗯呼……唔嗯……啾……
LOCALS = %LOCALS%ん………ぷは、ぁ……	LOCALS = %LOCALS%呃………噗哈、啊……
LOCALS = %LOCALS%ぅん………ちゅ……	LOCALS = %LOCALS%呜嗯………啾……
LOCALS = %LOCALS%はむ、ん、んん……	LOCALS = %LOCALS%哈唔、嗯、嗯嗯……
LOCALS = %LOCALS%んふ……ん……	LOCALS = %LOCALS%嗯呼……嗯……
LOCALS = %LOCALS%ん……ぁむ……	LOCALS = %LOCALS%嗯……啊呜……
LOCALS = %LOCALS%んふ…ちゅ…んん……	LOCALS = %LOCALS%嗯呼…啾…呃嗯……
LOCALS = %LOCALS%ぁむ…ちゅぅ……	LOCALS = %LOCALS%啊唔…啾——……
LOCALS = %LOCALS%んちゅ…ぁ、むぅ……	LOCALS = %LOCALS%嗯啾…啊、呣呜……
LOCALS = %LOCALS%…ぅん…ちゅ……	LOCALS = %LOCALS%…呜嗯…啾……
LOCALS = %LOCALS%んん…ちゅぅ……	LOCALS = %LOCALS%嗯嗯…啾——……
LOCALS = %LOCALS%ちゅ…ん、む……	LOCALS = %LOCALS%啾…嗯、呣……
LOCALS = %LOCALS%ぁむ…れろ……	LOCALS = %LOCALS%啊呣…舔……
LOCALS = %LOCALS%ちゅっ…ちゅ……	LOCALS = %LOCALS%啾っ…啾……
LOCALS = %LOCALS%ちゅぅぅ……れろ、れろ…	LOCALS = %LOCALS%啾————……舔、舔…
LOCALS = %LOCALS%れろ、ちゅ、じゅるる…	LOCALS = %LOCALS%舔、啾、啾噜噜…
LOCALS = %LOCALS%じゅる、じゅるる……ぷは、ちゅ…	LOCALS = %LOCALS%啾噜、啾噜噜……噗哈、啾…
LOCALS = %LOCALS%ちゅぅぅ…じゅるる…	LOCALS = %LOCALS%啾————…啾噜噜…
LOCALS = %LOCALS%ちゅぅ…れろれろ…	LOCALS = %LOCALS%啾——…舔舔…
LOCALS = %LOCALS%ちゅぅ……れろ…	LOCALS = %LOCALS%啾——……舔…
LOCALS = %LOCALS%じゅぶ、じゅるる…	LOCALS = %LOCALS%啾噗、啾噜噜…
LOCALS = %LOCALS%じゅぶ、じゅるるっ…	LOCALS = %LOCALS%啾噗、啾噜噜っ…
LOCALS = %LOCALS%ぁむっ…ちゅぅ…	LOCALS = %LOCALS%啊呣っ…啾——…
LOCALS = %LOCALS%ちゅぱっ……ちゅぷっ…	LOCALS = %LOCALS%啾啪っ……啾啪っ…
LOCALS = %LOCALS%くちゅ……ちゅぅ…	LOCALS = %LOCALS%く啾……啾——…
LOCALS = %LOCALS%ちゅっ……くちゅ…	LOCALS = %LOCALS%啾っ……咕啾…
LOCALS = %LOCALS%ぴちゃ……ちゅぅ…	LOCALS = %LOCALS%噼啾……啾——…
LOCALS = %LOCALS%ぴちゃ…ぺろ…ちゅっ…	LOCALS = %LOCALS%噼啾…舔…啾っ…
LOCALS = %LOCALS%じゅぷ、ちゅる…ちゅぽっ	LOCALS = %LOCALS%啾噗、啾噜…啾啵っ
LOCALS = %LOCALS%ぺろっ…ふふ…くちゅ…	LOCALS = %LOCALS%舔っ…呼呼…く啾…
LOCALS = %LOCALS%んちゅ……ぷは、ぁ…	LOCALS = %LOCALS%嗯啾……啪哈、啊…
LOCALS = %LOCALS%んふ…ちゅ…んん…	LOCALS = %LOCALS%嗯呼…啾…呃嗯…
LOCALS = %LOCALS%ぁむ…ちゅぅ…	LOCALS = %LOCALS%啊唔…啾——…
LOCALS = %LOCALS%じゅぷ、じゅぷ…	LOCALS = %LOCALS%啾噗、啾噗…
LOCALS = %LOCALS%ぅん…ちゅ…はむ…	LOCALS = %LOCALS%唔嗯…啾…哈呼…
LOCALS = %LOCALS%ふぁ……んくッ……ちゅ	LOCALS = %LOCALS%呼啊……嗯咕ッ……啾
LOCALS = %LOCALS%じゅぷじゅぷっ、じゅる	LOCALS = %LOCALS%啾噗啾噗っ、啾噜
LOCALS = %LOCALS%んっ…んむ……ちゅっ、ちゅ…	LOCALS = %LOCALS%嗯っ…呃呣……啾っ、啾…
LOCALS = %LOCALS%じゅるっ…んっ…んむ…	LOCALS = %LOCALS%啾噜っ…嗯っ…唔呣…
LOCALS = %LOCALS%ぴちゃ…ちゅむっ…	LOCALS = %LOCALS%哔啾…啾呣っ…
LOCALS = %LOCALS%ちゅ…じゅぼ、じゅる…	LOCALS = %LOCALS%啾…啾啵、啾噜…
LOCALS = %LOCALS%じゅるっ…んっ…む…	LOCALS = %LOCALS%啾噜っ…嗯っ…呣…
LOCALS = %LOCALS%じゅく、じゅぷじゅぷっ、くちゅぅ…	LOCALS = %LOCALS%啾咕、啾噗啾噗っ、く啾——…
LOCALS = %LOCALS%あむっ…ちゅっ、ちゅ…	LOCALS = %LOCALS%啊唔っ…啾っ、啾…
LOCALS = %LOCALS%ちゅぷっ、くちゃ…ちゅ	LOCALS = %LOCALS%啾噗っ、咕啾…啾
LOCALS = %LOCALS%はむっ…ん、ちゅっ、ちゅ	LOCALS = %LOCALS%哈唔っ…嗯、啾っ、啾
LOCALS = %LOCALS%ちゅっ、ぺろ…	LOCALS = %LOCALS%啾っ、舔…
LOCALS = %LOCALS%ぷぁ……じゅる	LOCALS = %LOCALS%噗啊……啾噜
LOCALS = %LOCALS%れろ……ぁむ、ちゅ…	LOCALS = %LOCALS%舔……啊呣、啾…
LOCALS = %LOCALS%ちゅ……れろ、れろ…	LOCALS = %LOCALS%啾……舔、舔…
LOCALS = %LOCALS%れろ……じゅる…る…	LOCALS = %LOCALS%舔……啾噜…噜…
LOCALS = %LOCALS%じゅる、じゅるる……	LOCALS = %LOCALS%啾噜、啾噜噜……
LOCALS = %LOCALS%ちゅ……じゅる、る…	LOCALS = %LOCALS%啾……啾噜、噜…
LOCALS = %LOCALS%ちゅ…れろ……	LOCALS = %LOCALS%啾…舔……
LOCALS = %LOCALS%ちゅ……れろ…	LOCALS = %LOCALS%啾……舔…
LOCALS = %LOCALS%じゅぶ、じゅる…	LOCALS = %LOCALS%啾噗、啾噜…
LOCALS = %LOCALS%ぁむっ…ちゅ……	LOCALS = %LOCALS%呃呣っ…啾……
LOCALS = %LOCALS%ちゅぱ……ちゅぷっ…	LOCALS = %LOCALS%啾啪……啾噗っ…
LOCALS = %LOCALS%ちゅ……くちゅ…	LOCALS = %LOCALS%啾……咕啾…
LOCALS = %LOCALS%ぴちゃ……ちゅ……	LOCALS = %LOCALS%噼啾……啾……
LOCALS = %LOCALS%ぴちゃ……ちゅ…	LOCALS = %LOCALS%噼啾……啾…
LOCALS = %LOCALS%ぅん…ちゅ、くちゅ…	LOCALS = %LOCALS%唔嗯…啾、咕啾…
LOCALS = %LOCALS%じゅぷ、ちゅる…ちゅぷ…	LOCALS = %LOCALS%啾噗、啾噜…啾噗…
LOCALS = %LOCALS%ぺろっ……くちゅ…	LOCALS = %LOCALS%舔っ……咕啾…
LOCALS = %LOCALS%んちゅ……ぷは…	LOCALS = %LOCALS%嗯啾……啪哈
LOCALS = %LOCALS%ん…ちゅ……	LOCALS = %LOCALS%嗯…啾……
LOCALS = %LOCALS%ぁむ…ちゅ…	LOCALS = %LOCALS%啊呜…啾…
LOCALS = %LOCALS%ぅん……はむ…	LOCALS = %LOCALS%唔嗯……哈呣…
LOCALS = %LOCALS%んん…ちゅ……	LOCALS = %LOCALS%嗯嗯…啾……
LOCALS = %LOCALS%ん…ちゅ……くちゅ…	LOCALS = %LOCALS%嗯…啾……咕啾…
LOCALS = %LOCALS%ちゅ…ぁむ…んん…	LOCALS = %LOCALS%啾…啊呣…嗯嗯…
LOCALS = %LOCALS%ぁむ…れろ……ん、ちゅ…	LOCALS = %LOCALS%啊唔…舔……呃、啾…
LOCALS = %LOCALS%じゅぷ、じゅる……	LOCALS = %LOCALS%啾噗、啾噜……
LOCALS = %LOCALS%んっ…んむ……ちゅ、ちゅ…	LOCALS = %LOCALS%呃っ…唔呣……啾、啾…
LOCALS = %LOCALS%じゅる……んっ…んむ…	LOCALS = %LOCALS%啾噜……呃っ…唔呣…
LOCALS = %LOCALS%あむ…、くちゅ…	LOCALS = %LOCALS%唔呣…、咕啾…
LOCALS = %LOCALS%ちゅ…、ちゅ…	LOCALS = %LOCALS%啾…、啾…
LOCALS = %LOCALS%んっ、ちゅ…っ、ちゅ…	LOCALS = %LOCALS%呃っ、啾…っ、啾…
LOCALS = %LOCALS%ちゅっ、ちゅ…ちゅるる…	LOCALS = %LOCALS%啾っ、啾…啾噜噜…
LOCALS = %LOCALS%ちゅっ、ちゅっ……んむ…	LOCALS = %LOCALS%啾っ、啾っ……唔呣…
LOCALS = %LOCALS%じゅるっ……んっ…む…	LOCALS = %LOCALS%啾噜っ……呃っ…呣…
LOCALS = %LOCALS%じゅく、じゅぷ…くちゅぅ…	LOCALS = %LOCALS%啾咕、啾噗…咕啾——…
LOCALS = %LOCALS%ちゅっ、ちゅく、ちゅ…	LOCALS = %LOCALS%啾っ、啾咕、啾…
LOCALS = %LOCALS%んっ、ちゅ…ちゅ…	LOCALS = %LOCALS%呃っ、啾…啾…
LOCALS = %LOCALS%はむ……んふ…、ちゅ	LOCALS = %LOCALS%哈呜……嗯呼…、啾
LOCALS = %LOCALS%あむ……ちゅっ、ちゅ…	LOCALS = %LOCALS%啊呣……啾っ、啾…
LOCALS = %LOCALS%はむっ…ん、ちゅ…ちゅ	LOCALS = %LOCALS%哈呣っ…嗯、啾…啾
LOCALS = %LOCALS%ちゅく……ちゅるる	LOCALS = %LOCALS%啾咕……啾噜噜
LOCALS = %LOCALS%んげ、ぇ……、ぉごっ……	LOCALS = %LOCALS%呃咳、呃……、咕っ……
LOCALS = %LOCALS%っご、ぉぶ……ん、ぐ…	LOCALS = %LOCALS%っ咕、呜卟……嗯、咕…
LOCALS = %LOCALS%んぶっ、ぐ…げぇ…	LOCALS = %LOCALS%呃噗っ、咕…吭——…
LOCALS = %LOCALS%んご、ぉげ……、ぐ…	LOCALS = %LOCALS%呃咕、呃吭……、咕…
LOCALS = %LOCALS%んぐぅぅぅぅ…	LOCALS = %LOCALS%呃咕————…
LOCALS = %LOCALS%んぐっ、こほっ、こほっ…	LOCALS = %LOCALS%呃咕っ、咳っ、咳っ…
LOCALS = %LOCALS%ぐっ、ん、ぅぐ…	LOCALS = %LOCALS%咕っ、嗯、呜咕…
LOCALS = %LOCALS%げほっ、ごほごほっ…	LOCALS = %LOCALS%呜咳っ、咳咳っ…
LOCALS = %LOCALS%んくっぅぅ…	LOCALS = %LOCALS%呃咕っ————…
LOCALS = %LOCALS%んんっ、ぐっ、んっ	LOCALS = %LOCALS%嗯呃っ、咕っ、呃っ
LOCALS = %LOCALS%じゅぼっ…ん、ちゅば…	LOCALS = %LOCALS%啾啵っ…嗯、啾吧…
LOCALS = %LOCALS%はぁ、んぐ…	LOCALS = %LOCALS%哈啊、呃咕…
LOCALS = %LOCALS%げっ！　…ぇほっ、んぁぁ…	LOCALS = %LOCALS%吭っ！　…唔呼っ、呃啊——…
LOCALS = %LOCALS%ん……じゅるっ、んぐぅっ…	LOCALS = %LOCALS%嗯……啾噜っ、呃咕——っ…
LOCALS = %LOCALS%んぐ……じゅる…	LOCALS = %LOCALS%呃咕……啾噜…
LOCALS = %LOCALS%じゅぶっ……れろ、れろ…	LOCALS = %LOCALS%啾噗っ……舔、舔…
LOCALS = %LOCALS%ん、くぅ……けほっ、んっ	LOCALS = %LOCALS%嗯、咕——……吭咳っ、呃っ
LOCALS = %LOCALS%んぐぅ……ッ、ぐ…	LOCALS = %LOCALS%嗯咕——……ッ、咕…
LOCALS = %LOCALS%むぐっ、んふ、じゅぼっ…んぅ、じゅる…	LOCALS = %LOCALS%呣咕っ、嗯呼、啾啵っ…嗯——、啾噜…
LOCALS = %LOCALS%んぐっ、んむぅ…	LOCALS = %LOCALS%嗯咕っ、唔呣——…
LOCALS = %LOCALS%じゅるっ…んんぅっ、じゅる…	LOCALS = %LOCALS%啾噜っ…呃呃呜っ、啾噜…
LOCALS = %LOCALS%んんっ、ぐっ、ん、ぅぐ…	LOCALS = %LOCALS%嗯呃っ、咕っ、嗯、呜咕…
LOCALS = %LOCALS%むぅ、んっ…けほっ…	LOCALS = %LOCALS%呣——、呃っ…吭咳っ…
LOCALS = %LOCALS%むぐ！？…んんっ、ぐ…	LOCALS = %LOCALS%呣咕！？…嗯呃っ、咕…
LOCALS = %LOCALS%ん、ぅぐ…げほっ、んっ、んぐっ…	LOCALS = %LOCALS%嗯、呜咕…吭咳っ、呃っ、呃咕っ…
LOCALS = %LOCALS%んんっ、ぐっ、ん、ぅぐ…むぅ、んっ…	LOCALS = %LOCALS%嗯呃っ、咕っ、嗯、呜咕…呣——、呃っ…
LOCALS = %LOCALS%んん…ちゅ…んぐっ…	LOCALS = %LOCALS%嗯嗯…啾…呃咕っ…
LOCALS = %LOCALS%んんっ…ぁふ、んんっ…	LOCALS = %LOCALS%嗯呃っ…啊呼、嗯呃っ…
LOCALS = %LOCALS%れろ……ぁぶ、んんぶ…ぐぅっ	LOCALS = %LOCALS%舔……啊噗、嗯呃噗…咕呜っ
LOCALS = %LOCALS%ふぁ……んくッ……	LOCALS = %LOCALS%呼啊……嗯咕ッ……
LOCALS = %LOCALS%じゅぷじゅぷっ、じゅるっ…	LOCALS = %LOCALS%啾噗啾噗っ、啾噜っ…
LOCALS = %LOCALS%んっ…んむ……れろ…んむ…	LOCALS = %LOCALS%呃っ…唔呣……舔…唔呣…
LOCALS = %LOCALS%じゅぶ…ちゅむっ…	LOCALS = %LOCALS%啾噗…啾呣っ…
LOCALS = %LOCALS%んむっ、んんっ…んぶっ…	LOCALS = %LOCALS%呃呣っ、嗯嗯っ…呃噗っ…
LOCALS = %LOCALS%んぐぅっ！　んっ、んんんっぅ～	LOCALS = %LOCALS%呃咕呜っ！　呃っ、嗯呃呃っ唔～
LOCALS = %LOCALS%むぐっ、んっ………～～～っ！　ぷは、ぁっ…	LOCALS = %LOCALS%呣咕っ、呃っ………～～～っ！　噗哈、啊っ…
LOCALS = %LOCALS%んむっ、んっ……んん、んんぅぅぅ～～	LOCALS = %LOCALS%唔呣っ、呃っ……嗯嗯、呃呜呜————～～
LOCALS = %LOCALS%んぐっ、んぶっ…じゅぼ、じゅぶ…	LOCALS = %LOCALS%呃咕っ、呃噗っ…啾啵、啾噗…
LOCALS = %LOCALS%んぶっ…じゅぼ、じゅる…	LOCALS = %LOCALS%唔噗っ…啾啵、啾噜…
LOCALS = %LOCALS%ぴちゃ…じゅるるっ…	LOCALS = %LOCALS%噼啾…啾噜噜っ…
LOCALS = %LOCALS%じゅぅ…んぐ、んん…	LOCALS = %LOCALS%啾——…呃咕、嗯嗯…
LOCALS = %LOCALS%むぐっ！？　げほっ…ぉえ…	LOCALS = %LOCALS%呣咕っ！？　吭咳っ…唔唉…
LOCALS = %LOCALS%んんっ……じゅぶ…	LOCALS = %LOCALS%嗯呃っ……啾噗…
LOCALS = %LOCALS%んぐっ……んふっ、じゅぶ…	LOCALS = %LOCALS%呃咕っ……嗯呼っ、啾噗…
LOCALS = %LOCALS%んんんっ、ぁふ、ぁむっ、んんっ…	LOCALS = %LOCALS%嗯呃呃っ、啊呼、啊唔っ、嗯呃っ…
LOCALS = %LOCALS%んんぅっ！？　げほっ…ぁふ、ぅぅ…むぐ…	LOCALS = %LOCALS%呃呃唔っ！？　吭咳っ…啊呼、唔唔…呣咕…
LOCALS = %LOCALS%じゅる…じゅぶ、じゅぶぶ…	LOCALS = %LOCALS%啾噜…啾噗、啾噗噗…
LOCALS = %LOCALS%んんっ、じゅる…じゅぅぅ…	LOCALS = %LOCALS%嗯呃っ、啾噜…啾————…
LOCALS = %LOCALS%ぷぁ……じゅる……れろ…	LOCALS = %LOCALS%噗啊……啾噜……舔…
LOCALS = %LOCALS%んくっ、んっ…	LOCALS = %LOCALS%唔咕っ、唔っ…

//EVENT_K37_DAILY

PRINTFORMW 「ちゅぅっ…ちゅちゅっ…%TEXTR("あら/ふふ")%、%TEXTR("おはようございます/やっ…と起きましたわね")%♪」	PRINTFORMW 「啾…啾啾…%TEXTR("啊啦/哼哼")%、%TEXTR("早上好啊/终——于醒来了呢")%♪」
PRINTFORMW 「%TEXTR(@"ごめんなさい、%CNAME("二人称")%の%TEXTR("御子息/御立派様/おチンポ")%をつまみ食いしてしまって/もっとも、%CNAME("二人称")%の%TEXTR("御子息/御立派様/おチンポ/おチンチン")%はとっくに早起きしてらしたけど…")%♪」	PRINTFORMW 「%TEXTR(@"真抱歉，擅自偷吃%CNAME("二人称")%的%TEXTR("小弟弟/大家伙/肉棒")%/话虽如此，%CNAME("二人称")%的%TEXTR("小弟弟/大家伙/肉棒/大鸡鸡")%倒是早早地就起来了呢…")%♪」
PRINTFORMW 「%TEXTR("あら/ふふ")%、上から失礼して…おはようございます♪」	PRINTFORMW 「%TEXTR("あら/ふふ")%、虽然坐在你上面这样说有些失礼…早上好♪」
PRINTFORMW 「今日は体育の授業がありますわね」	PRINTFORMW 「今天有体育课呢」
PRINTFORMW 「%CNAME("一人称")%大活躍の予感ですわ！」	PRINTFORMW 「我有预感%CNAME("一人称")%会大显身手哇！」
PRINTFORMW 「今日は体育の授業がありますわね。体育着は忘れずにお持ちになりまして？」	PRINTFORMW 「今天有体育课呢。不要忘记带上体育服哦？」
PRINTFORMW 「今日は水泳の授業がありますわね」	PRINTFORMW 「今天有游泳课呢」
PRINTFORMW 「ふふ、%CNAME("一人称")%の水着姿に見とれて溺れないように注意ですわよ♪」	PRINTFORMW 「哼哼，小心不要因为看%CNAME("一人称")%穿着泳装的样子看得太入迷导致溺水了哟♪」
PRINTFORMW 「今日は水泳の授業がありますわね。水着は忘れずにお持ちになりまして？」	PRINTFORMW 「今天有游泳课呢。不要忘记带泳服哦？」
PRINTFORMW 「あ、あら、おはようございます！」	PRINTFORMW 「啊，啊啦，早上好！」
PRINTFORMW （むぅ、おはようエアバズーカをぶっ放すチャンスを失いましたわ…）	PRINTFORMW （唔、失去了一次释放早安空气炮的机会哇…）
PRINTFORMW 「おはようございます%TEXTR("＿/ッ")%！」	PRINTFORMW 「早上好啊%TEXTR("＿/ッ")%！」
PRINTFORMW 「今日も良い天気ですわよ！」	PRINTFORMW 「今天也是好天气哟！」
PRINTFORMW 「今なら人目を気にせずセクハラし放題ですわよ♪　ほらほら♪」	PRINTFORMW 「现在的话可以不用担心别人的目光随意的对我性骚扰哟♪　来呀来呀♪」
PRINTFORMW 「あら、二人っきりですわね」	PRINTFORMW 「啊、是二人独处呢」
PRINTFORMW 「他の方はどうしたのかしら？」	PRINTFORMW 「其他人都去哪里了呀？」
PRINTFORMW 「只今帰りましたわ」	PRINTFORMW 「我回来啦」
PRINTFORMW 「あら、良い匂い…%TEXTR("玄関の芳香剤、変えました？/今日のおゆはんかしら…(ｸﾞｩｩ…)")%」	PRINTFORMW 「啊呀，好好闻啊…%TEXTR("玄关的芳香剂换了吗？/是今天的晚饭吗…(咕噜噜…)")%」
PRINTFORMW 「お帰りなさいませ、%TEXTR("今日も学校楽しかったですわね！ねっ！/お先に寛がせていただいてますわ")%」	PRINTFORMW 「你回来啦，%TEXTR("今天也在学校过得很开心呢！对吧！/请允许我先放松一下哇")%」
PRINTFORML 「まったく…だいぶ寄り道してらしたようですわね？」	PRINTFORML 「真是的…你是不是途中饶了不少远路哇？」
PRINTFORMW 「%CNAME("一人称")%、すこーしだけ心配しましたのよ？」	PRINTFORMW 「%CNAME("一人称")%，让我稍微有些担心了哟？」
PRINTFORML 「あら、お帰りなさいませ～」	PRINTFORML 「啊，你回来啦～」
PRINTFORMW 玄関のドアを開けると、%CALLNAME:ARG%が僅かに身体を宙に浮かせて漂っていた…。	PRINTFORMW 一打开门，发现%CALLNAME:ARG%让身体微微漂浮在半空中…。
PRINTFORMW 「あら、お先に寛がせていただいてますわ」	PRINTFORMW 「啊呀，请允许我先放松一下哇」
PRINTFORML 「だいぶ重役出勤でしたわね」	PRINTFORML 「做了很重要的工作呢」
PRINTFORMW 「補習でしたら%CNAME("一人称")%の分かる範囲で教えますわよ？」	PRINTFORMW 「要补习的话，只要是%CNAME("一人称")%所知道的范围都可以教你哟？」
PRINTFORMW 「もう、せっかくのお茶が温くなっちゃいましたわ…」	PRINTFORMW 「呜、好不容易泡的茶已经变成温的了哇…」
PRINTFORMW 「…何をやってるのかしら？」	PRINTFORMW 「…这是在做什么呢？」
PRINTFORMW %CALLNAME:ARG%は%CALLNAME:MASTER%の様子を伺っている…。	PRINTFORMW %CALLNAME:ARG%在观察着%CALLNAME:MASTER%的样子…。
PRINTFORMW 「ふむ…やはり%CNAME("二人称")%ってばもしかしなくても変態ですわね！」	PRINTFORMW 「嗯…果然%CNAME("二人称")%不管怎么说都是个变态啊！」
PRINTFORMW 呆れたように言う%CALLNAME:ARG%だが、%CALLNAME:MASTER%を見る目は愉快そうに弓なりに反っている…。	PRINTFORMW 虽然%CALLNAME:ARG%好像很惊讶似地说着、那双看向%CALLNAME:MASTER%的眼睛却愉快地眯成了月牙状…。
PRINTFORMW 「あら失礼…いえ、%CNAME("一人称")%にお構いなく続けなさいな」	PRINTFORMW 「哎呀真抱歉…不、请不用在意%CNAME("一人称")%，尽管继续就好啦」
PRINTFORMW %CALLNAME:ARG%は%CALLNAME:MASTER%達を面白そうに眺めながら続きを促して来た…。	PRINTFORMW %CALLNAME:ARG%一边好像觉得很有趣的样子看着%CALLNAME:MASTER%两人，一边催促两人继续…。
PRINTFORMW 「あらあら、お熱いこと…ちょっと妬けちゃいますわ」	PRINTFORMW 「哎呀哎呀、这么亲热…有点点嫉妒哇」
PRINTFORMW %CALLNAME:ARG%はそう言いながら唇を尖らせるが、その目は楽しそうに笑っている。	PRINTFORMW %CALLNAME:ARG%一边这样说着一边撅起了嘴，但眼中却带着快乐的笑意。
PRINTFORMW 「これは失礼…いえ、%CNAME("一人称")%にお構いなく続けてくださいな」	PRINTFORMW 「还真是抱歉…不、请不用在意%CNAME("一人称")%，尽管继续就好啦」
PRINTFORMW %CALLNAME:ARG%は%CALLNAME:MASTER%達を面白そうに見つめながら続きを促して来た…。	PRINTFORMW %CALLNAME:ARG%一边好像觉得很有趣的样子看着%CALLNAME:MASTER%两人，一边催促两人继续…。
PRINTFORMW 「あらあら、近づけないほどに熱々ですわね！」	PRINTFORMW 「哎呀呀，明明都没有靠近就已经感觉很热了呢！」
PRINTFORMW %CALLNAME:ARG%は楽しそうな顔で%CALLNAME:MASTER%達を遠巻きに眺めている。	PRINTFORMW %CALLNAME:ARG%用一副很享受的表情远远地凝望着%CALLNAME:MASTER%二人。
PRINTFORMW 「あらあら、本当にお熱いこと…妬けちゃいますわ」	PRINTFORMW 「哎呀哎呀，真是亲热呢…总感觉很嫉妒哇」
PRINTFORMW 「%CNAME("一人称")%の惚れた方ですから、しょうがないですわね」	PRINTFORMW 「毕竟是%CNAME("一人称")%所恋慕的人，真拿你没办法呢」
PRINTFORMW 「あら、砂糖菓子の如く甘々な空気ですわね。嫌いじゃありませんわ」	PRINTFORMW 「啊啦，气氛就像糖果一般甜蜜呢。倒也不讨厌哇」
PRINTFORMW %CALLNAME:ARG%は甘い雰囲気を漂わせる%CALLNAME:MASTER%達をニコニコしながら見つめている。	PRINTFORMW %CALLNAME:ARG%微笑地注视着散发着甜美的氛围的%CALLNAME:MASTER%二人。
PRINTFORMW 「…あまりそういう事はやらない方がよろしいのではなくて？」	PRINTFORMW 「…这种事情是不是还是别做比较好啊？」
PRINTFORMW 「ほら、%CNAME("一人称")%のパンツならいくらでも見せて差し上げますわよ？」	PRINTFORMW 「看吧、%CNAME("一人称")%的内裤的话不管怎样都可以献给你看哟？」
PRINTFORMW %CALLNAME:ARG%は%CALLNAME:MASTER%の行為をやんわりと咎めてきた。	PRINTFORMW %CALLNAME:ARG%温和地责备了%CALLNAME:MASTER%的行为。
PRINTFORMW 「訴えられたり捕まったりしないようにお気をつけなさいな」	PRINTFORMW 「要小心不要被举报或者被逮捕哦」
PRINTFORMW 「もしそうなったら%CNAME("一人称")%、悲しいですわ…」	PRINTFORMW 「如果变成那样的话%CNAME("一人称")%，会很难过啊…」
PRINTFORMW %CALLNAME:ARG%はパンツを堪能する%CALLNAME:MASTER%を心配そうに見つめている…。	PRINTFORMW %CALLNAME:ARG%有些担心地盯着对内裤心满意足的%CALLNAME:MASTER%…。
PRINTFORMW 「大変お待たせしましたわ」	PRINTFORMW 「抱歉让各位久等了」
PRINTFORMW 「うふ、%CNAME("一人称")%を呼びまして？」	PRINTFORMW 「呵呵、您叫%CNAME("一人称")%吗？」
PRINTFORMW 「皆様ごきげんよう！」	PRINTFORMW 「各位贵安！」
PRINTFORMW 『あら先生、どうもこんにちは』	PRINTFORMW 『啊呀老师，您好啊』
PRINTFORMW 『あら、ずいぶん遅かったですわね？』	PRINTFORMW 『啊啦，我好像迟到了很久呢？』
PRINTFORMW 『ふふ、今日も元気そうで何よりですわ』	PRINTFORMW 『哼哼，今天也很精神呢，这就最好哇』
PRINTFORMW 「%CNAME("一人称")%を置いて逢瀬ですの？ふ～ん…」	PRINTFORMW 「把%CNAME("一人称")%留在这里去和别人幽会吗？嗯～…」
PRINTFORMW 「あら、二人揃って御用事かしら？いってらっしゃいませ～」	PRINTFORMW 「啊，两个人都有事情吗？请慢走哦～」
PRINTFORMW 「まぁ…懇ろなんですのね」	PRINTFORMW 「嘛…还真是亲密呢」
PRINTFORML 「はい、どうぞ。今日のは自信ありますわよ！」	PRINTFORML 「来，尝尝吧。我对今天的便当很有自信哟！」
PRINTFORMW （…ほとんど%CALLNAME:FINDCHARA(NO, 1)%が作ってくれたことは秘密ですわ）	PRINTFORMW （…几乎都是%CALLNAME:FINDCHARA(NO, 1)%做的这种事情还是保密好了哇）
PRINTFORML 「ごめんなさい、きょ、今日は焦ってたからいつにも増して酷い出来ですわ…」	PRINTFORML 「对不起啊，今，今天有些着急所以发挥比之前任何一次都差…」
PRINTFORMW 「次はもっと手作りの…多分ちゃんとしたのを作りますわ…きっと」	PRINTFORMW 「下次会更加…应该能好好地做出来吧…肯定可以」
PRINTFORML 「つ、作ってきましたわよ！とくとご賞味くださいまし！」	PRINTFORML 「做，做出来了哟！请仔细品尝一下吧！」
PRINTFORMW 「…出来るなら見た目の悪さなどには目をつぶってくれるとありがたいですわ…」	PRINTFORMW 「…如果可以的话对那可怕的外观睁一只眼闭一只眼吧，我会很感激的哇…」
PRINTFORMW 「ささ、早く食べましょう？%CNAME("一人称")%、もうお腹ペコペコですわぁ～」	PRINTFORMW 「来来，快来吃吧？%CNAME("一人称")%我的肚子已经饿得咕咕叫了哇～」
PRINTFORMW %CALLNAME:ARG%はいそいそと弁当を取り出して%CALLNAME:MASTER%の隣に陣取った。	PRINTFORMW %CALLNAME:ARG%兴冲冲地取出了便当在%CALLNAME:MASTER%的身边坐了下来。
PRINTFORMW 「はい、どうぞ。%CNAME("二人称")%の好物だけ詰め込んでもら…みましたわ！」	PRINTFORMW 「来，尝尝吧。我只放了%CNAME("二人称")%喜欢吃的东西…我是这样认为的 ！」
PRINTFORMW %CALLNAME:ARG%が持ってきたのは三段重ねの重箱だった。	PRINTFORMW %CALLNAME:ARG%带来的是一个有三层的便当箱。
PRINTFORMW 「つ、つい作りすぎてしまいましたの。皆も呼んで食べましょう？」	PRINTFORMW 「不，不知不觉就做了好多。把大家叫来一起吃吧？」
PRINTFORML 「皆さん、これからよろしくお願いいたしますわ！！」	PRINTFORML 「大家，从今天开始请多多指教哇！！」
PRINTFORML %CALLNAME:TARGET%は眩しい笑顔で部員一人一人と順番に握手をしている。	PRINTFORML %CALLNAME:TARGET%带着光彩夺目的笑颜和部员们一个接一个地握手。
PRINTFORML 「あら、服が透けてブラが見えますわね」	PRINTFORML 「哎呀，衣服这么透都能看见胸衣了」
PRINTFORML 「こういうのはお好きかしら？」	PRINTFORML 「你喜欢这种的吗？」
PRINTFORML 「はぁ～、髪が汗でビショビショですわ」	PRINTFORML 「哈啊～、汗水都把头发浸湿了哇」
PRINTFORML 「突風で吹き散らしてしまうのが一番かしら…」	PRINTFORML 「要是突然来阵风把它吹干就好啦…」
PRINTFORML 「ふぅ…ハッスルし過ぎて溶けそうですわ～…」	PRINTFORML 「唔…闹过头了感觉像要溶化了一样哇～…」
PRINTFORML 「ん………」	PRINTFORML 「嗯………」
PRINTFORML （何でしょう…？　オマンコが凄く濡れてますわ…）	PRINTFORML （怎么回事…？　小穴湿得好厉害哇…）
PRINTFORML %CALLNAME:TARGET%は首を傾げながらしきりに太ももを擦り合わせている。	PRINTFORML %CALLNAME:TARGET%一边歪着头困惑地思考着，一边不停地来回擦着自己的大腿内侧。
PRINTFORML 「………………」	PRINTFORML 「………………」
PRINTFORML %CALLNAME:TARGET%は顔を赤く染めながらぼんやりと%CALLNAME:MASTER%の事を見ている。	PRINTFORML %CALLNAME:TARGET%想起了%CALLNAME:MASTER%的事情，脸被染得通红。
PRINTFORML （%CNAME("一人称")%ったら%CALLNAME:MASTER%に抱かれる夢なんて見ちゃいましたわ…）	PRINTFORML （好像做了一个%CNAME("一人称")%被%CALLNAME:MASTER%抱着的梦…）
PRINTFORML 「うーん………ふぁ～………」	PRINTFORML 「唔ー嗯………哈～………」
PRINTFORML （何だかお腹に幸せな重みがありますわね…）	PRINTFORML （总感觉肚子里有种幸福的重量呢…）
PRINTFORML %CALLNAME:TARGET%は寝てる間に子種を注がれた下腹部をゆっくり擦っている。	PRINTFORML %CALLNAME:TARGET%在睡觉时用手柔缓地揉着被注入了种子的下腹部。
PRINTFORML 「あら…何だか元気が無いですわね？　顔色もあまり良くないようで…」	PRINTFORML 「哎呀…感觉没什么精神呢？　脸色看着也不太好…」
PRINTFORML 「冬の寒さに負けそう？それは鍛練が…鍛え方が足りないのですわ！！」	PRINTFORML 「感觉输给冬天的寒冷了？这是因为锻炼…锻炼的程度还不够哇！！」
PRINTFORML 「身体を鍛えれば冬の厳しい寒さにも負けませんわッ！！」	PRINTFORML 「好好锻炼身体的话冬天的严寒也没什么大不了的哇！！」
PRINTFORML 「さあ、準備は出来まして！？行きますわよ、いざ雪山へ！！！」	PRINTFORML 「来吧，准备好了吗！？那就出发了哟，向着雪山进发！！！」
PRINTFORML 「っていう悪夢を見ましたわ…何でマッチョになってたのかしら…」	PRINTFORML 「…做了这样的噩梦…为什么最后变成了筋肉魔鬼呢…」
PRINTFORML 「ふわぁ～～～………」	PRINTFORML 「呼啊～～～………」
PRINTFORML %CALLNAME:TARGET%は大欠伸をすると額に張り付いた髪を軽く払っている。	PRINTFORML %CALLNAME:TARGET%打了一个大呵欠，又轻轻地拂去了贴在前额上的发丝。
PRINTFORML 「（ゴキッ、ボキボキ…）…あらごめんなさい、見苦しい所を見せてしまいましたわね」	PRINTFORML 「（咚咔、啵咔啵咔…）…啊呀不好意思、让你看到了不得体的样子呢」
PRINTFORML %CALLNAME:TARGET%は首と肩を鳴らして眠気を覚まそうとしている。	PRINTFORML %CALLNAME:TARGET%拍了拍自己的脑袋和肩膀试图把睡意驱散掉。
PRINTFORML 「んん～っ、良く寝ましたわ～」	PRINTFORML 「嗯嗯～呼、睡了个好觉呢～」
PRINTFORML %CALLNAME:TARGET%は豊かな胸を強調するように伸びをしている。	PRINTFORML %CALLNAME:TARGET%像是在强调丰满的胸部一样舒展着身体。
PRINTFORML KOJO_DAILY_K37, %CSTR:PREV_DAILYCOM%後	PRINTFORML KOJO_DAILY_K37, %CSTR:PREV_DAILYCOM%后
PRINTFORML 「うふふっ♪デート、デートッ♪」	PRINTFORML 「哎嘿嘿っ♪约会，约会——♪」
PRINTFORML 「週末が待ちきれませんわぁ～♪」	PRINTFORML 「我都要等不及到周末了哇～♪」
PRINTFORML 「あら、もう一部屋ありましたの？」	PRINTFORML 「啊啦，原来还有一个房间吗？」
PRINTFORML 「こちらはまさしくそういうことをする部屋、ですわね」	PRINTFORML 「这里原来是做那种事情的房间呢，原来如此」
PRINTFORML 「うふふ、沢山可愛がってくださいまし♪」	PRINTFORML 「呜呼呼，请多多疼爱我吧♪」
PRINTFORML 「まさかここでなさるの？そんな…」	PRINTFORML 「难道要在这里做吗？这样的话…」
PRINTFORML 「…先生方や他の生徒の方々にバレたりしないか、スリル満点ですわね♪」	PRINTFORML 「…不知道会不会被老师们和其他的学生们看见，感觉超级刺激呢♪」
PRINTFORML 「ここまでの道もデートしているみたいでとても楽しかったのですが…」	PRINTFORML 「来这里的途中感觉也像在约会时一样让人非常开心呢…」
PRINTFORML 「やはりここでの本命が一番楽しみですわね♪」	PRINTFORML 「果然在这里的本命是最让人高兴的哇♪」
PRINTFORML 「先にシャワー浴びてますわね♪　後で入って来ても良いですわよ♪」	PRINTFORML 「先去洗个澡吧♪　之后再进来也可以哟♪」
PRINTFORML 「ｽﾝｽﾝ…%CNAME("二人称")%の部屋の匂い、何だか落ち着きますわ…」	PRINTFORML 「ｽﾝｽﾝ…%CNAME("二人称")%的房间的味道，不知为何让我感觉很平静哇…」
PRINTFORML 「あら、%CNAME("一人称")%を連れ込んで何をするつもりかしら？」	PRINTFORML 「啊啦、带着%CNAME("一人称")%过来是打算做什么呢？」
PRINTFORML 「一緒に勉強したいなら分かる範囲で何でも教えますわよ♪」	PRINTFORML 「想要一起学习的话，只要是我会的都可以教你哦♪」
PRINTFORML 「ふふ、おしゃべりでもエッチなことでも%CNAME("一人称")%は大歓迎ですわ♪」	PRINTFORML 「哼哼，无论是想闲聊还是想做色色的事情%CNAME("一人称")%都很欢迎哦♪」
PRINTFORML 「ふふ、%CNAME("一人称")%の部屋に来てくださってありがとうございます♪」	PRINTFORML 「哼哼、愿意来%CNAME("一人称")%的房间真是非常感谢呢♪」
PRINTFORML 「そうそう…良かったらこちらの%TEXTR("ケープ/ブランケット")%、使ってくださいませ」	PRINTFORML 「对了…需要的话请随意使用这里的%TEXTR("披肩/毛毯")%」
PRINTFORML 「%TEXTR("一人称")%の手編みですの。持って帰って使っても構いませんわよ♪」	PRINTFORML 「都是%TEXTR("一人称")%亲手编织的东西。带回去自己用也没关系哟♪」
PRINTFORML 「紅茶の匂いがする？ええ、たった今淹れたところですの。もちろん%CNAME("二人称")%の分もありますわよ♪」	PRINTFORML 「闻到红茶的味道了吗？对，是刚刚才泡好的。当然%CNAME("二人称")%的那份也有备好哟♪」
PRINTFORML 「はいどうぞ、%TEXTR("アッツアツな/熱い/激熱な/滅茶苦茶ＨＯＴな")%ので気をつけてくださいませ」	PRINTFORML 「请用吧，因为还%TEXTR("是滚烫的/非常热/非常烫/很烫嘴/")%所以请小心点哦」
PRINTFORML 「それで何をいたしましょうか？」	PRINTFORML 「然后该做什么呢？」
PRINTFORML 「ふふ、おしゃべりでもエッチなことでも%CNAME("一人称")%は大歓迎ですわよ♪」	PRINTFORML 「哼哼，无论是想闲聊还是想做色色的事情%CNAME("一人称")%都很欢迎哦♪」
PRINTFORML 「…とりあえずお茶を用意いたしますわね。適当な所に座って待っていてくださいませ」	PRINTFORML 「…总之我先去准备茶水吧。请先在觉得舒适的地方坐着等一会儿」
PRINTFORML 「あら、%CNAME("二人称")%に%CNAME(CSVCALLNAME(NO:ASSI) )%。わざわざ訪ねて来てくださったのね」	PRINTFORML 「啊啦，%CNAME("二人称")%に%CNAME(CSVCALLNAME(NO:ASSI) )%。是特意来拜访我的吗」
PRINTFORML 「二人揃ってどうかなさいましたの？」	PRINTFORML 「两位一起前来是有什么事情吗？」
PRINTFORML 「今お茶を用意いたしますわ。適当な所に座って待っていてくださいまし」	PRINTFORML 「现在我先去为你们准备茶水。请先在觉得舒适的地方坐着等一会儿」
PRINTFORML 「あら、%CNAME("二人称")%。わざわざ訪ねて来てくださったのね」	PRINTFORML 「啊啦、%CNAME("二人称")%。是特意来拜访我的吗」
PRINTFORML 「一体どうなさいましたの？」	PRINTFORML 「到底是有什么事情呢？」
PRINTFORML 「…顔が見たかった？まあ、嬉しいですわ♪」	PRINTFORML 「…想来见见我？嘛，很高兴你这么说哇♪」
PRINTFORML 「一緒に勉強したいなら何でも教えますわよ♪」	PRINTFORML 「想一起学习的话我会尽我所能教你的哟♪」
PRINTFORML 「とりあえずお茶を用意いたしますわね。適当な所に座って待っててくださいまし」	PRINTFORML 「总之我先去准备茶水啦。请先在觉得舒适的地方坐着等一会儿吧」
PRINTFORML 「お二人は%CNAME("一人称")%がいないものと思って振舞ってくださいませ」	PRINTFORML 「二位%CNAME("一人称")%就请当我不存在该做什么就做什么就好」
PRINTFORML 「ええ、%CNAME("一人称")%はここで見守ってますわ♪」	PRINTFORML 「嗯，%CNAME("一人称")%在这里旁观就好♪」
PRINTFORML %CALLNAME:TARGET%はニヤニヤしながら二人の視界にギリギリ入るか入らないかの所に陣取った…。	PRINTFORML %CALLNAME:TARGET%一边嘿嘿嘿地坏笑着在两人视线的边缘找了个位置…。
PRINTFORML 「どうしたんですの？　ニヤニヤ笑って…」	PRINTFORML 「怎么了吗？　一脸坏笑的…」
PRINTFORML 「もしかして今%CNAME("一人称")%のパンツが見えてらして？」	PRINTFORML 「难道说是看到%CNAME("一人称")%现在穿着的内裤了吗？」
PRINTFORML 「もう、正々堂々と見ればよろしいのに…」	PRINTFORML 「真是，明明光明正大地看就好了…」
PRINTFORML %CALLNAME:MASTER%が頷くと%CALLNAME:TARGET%は、唇を尖らせて文句を言っている。	PRINTFORML %CALLNAME:MASTER%点了点头作为回答后，%CALLNAME:TARGET%撅着嘴唇发起了牢骚。
PRINTFORML 「ふふ、それで終わりかしら？もっと色々してもよろしいのに…」	PRINTFORML 「哼哼，这就结束了吗？明明再多做些这样那样的事情也可以的…」
PRINTFORML %CALLNAME:TARGET%は妖艶に微笑んで%CALLNAME:MASTER%を見つめている。	PRINTFORML %CALLNAME:TARGET%露出了妖媚的微笑注视着%CALLNAME:MASTER%。
PRINTFORML 「いつ見られても良いように、%CNAME("二人称")%の好きそうなものを選んでますのよ」	PRINTFORML 「为了任何时候被看到都没关系，我专门选了%CNAME("二人称")%喜欢的种类哟」
PRINTFORML 「今日のパンツはお気に召したかしら？」	PRINTFORML 「今天的内裤还算满意吗？」
PRINTFORML 「全く、女性のスカートの中を無断で覗いたりするのは駄目ですわよ？」	PRINTFORML 「真是的，擅自偷看女孩子的短裙下面可是不行的哟？」
PRINTFORML 「あ、%CNAME("一人称")%に対してなら先に一言断りを入れてくださいまし♪」	PRINTFORML 「啊，如果对象是%CNAME("一人称")%的话请事先告知一声就好啦♪」
PRINTFORML 「どうかしら？%CNAME("二人称")%のお眼鏡に適う%PANTIES(TARGET, "パンツ")%だったかしら？」	PRINTFORML 「如何呢？有%CNAME("二人称")%看着顺眼的%PANTIES(TARGET, "パンツ")%吗？」
PRINTFORML 「うふ、%CNAME("一人称")%の%PANTIES(TARGET, "パンツ")%はいかがでした？」	PRINTFORML 「唔呼，%CNAME("一人称")%的%PANTIES(TARGET, "パンツ")%看起来如何呢？」
PRINTFORML 「もう、%CNAME("二人称")%ってば本当に%PANTIES(TARGET, "パンツ")%がお好きですわね」	PRINTFORML 「真是的、%CNAME("二人称")%还真是喜欢%PANTIES(TARGET, "パンツ")%呢」
PRINTFORML %CALLNAME:TARGET%はクスクスと笑っている…。	PRINTFORML %CALLNAME:TARGET%小声偷笑着…。
PRINTFORML 「うふ、%CNAME("一人称")%の大事な所…存分に検分してくださいませ…♪」	PRINTFORML 「呼呼，%CNAME("一人称")%最私密的部位…请尽情地检查吧…♪」
PRINTFORML %CALLNAME:TARGET%は頬を赤らめながら微笑んでいる。	PRINTFORML %CALLNAME:TARGET%红着脸的同时对你微笑着。
PRINTFORML 「やん、%CNAME("二人称")%ってば鼻息が荒いですわぁ♪」	PRINTFORML 「呀啊，%CNAME("二人称")%的呼吸有些粗重啊♪」
PRINTFORML %CALLNAME:TARGET%はクスクスと笑っている。	PRINTFORML %CALLNAME:TARGET%は小声偷笑着。
PRINTFORML 「%CNAME("一人称")%の力について、ですの？」	PRINTFORML 「关于%CNAME("一人称")%的能力，这样吗？」
PRINTFORML 「…母の家系では、昔から何代かおきに風の精霊の生まれ変わりが産まれてくるとか」	PRINTFORML 「…母亲的家族，据说从很久以前开始每隔几代都会产下风精灵的转世」
PRINTFORML 「それで、今回の生まれ変わりが%CNAME("一人称")%だったようですわ」	PRINTFORML 「然后，这一次的转世貌似就是%CNAME("一人称")%哇」
PRINTFORML 「だから、産まれた時からこの力は使えていた…と思いますわ」	PRINTFORML 「所以呢，从被生下来开始就可以使用这种能力了…我是这么认为的哇」
PRINTFORML 「%CNAME("一人称")%の家族について？」	PRINTFORML 「关于%CNAME("一人称")%的家庭？」
PRINTFORML 「母は北欧の貴族の生まれで、こちらに父の家に嫁いで来たんですの」	PRINTFORML 「母亲是北欧的贵族后裔、嫁到了这边的父亲家里」
PRINTFORML 「父はこちらの良家…風鳴家の生まれですわね」	PRINTFORML 「父亲是这边的名门…風鳴家的子嗣呢」
PRINTFORML 「二人はそれはもう両家が呆れるほどの大恋愛の末に結婚したらしいですわ」	PRINTFORML 「两人似乎是经历了一场让两家都震惊到的困难重重又刻骨铭心的恋爱之后才结婚的哇」
PRINTFORML 「あぁ、%CNAME("一人称")%もそんなロマンチックな恋愛を…きっと出来ますわね、うふふっ♪」	PRINTFORML 「啊啊、要是也能和%CNAME("一人称")%有那样浪漫的恋爱…一定会有的吧、欸嘿嘿♪」
PRINTFORML そう言って%CALLNAME:TARGET%が%CALLNAME:MASTER%を見る目はどこか熱い…。	PRINTFORML %CALLNAME:TARGET%这样说着，看着%CALLNAME:MASTER%的目光似乎变得灼热起来…。
PRINTFORML 「変わったことや噂…うーん、何かあったかしら………あっ、そうですわ」	PRINTFORML 「奇怪的事情和传闻…唔嗯——、都有什么呢………啊、对了哇」
PRINTFORML 「確か…%CNAME("一人称")%のはとこが世界的な歌手なのに国家防衛？もしているって噂を聞きましたわ」	PRINTFORML 「的确…好像在哪听说过“虽然%CNAME("一人称")%是世界级的歌手但是也在负责国家防务”这样的传闻哇」
PRINTFORML 「もしかしたら歌いながら戦う、だなんてぶっ飛んだことをなさっていると考えると…何だか面白いと思いません？」	PRINTFORML 「“说不定是做着一边歌唱一边战斗之类的不可思议的事情呢”还会这样想…不觉得很有趣吗？」
PRINTFORML 「%TEXTR("ふふふ/うふふ")%、雪が良い感じに積もってて%TEXTR("気分が盛り上がり/テンションが上がり/心が躍り")%ますわぁ♪」	PRINTFORML 「%TEXTR("呼呼呼/唔呵呵")%、看着积得很好看的雪，感觉%TEXTR("心情都好起来了/情绪高涨/心里很欢快")%哇ぁ♪」
PRINTFORML %CALLNAME:TARGET%は窓の外を見ながら楽しそうに笑っている。	PRINTFORML %CALLNAME:TARGET%一边看着窗外一边高兴地笑着。
PRINTFORML 「%TEXTR("ラララ～～～/ラ～ララ～/ラララ…/ルルル～…")%♪」	PRINTFORML 「%TEXTR("啦啦啦～～～/啦～啦啦～/啦啦啦…/噜噜噜～…")%♪」
PRINTFORML %CALLNAME:TARGET%は%TEXTR("即興で作った歌/故郷の民謡")%を楽しそうに口ずさみながら編み物をしている。	PRINTFORML %CALLNAME:TARGET%一边愉快地哼唱着%TEXTR("即兴创作的曲子/故乡的民谣")%一边编织着织物。
PRINTFORML 「もうすぐ待ちに待った冬ですわぁ………うふふ………」	PRINTFORML 「离我盼望已久的冬天已经不远了哇………呜呼呼………」
PRINTFORML %CALLNAME:TARGET%はワクワクが止まらないようだ…。	PRINTFORML %CALLNAME:TARGET%似乎因为迫不及待而兴奋不已…。
PRINTFORML 「%TEXTR("えぇと/後は")%…%TEXTR("太/並太/合太/中細")%の%TEXTR("赤/橙/黄/緑/黄緑/青/紫/茶/黒/白")%色が足りないですわね…」	PRINTFORML 「%TEXTR("还有/然后是")%…%TEXTR("红/橙/黄/绿/黄绿/青/紫/茶/黒/白")%色的%TEXTR("高粗/中粗/中细/极细")%毛线不够了哇…」
PRINTFORML %CALLNAME:TARGET%は毛糸の山と睨み合っている…。	PRINTFORML %CALLNAME:TARGET%和毛线团组成的小山对视着…。
PRINTFORML 「%TEXTR("う゛あ゛あ～/う゛う゛～/はあ～")%…%TEXTR("暑い/あっつい/猛暑/溶けそう")%ですわ～………」	PRINTFORML 「%TEXTR("呜゛啊゛啊～/呜゛呜゛～/哈啊～")%…%TEXTR("好热/超热/酷暑/感觉要化掉了")%哇～………」
PRINTFORML %CALLNAME:TARGET%は%TEXTR("心底ダルそうに/全く気品の感じられない動きで")%%SHIRT(TARGET, "略")%の胸元をパタパタと扇いでいる。	PRINTFORML %CALLNAME:TARGET%は%TEXTR("倦怠至极的/毫无形象的")%%SHIRT(TARGET, "略")%啪嗒啪嗒地对胸口扇着风。
PRINTFORML %CALLNAME:TARGET%は肌や髪から汗を払い落としながらぐったりしている…。	PRINTFORML %CALLNAME:TARGET%软成一滩的同时也还在不停拂落着肌肤与发丝上粘连的汗珠…。
PRINTFORML 「はぁ…蝉がうるさいと余計に暑く感じるのは何故かしら…？」	PRINTFORML 「哈啊…听着喧嚣的蝉鸣声就感觉越来越热了是怎么回事…？」
PRINTFORML %CALLNAME:TARGET%は%TEXTR("げんなりしながら/忌々し気に")%窓の外を睨んでいる…。	PRINTFORML %CALLNAME:TARGET%は%TEXTR("无精打采地/幽怨地")%瞪着窗户外面…。
PRINTFORML 「ちょっと…これより温度下がらないんですの？！」	PRINTFORML 「等等…这样不就能让温度变低了吗？！」
PRINTFORML %CALLNAME:TARGET%はエアコンの温度を下げようと躍起になっている…。	PRINTFORML %CALLNAME:TARGET%一跃而起想去调低空调的温度…。
PRINTFORML 「%TEXTR("へックション/ヘーックショイ/ハクション/へっくち")%！　…%TEXTR("ティッシュティッシュ…/チーン！/し、失礼しましたわ…")%」	PRINTFORML 「%TEXTR("阿嚏/啊——嚏/哈——嚏/哈——啾")%！　…%TEXTR("纸巾纸巾…/啾——！/不，不好意思哇…")%」
PRINTFORML %CALLNAME:TARGET%は勢いよくくしゃみをしている…。	PRINTFORML %CALLNAME:TARGET%剧烈地打着喷嚏…。
PRINTFORML 「桜…吹雪～♪」	PRINTFORML 「樱花…吹雪～♪」
PRINTFORML どうやら%CALLNAME:TARGET%は%TEXTR("桜/外")%目掛けて風を起こしているようだ…。	PRINTFORML %CALLNAME:TARGET%朝着%TEXTR("樱花/窗外")%唤起一阵微风…。
PRINTFORML %CALLNAME:TARGET%は%CALLNAME:LOCAL%と談笑している。	PRINTFORML %CALLNAME:TARGET%和%CALLNAME:LOCAL%在有说有笑的。
PRINTFORML %CALLNAME:TARGET%は%TEXTR("真剣な表情で/時折思い出し笑いをしながら")%実家に宛てた手紙を書いている。	PRINTFORML %CALLNAME:TARGET%は%TEXTR("用专注认真的表情/一边不时因为美好的回忆露出笑容一边")%书写着寄给家里的信。
PRINTFORM %CALLNAME:LOCAL%と一緒に	PRINTFORM 和%CALLNAME:LOCAL%一起
PRINTFORM ロッキングチェアーに揺られながら	PRINTFORM 坐在摇椅不停前后摇晃着
PRINTFORM ソファーに腰かけて	PRINTFORM 坐在了沙发上
PRINTFORM 椅子に腰かけて	PRINTFORM 坐在了椅子上
PRINTFORML 『%TEXTR("剛力！陽だまりちゃん/天誅！防人さん/怪傑！うたずきん/駆けろ！快盗姉妹")%』と題された漫画を読んでいる。	PRINTFORML 在看一本名为『%TEXTR("剛力！向阳酱/天诛！防人君/怪杰！歌头巾/奔跑吧！快盗姐妹")%』的漫画。
PRINTFORML %CALLNAME:TARGET%は%TEXTR("退屈そうに/欠伸を噛み殺しながら/ぼんやりと")%小さいつむじ風を%TEXTR("手のひら/両手の間/指先")%に作ってはその辺に飛ばしている。	PRINTFORML %CALLNAME:TARGET%は%TEXTR("百无聊赖地/一边忍着哈欠一边/无所事事地")%在%TEXTR("手心/两手之间/指尖")%附近制造了一股不断盘旋的小小的旋风。
PRINTFORML 良く見ると、飛んで行ったつむじ風は%CALLNAME:LOCAL%%TEXTR("を追従するように動いている/の足元を行ったり来たりしている")%…。	PRINTFORML 仔细一看、在空中飞舞着的旋风在%TEXTR("像是在追踪%CALLNAME:LOCAL%一样移动着/在%CALLNAME:LOCAL%的脚边来回转动着")%…。
CALL PRINT_STR, "「………ＺＺＺ………ッ_H_」_L"	CALL PRINT_STR, "「………ＺＺＺ………嗯っ_H_」_L"
PRINTFORML %CALLNAME:TARGET%は膣に%CALLNAME:PLAYER%のペニスを無遠慮に突きこまれながら寝息を立てている…。	PRINTFORML 发出着熟睡的呼吸声的%CALLNAME:TARGET%被%CALLNAME:PLAYER%用肉棒毫不犹豫地塞满了下面的膣道…。
CALL PRINT_STR, "「あ………んっ………_H_」_L"	CALL PRINT_STR, "「啊………嗯っ………_H_」_L"
PRINTFORML 眠っている%CALLNAME:TARGET%は%CALLNAME:PLAYER%の性欲処理に使われているが起きる気配は無い…。	PRINTFORML 熟睡的%CALLNAME:TARGET%被%CALLNAME:PLAYER%用来处理着性欲也丝毫没有要醒来的迹象…。
CALL PRINT_STR, "「ん………ッ………_H_」_L"	CALL PRINT_STR, "「嗯………唔………_H_」_L"
PRINTFORML %CALLNAME:PLAYER%が強く腰を打ち付けるのに合わせ、%CALLNAME:TARGET%の乳房が揺れている…。	PRINTFORML 被%CALLNAME:PLAYER%激烈摆动腰部撞击着，%CALLNAME:TARGET%的乳房不停上下晃动…。
CALL PRINT_STR, "「…………ッ_H_　……ぁっ_H_」_L"	CALL PRINT_STR, "「…………呜_H_　……啊っ_H_」_L"
PRINTFORML %CALLNAME:TARGET%の%TEXTR("子宮口/Ｇスポット")%をぐりぐりと責めると、小さな甘い声と共に身体がピクンと跳ねた…。	PRINTFORML 咕啾咕啾地欺负着%CALLNAME:TARGET%的%TEXTR("子宮口/Ｇ点")%，%CALLNAME:TARGET%发出甜美的轻声呻吟的同时身体也一下子后弓了起来…。
CALL PRINT_STR, "「ぁは……_H_　んぁ……っ_H_」_L"	CALL PRINT_STR, "「哈嗯……_H_　嗯啊……っ_H_」_L"
PRINTFORML 睡眠中に%CALLNAME:PLAYER%に犯される%CALLNAME:TARGET%の口からは、熱く甘い喘ぎ声が漏れている…。	PRINTFORML 在睡眠中被%CALLNAME:TARGET%侵犯的%CALLNAME:PLAYER%从口中漏出火热娇美的喘息声…。
CALL PRINT_STR, "「……うっ……ぁ……_H_」_L"	CALL PRINT_STR, "「……呜っ……啊……_H_」_L"
PRINTFORML %CALLNAME:TARGET%の膣奥をコツコツと突いてやると、彼女は少しだけ眉根を寄せて身を強張らせた…。	PRINTFORML 在%CALLNAME:TARGET%的阴道里一下下冲刺着，能感到她轻蹙着眉头绷紧了身体…。
CALL PRINT_STR, "「んん……ぅ……？_H_　ぁぅ…_H_」_L"	CALL PRINT_STR, "「嗯嗯……呜……？_H_　啊呜…_H_」_L"
PRINTFORML %CALLNAME:TARGET%が快感に身じろぎするたびに膣内がうごめき、%CALLNAME:PLAYER%の一物をきゅっきゅっと締め付ける…。	PRINTFORML %CALLNAME:TARGET%由于快感而轻轻扭动着身体，膣内的软嫩的肉壁也在蠕动收缩着，把%CALLNAME:PLAYER%的大家伙紧紧地吸在里面包裹着…。
CALL PRINT_STR, "「ふ、ぁ……_H_　んっ_H_　ぁ……ふふ_H_」_L"	CALL PRINT_STR, "「呼、啊……_H_　嗯っ_H_　啊……呼呼_H_」_L"
PRINTFORML %CALLNAME:TARGET%の%TEXTR("子宮口/Ｇスポット")%を小刻みに突き上げてやると彼女は無意識にニヘラと笑い、	PRINTFORML 每隔一会儿就针对%CALLNAME:TARGET%的%TEXTR("子宮口/Ｇ点")%进行的冲撞让她在无意识中露出了幸福的痴笑，
PRINTFORML 膣肉はペニスを離すまいときゅうきゅうと絡みついてくる…。	PRINTFORML 膣肉好像不愿意离开肉棒一样紧紧地将其缠住…。
CALL PRINT_STR, "「んぅっ……_H_　け…_H_　ケダモノ……_H_」_L"	CALL PRINT_STR, "「嗯呜っ……_H_　哈…_H_　坏蛋……_H_」_L"
PRINTFORML 寝ぼけている%CALLNAME:TARGET%は自らを犯す%CALLNAME:PLAYER%にしがみつくと	PRINTFORML 半梦半醒间%CALLNAME:TARGET%把侵犯着自己的%CALLNAME:PLAYER%抱住不放
PRINTFORML ピストン運動に合わせるように腰を淫らに揺らしだした…。	PRINTFORML 配合着你抽插的动作淫靡地晃动着自己的腰…。
CALL PRINT_STR, "「んぁッ………ぁ？_H_　………」_L"	CALL PRINT_STR, "「嗯啊ッ………啊？_H_　………」_L"
PRINTFORML %CALLNAME:PLAYER%が%TEXTR("ドチュンと/ゴリゴリと/激しく/乱暴に")%%CALLNAME:TARGET%の%TEXTR("子宮口/Ｇスポット")%を抉ると、	PRINTFORML %CALLNAME:PLAYER%が%TEXTR("使劲地/大力地/激烈地/猛烈地")%进攻着%CALLNAME:TARGET%的%TEXTR("子宮口/Ｇ点")%，
PRINTFORML %CALLNAME:TARGET%は嬌声を上げて薄目を開けたが、ニヤッと笑った後すぐに閉じてしまった…。	PRINTFORML %CALLNAME:TARGET%娇声呻吟着微微睁开了眼睛，露出了些笑意后又马上闭了起来…。
CALL PRINT_STR, "「んっ…あっ…う…ぅっ…うぁっ…_H_」_L"	CALL PRINT_STR, "「嗯っ…啊っ…唔…呜っ…呜啊っ…_H_」_L"
PRINTFORML %CALLNAME:PLAYER%が%CALLNAME:TARGET%に%TEXTR("テンポ良く/リズミカルに/パンパンと")%腰を打ち付けるたび、	PRINTFORML 当%CALLNAME:PLAYER%每一次%TEXTR("有节奏地/合着节奏地/梆梆梆地")%撞击着%CALLNAME:TARGET%的下胯部时，
PRINTFORML 彼女は少し苦しそうな喘ぎを漏らしている…。	PRINTFORML 她都会漏出带着些许苦闷感的娇喘声…。
PRINTFORML 「スー……スー………」	PRINTFORML 「嘶ー……嘶ー………」
PRINTFORML 「ＺＺＺ………zzz………」	PRINTFORML 「ＺＺＺ………zzz………」
PRINTFORML 「すぴー……」	PRINTFORML 「嘶呼ー……」
PRINTFORML 「ｷﾞﾘｷﾞﾘｷﾞﾘ………（歯ぎしりする音）」	PRINTFORML 「咯吱咯吱咯吱………（轻轻的磨牙声）」
PRINTFORML 「グゥ………」	PRINTFORML 「唔嗯………」
PRINTFORML 「………いざ雪山へ………」	PRINTFORML 「………向雪山进发………」
PRINTFORML 「ふふ………楽しいですわー………」	PRINTFORML 「呼呼………真开心哇ー………」
PRINTFORML 「うーん………父様…母様………」	PRINTFORML 「唔ー………父亲大人…母亲大人………」
PRINTFORML 「うふふ…もう食べきれませんわー………」	PRINTFORML 「唔嘿嘿…已经吃不下了哇ー………」
GREETING = こんばんは	GREETING = 晚上好
GREETING = %TEXTR("こんにちは/ごきげんよう")%	GREETING = %TEXTR("早啊/您贵安啊")%
GREETING = おはようございます	GREETING = 早上好啊
PRINTFORMW 「%GREETING%…あら、情熱的ですわね♪」	PRINTFORMW 「%GREETING%…啊呀，真是热情呢♪」
PRINTFORMW 「ではお返しに…ぎゅっと♪」	PRINTFORMW 「那么作为回应…抱紧♪」
PRINTFORMW 「%GREETING%…！　もう、抱きつくなら汗を拭いてからにしてくださいませ」	PRINTFORMW 「%GREETING%…！　欸欸，抱我之前要先把汗擦干净呀」
PRINTFORMW 「ふふ、この頑張った男性の匂いは嫌いじゃありませんわ」	PRINTFORMW 「哼哼，倒也不讨厌这种代表努力过的男性的气味呢」
PRINTFORMW 「しょうがない人ですわね、%CNAME("一人称")%が拭いて差しあげますわ♪」	PRINTFORMW 「真是让人无可奈何，%CNAME("一人称")%我来帮你擦一擦哦♪」
PRINTFORMW 「ほら、%CNAME("一人称")%の冷気で汗が凍ってしまってますわよ？」	PRINTFORMW 「你看，%CNAME("一人称")%的冷气把你的汗都冻住了哟？」
PRINTFORMW 「%GREETING%…ふふ、暖かいですわね」	PRINTFORMW 「%GREETING%…呼呼，真暖和呢」
PRINTFORMW 「%CNAME("二人称")%、このぐらいのぬくもりならむしろ好きですのよ」	PRINTFORMW 「%CNAME("二人称")%，这种程度的热我还是挺喜欢的啦」
PRINTFORMW 「うふふ、%GREETING%！　ぎゅっ♪」	PRINTFORMW 「呜呼呼呼、%GREETING%！　抱——♪」
PRINTFORMW %CALLNAME:TARGET%はニコニコ笑顔で%CALLNAME:MASTER%を抱き返してきた。	PRINTFORMW %CALLNAME:TARGET%笑眯眯地回过来抱住了%CALLNAME:MASTER%。
PRINTFORMW 「そんなに熱心に抱きつくと…凍らせてしまいますわよ？」	PRINTFORMW 「这么热情的拥抱…是不是该把你冻住降降温呢？」
PRINTFORMW 「…うふふ、冗談ですわ♪　そんなことする気なんてこれっぽちもございませんわ♪」	PRINTFORMW 「…唔嘿嘿，开玩笑的♪　我才不会做出那种事情哇♪」
PRINTFORMW 「んッ？　…ちゅっ………%GREETING%」	PRINTFORMW 「嗯？　…啾っ………%GREETING%」
PRINTFORMW 「うふふ、キスで挨拶だなんて…素敵ですわね♪」	PRINTFORMW 「唔嘿嘿、用吻来作为问候…真棒呐♪」
PRINTFORMW 「ん………ぷは…%GREETING%」	PRINTFORMW 「嗯………噗哈…%GREETING%」
PRINTFORMW 「ふふ、本当に素敵な挨拶ですわ♪」	PRINTFORMW 「呼呼，真是超棒的问候呢♪」
PRINTFORMW 「ちゅ……%GREETING%」	PRINTFORMW 「啾……%GREETING%」
PRINTFORMW 「…物足りませんわ、もう一度だけ…ちゅっ」	PRINTFORMW 「…不满足哇，再来一次吧…啾っ」
PRINTFORMW 「%GREETING%、んちゅ…んふ………」	PRINTFORMW 「%GREETING%，嗯啾…呼………」
PRINTFORMW 「ふは…唇が溶けてしまいそうですわ…♪」	PRINTFORMW 「呼哈…感觉嘴唇都要溶化了呢…♪」
PRINTFORMW 「んっ…これが挨拶ですの？」	PRINTFORMW 「嗯っ…这是在打招呼吗？」
PRINTFORMW 「大胆かつ斬新で中々面白いですわね♪」	PRINTFORMW 「感觉大胆又新颖，还真是有趣呢♪」
PRINTFORMW 「うふふ、%GREETING%」	PRINTFORMW 「呜呼呼、%GREETING%」
PRINTFORMW 「会って早々にこうして求められるのも悪くないですわね」	PRINTFORMW 「一见面就被请求做这种事情也不坏呢」
PRINTFORMW 「全く、%CNAME("二人称")%ってば節操の無い方ですわね」	PRINTFORMW 「真是的，%CNAME("二人称")%还真是个没节操的家伙呢」
PRINTFORM 「ふふ、続きをするなら	PRINTFORM 「呼呼、要继续做下去的话
PRINTFORM %CNAME("二人称")%か%CNAME("一人称")%のお部屋	PRINTFORM 请在%CNAME("二人称")%在%CNAME("一人称")%卧室
PRINTFORM ベッド	PRINTFORM 的床上
PRINTFORMW でお願いしますわ♪」	PRINTFORMW 继续吧♪」
PRINTFORMW 「普通の挨拶ではもう満足出来ない、って感じですわね」	PRINTFORMW 「普通的问候方式已经没法满足了，是这个意思吧」
PRINTFORMW 「%TEXTR("あら/ふふ")%、%GREETING%」	PRINTFORMW 「%TEXTR("啊啦/呵呵")%、%GREETING%」
PRINTFORMW 「%CNAME("二人称")%は今日も精力ビンビンのようですわね！」	PRINTFORMW 「%CNAME("二人称")%今天看着也元气满满呢！」
PRINTFORMW 「元気な挨拶はお互い気持ちが良くなりますわね！」	PRINTFORMW 「有精神的招呼会让双方的心情都好起来呢！」
PRINTFORMW 「…あら？夢でしたの…残念ですわ」	PRINTFORMW 「…哦呀？原来是梦啊…真可惜哇」
PRINTFORMW %CALLNAME:TARGET%はどこか%TEXTR("残念そう/不満げ")%な顔でため息をついている…。	PRINTFORMW %CALLNAME:TARGET%一脸%TEXTR("遗憾地/不满地")%似地发出了叹息…。
PRINTFORMW 「ふわぁああぁ～～～…ッ……」	PRINTFORMW 「呼哇啊啊～～～…ッ……」
PRINTFORMW %CALLNAME:TARGET%は口を大きく開けて欠伸をしながら目をこすっている。	PRINTFORMW %CALLNAME:TARGET%揉着惺松的睡眼，长大了嘴打着哈欠。
PRINTFORMW 「あうぅ…後生ですから…あと５分だけ寝かせてくださいませぇ………」	PRINTFORMW 「啊呜呜…就当是在做善事吧…请就让我再睡五分钟——………」
PRINTFORMW %CALLNAME:TARGET%は自分の周りに風のバリアを展開して二度寝しようとしている…。	PRINTFORMW %CALLNAME:TARGET%在自己的四周展开了一堵风墙准备继续睡回笼觉…。
PRINTFORMW 「ふわぁぁ…あら失礼、眠たくなってきてしまったもので…」	PRINTFORMW 「呼哇啊啊…啊啦失礼了，但是开始感觉有些困了…」
PRINTFORMW 「お先に失礼しますわね…ふあぁぁ～…」	PRINTFORMW 「我就先行失陪了…呼啊啊～…」
PRINTFORMW 「い、いきなりそんなこと言われても困りますわ…何故って？」	PRINTFORMW 「突，突然被这样说的话我会很为难的…原因？」
PRINTFORMW 「%CNAME("一人称")%の心が%CNAME("二人称")%にがっちりキャッチされて虜になってしまいますものっ♪」	PRINTFORMW 「因为%CNAME("一人称")%的心会被%CNAME("二人称")%牢牢地俘虏呀♪」
PRINTFORMW 「うふふ、ありがとうございます♪」	PRINTFORMW 「唔嘿嘿、谢谢你啦♪」
PRINTFORMW 「こうしてストレートに褒められるのも悪くないですわね♪」	PRINTFORMW 「被这么直白地褒奖感觉也不错呢♪」
PRINTFORMW 「あら、褒めるのがお上手ですわね♪」	PRINTFORMW 「啊啦、你还真是会夸人呢♪」
PRINTFORMW 「もーっと褒めてくださっても良いんですのよ♪」	PRINTFORMW 「再多多夸夸我也没关系哟♪」
CALL PRINT_STR, "「そっ、それ以上言うのはやめてくださいましっ_H_」_W"	CALL PRINT_STR, "「这、这种话请不要再说了——_H_」_W"
CALL PRINT_STR, @"「%CNAME("一人称")%、胸の奥が熱くなって心も体も溶けてしまいますわっ_HH_」_W"	CALL PRINT_STR, @"「%CNAME("一人称")%，感觉自己的心里热乎乎的，就像心灵和肉体都要溶化了一样哇——_HH_」_W"
CALL PRINT_STR, "「ッ！_H_　うふふ…_H_」_W"	CALL PRINT_STR, "「欸！_H_　呜呼呼…_H_」_W"
CALL PRINT_STR, @"「ねぇ%CNAME("二人称")%？　私も…愛していますわ_HH_」_W"	CALL PRINT_STR, @"「我说%CNAME("二人称")%？　我也…爱你哇_HH_」_W"
CALL PRINT_STR, @"「%CNAME("二人称", "どもり")%にこんなっ、こんなにも甘い言葉をかけられたら…っ_H_」_W"	CALL PRINT_STR, @"「被%CNAME("二人称", "どもり")%说了这种，这么甜言蜜语的话…っ_H_」_W"
CALL PRINT_STR, @"「%CNAME("一人称")%幸せ過ぎてどうにかなってしまいそうですわぁ～～～ッ！！_HH_」_W"	CALL PRINT_STR, @"「%CNAME("一人称")%会感觉有些幸福过头了哇啊啊～～～ッ！！_HH_」_W"
PRINTFORMW 「ふっ…%CNAME("二人称")%の魂胆はお見通しですのよ！」	PRINTFORMW 「呼——…%CNAME("二人称")%我已经看穿你的企图了哦！」
PRINTFORMW 「%CNAME("一人称")%の心をキュンキュンさせて%CNAME("二人称")%の虜にするつもりですわね！？」	PRINTFORMW 「是企图让%CNAME("一人称")%心动不已变成%CNAME("二人称")%的俘虏对吧！？」
PRINTFORMW 「安心なさい！　見事急所に当たって効果抜群ですわ！！」	PRINTFORMW 「请放心！　漂亮地击中了要害，效果拔群哇！！」
PRINTFORMW 「あ、愛してるだなんてそんな…もっと言ってくださっても良いんですのよ♪」	PRINTFORMW 「ai、爱我什么的这种…多说一些也感觉不错哦♪」
PRINTFORMW 「ほら照れてないで、さあ、さあ、さあッ！」	PRINTFORMW 「来嘛别害羞，快、快、快啊！」
PRINTFORMW 「急に何を言うかと思えば…全く、何なんですの？！」	PRINTFORMW 「还想着突然在说什么呢…真是，什么啊？！」
PRINTFORMW 「%CNAME("二人称")%はそんなに%CNAME("一人称")%の胸をドキドキさせるのが好きなんですのッ！？」	PRINTFORMW 「%CNAME("二人称")%就那么喜欢看%CNAME("一人称")%被弄得怦然心动的样子吗！？」
PRINTFORMW 「%CNAME("一人称")%はどう思ってるのかですって？　ええ、%CNAME("二人称")%にドキドキさせられるの大好きですわっ！」	PRINTFORMW 「想知道%CNAME("一人称")%我是怎么想的？　好吧，%CNAME("二人称")%超喜欢被你弄得小鹿乱撞——！」
PRINTFORMW 「……………」	PRINTFORMW 「……………」
PRINTFORMW 「？　あらごめんなさい、良く聞こえませんでしたわ」	PRINTFORMW 「？　哎呀真是抱歉、我没有听清哇」
PRINTFORMW 「ごめんなさい、今%TEXTR("ちょ～っと手が放せないんですの…/手を出したら切り裂いてしまいますわよ")%」	PRINTFORMW 「不好意思啊、现在%TEXTR("有点腾不开手呢…/手伸过去的话会被切到哟")%」
PRINTFORMW %CALLNAME:TARGET%は手乗りサイズの%TEXTR("氷像/雪だるま")%を、指先に発生させたかまいたちで顔を彫り込んでいる…。	PRINTFORMW %CALLNAME:TARGET%对着一个手掌大小的%TEXTR("冰雕/雪人")%，用指尖制造出的气刃雕刻着它的面部…。
PRINTFORMW 「ふふふ…良い感じに雪が積もりましたわね」	PRINTFORMW 「呼呼呼…积雪看着真不错呢」
PRINTFORM 「皆で	PRINTFORM 「想和大家一起
PRINTFORM %TEXTR("雪ダルマ/雪像/かまくら")%でも作りたい	PRINTFORM 堆%TEXTR("雪人/雪像/雪屋")%也好
PRINTFORM %TEXTR("雪合戦/ソリ滑り")%で遊びたい	PRINTFORM 玩%TEXTR("打雪仗/滑雪橇")%也好
PRINTFORMW 気分ですわ♪」	PRINTFORMW 的感觉哇♪」
PRINTFORMW 「ねぇ%CNAME("二人称")%、ちょっと腕を横に広げていただけるかしら？」	PRINTFORMW 「呐%CNAME("二人称")%，能把手臂伸直一下吗？」
PRINTFORMW %CALLNAME:TARGET%に言われるままに腕を広げると、彼女は%CALLNAME:MASTER%の身体に巻き尺を当ててはメモに数字を書き込んでいる。	PRINTFORMW 照着%CALLNAME:TARGET%说的那样伸直了手臂、她用卷尺丈量着%CALLNAME:MASTER%的身体，然后在笔记簿上记下了一些数字。
PRINTFORMW 「…はい、ご協力ありがとうございます。これで%CNAME("二人称")%の新しいセーターが編めますわ♪」	PRINTFORMW 「…好了，谢谢配合啊。这样就可以去织%CNAME("二人称")%的新毛衣了哇♪」
PRINTFORMW 「%CNAME("二人称")%ー？一緒に冷凍ミカン食べません？」	PRINTFORMW 「%CNAME("二人称")%ー？要不要一起吃冻橘子？」
PRINTFORMW 「朝、すぐそこの雪の塊の中に埋めておいたんですの♪」	PRINTFORMW 「早上刚埋进那边的雪堆里面的♪」
PRINTFORMW 「そういえばこの学園、意外と果樹が多いですのね」	PRINTFORMW 「说起来这说学校，意外的有很多果树呢」
PRINTFORMW 「それに、時折%TEXTR("体育館裏のリンゴ/職員室前の梨/第四図書室前の柿")%の実が減っている気がしますの」	PRINTFORMW 「说起来、偶尔会发现%TEXTR("体育馆里的苹果树/教员室前的梨树/第四图书室前的柿子树")%上的果实越来越少了呢」
PRINTFORMW 「先生方か誰かが収穫しているのかしら…？　少し分けて欲しいですわ…」	PRINTFORMW 「老师们还是其他人会去摘收树上的果实吗…？　有些好奇啊…」
PRINTFORMW 「…ここだけの話、実をかまいたちで撃ち落として取ろうとしたことがありますの」	PRINTFORMW 「…告诉你个秘密、我之前本来试图用气刃把树上的果子打下来然后拿走的」
PRINTFORMW 「結果？力加減を間違えて枝ごとみじん切りになってしまいましたわ…」	PRINTFORMW 「结果？最后没有控制好力度结果把树枝全都切得粉碎哇…」
PRINTFORMW 「…え？風の精霊なんだから飛んで取ればいい…？　あっ…」	PRINTFORMW 「…欸？反正是风精灵，直接飞起来去摘下来不就好了…？　啊——…」
PRINTFORMW 「校庭のあの辺り、落ち葉が積まれてますわね」	PRINTFORMW 「校园的各处，都堆积了不少落叶呢」
PRINTFORMW 「幼い頃、実家の敷地内の森林で落ち葉のベッドを作ったのを思い出しますわ」	PRINTFORMW 「我想起了小的时候，我在家里的所有土地里面的森林中用落叶做了一张床」
PRINTFORMW 「どうせ捨ててしまうなら、リンゴやサツマイモを焼いて楽しみたいですわね」	PRINTFORMW 「反正最后肯定就不要了，用来烤苹果和红薯的话似乎也挺好玩的呢」
PRINTFORMW 「モミジもイチョウも鮮やかに色付きましたわね。目に眩しいぐらいですわ」	PRINTFORMW 「无论是红叶还是银杏叶都变成了很鲜艳的颜色呢。真是炫目多彩哇」
PRINTFORMW 「放課後に部の皆と一緒に紅葉狩りに行きたいですわね」	PRINTFORMW 「放学之后想和社团的各位一起去赏红叶哇」
PRINTFORMW 「銀杏の葉は黄金色で綺麗なのに、実は何故あんなに臭いのかしら？」	PRINTFORMW 「银杏的叶子明明是那么绮丽的金黄色、为什么实际闻起来却那么臭呢？」
PRINTFORMW 「アレを綺麗に掃除してる方には感服いたしますわ…」	PRINTFORMW 「真钦佩那些能把它们全扫干净的人啊…」
PRINTFORMW 「あら、赤トンボ…沢山飛んでますわね」	PRINTFORMW 「啊啦、红蜻蜓…有好多红蜻蜓在飞来飞去呢」
PRINTFORMW 「一体何処からこんなに飛んでくるのでしょうね」	PRINTFORMW 「究竟是从哪里飞过来的呢」
PRINTFORMW %CALLNAME:TARGET%と外の景色を見ながら雑談した。	PRINTFORMW %CALLNAME:TARGET%一边看着外面的景色一边闲谈着。
PRINTFORMW 「来ますわね…台風。対策は出来ていまして？」	PRINTFORMW 「要来了呢…台风。已经出台对策了吗？」
PRINTFORMW 「飛ばされて困るものは今のうちに家の中に入れておくのが吉ですわよ！」	PRINTFORMW 「被吹跑的话会很麻烦所以趁现在回家待着就好了哟！」
PRINTFORMW 「それと養生テープと食料と水の買い置きと避難経路の確認も忘れちゃいけませんわ！」	PRINTFORMW 「然后是养生胶带还有食物和水的采购以及避难路线的确认都千万不要忘了哇！」
PRINTFORMW 「%CNAME("一人称")%の力でどうにか出来ないのかですって？」	PRINTFORMW 「你说%CNAME("一人称")%的能力应该能派上些用场吗？」
PRINTFORMW 「うーん、精々この付近に差し掛かった時に勢力を弱める程度しか…」	PRINTFORMW 「嗯——，最多只有在台风来到附近的时候削弱一下它的势力的程度…」
PRINTFORMW 「非常用にお肉屋さんのコロッケを買い込んでおこうかしら…」	PRINTFORMW 「要不要去肉铺里买些可乐饼以备不时之需呢…」
PRINTFORMW 「後は用水路と海岸の様子を見なくちゃいけませんわね…」	PRINTFORMW 「之后必须要注意观察水渠和海岸的情况呢…」
PRINTFORMW 「…%CNAME("一人称")%の能力でもっと涼しく出来ないのかですって？」	PRINTFORMW 「…你问能不能用%CNAME("一人称")%的能力让四周变凉快一些？」
PRINTFORMW 「何もない所から冷気を生み出すことは流石に難しいですわね…」	PRINTFORMW 「在什么都没有的地方凭空产生出冷气这种事情确实做不到呢…」
PRINTFORMW 「うーん、他はせいぜいエアコンの中の埃を掃除するぐらいかしら…」	PRINTFORMW 「嗯——，要说的话也只能清扫一下空调里的灰尘这样吧…」
PRINTFORMW %CALLNAME:MASTER%の頼みに%CALLNAME:TARGET%はげんなりとしながら首を横に振った…。	PRINTFORMW 面对%CALLNAME:MASTER%的请求，%CALLNAME:TARGET%无精打采地摇着头…。
PRINTFORMW 「夏の好きな所？そうですわねぇ、アイスが美味しい、可愛い水着が着られる…」	PRINTFORMW 「夏天喜欢去的地方？我看看啊，有美味的冰淇淋，可以穿可爱的泳装…」
PRINTFORMW 「水も滴る良い殿方や美少女とお近づきになれる…あれ？意外と良い所ありますわね…」	PRINTFORMW 「还可以接近身上滴着水珠的男士和美少女…啊咧？意外的是个好地方呢…」
PRINTFORMW 「あ～あ…涼しい時期まで時間を飛ばせれば良いのに………」	PRINTFORMW 「啊～啊…要是时间可以直接快进到凉快的时候就好了………」
PRINTFORMW 「ねえ、あのメイド悪魔は魂を使って時間操作とかそういうことは出来ませんの？」	PRINTFORMW 「我说啊、那个恶魔女仆能不能通过魂操纵时间什么的呢？」
PRINTFORMW 「うぅ～…ほんっとにどうしようもない暑さですわね………」	PRINTFORMW 「呜～…这暑气真是让人无可奈何哇………」
PRINTFORMW 「これはもはや…いえ、絶ッッッ対に異常気象…そうに決まってますわ…」	PRINTFORMW 「这个难道说…不对、绝————对是异常气象吧…一定是这样的哇…」
PRINTFORMW 「は～あ…こんなに暑いならいっそ実家に帰ってしまおうかしら………」	PRINTFORMW 「哈～啊…这么热的话真想索性回父母家呢………」
PRINTFORMW 「何なら部の皆も連れて…%TEXTR("ゆっくり/のんびり")%と%TEXTR("お茶会を開きたい/おしゃべりしたい/お散歩したい")%ですわ…」	PRINTFORMW 「我想，要不叫上社团的各位…%TEXTR("轻闲地/悠闲地")%と%TEXTR("开个茶会/聊会儿天/散散步")%哇…」
PRINTFORMW 「%TEXTR("へックション/ヘーックショイ/ハクション/ハックショーイ/へっくち")%！！」	PRINTFORMW 「%TEXTR("阿嚏/啊——嚏/哈——嚏/哈嚏——/哈——啾")%！！」
PRINTFORMW 「うう、鼻に虫が入りましたわ…」	PRINTFORMW 「呃——、鼻子里好像进了小虫子哇…」
PRINTFORMW 「ふわぁ～…この丁度良い陽気、眠くなりますわぁ～…」	PRINTFORMW 「呼哇～…这个天气正好呢，有些变困了哇～…」
PRINTFORMW 「二人で少しお昼寝でもしませんこと？」	PRINTFORMW 「不如我们一起稍微睡个午觉吧？」
PRINTFORMW 「ふふ、桜が綺麗ですわね」	PRINTFORMW 「呵呵、樱花真是美丽呢」
PRINTFORMW 「皆でお花見に行きたいですわ♪」	PRINTFORMW 「想和大家一起去赏花哇♪」
PRINTFORMW 「そういえば%CNAME("二人称")%…勉強で分からない所はありません？」	PRINTFORMW 「说起来%CNAME("二人称")%…在学习的时候有没有不明白的地方？」
PRINTFORMW 「性教育では%CNAME("二人称")%には勝てないでしょうけど…それ以外なら自信ありますわよ！」	PRINTFORMW 「性教育的话我确实是胜不过%CNAME("二人称")%…そ除此之外我都很有自信哟！」
PRINTFORMW 「%CNAME("一人称")%、これでも成績優秀なので…何でも聞いてくださいまし♪」	PRINTFORMW 「%CNAME("一人称")%啊，可是成绩非常优秀的…什么都可以来问我哦♪」
PRINTFORMW 「何ですって、それは本当ですの？！」	PRINTFORMW 「你说什么、这是真的吗？！」
PRINTFORMW %CALLNAME:TARGET%は%CALLNAME:MASTER%%TEXTR("の冗談交じりの/のホラ/に誇張された/に脚色された")%話も真剣に聞いている…。	PRINTFORMW %CALLNAME:TARGET%把%CALLNAME:MASTER%%TEXTR("半开玩笑地/吹牛的/经过夸张地/添油加醋的")%话语当真了…。
PRINTFORMW 「瞬間瞬間を必死に生きることが%CNAME("一人称")%のモットーですの」	PRINTFORMW 「全心全意对待生命中的每一个瞬间，这就是%CNAME("一人称")%的座右铭」
PRINTFORMW 「だって人生は一回ですもの…エンジョイしなきゃもったいないですわ」	PRINTFORMW 「因为人生是只有一次的东西…不好好享受的话就太浪费了哇」
PRINTFORMW 「あら、汗を拭いてくださるのね。ありがとうございますわ」	PRINTFORMW 「啊啦，您在为我擦汗吗。非常感谢哇」
PRINTFORMW 「…少しぐらい悪戯しても良いんですのよ？　ほらほら♪」	PRINTFORMW 「…稍稍做些恶作剧也是没关系的哟？　来吧来吧♪」
PRINTFORMW 「こっちの方…%TEXTR("胸の谷間/脇の下/お尻")%も拭いてくださいませ♪」	PRINTFORMW 「那里…%TEXTR("乳沟里面/腋下/臀部")%也请帮忙擦一下♪」
PRINTFORML 「%TEXTR("あっ熱ッ、ア゛ッツ゛イ゛ですわッ！/きゃあっ！つ、つ、冷たいですわっ！/はぁ～…身体も気持ちもさっぱりしますわぁ～♪/これこれ、やはりシャワーはぬるま湯に限りますわぁ～♪")%」	PRINTFORML 「%TEXTR("好——烫——，真的゛好゛烫——゛哇——！/咿呀——！哈，好，好冷哇——！/哈啊～…身体和精神都好清爽哇～♪/对啦对啦，果然淋浴就该用温水啊～♪")%」
PRINTFORM 「あっ、お帰りなさいませ、	PRINTFORM 「啊——，欢迎回来，
PRINTFORM 「あら、来てらしたのね？　	PRINTFORM 「啊啦、您来了呢？　
PRINTFORMW シャワーお借りしましたわ」	PRINTFORMW 借用一下淋浴间哦」
PRINTFORMW 「それで%CNAME("一人称")%の使用済みパンツはお気に召したかしら？」	PRINTFORMW 「话说%CNAME("一人称")%穿过的内裤还算合您的意吗？」
PRINTFORMW 「あら、バレてないとでもお思い？大丈夫、これぐらいじゃ怒りませんわ♪」	PRINTFORMW 「啊啦，本以为不会被发现吗？没关系，这种程度我是不会生气的哇♪」
PRINTFORMW 「ふふ、%CNAME("一人称")%のパンツを漁った感想はいかがかしら？」	PRINTFORMW 「呵呵、抓住了%CNAME("一人称")%的内裤你感觉如何啊？」
PRINTFORMW 「答えてもらわなくても分かりますわ、%CNAME("二人称")%のおちんちん、元気になってますもの♪」	PRINTFORMW 「不管你回答与否我都知道哇，因为%CNAME("二人称")%的大鸡鸡已经变得很精神了呢♪」
PRINTFORMW 「%CNAME("二人称")%の事ですからお風呂に突撃してくるかと思いましたが…来ませんでしたわね」	PRINTFORMW 「本来还以为%CNAME("二人称")%的话会在我洗澡的时候来突袭…结果没有来呢」
PRINTFORMW 「%CNAME("一人称")%は何時でもウェルカムですのに…」	PRINTFORMW 「明明无论何时%CNAME("一人称")%都很欢迎的…」
PRINTFORMW 「…丁度良いですわ、髪を乾かすのを手伝ってくださいませんこと？」	PRINTFORMW 「…来得正好哇、可以帮我一起把头发吹干吗？」
PRINTFORMW 「と言っても、%CNAME("一人称")%が風で乾かしたところを櫛で整えていただければそれで終わりですわ」	PRINTFORMW 「虽然是这么说、%CNAME("一人称")%用风吹干之后请帮我用梳子梳理一下就可以了哇」
PRINTFORMW 「どうしましたの、黙ってしまって…あっ、分かりましたわ」	PRINTFORMW 「你怎么了呀、这么沉默…啊——、我知道了哇」
PRINTFORMW 「%CNAME("一人称")%のスタイルと香りに股間が反応して動けないと見ましたわ！」	PRINTFORMW 「因为%CNAME("一人称")%的身材的香味让你的胯下起反应了所以不敢动吧，我看到了哦！」
PRINTFORMW 「マッサージ…ですの？う～ん、まぁ確かに…肩が重かったりはしますけど…」	PRINTFORMW 「要给我…按摩吗？嗯～，嘛也确实…感觉肩膀很沉重…」
PRINTFORMW 「…痛いのやったら泣きますわよ？」	PRINTFORMW 「…把我弄疼的话我会哭出来哟？」
PRINTFORMW １５分後…	PRINTFORMW １５分钟后…
PRINTFORMW 「あっ、ああぁぁぁ～～～～ッ…んっ、ん～～～～………」	PRINTFORMW 「啊——、啊啊啊～～～～…嗯——，嗯～～～～………」
PRINTFORMW 「…そ、そんな…まさかこんなに肩が軽くなるなんて…まるで羽でも生えたかのようですわぁ♪」	PRINTFORMW 「…不，不会吧…肩膀的感觉变得好轻松…就好像长了翅膀一样哇♪」
PRINTFORMW 「うふふ、また今度お願いしますわね♪ちゅっ♪」	PRINTFORMW 「哎嘿嘿、下次也拜托你啦♪啾——♪」
PRINTFORMW マッサージにすっかりご満悦な%CALLNAME:TARGET%は%CALLNAME:MASTER%に抱きつき、頬にキスしてきた。	PRINTFORMW 对按摩十分满意的%CALLNAME:TARGET%紧紧抱住了%CALLNAME:MASTER%，在脸颊上吻了一下。
PRINTFORMW 「ああぁ～～～、そこそこ…良いですわぁ～～～」	PRINTFORMW 「啊啊啊～～～，那里哪里…好舒服哇～～～」
PRINTFORMW 「…何だか今の%CNAME("一人称")%、仕事終わりのおじさまのようですわね…」	PRINTFORMW 「…总感觉现在的%CNAME("一人称")%，就好像刚工作完的大叔一样呢…」
PRINTFORMW 「足もやってくださるの？ではお言葉に甘えて…」	PRINTFORMW 「脚也要按摩吗？既然你都这样说了…」
PRINTFORMW 「ふっ、うふふっ、くく、くすぐったいですわっ、んふっ、んふふっ…」	PRINTFORMW 「呼——，唔呼呼——，哈哈好，好——痒啊——，呜哈——，呜哈哈——…」
PRINTFORMW 「んちゅ、じゅっ、じゅるるっ…んふっ、ふーっ…」	PRINTFORMW 「嗯啾、啾、啾噜噜…嗯呼、呼ーっ…」
PRINTFORMW （こんなに深く激しいと…最早キスじゃなくてお口でのセックスですわね…）	PRINTFORMW （这么深厚激烈的…比起亲吻不如说是嘴巴之间的性交吧…）
PRINTFORMW （あぁ…もっと…もっと%CNAME("一人称")%の口貪って…味わってくださいませぇ…♪）	PRINTFORMW （啊啊…请再更加…更多地索求%CNAME("一人称")%的嘴…请尽情地品尝吧…♪）
PRINTFORMW 「ちゅぅっ、ちゅるる…んっ、ん～ッ…♪」	PRINTFORMW 「啾——，啾噜噜…嗯——，嗯～ッ…♪」
PRINTFORMW 「ぷぁ…%CNAME("二人称")%とのキス、気持ちいいですわぁ…♪」	PRINTFORMW 「噗啊…和%CNAME("二人称")%亲吻着，真的好舒服哇…♪」
PRINTFORMW 「ぷは…あらごめんなさい、涎が…。今お拭きしますわね」	PRINTFORMW 「噗哈…啊啦对不起，有口水…。我马上擦干净哦」
PRINTFORMW %CALLNAME:TARGET%は口を離したときに%CALLNAME:MASTER%の服に零れてしまった涎をハンカチで拭き取った。	PRINTFORMW %CALLNAME:TARGET%用手巾拭去了自己与%CALLNAME:MASTER%嘴唇分离时滴落在%CALLNAME:MASTER%衣服上的涎水。
PRINTFORMW 「ちゅっ……あら？触れるだけですの？」	PRINTFORMW 「啾——……啊啦？只是轻轻碰上吗？」
PRINTFORMW 「てっきりもっと深く激しくやってくださるのかと…」	PRINTFORMW 「还以为会是更加浓厚激烈的吻呢…」
PRINTFORMW 唇に指を当て、%CALLNAME:TARGET%はどこか残念そうにしている。	PRINTFORMW %CALLNAME:TARGET%把手指搭在嘴唇上，看起来一副很遗憾的样子。
PRINTFORMW 「ちゅぅ…ちゅぱ、ちゅっちゅ…♪」	PRINTFORMW 「啾呜…啾叭、啾——啾…♪」
PRINTFORMW 「ん…もう、終わりですの？…もっとしましょう？」	PRINTFORMW 「嗯…唔，已经结束了吗？…再多亲一会儿吧？」
PRINTFORMW 「あら…膝枕してくださるの？」	PRINTFORMW 「啊啦…想给我膝枕吗？」
PRINTFORMW 「ふふ、ではお言葉に甘えて…♪」	PRINTFORMW 「呵呵、既然你都这么说了…♪」
PRINTFORMW %CALLNAME:TARGET%はいそいそと%CALLNAME:MASTER%の膝に寝転び、甘えるように太ももへ頬擦りしてきた。	PRINTFORMW %CALLNAME:TARGET%は兴高采烈地躺倒在%CALLNAME:MASTER%的腿上、撒娇似的用脸颊轻轻蹭着%CALLNAME:MASTER%的大腿。
PRINTFORMW 「されてばっかりというのもなんだか悪いですわね…」	PRINTFORMW 「总是让你来做总感觉不太好呢…」
PRINTFORMW 「次は%CNAME("一人称")%が%CNAME("二人称")%に膝枕する番だって覚えておいてくださいまし」	PRINTFORMW 「下次就轮到%CNAME("一人称")%来给%CNAME("二人称")%膝枕好了，不要忘记了哦」
PRINTFORMW 「なんだか…故郷の両親を……思い出し………ＺＺＺ………」	PRINTFORMW 「感觉…回忆起了……故乡的双亲啊………ＺＺＺ………」
PRINTFORMW 膝枕されている%CALLNAME:TARGET%はあっさりと寝落ちした…。	PRINTFORMW 享受着膝枕地%CALLNAME:TARGET%恬然地睡着了…。
PRINTFORMW 「もう少し足を閉じて…そう、良い感じですわよ」	PRINTFORMW 「再稍稍把腿并拢一些…对，感觉真舒服哇」
PRINTFORMW 「ん…そうそう、これこれ…これが%CNAME("一人称")%の理想の膝枕ですわ♪」	PRINTFORMW 「嗯…没错没错、这个这个…这个就是%CNAME("一人称")%理想中地膝枕哇♪」
PRINTFORMW %CALLNAME:TARGET%はご満悦といった表情で%CALLNAME:MASTER%に笑いかけてきた。	PRINTFORMW %CALLNAME:TARGET%带着一脸满足的表情对%CALLNAME:MASTER%展露着笑颜。
PRINTFORMW 「お茶を淹れてくださったの？　ありがとうございます」	PRINTFORMW 「为我泡了茶吗？　非常感谢」
PRINTFORMW 「ふふ、誰かにお茶を淹れてもらえるってなんだか嬉しいですわ♪」	PRINTFORMW 「呵呵，有人为我泡茶真是很让人高兴哇♪」
PRINTFORMW 「そうだわ、おやつも持ってきたので一緒に食べましょう♪」	PRINTFORMW 「对了哇，我带了点心所以一起来吃吧♪」
PRINTFORMW %CALLNAME:TARGET%はそう言いながら何処からか%TEXTR("ショートケーキ/チョコレートケーキ/モンブラン/チーズケーキ/カステラ/芋羊羹/シュークリーム/ワッフル/クッキー/ビスケット")%と食器を取り出した。	PRINTFORMW %CALLNAME:TARGET%一边这么说着一边不知从何处取出了%TEXTR("奶油酥饼/巧克力蛋糕/蒙布朗/芝士蛋糕/长崎蛋糕/红薯羊羹/奶油泡芙/华夫饼/曲奇饼/饼干")%和餐具。
PRINTFORM 「%TEXTR("ゴクッ…ゴクッ/ズズズ")%………	PRINTFORM 「%TEXTR("咕噜——…咕噜——/嘶嘶嘶")%………
PRINTFORMW ふむ…{RAND(60, 70)}…いえ、{RAND(75, 80)}点（%CALLNAME:TARGET%基準）といったところですわね」	PRINTFORMW 呼唔…{RAND(60, 70)}…不对，{RAND(75, 80)}分（%CALLNAME:TARGET%标准）的感觉吧」
PRINTFORMW 「まだまだ精進出来ますわね。何ならレクチャーして差し上げますわよ？」	PRINTFORMW 「还有精进的空间呢。要不要给你开个小讲座分析一下？」
PRINTFORMW 良いですわね、{RAND(85, 95)}点（%CALLNAME:TARGET%基準）ですわ」	PRINTFORMW 真是不错呢、{RAND(85, 95)}分（%CALLNAME:TARGET%标准）的感觉哇」
PRINTFORMW 「%TEXTR("あともう一押し、ってところですわ！/もっとお湯の温度に敏感になるとよろしいかと…/蒸らす時間をもう少し厳密に計ってみてくださいませ")%」	PRINTFORMW 「%TEXTR("离完美就差临门一脚，就是这种感觉哇！/再多多注意一下水的温度的话…/可以再仔细把控一下醒茶的时间")%」
PRINTFORMW これは…ほぼ１００点満点（%CALLNAME:TARGET%基準）ですわ！」	PRINTFORMW 这是…基本就是１００分满分（%CALLNAME:TARGET%标准）的水平了哇！」
PRINTFORMW 「出来れば毎回このクオリティーを保ってくださいませ！　『ティー』だけに！」	PRINTFORMW 「可以的话请每次都保持这个水平啊！　正所谓『茶『水』』！」
PRINTFORMW 「%TEXTR("うふふ、/はあぁ…")%%CNAME("二人称")%が淹れたお茶は今日も美味しいですわぁ♪」	PRINTFORMW 「%TEXTR("唔呼呼，/哈啊…")%%CNAME("二人称")%泡出来的茶今天也同样美味哇——♪」
PRINTFORMW 「このまま%CNAME("一人称")%の家に永久就職させて…うふ、冗談ですわ」	PRINTFORMW 「这样下去可以去%CNAME("一人称")%家里永久就职了呢…哎嘿、开个玩笑哇」
PRINTFORMW そう言う%CALLNAME:TARGET%の目つきは冗談とは思えないほど本気だった…。	PRINTFORMW 这样说着的%CALLNAME:TARGET%的眼神却认真的完全不像在开玩笑…。
PRINTFORMW 「よくここまで成長して…%CNAME("一人称")%、鼻が高いですわっ♪」	PRINTFORMW 「居然有了这种进步…%CNAME("一人称")%为你感到自豪哇——♪」
PRINTFORMW 「%CNAME("一人称")%は今、学園一の幸せ者だと胸を張って言えるぐらい…え？大げさすぎる？」	PRINTFORMW 「%CNAME("一人称")%现在，可以挺起胸说自己是学校最幸福的人啦…欸？太夸张了？」
PRINTFORMW 「…あら、茶柱が立ってますわ。風情がありますわね」	PRINTFORMW 「…啊啦、茶叶梗立起来了哇。还真是解风情呢」
PRINTFORMW 「ちゅぅ、れろ…うふふ、キスしながらなでなでだなんて…」	PRINTFORMW 「啾——，唦啦…唔呵呵、一边亲吻一边抚摸什么的…」
PRINTFORMW 「もっともっと%CNAME("二人称")%に甘えたくなってしまいますわ♪ちゅっ♪」	PRINTFORMW 「还想要更多更多的对着%CNAME("二人称")%撒娇哇♪啾——♪」
PRINTFORMW 「これは…ちゃんとご奉仕出来たご褒美ですの？嬉しいですわ♪」	PRINTFORMW 「这是在…因为我有好好在侍奉所以夸奖了我吗？好高兴哇♪」
PRINTFORMW 「次も頑張らせていただきますわね…♪」	PRINTFORMW 「下次也请让我尽我所能哦…♪」
PRINTFORMW 「んぁ…はぁ、ふぅ…せ、切ないですわ…」	PRINTFORMW 「嗯啊…哈啊，呼唔…好，好难受啊…」
PRINTFORMW 「こうして触れ合うだけでは物足りないと…お腹がキュンキュンしてしまいますの…」	PRINTFORMW 「仅仅是这样互相触碰着已经没法满足了…小腹不停地有种啾啾啾的感觉…」
PRINTFORMW 「ぁん、撫でるならもっと優しくお願いしますわ」	PRINTFORMW 「啊嗯，摸我的时候希望可以更温柔一些哇」
PRINTFORMW 「そうそう、そんな感じに…うふふ、気持ち良いですわぁ…♪」	PRINTFORMW 「对对，就是这种感觉…呜呼呼、真是好舒服哇…♪」
PRINTFORMW 「どうかしら、%CNAME("一人称")%の髪…サラッサラでしょう？」	PRINTFORMW 「怎么样，%CNAME("一人称")%的头发…很顺滑吧？」
PRINTFORMW 「好きなだけ…禿げない程度に撫でてくださって構いませんわよ♪」	PRINTFORMW 「随你喜欢…只要不会把我摸秃的话就没关系哟♪」
PRINTFORMW 「こうやって優しく頭を撫でられて…なんだか褒められているようですわ」	PRINTFORMW 「这么温柔地轻抚着我的头发…总感觉像在被夸奖一样哇」
PRINTFORMW 「もっともっと…褒めてくださいませ♪」	PRINTFORMW 「还想更多更多地…被你夸奖呀♪」
PRINTFORMW 「はぁぁ…何だか身体が熱くてムズムズしますわ…ねぇ%CNAME("二人称")%？」	PRINTFORMW 「哈啊啊…不知为何身体好热而且痒痒的哇…呐%CNAME("二人称")%？」
PRINTFORMW 「そちらのベッドで%CNAME("一人称")%の身体…調べてみてくださいませんか…？」	PRINTFORMW 「去那边的床上帮%CNAME("一人称")%把身体…好好检查一些看看吧…？」
PRINTFORMW 「…えいっ」	PRINTFORMW 「…嘿咿——」
PRINTFORML いきなり強く押すような突風が吹き、ベッドに尻もちをついた%CALLNAME:MASTER%。	PRINTFORML 突然一阵强风重重地推着你，让你仰面摔了床上%CALLNAME:MASTER%。
PRINTFORMW その上へ、赤面した%CALLNAME:TARGET%が乗ってきた…。	PRINTFORMW 在你仰面躺倒的时候，满脸通红的%CALLNAME:TARGET%坐了上来…。
PRINTFORMW 「ごめんなさい、手荒な真似をしてしまって」	PRINTFORMW 「真抱歉、做出了如此粗暴的举动」
PRINTFORMW 「でも、ここが…お腹がきゅうきゅう疼いて…%CNAME("二人称")%を欲しがっているんですの…」	PRINTFORMW 「可是，这里…小腹啾啾地抽痛着…在不停地渴求着%CNAME("二人称")%啊…」
PRINTFORMW 「よーし………きゃっ！」	PRINTFORMW 「看我的………咿呀——！」
PRINTFORMW %CALLNAME:TARGET%はわざとらしく足を滑らせ、%CALLNAME:MASTER%を巻き込みながらベッドに倒れこんだ…。	PRINTFORMW %CALLNAME:TARGET%故意让脚底打了下滑，然后一边紧紧抱住%CALLNAME:MASTER%一边朝着一旁的床上倒了下去…。
PRINTFORMW 「あ、あら、ごめんなさい…お怪我はありませんか？」	PRINTFORMW 「啊，啊啦，真不好意思…你没有受伤吧？」
PRINTFORMW 「…責任をもって%CNAME("一人称")%が調べて差し上げますわ。ささ、服を脱いでくださいませ」	PRINTFORMW 「…%CNAME("一人称")%负起责任帮您检查一下。来来，请快把衣服脱掉吧」
PRINTFORMW 「その…お詫びになるか分かりませんが…%CNAME("一人称")%の身体、好きにしてくださいませ」	PRINTFORMW 「那个…不知是不是该向您赔个罪…就请对%CNAME("一人称")%的身体，随意地做您喜欢的事情吧」
PRINTFORMW 「いつでも素敵な方でいるために、後始末と身だしなみを整えましょう」	PRINTFORMW 「为了时刻保持完美得体的状态，来进行一些善后清理吧」
PRINTFORMW 「うふふ、ここのお掃除は%CNAME("一人称")%に任せてくださいまし♪」	PRINTFORMW 「唔呵呵，这里的清扫就请交给%CNAME("一人称")%吧♪」
PRINTFORMW %CALLNAME:TARGET%は汚れた肉棒を躊躇無く根元まで咥えこみ、丁寧に舐め清めた…。	PRINTFORMW %CALLNAME:TARGET%毫不犹豫地将沾染着各种液体的肉棒整根含了进去，仔细地吮吸舔舐清理着…。
PRINTFORMW 「お、お口が寂しくなってしまっただけですのよ？ちょっとだけ…ちょっとだけ、ね？」	PRINTFORMW 「嘴，嘴巴有点寂寞哟？只是有点…真的只是一点、呢？」
PRINTFORMW そう言いながら跪いた%CALLNAME:TARGET%は、%CALLNAME:MASTER%の肉棒を取り出すとねっとりとしゃぶり始めた…。	PRINTFORMW %CALLNAME:TARGET%一边这样说着一边跪了下去，掏出了%CALLNAME:MASTER%的肉棒开始黏乎乎地含吮起来…。
PRINTFORMW 「はぁん…%CNAME("二人称")%のおちんちん…♪ふぅーってしただけでビクビクしてますわぁ♪」	PRINTFORMW 「哈呜…%CNAME("二人称")%地大鸡鸡…♪只要对着呼ー地一下就会一颤一颤的哇♪」
PRINTFORMW %CALLNAME:TARGET%は露出させた亀頭に吹きかけた吐息を操り、%CALLNAME:MASTER%の反応を楽しんでいる…。	PRINTFORMW %CALLNAME:TARGET%对着裸露在外的龟头轻吐着气，享受着%CALLNAME:MASTER%有趣的反应…。
PRINTFORMW 「ちゅっ…うふふ、キスはいつしても良いものですわね」	PRINTFORMW 「啾っ…欸嘿嘿，不管什么时候吻都是个好东西呢」
PRINTFORMW 「ささ、今度は%CNAME("二人称")%が%CNAME("一人称")%にする版ですわよ♪」	PRINTFORMW 「来来、这次该%CNAME("二人称")%来亲%CNAME("一人称")%了哟♪」
PRINTFORMW 「ちゅっ…あら？少し乾燥してらっしゃるわね」	PRINTFORMW 「啾っ…啊啦？感觉有些干燥呢」
PRINTFORMW 「…%CNAME("一人称")%、少し風を起こし過ぎたかしら…」	PRINTFORMW 「…%CNAME("一人称")%是不是，用风把你吹过头了啊…」
PRINTFORMW 「ん、んんっ…はぁっ、はぁっ…熱い…熱くて疼くんですの…」	PRINTFORMW 「呃，呃嗯っ…哈啊っ、哈啊っ…好热…不仅热还有些疼啊…」
PRINTFORMW 「だから…だから仕方ないですわよね？」	PRINTFORMW 「所以…所以也是没办法对吧？」
PRINTFORMW 「%CNAME("一人称")%、えっちなことは好きですけど…こんなにはしたない女じゃなかったのに…」	PRINTFORMW 「%CNAME("一人称")%，虽说喜欢色色的事情…但明明不是个这么下流的女孩子…」
PRINTFORMW 「%CNAME("二人称", "どもり")%が悪いんですのよ…ずっとほおっておくから…」	PRINTFORMW 「都是%CNAME("二人称", "どもり")%不好哦…总对我做这种事情…」
PRINTFORMW 「ふわぁぁ…すみませんが、お膝を借りますわよ…」	PRINTFORMW 「呼啊啊——…不好意思、把大腿借我一下哦…」
PRINTFORMW %CALLNAME:TARGET%は言うが早いが%CALLNAME:MASTER%の膝に寝転んできた…。	PRINTFORMW %CALLNAME:TARGET%说完就迅速枕倒在%CALLNAME:MASTER%的大腿上…。
PRINTFORMW 「ふふふ、冷たくて涼しくなるでしょう？」	PRINTFORMW 「呼呼呼、是不是很凉快啊？」
PRINTFORMW 「%CNAME("一人称")%？　元々暑いから、%CNAME("二人称")%に抱きつくぐらいどうってことはありませんわ」	PRINTFORMW 「%CNAME("一人称")%？　本来是很热，但只要抱着%CNAME("二人称")%就不这样觉得了哇」
PRINTFORMW エアコンの冷気を纏った%CALLNAME:TARGET%は豊かな胸を押し付けるように抱きついてきた。	PRINTFORMW 被空调的冷气缠绕着的%CALLNAME:TARGET%用丰满的胸部挤压着抱住了你。
PRINTFORMW 「ねえ%CNAME("二人称")%、お暇ならかまってくださいませ」	PRINTFORMW 「我说%CNAME("二人称")%、有空的话请搭理下我啊」
PRINTFORMW 「嫌と言っても%CNAME("一人称")%の方から行きますわよ！」	PRINTFORMW 「就算你说不要%CNAME("一人称")%也会靠过去的哟！」
PRINTFORMW %CALLNAME:TARGET%はそう言って%CALLNAME:MASTER%が苦しくならない程度に身体を押し付けてきた。	PRINTFORMW %CALLNAME:TARGET%这样说着，以一个不会让%CALLNAME:MASTER%难受的力度将身体靠了上来。
PRINTFORMW 「%CNAME("二人称")%の身体…とっても抱き心地が良いですわ…」	PRINTFORMW 「%CNAME("二人称")%的身体…不管怎么抱着都感觉很舒服哇…」
PRINTFORMW 「ふふ、何だか落ち着きますわ…」	PRINTFORMW 「呼呼、总感觉很安心哇…」
PRINTFORMW %CALLNAME:TARGET%は%CALLNAME:MASTER%の感触を確かめるようにしっかりと抱きついてきた。	PRINTFORMW %CALLNAME:TARGET%像是在确认%CALLNAME:MASTER%的触感一般紧紧抱住了%CALLNAME:MASTER%。
PRINTFORMW 「うふふ、可愛い可愛い%CNAME("二人称")%…」	PRINTFORMW 「唔嘿嘿，%CNAME("二人称")%真是好可爱好可爱啊…」
PRINTFORMW 「今はただ、%CNAME("一人称")%に身を委ねてくださいませ…♪」	PRINTFORMW 「只要一会儿就好，请把身体交给%CNAME("一人称")%吧…♪」
PRINTFORMW 「たまにはこうして撫でて…労って差し上げますわ」	PRINTFORMW 「偶尔像这样摸一摸…慰劳一下你吧」
PRINTFORMW 「この後も、これからも頑張ってくださいまし」	PRINTFORMW 「今后也请继续努力吧」
PRINTFORMW 「うふふっ、手慰みには丁度良いですわね♪」	PRINTFORMW 「唔呼呼——、现在很适合帮你手淫呢♪」
PRINTFORMW %CALLNAME:TARGET%は%CALLNAME:MASTER%の肉棒を手でくにくにと悪戯している…。	PRINTFORMW %CALLNAME:TARGET%用手咕啾咕啾地玩弄着%CALLNAME:MASTER%的肉棒…。
PRINTFORMW 「もう、すでに硬くなりつつありますわね…」	PRINTFORMW 「啧啧、立刻就开始不停变硬了呢…」
PRINTFORMW 「何を考えてこんなに元気にしているのか聞かせてもらってもよろしくて？」	PRINTFORMW 「到底是想着什么才变得这么有精神呢，说给我听听怎么样呀？」
PRINTFORMW 「%CNAME("二人称")%…少しお疲れではなくて？」	PRINTFORMW 「%CNAME("二人称")%…是不是有些累了呀？」
PRINTFORMW 「良かったら%CALLNAME:TARGET%のここ、空いておりますわよ」	PRINTFORMW 「不介意的话来%CALLNAME:TARGET%这里，已经帮你准备好了哟」
PRINTFORMW 「ねぇ～～～むれ～～～ねぇ～～～むれ～～～♪」	PRINTFORMW 「睡～～～吧～～～睡～～～吧～～～♪」
PRINTFORMW 歌ってくれるのは良いが、酷い音痴だった…。	PRINTFORMW 虽然很高兴愿意为自己唱歌，但似乎是个可怕的音痴啊…。
PRINTFORMW 「良かったら%TEXTR(@"あったかいもの/%SAVESTR:お茶%")%はいかが？」	PRINTFORMW 「不介意的话来写%TEXTR(@"热饮/%SAVESTR:お茶%")%如何？」
PRINTFORMW 「リラックス出来ますわよ…ズズズ…」	PRINTFORMW 「可以放松些哟…嘶嘶嘶——…」
PRINTFORMW 「はぁ…しつこいですわね」	PRINTFORMW 「哈啊…真是纠缠不休啊」
PRINTFORMW 「%CNAME("一人称")%が本気で怒る前に諦めてくださいませ」	PRINTFORMW 「%CNAME("一人称")%在我真的生气之前停下比较好哦」
PRINTFORMW 珍しく笑っていない目をした%CALLNAME:TARGET%から、強く押し返すような風が吹いてくる…。	PRINTFORMW %CALLNAME:TARGET%用少见的完全没有笑意的眼神看着你，用一阵风将你重重推开…。
PRINTFORMW 「そういうことはベッドの上でしませんこと？」	PRINTFORMW 「这种事情不是应该在床上做的事吧？」
PRINTFORMW 「ごめんなさい、%CNAME("一人称")%今はそんな気分じゃありませんの」	PRINTFORMW 「抱歉，%CNAME("一人称")%现在没有那种心情」
PRINTFORMW 「%CNAME("一人称")%の身嗜みを確認したいと？」	PRINTFORMW 「想确认下%CNAME("一人称")%下面的仪容？」
PRINTFORMW 「もうっ、%CNAME("二人称")%に心配されなくても綺麗にしてますわ！」	PRINTFORMW 「真是的，不被你%CNAME("二人称")%操这种心的话我会更高兴哇！」
PRINTFORMW 「…何なら実際に見て確かめてごらんなさい！　…ふふ♪」	PRINTFORMW 「…真想知道的话就请实际亲眼看看来好好确认一下吧！　…呼呼♪」
PRINTFORMW 「ふふ、見るだけで満足ですの？」	PRINTFORMW 「呵呵、只是看看就满足了吗？」
PRINTFORMW 「ちょっとぐらいは触ったり舐めたりしても良いんですのよ♪」	PRINTFORMW 「就算稍微摸一摸、舔几下也可以的哟♪」
PRINTFORMW 「それだけで満足出来なくなりましたら、ベッドで続きを…うふふっ♪」	PRINTFORMW 「如果仅仅那样还是不够满足的话，就去床上继续吧…唔呵呵—♪」
PRINTFORMW 「ふふ、%CNAME("二人称")%が目を皿のようにして熱心に見ているのが容易に想像出来ますわ」	PRINTFORMW 「呵呵，很容易就能想象出%CNAME("二人称")%睁大眼睛用火热的目光看着我的样子呢」
PRINTFORMW 「ここまでアソコに夢中になられると、ちょっぴり恥ずかしいですわね♪」	PRINTFORMW 「你这么痴迷于那里的话，我会感觉有些害羞呢♪」
PRINTFORMW 「あら…まだ%CNAME("二人称")%にそこまで許した覚えはありませんわよ？」	PRINTFORMW 「啊啦…我可不记得自己允许过%CNAME("二人称")%做到那种地步哦？」
PRINTFORMW 「もっと%CNAME("一人称")%に%CNAME("二人称")%の素敵な所を見せて…虜にしてくれるまでお預けですわ」	PRINTFORMW 「让%CNAME("一人称")%更多地看见%CNAME("二人称")%的出色之处…直到我的心被你俘获为止就先听我的吧」
PRINTFORMW 「うぅ、%CNAME("二人称")%ばかりそうやって…少し不公平だと思いませんこと？」	PRINTFORMW 「唔——、%CNAME("二人称")%总是做这种事情…就不觉得有些不公平吗？」
PRINTFORMW 「%CNAME("一人称")%だって%CNAME("二人称")%のパンツをチェックしたいのに…」	PRINTFORMW 「明明%CNAME("一人称")%也想看看%CNAME("二人称")%的内裤啊…」
PRINTFORMW 「それにしても…こうやって確認するだけで満足出来るものなのかしら？」	PRINTFORMW 「话虽如此…只是这样检查一下你就满足了吗？」
PRINTFORMW 「これだけで満足出来なくなりましたら、是非ベッドにお誘いくださいませ♪」	PRINTFORMW 「如果这样没法满足的话，请务必把我诱到床上去哦♪」
PRINTFORMW 「あぁ、どんどん呼吸が荒くなって…そんなに%CNAME("一人称")%の%PANTIES(TARGET, "パンツ")%が気に入りましたのね」	PRINTFORMW 「啊啊、呼吸在不断加粗呢…就这么喜欢%CNAME("一人称")%的%PANTIES(TARGET, "パンツ")%啊」
PRINTFORMW 「うふふ…どうぞ心行くまで堪能してくださいまし♪」	PRINTFORMW 「呜嘿嘿…请尽情的享受吧♪」
PRINTFORMW 「もう少し足を開いた方が良い？うふふ、こうですの？」	PRINTFORMW 「再稍微把腿张开些会更好？唔呵呵、像这样吗？」
PRINTFORMW 「やん♪い、息がかかってこ、こそばゆいですわっ♪」	PRINTFORMW 「咿呀♪呼、呼出的气喷到那、那里会很痒哇——♪」
PRINTFORMW 「%CNAME("二人称")%が目を皿のようにして熱心に見ているのが容易に想像出来ますわ」	PRINTFORMW 「很容易就能想象出%CNAME("二人称")%睁大眼睛用火热的目光看着我的样子呢」
PRINTFORMW 「ここまで%PANTIES(TARGET, "パンツ")%に夢中になっているのは中々可愛らしいですわね♪」	PRINTFORMW 「对%PANTIES(TARGET, "パンツ")%痴迷到这种程度的样子还真是可爱呢♪」
PRINTFORMW 「あら、少し顔が近すぎるのではなくて？」	PRINTFORMW 「啊啦、脸是不是有些靠得太近了？」
PRINTFORMW 「逃げたりしませんから、落ち着いてじっくりゆっくり見てくださいまし」	PRINTFORMW 「我是不会逃开的、安安心心地慢慢观赏就好的」
PRINTFORML 「…♪」	PRINTFORML 「…♪」
PRINTFORMW %CALLNAME:TARGET%が起こしたであろう風が、彼女のスカートをふわりとめくりあげた…。	PRINTFORMW 一阵似乎是%CALLNAME:TARGET%自己唤起的清风，把她的裙子轻轻掀了起来…。
PRINTFORML 「ぁん、パンツを見られてしまいましたわ…」	PRINTFORML 「呜嗯，内裤被看见了哇…」
PRINTFORMW 「でも%CNAME("二人称")%になら…見てもらって構いませんわよ♪」	PRINTFORMW 「不过是%CNAME("二人称")%的话…被看了我也不会介意哟♪」
PRINTFORMW 「うふ、見られちゃいましたわ…♪」	PRINTFORMW 「呜呵、被看到了哇…♪」
PRINTFORMW いたずらっぽく笑う%CALLNAME:TARGET%から、%CALLNAME:MASTER%の股間をくすぐるように風が吹き抜けた…。	PRINTFORMW 一阵风从挂着一副小恶魔似的坏笑的%CALLNAME:TARGET%那边吹了过来，像是在挑逗一般从%CALLNAME:MASTER%的股间穿流而过…。
PRINTFORML 「うふふ、%CNAME("一人称")%のパンツ、気になっていたのではなくて？」	PRINTFORML 「唔呵呵、%CNAME("一人称")%的内裤，你不是很在意吗？」
PRINTFORMW 「さぁさ、どうぞご存分にご覧くださいませ…♪」	PRINTFORMW 「来～来、请过来尽情地观赏吧…♪」
PRINTFORML 「いやぁんっ♪急に風が吹いてパンツが丸見えになってしまいましたわー♪」	PRINTFORML 「咿呀——っ♪怎么突然来了一阵风吹得内裤都要被看光了哇ー♪」
PRINTFORMW %CALLNAME:TARGET%はわざとらしい悲鳴を上げている…。	PRINTFORMW %CALLNAME:TARGET%似乎故意发出了哀叫声…。
PRINTFORMW 「んぅ…なんだかスース―しますわ…」	PRINTFORMW 「嗯唔…怎么感觉怪怪的哇…」
PRINTFORMW 「全く%CNAME("二人称")%ったら、何やってるんですの…？」	PRINTFORMW 「真是的，%CNAME("二人称")%这家伙啊，在做什么呀…？」
PRINTFORMW 「ふわぁ～…寝起きの女性を狙うのは感心しませんわね」	PRINTFORMW 「呼哇～…袭击刚起床的女孩子这种事可不讨喜啊」
PRINTFORMW 「%CNAME("一人称")%以外にはやめておいた方が無難ですわよ？」	PRINTFORMW 「可不要%CNAME("一人称")%以外的人做这种事情哦？」
PRINTFORML 「あら、さも当然のように…%CNAME("一人称")%のパンツが気になりまして？」	PRINTFORML 「啊啦、好像理所当然呢…很想看%CNAME("一人称")%的内裤吗？」
PRINTFORMW 「良いですわ、どうぞ好きにめくってくださいませ♪」	PRINTFORMW 「好呀，请尽情地看个够吧♪」
PRINTFORML 「あら…良く見えなかったのかしら？」	PRINTFORML 「欸…没法好好看清楚？」
PRINTFORMW 「どうぞ、好きにご覧になって…うふふ…♪」	PRINTFORMW 「请吧，尽情地看个够…唔呵呵…♪」
PRINTFORML 「はぁい、答え合わせですわね」	PRINTFORML 「好啦——、来对个答案吧」
PRINTFORMW 「ふふ、予想は当たっていまして？」	PRINTFORMW 「呼呼、和你猜想得一样吗？」
PRINTFORML 「きゃっ！挨拶も無しにスカートめくりですの？！」	PRINTFORML 「咿呀——！招呼都不打直接掀裙子吗？！」
PRINTFORMW 「いえ、むしろこれが挨拶と見るべきなのかしら…」	PRINTFORMW 「不对，不如说这才是应该会出现的招呼吗…」
PRINTFORMW 「あぁんっ、%CNAME("二人称")%ってば本当に性欲旺盛ですわね…！」	PRINTFORMW 「啊啊——，%CNAME("二人称")%这家伙还真是性欲旺盛啊…！」
PRINTFORMW 「ふふ、すぐに相手出来るように用意してますのよ？」	PRINTFORMW 「呵呵，这可是为了随时都可以让你享用才这样准备的哦？」
PRINTFORMW 「だから好きなタイミングで誘ってくださいませ♪」	PRINTFORMW 「所以找个适合的时机来邀请我吧♪」
PRINTFORMW 「いやぁん、ノーパンなのにめくられちゃって…なのに嫌じゃなくて…♪」	PRINTFORMW 「咿呀——，我明明是真空还被掀了裙子…不过我不讨厌哦…♪」
PRINTFORMW 「%CNAME("二人称")%はこんないやらしい女はお嫌いかしら…？」	PRINTFORMW 「%CNAME("二人称")%会不会讨厌这种下流的女孩子啊…？」
PRINTFORMW 「今日のパンツは%PANTIES(TARGET)%ですのよ」	PRINTFORMW 「今天的内裤是%PANTIES(TARGET)%哦」
PRINTFORMW 「ふふ、お気に召したかしら♪」	PRINTFORMW 「哼哼，你喜欢吗♪」
PRINTFORMW 「何というか…執念を感じますわね」	PRINTFORMW 「怎么说呢…能感觉到你的执念呢」
PRINTFORMW 「目的はどうあれ、すぐに行動に移せるところは見習いたいですわ」	PRINTFORMW 「先不论目的如何，我还是很想学习一下你马上付诸行动这一点哇」
PRINTFORMW 「ひゃんっ♪　もう、いきなりめくるなんて卑怯ですわよ！」	PRINTFORMW 「咿呀——♪　真是的，突然就掀起来什么的太卑鄙了！」
PRINTFORMW 「罰として%CNAME("一人称")%のパンツを見た感想を聞かせてもらいますわ！」	PRINTFORMW 「作为惩罚，%CNAME("一人称")%想听一听你看了%CNAME("一人称")%的内裤之后的感想哇！」
PRINTFORMW 「うふ、本来の持ち主の目の前でそういうことしちゃうんですのね」	PRINTFORMW 「唔呵，居然在内裤原本的主人面前做这种事呢」
PRINTFORMW 「気に入っていただけたようで、持ち主冥利に尽きますわ♪」	PRINTFORMW 「您能喜欢的话，也是原主的荣幸呢♪」
PRINTFORMW 「あら、わざわざ%CNAME("一人称")%の目の前でそういうことしちゃうんですのね」	PRINTFORMW 「啊啦，特意在%CNAME("一人称")%我面前做这种事情吗」
PRINTFORMW 「%CNAME("一人称")%の反応が見たくてやってるのかしら…可愛いですわね♪」	PRINTFORMW 「是想观察%CNAME("一人称")%的反应吧…真可爱呢♪」
PRINTFORMW 「%CNAME("一人称")%もちょっとは恥ずかしく思いますのよ？」	PRINTFORMW 「%CNAME("一人称")%也会感觉有些不好意思哦？」
PRINTFORMW 「%CNAME("二人称")%の行動が面白いのでついつい許してしまいますけど」	PRINTFORMW 「只是%CNAME("二人称")%的行为感觉很有趣不知不觉就默许了」
PRINTFORMW 「どうかしら、今日の%CNAME("一人称")%のお・パ・ン・ツ♪」	PRINTFORMW 「感觉如何啊，%CNAME("一人称")%今天的小・内・裤♪」
PRINTFORMW 「毎日綺麗に洗っていますけど、汚れてる方がお好みなら…ご用意いたしますわ♪」	PRINTFORMW 「虽然每天我都会好好洗干净，但是如果你更喜欢脏一些的…我也可以为你准备的哦♪」
PRINTFORMW 「もう、他の方のパンツなのに%CNAME("一人称")%の前でそういうことするだなんて…」	PRINTFORMW 「真是，明明%CNAME("一人称")%在我面前还要对其他人的内裤做那种事情…」
PRINTFORMW 「まさか%CNAME("一人称")%の%TEXTR("対抗心/嫉妬心")%を煽っているおつもりですの？」	PRINTFORMW 「难道说是想把%CNAME("一人称")%%TEXTR("不服输/嫉妒")%的心情煽起来吗？」
PRINTFORMW 「あの、終わったら%CNAME("一人称")%にも少し貸してくださいませ」	PRINTFORMW 「那个，完事了的话可以稍微借给%CNAME("一人称")%一下吗」
PRINTFORMW 「どんな匂いか気になってしまって…」	PRINTFORMW 「有些在意到底是什么样的气味呢…」
PRINTFORMW 「%CNAME("二人称")%、週末は暇じゃありませんこと？」	PRINTFORMW 「%CNAME("二人称")%，周末是不是很闲啊？」
PRINTFORMW 「何なら%CNAME("一人称")%とお出かけしましょう！」	PRINTFORMW 「要不要和%CNAME("一人称")%一起出去转转呀！」
PRINTFORMW 「うふふ、誘いを受けてくださってありがとうございますわ♪」	PRINTFORMW 「哎嘿嘿，感谢你愿意接受我的邀请哇♪」
PRINTFORMW 「今から週末が楽しみですわ♪」	PRINTFORMW 「现在已经开始期待着周末的到来了哇♪」
PRINTFORMW 「あら…すでにご予定が？それは残念ですわ…」	PRINTFORMW 「啊啦…已经有预约了吗？还真是遗憾呀…」
PRINTFORMW 「それでは次の機会にでも…」	PRINTFORMW 「那如果下次有机会的话…」
PRINTFORMW 「週末にお出かけ…つまりはデートですわね？！」	PRINTFORMW 「周末出门…也就是说是约会吗？！」
PRINTFORMW 「うふふっ、良いですわよ！」	PRINTFORMW 「唔哈哈——，当然可以哟！」
PRINTFORMW 「%CNAME("二人称")%からデートのお誘い…もちろんお受けいたしますわ！」	PRINTFORMW 「%CNAME("二人称")%发出的约会邀请…当然会接受啊！」
PRINTFORMW 「どこに行って何を見ましょう？今から楽しみですわぁ♪」	PRINTFORMW 「会去哪里会做些什么呢？已经开始期待了哇♪」
PRINTFORMW 「はい…はい…デート？今から？」	PRINTFORMW 「嗯…嗯…约会？现在吗？」
PRINTFORMW 「ええ、ええ、行きますわ！どちらに向かえばよろしいでしょうか！？」	PRINTFORMW 「嗯嗯，嗯嗯，当然要去哇！应该去哪里比较好呢！？」
PRINTFORMW 「デート？今から？」	PRINTFORMW 「约会？现在吗？」
PRINTFORMW 「ええ、ええ、行きますわ！今準備いたしますので少しお待ちくださいまし！」	PRINTFORMW 「嗯嗯，嗯嗯，当然要去哇！我现在先去准备一下请稍等一会儿哦！」
PRINTFORMW 「あら、もうこんな時間ですわ」	PRINTFORMW 「啊呀，已经到这个点了啊」
PRINTFORMW 「楽しいことをしていると時間がたつのが早いですわね」	PRINTFORMW 「高兴的时候时间总是过得那么快呢」
PRINTFORMW 「日も暮れてきましたし…そろそろお開きの時間ですわね」	PRINTFORMW 「太阳已经要下山了…也差不多到了该回去的时候了呢」
PRINTFORMW 「だけど最後まで目いっぱい楽しみましょう、%CNAME("二人称")%」	PRINTFORMW 「不过到最后为止都过得很开心呢，%CNAME("二人称")%」
PRINTFORMW 「あら、ここって…もう、%CNAME("二人称")%ったら…」	PRINTFORMW 「啊啦，在这里吗…真是的，%CNAME("二人称")%的话…」
PRINTFORMW 「あんまり遅くなって%CALLNAME:FINDCHARA(NO, 1)%さんを心配させないようにしないといけませんわね、うふふっ♪」	PRINTFORMW 「如果回去太晚的话让%CALLNAME:FINDCHARA(NO, 1)%担心可不好啊，嘿嘿——♪」
PRINTFORMW 「うふふ…そうですわね、デートの締めと言えばホテルって雑誌にも書いてありますもの♪」	PRINTFORMW 「呼呼…说得也是呢，杂志上也说过，说到约会的结尾的话就应该去宾馆♪」
PRINTFORMW 「そうと決まればレッツゴー！ですわ！」	PRINTFORMW 「既然决定了的话那就Let‘s go！就是这样！」
PRINTFORMW 「あぁ～っ、今日は楽しかったですわ♪」	PRINTFORMW 「哈啊～～，今天真的很开心哇♪」
PRINTFORMW 「良かったらまた今度、デートに誘ってくださいませ」	PRINTFORMW 「不介意的话，下次也要邀请我和你约会哦」
PRINTFORMW 「(ｸﾞｩｩ…)あらやだごめんなさい、お腹が鳴ってしまいましたわ」	PRINTFORMW 「(咕呜…)哎呀讨厌，真是不好意思，肚子已经开始叫了啊」
PRINTFORMW 「今日のおゆはんが気になりますわね」	PRINTFORMW 「有些好奇今天的晚饭呢」
PRINTFORMW 「今日はここでお別れ、ですわね」	PRINTFORMW 「今天就在这里分别吧，如何呢」
PRINTFORMW 「うふふ、また学園で会いましょう…ちゅっ」	PRINTFORMW 「唔呵呵，在学校再见吧…啾——」
PRINTFORMW %CALLNAME:TARGET%は名残惜しそうに%CALLNAME:MASTER%の頬に触れるだけのキスをすると、爽やかな風と共に去っていった…。	PRINTFORMW %CALLNAME:TARGET%有些恋恋不舍地在%CALLNAME:MASTER%的脸颊上留了一个仅仅是轻轻触碰到的吻，然后便随着清爽的晚风一起离开了…。



//EVENT_K37_SHOP

PRINTFORMW 「%CNAME("一人称")%にお願いごとですの？」	PRINTFORMW 「%CNAME("一人称")%的愿望吗？」
PRINTFORMW 「生憎、悪魔のような取引は出来ませんけど、聞いて差し上げますわ」	PRINTFORMW 「那就请让我听一听吧，不过我可不会接受讨厌的或是很过分的交易的哦」
PRINTFORMW 「どんなお願いをされるのか…うふふ、わくわくしますわ♪」	PRINTFORMW 「会被提出怎样的请求呢…唔呵呵，心脏怦怦直跳呢♪」
PRINTFORMW 「えっ…そ、そう、ですの…」	PRINTFORMW 「呃っ…这，这个，样子吗…」
PRINTFORMW 「………お、お慕いしてくださっているのはとても嬉しいですわ。でも…ごめんなさい」	PRINTFORMW 「………很，很高兴您能这么爱慕我哇。但是…对不起」
PRINTFORMW 「%CNAME("一人称")%、%CNAME("二人称")%とはお友達でいた方が良いと思いますの」	PRINTFORMW 「%CNAME("一人称")%，和%CNAME("二人称")%应该还是做朋友比较好吧」
PRINTFORMW 「もう、そうやって%CNAME("一人称")%をからかうのはやめてくださいまし」	PRINTFORMW 「真是的、请不要再说这种嘲弄%CNAME("一人称")%的话了」
PRINTFORMW %CALLNAME:TARGET%は全く相手にしてくれない…。	PRINTFORMW %CALLNAME:TARGET%完全听不进你的话…。
PRINTFORM 「あげたいのは山々ですけども…	PRINTFORM 「虽然很想给你…
PRINTFORMW ごめんなさい、今%TEXTR("はいておりませんの/は手元に無いというか…")%」	PRINTFORMW 不过十分抱歉，今天%TEXTR("其实没有穿/没带在身边呢…")%」
PRINTFORMW %CALLNAME:TARGET%はいじらしく微笑みながらモジモジと股を擦りあわせている。	PRINTFORMW %CALLNAME:TARGET%露出了惹人怜爱的微笑，大腿嚓唦嚓唦的互相磨蹭着。
PRINTFORMW 「%CNAME("一人称")%ともっと一緒に居たい…そういう事ですわね」	PRINTFORMW 「想和%CNAME("一人称")%一起住…是这个意思吧」
PRINTFORMW 「その気持ちは嬉しいですわ…でも、あまり迷惑をかけるわけには…ごめんなさい」	PRINTFORMW 「很高兴你有这种想法…但是，因为这样会让我很为难所以…十分抱歉」
PRINTFORMW 「うぅん…%CNAME("一人称")%の母は心配するでしょうけどきっと分かってくださるはず」	PRINTFORMW 「嗯——…虽然%CNAME("一人称")%的母亲会很担心，不过她一定能理解我的」
PRINTFORMW 「良いですわ。同棲、いたしましょうか」	PRINTFORMW 「好哇。同居，从现在就开始吧」
PRINTFORMW 「うふふ、%CNAME("一人称")%の作ったお弁当が食べたいんですのね？」	PRINTFORMW 「唔呵呵、想尝尝%CNAME("一人称")%做的便当吗？」
PRINTFORMW 「でもごめんなさい。もう少し%CNAME("二人称")%の事を知ってからにさせてくださいまし」	PRINTFORMW 「但是不好意思。让我更加了解%CNAME("二人称")%的事情后再说吧」
PRINTFORMW 「また%CNAME("一人称")%のお弁当が食べたいんですの？」	PRINTFORMW 「又想吃%CNAME("一人称")%做的便当了吗？」
PRINTFORMW 「良いですけど…%CNAME("二人称")%も物好きですわね」	PRINTFORMW 「可以倒是可以…%CNAME("二人称")%的爱好还真是奇怪呢」
PRINTFORMW 「分かりましたわ、%CNAME("二人称")%の分も持ってきますわね」	PRINTFORMW 「我知道啦，会连%CNAME("二人称")%的份一起带过来的」
PRINTFORMW 「ええっ？！%CNAME("一人称", "どもり")%の作ったお弁当が食べたいですって！？」	PRINTFORMW 「欸欸——？！你说想吃%CNAME("一人称")%做的便当！？」
PRINTFORMW 「あうぅ…りょ、料理には自信が……いえ、作る前から弱気になるなんて%CNAME("一人称")%らしくありませんわね」	PRINTFORMW 「啊呜…我，我对自己的料理料理水平……不对，在行动之前就如此唯唯诺诺的话就不像%CNAME("一人称")%了呢」
PRINTFORMW 「分かりましたわ！作りましょう、お弁当！　…味の保証は致しませんけど」	PRINTFORMW 「我知道了哇！那就给你做吧，便当！　…虽然不敢保证味道就是了」
PRINTFORMW 「うふふ、%CNAME("一人称")%の作ったお弁当が食べたいんですのね？」	PRINTFORMW 「唔呵呵，想吃%CNAME("一人称")%做的便当吗？」
PRINTFORMW 「良いですわ、早速明日から%CNAME("二人称")%の分も作ってもら…作ってきますわ♪」	PRINTFORMW 「可以哇、明天就会把%CNAME("二人称")%的那份叫人做…亲自做好哇♪」
PRINTFORMW 「お買い物に付き合ってほしいんですの？」	PRINTFORMW 「想和我一起去买东西吗？」
PRINTFORMW 「良いですわ。エスコート、お願いしますわね♪」	PRINTFORMW 「可以啊。那就拜托你陪着我了哦♪」
PRINTFORMW 「あら、お買い物に行きますの？」	PRINTFORMW 「啊啦，你要去买东西吗？」
PRINTFORMW 「ついでにミネラルウォーター、それにこの雑誌の今月号もお願いしますわ」	PRINTFORMW 「那就请顺便帮我带瓶矿泉水，还有本月号的这种杂志」
PRINTFORMW 「気を付けて行ってらっしゃいませ」	PRINTFORMW 「路上请小心哦」
PRINTFORML 「んっ…アソコがムズムズしてきますわ…」	PRINTFORML 「嗯——…感觉那个地方痒痒的啊…」
PRINTFORMW %CALLNAME:TARGET%は落ち着かない様子でもじもじしている。	PRINTFORMW %CALLNAME:TARGET%一副忸忸怩怩焦躁不安的样子。
PRINTFORML 「%TEXTR("………/ふぅん…これ、ちょっと面白いですわね")%」	PRINTFORML 「%TEXTR("………/呼嗯…这个，还挺有意思的呢")%」
PRINTFORMW %CALLNAME:TARGET%は興味深そうに商品を物色している。	PRINTFORMW %CALLNAME:TARGET%兴致勃勃地物色着商品。