//EVENT_K40_綾乃.ERB

STR:1 = 愛らしい容姿と、穏やかかつ物静かな性格から人気の高い三年生。	STR:1 = 因为可愛的外表与文静的性格而颇具人気的三年生
STR:2 = 高い資質を具える淫魔であり、ある人間の夫妻に拾われて育った	STR:2 = 其实有有很高資質的淫魔、被某对人类夫妻捡到养育大的
STR:3 = 園芸部に所属しており、普段は花から精気を吸って空腹をしのいでいるのだが、どうしても我慢のできないときは、たびたび男子から死なない程度に精を搾っている。	STR:3 = 所属于園芸部、平常一直从花中吸取精気来对抗饥渴、但如果忍耐到无法抗拒的时候、就会把男子搾到仅仅是死不了的程度
PRINTFORMW その愛らしい容姿と物静かな性格で男女問わずに人気の高い三年生。	PRINTFORMW 其可愛的外表与文静的性格无论在男女之問都有着很高人気的三年生。
STR:4 = 特に近頃は以前にも増して色っぽくなったと評判で、彼女と話した後にトイレに駆け込んでいく男子学生すらいるらしい。	PRINTFORMW 特别是受到後輩们的广泛支持、据说还有一部分人成立了粉丝俱乐部。
PRINTFORMW しかしその一方で後ろ暗い噂もちらほらと耳にする。	PRINTFORMW 但另一方面、也时不时听到一些阴暗的传闻。
PRINTFORMW 曰く、淫魔。大人しい顔してとんでもないビッチ。	PRINTFORMW 其曰、淫魔。文静的面孔下其实是一个不得了的碧池。
PRINTFORMW 夜な夜な学園を練り歩いては、目に付いた男子に襲い掛かっているのだとか。	PRINTFORMW 夜夜在学園里游荡、襲击盯上的男子之类的。
PRINTFORML 無論、普通はただの噂か性質の悪い冗談として一笑に付すようなものではあるのだが	PRINTFORML 当然、一般来说这就只是单纯的性质比较恶劣的传闻和玩笑而已、所以笑一笑就带过去了
PRINTFORMW 幸か不幸か、%CALLNAME:MASTER%はそれがまぎれもない事実であることを知ってしまっている。	PRINTFORMW 不知是幸运还是不幸、%CALLNAME:MASTER%却已得知这是千真万确的事实。
PRINTFORMW 何を恥じることもないごくごく普通の一般家庭に拾われて育った高位淫魔。	PRINTFORMW 是被普通的一般家庭捡来养大的、当之无愧的高位淫魔。
PRINTFORMW それが彼女の正体であった。	PRINTFORMW 这就是她的真面目。
PRINTFORMW 旧校舎の３０２教室。	PRINTFORMW 旧校舎的３０２教室。
PRINTFORMW この学園にいくつか存在する、所謂ヤリ部屋のひとつ。	PRINTFORMW 这个是学園里一直存在着的、所謂的做爱房的其中一个。
PRINTFORMW …だったのだが、ここはもはやその用途で使われなくなって久しい。	PRINTFORMW …话虽如此、这里已经很久没有以这个用途使用过了。
PRINTFORMW なぜなら――	PRINTFORMW 如果问为什么的话――
CALL PRINT_STR, @"「あ、君が例の人かな…？_BH_」_W"	CALL PRINT_STR, @"「啊、你就是说好的那个人吗…？_BH_」_W"
PRINTFORMW ――今はヤリ部屋ではなく、彼女の『狩り場』となっているからである。	PRINTFORMW ――现在已经不再是做爱房、仅仅只是她的『狩猎場』而已。
PRINTFORMW 「ごめんね、今ちょっと『お手伝い』してもらってて…すぐ済ませちゃうから」	PRINTFORMW 「对不起呢、现在不巧正给别人『帮把手』…马上就会结束的~」
PRINTFORMW 振り返り、無垢な顔で笑いながらこちらへ向けて片手を振る彼女。	PRINTFORMW 她回过头来、用纯洁无垢的表情向你摆了摆手。
PRINTFORMW 傍らには目隠しをされて椅子に座る男子生徒がおり、その股座では彼女の右手が激しく動いている。	PRINTFORMW 在她旁边正有一个被蒙着眼睛坐在椅子上的男学生、她的右手正在他的股间激烈地動作着。
PRINTFORMW 肝心な部分こそ陰になっていて見えないものの、椅子の下の白濁溜りや、部屋に充満する熱気からして	PRINTFORMW 虽然看不到关键的部分、不过从椅子下面的白濁、和房间里充満的熱気来看
PRINTFORMW 彼女が狩りの真っ最中であることは火を見るよりも明らかだった。	PRINTFORMW 很明显，她正在狩猎中。
PRINTFORMW 『あ、綾乃先輩っ、誰か来て…っ！？』	PRINTFORMW 『啊、綾乃前輩、有誰来了吗…呜！？』
PRINTFORMW 「ん、ごめんね…えーと…佐々岡君、だっけ…？」	PRINTFORMW 「嗯、对不起呢…那个…佐佐岡君、是叫这个名字的吧…？」
PRINTFORMW 男子生徒の耳元へ、覆いかぶさるように唇を近づける。	PRINTFORMW 在男学生的耳边、就像是要把嘴唇贴上去一样。
PRINTFORMW 「ほんとはじっくり相手してあげる予定だったんだけど…」	PRINTFORMW 「本来的话是打算好~好地陪一陪你的…」
PRINTFORMW 耳を舐り、余していた左手を『そこ』へ。	PRINTFORMW 舔了一下耳朵、把左手伸向了『那里』。
CALL PRINT_STR, @"「大切なお客さんが来ちゃったから…_BH_」_W"	CALL PRINT_STR, @"「因为来了一个很重要的客人…_BH_」_W"
PRINTFORMW 彼女がそっと恋人に囁くような声で言うと。	PRINTFORMW 她用像是恋人一样的嗫嚅的语调说道。
CALL PRINT_STR, @"「だから…_BH_」_W"	CALL PRINT_STR, @"「所以…_BH_」_W"
PRINTFORMW 静かな教室に、ぐちゃぐちゃぐちゃ、と音が響いた。	PRINTFORMW 安静的教室里、只剩下咕啾咕啾的声音、不断地回响着。
CALL PRINT_STR, @"「とりあえず、おやすみなさい、ね…？_BH_」_W"	CALL PRINT_STR, @"「总而言之、晚安、呐…？_BH_」_W"
PRINTFORMW 「…待たせてごめんね？ …えーと、上履きの色からして、後輩の子だよね」	PRINTFORMW 「…让你久等了不好意思 …那个、从上衣的颜色来看、应该是後輩吧？」
PRINTFORMW 先ほどまでの光景が嘘のように、ただの少女然としてはにかむ%CALLNAME:ARG%。	PRINTFORMW 刚才的光景就像是假的一样、这里的只有一个普通的羞涩少女%CALLNAME:ARG%。
PRINTFORMW しかしその手を汚す行為の名残がすっと薄まり消えていくのを、%CALLNAME:MASTER%はしっかりと確認していた。	PRINTFORMW 然而那双手上弄脏了的痕迹正在一点一点的消失、%CALLNAME:MASTER%好好地確認了这一点。
PRINTFORMW 「その、今見てもらった通りなんだ…」	PRINTFORMW 「那个、就像你现在看到的一样…」
PRINTFORMW 「いつもはお花の精気を吸ってれば、最低限は正気を保っていられるんだけど…」	PRINTFORMW 「平常的话只要吸取花的精気、最少能够保证最低限度的正常…」
PRINTFORMW 「激しい運動をしたり、男の子からの強い視線を感じたり、あるいは…こう…女の子の『周期』によっては、自分を抑えられなくなっちゃうことがあるの」	PRINTFORMW 「但是如果做了激烈的運動、或者感受到了男生強烈的視線、还有就是…像现在这样…因为女孩子的『周期』、就会变得有些无法控制住自己」
PRINTFORMW 「一度スイッチ入っちゃうと、もう、えっちのことしか考えられなくなって…」	PRINTFORMW 「只要打开了开关的话、就、脑袋里只会想着H的事情了…」
PRINTFORMW 「そのたびに男の子を襲って…でも、私の身体は普通じゃないから、同じ人を何度も相手には出来なくて…」	PRINTFORMW 「那个时候就会去襲击男生…但是、因为我不是普通的人类、所以同一个人就只能用一次…」
PRINTFORMW 「記憶ごと飛ばすくらいに責めちゃうから、秘密保持的な問題は概ね勝手に解決してるんだけど」	PRINTFORMW 「现在的话是用激烈地欺负到失去記憶的等级、姑且解决了保守秘密的問題」
PRINTFORMW 「そういうわけだから、その、気持ちよくなるためだけなら、この話はここで終わらせたほうがいいと思う…」	PRINTFORMW 「大概就是这么一回事了、那个、为了双方的心情着想、话就先聊到这里…」
PRINTFORMW %CALLNAME:MASTER%は判明した自らの体質と所属する部活、その内容を彼女に伝えた。	PRINTFORMW %CALLNAME:MASTER%挑明了自己的体質和正在进行的社团活动、把内容全部告诉了她。
PRINTFORMW 「…ふーん？」	PRINTFORMW 「…嗯？」
PRINTFORMW 「なるほど…それであの娘が紹介してきたんだね…」	PRINTFORMW 「原来如此…所以那孩子才会向我紹介你啊…」
PRINTFORMW 「確かに、そういうことなら学園中を駆け回って、男の子をいちいち見繕う必要もなくなるのかも…」	PRINTFORMW 「的確、如果是这样的话就没必要在学校里游荡狩猎、也不需要平常对男生多加防范了…」
PRINTFORMW 「うん、わかった」	PRINTFORMW 「嗯、我明白了」
PRINTFORMW にっこりと笑う彼女。	PRINTFORMW 她微微一笑。
PRINTFORMW 「…でも、ちょっと気になることがあるんだけど」	PRINTFORMW 「…不过、有一件有点在意的事情」
PRINTFORMW 邪気のない顔。	PRINTFORMW 天真无邪的表情。
CALL PRINT_STR, @"「その部活って…要するに、%CNAMET(ARG, "二人称")%が色んな女の子とえっちするためのもの、ってことだよね…_BH_」_W"	CALL PRINT_STR, @"「刚才提到的这个社团活动…简单的说、就是%CNAMET(ARG, "二人称")%和各种各样的女孩子做色色的事情、这么一回事吧…_BH_」_W"
PRINTFORMW 己の胸の感触を%CALLNAME:MASTER%に伝えるように、一歩を踏み出し、上目遣いにこちらを見やる。	PRINTFORMW 向前踏了一步、把自己胸部的触感好好地展示给了%CALLNAME:MASTER%、向上看着你。
PRINTFORMW むせ返るような性臭の中でも、彼女の甘いにおいがわかった。	PRINTFORMW 在熏人的性臭中、能够清晰地闻出她的甘甜。
CALL PRINT_STR, @"「そして、その部活に%CNAMET(ARG, "一人称")%が入部する以上…_BH_」_W"	CALL PRINT_STR, @"「那么、既然%CNAMET(ARG, "一人称")%要加入这个社团…_BH_」_W"
PRINTFORMW 彼女の手が%CALLNAME:MASTER%のもとへ伸び、そして。	PRINTFORMW 她的手伸向了%CALLNAME:MASTER%的下半身、然后。
CALL PRINT_STR, @"「%CNAMET(ARG, "一人称")%の実力を、確かめておかなくちゃならないんじゃないかな…？_BH_」_W"	CALL PRINT_STR, @"「%CNAMET(ARG, "一人称")%的実力、不先好好地用这里確认一下吗…？_BH_」_W"
PRINTFORML 先ほどよりも三割り増しで輝くその笑顔に、%CALLNAME:MASTER%はただ頷くことしかできなかった。	PRINTFORML 看到比刚才还要艳丽三分的笑容、%CALLNAME:MASTER%除了点头之外一句话都说不出来。
PRINTFORMW 「えっと、ごめんね…？」	PRINTFORMW 「那个、对不起…？」
PRINTFORMW 「%CNAMET(ARG, "一人称")%、えっちなことになると見境がなくなっちゃって…」	PRINTFORMW 「%CNAMET(ARG, "一人称")%、一变得H起来的话就脑子里只有色色的事了…」
PRINTFORMW 「その、%CNAMET(ARG, "二人称")%も無理して付き合わなくていいから…」	PRINTFORMW 「那个、不会强迫%CNAMET(ARG, "二人称")%一直来陪%CNAMET(ARG, "一人称")%的…」
PRINTFORMW 「ただ、たまに暇なとき、%CNAMET(ARG, "一人称")%の相手してくれたら嬉しいな…」	PRINTFORMW 「只要在偶尔有空闲的时候、过来找%CNAMET(ARG, "一人称")%作为那个的对象、%CNAMET(ARG, "一人称")%就已经很开心了…」
PRINTFORML 比較的小さな日向の一室で、窓辺には手のひらほどのサボテンが飾られている。	PRINTFORML 一个比較小的向阳房间、窗辺装飾着手掌大小的仙人掌。
PRINTFORML 机の上には作りかけのボトルシップやオルゴールなどが置かれているが、どれも完成間近で放置されているようだ。	PRINTFORML 桌子上摆着还没做完的瓶中船和八音盒之类的一些东西、每个都是快要完成了却放在那里不动了。


PRINTFORMW 「ご、ごめんね…？ えっと、えっち、だよね…？」	PRINTFORMW 「对、对不起…？ 那个、要H、是吧…？」
CALL PRINT_STR, @"「あ、ううん、大丈夫…_BH_」_W"	CALL PRINT_STR, @"「啊、唔呣、没关系的…_BH_」_W"
CALL PRINT_STR, @"「ただちょっと、%CNAME("二人称")%に見惚れてただけ、だから…_BH_」_W"	CALL PRINT_STR, @"「只是、稍微有那么一瞬间爱上%CNAME("二人称")%了呢…_BH_」_W"
PRINTFORMW 「ふふ…いっぱいだしたね…」	PRINTFORMW 「呋呋…真够多的…」
CALL PRINT_STR, @"「とっても素敵だったよ…_BH_ 濃くて…_BH_ おいしくて…_BH_」_W"	CALL PRINT_STR, @"「好棒…_BH_ 浓浓的…_BH_ 好好吃…_BH_」_W"
CALL PRINT_STR, @"「……_BH_ 思い出したら、またシたくなってきちゃった…_BH_」_W"	CALL PRINT_STR, @"「……_BH_ 一想起来、又要忍不住了_BH_」_W"
PRINTFORMW 「でも、今日はこれでおしまい、ね」	PRINTFORMW 「不过、今天就到此为止吧 呐」
CALL PRINT_STR, @"「今度は、もっと溜めてきてくれたら、うれしいな…_BH_」_W"	CALL PRINT_STR, @"「下次要是能再多攒一点的话、我会很高兴的…_BH_」_W"
PRINTFORMW 「ん…きんたまの中身、からっぽになったかな…？」	PRINTFORMW 「欸…蛋蛋里面、都空了吗…？」
PRINTFORMW 「…%CNAME("一人称")%の身体で、気持ちよくなってくれて、うれしいな」	PRINTFORMW 「…%CNAME("一人称")%的身子、变得好舒服、好开心」
PRINTFORMW 「余韻のしこしこしてあげるから、今はゆっくり休んでね…」	PRINTFORMW 「会给你留余地的，所以现在好好休息吧…」
PRINTFORMW 「ザーメン引っこ抜くお手伝い、ちゃんとできてた？」	PRINTFORMW 「榨精作业已完成、您还满意吗？」
PRINTFORMW 「使い心地はどうだったかな…」	PRINTFORMW 「使用的感觉如何呢…」
CALL PRINT_STR, @"「もしよかったら、また使いに来てくれたら、うれしいな…_BH_」_W"	CALL PRINT_STR, @"「如果可以、再次使用的话、我会很高兴的…_BH_」_W"
PRINTFORMW 「ん…おちんぽマーキング、もう限界…？」	PRINTFORMW 「欸…小鸡鸡已经、不行了吗…？」
PRINTFORMW 「ふふ…♪ こんなにたっぷり…」	PRINTFORMW 「呋呋…♪ 不过也有很多了…」
CALL PRINT_STR, @"「ありがと、またしようね…_BH_」_W"	CALL PRINT_STR, @"「谢谢、下次继续吧…_BH_」_W"
PRINTFORMW 「ん、もうおしまい…？」	PRINTFORMW 「欸、已经结束了吗…？」
PRINTFORMW 「それじゃあ、おせーし溜まってむらむらしたら、また呼んでね」	PRINTFORMW 「那好吧、等下次精液囤起来了、再叫我吧」
CALL PRINT_STR, @"「はー…っ_BH_ はー…っ_BH_」_W"	CALL PRINT_STR, @"「啊…っ_BH_ 唔啊…っ_BH_」_W"
PRINTFORMW 「ご、ごめんね…%CNAME("一人称")%、ちょっと疲れちゃって…」	PRINTFORMW 「抱、抱歉…%CNAME("一人称")%、有点累了…」
PRINTFORMW 「これ以上%CNAME("一人称")%の身体使っても、あんまり気持ちよくなれないと思うから…」	PRINTFORMW 「就算再用%CNAME("一人称")%的身体、也不会太舒服吧…」
PRINTFORMW 「もし、まだきんたま軽くしたかったら、他の娘にしてもらってね…？」	PRINTFORMW 「如果、还想再释放存货的话、就去找其他姑娘吧…？」
CALL PRINT_STR, @"「満足できてなかったら、このまま気絶したあとも犯してくれていいからね…_BH_」_W"	CALL PRINT_STR, @"「如果实在不满足的话、晕过去之后、你也可以接着侵犯我…_BH_」_W"
PRINTFORMW 「ん、おつかれさま…」	PRINTFORMW 「嗯，辛苦了……」
CALL PRINT_STR, @"「とってもすてきなえっちだったよ…_BH_」_W"	CALL PRINT_STR, @"「真是次非常棒的H…_BH_」_W"
CALL PRINT_STR, @"「…もうしばらく、こうしていたいなぁ…_BH_」_W"	CALL PRINT_STR, @"「…好想、再这样来一次啊…_BH_」_W"
PRINTFORMW 「ん…おつかれさま」	PRINTFORMW 「嗯，辛苦了……」
CALL PRINT_STR, @"「…お掃除するね_BH_ ん、ちゅ_BH_ んむ…_BH_」_W"	CALL PRINT_STR, @"「…要我帮你清理一下吗 啊、这样吗_BH_ 那让我来…_BH_」_W"
CALL PRINT_STR, @"「ぷぁ_BH_ はい、綺麗になったよ_BH_」_W"	CALL PRINT_STR, @"「咕唔、呣_BH_ 好了、变干净了」_W"
PRINTFORMW 「ちょっとむずむずが残っちゃったかもだけど…」	PRINTFORMW 「好像还有点痒痒的…」
CALL PRINT_STR, @"「そっちの方は、またあとで、ね…_BH_」_W"	CALL PRINT_STR, @"「那边的话、就再等一下、吧…_BH_」_W"
PRINTFORMW 「はい、おしまいね」	PRINTFORMW 「好、结束」
PRINTFORMW 「…最近はね、こういうのも、焦らされてるみたいでいいなって」	PRINTFORMW 「…最近、这种事情开始变得上瘾了」
CALL PRINT_STR, @"「そう思えるようになってきたの…_BH_」_W"	CALL PRINT_STR, @"「我是这样想的…_BH_」_W"
CALL PRINT_STR, @"「…次、期待してるから、ね_BH_」_W"	CALL PRINT_STR, @"「…下次、我也很期待呢、呐_BH_」_W"
PRINTFORMW 「もっと欲しいなぁ…」	PRINTFORMW 「还想要更多啊…」
PRINTFORMW 「…だめ？」	PRINTFORMW 「…不行了？」
PRINTFORMW 「あれ…これくらいで、もう満足？」	PRINTFORMW 「啊嘞…这样就满足了吗？」
PRINTFORMW 「…もしかして、あんまり良くなかった…？」	PRINTFORMW 「…也许、不太够呢…？」
PRINTFORMW 「…そう？ でも、抜き足りなければまたすぐ来てくれてもいいからね？」	PRINTFORMW 「…是吗？ 如果榨得不够的话、马上再来也可以吧？」
PRINTFORMW 「もうおしまい…？」	PRINTFORMW 「已经结束了…？」
PRINTFORMW 「…あっ、もしかして予定詰まってたりした？」	PRINTFORMW 「…啊、接下来还有别的事？」
PRINTFORMW 「ごめんね、えっちするといつも夢中になっちゃって…」	PRINTFORMW 「对不起、每次都做的太过火了…」
PRINTFORMW 「次はもっと、ゆっくりできるときにしようね」	PRINTFORMW 「下次、有更多时间的时候再一起做吧」
PRINTFORMW 「ん…おつかれさま」	PRINTFORMW 「嗯…幸苦了」
CALL PRINT_STR, @"「ぷぁ_BH_ はい、綺麗になったよ_BH_」_W"	CALL PRINT_STR, @"「咕唔、呣_BH_ 好了、变干净了_BH_」_W"
CALL PRINT_STR, @"「そっちの方は、またあとで、ね…_BH_」_W"	CALL PRINT_STR, @"「那边，等会儿再说吧……_BH_」_W"
CALL PRINT_STR, @"「男の子だもん、やっぱり気になるよね…_BH_」_W	CALL PRINT_STR, @"「毕竟是男孩子、还是会好奇呢…_BH_」_W
PRINTFORMW 「目の前のメスのまんこが、いったいどんな感触で%CNAME("二人称")%のちんぽを楽しませてくれるのか…」	PRINTFORMW 「眼前的小穴、到底是怎样的触感才让%CNAME("二人称")%的小鸡鸡那么快乐呢…」
CALL PRINT_STR, @"「その指で、じっくり確かめて…？_BH_」_W	CALL PRINT_STR, @"「用你的手指、好好确认一下吧…？_BH_」_W
CALL PRINT_STR, @"「ん…_BH_ あぅ_BH_ んふ…っ_BH_」_W	CALL PRINT_STR, @"「嗯…_BH_ 啊嗯_BH_ 唔呋…っ_BH_」_W
CALL PRINT_STR, @"「%CNAME("二人称")%、%CNAME("一人称")%のおまんこの感触、どうかな…_BH_」_W	CALL PRINT_STR, @"「%CNAME("二人称")%、%CNAME("一人称")%小穴的触感、怎么样…_BH_」_W
CALL PRINT_STR, @"「随分夢中になってるみたいだけど…_BH_ そんなにお気に召した…？_BH_」_W	CALL PRINT_STR, @"「好像很着迷的样子呢…_BH_ 这么喜欢她吗…？_BH_」_W
CALL PRINT_STR, @"「だったら…_BH_ だったら、ね…？_BH_」_W	CALL PRINT_STR, @"「然后…_BH_ 然后是不是该……呐…？_BH_」_W
CALL PRINT_STR, @"「あっ_BH_ あっ_BH_ あっ_BH__」_W	CALL PRINT_STR, @"「呜啊_BH_ 啊_BH_ 哈啊_BH__」_W
CALL PRINT_STR, @"「%CNAME("二人称")%の指、美味しい…_BH_ イイとこ、掻き分けてくる…っ_BH_」_W	CALL PRINT_STR, @"「%CNAME("二人称")%的指头、好吃…_BH_ 就是那里、把她拨开…っ_BH_」_W
CALL PRINT_STR, @"「もっと、もっと、欲しい、なぁ…_BH_」_W	CALL PRINT_STR, @"「再来、想要、还想要、呐…_BH_」_W
CALL PRINT_STR, @"「もっと、太いの…_BH_ 欲しいなぁ…_BH_」_W	CALL PRINT_STR, @"「想要更多、再深一点…_BH_ 好想要…_BH_」_W
CALL PRINT_STR, @"「あぁっ_BH_ 好き…っ_BH_ うぅぁ_BH_ そこ、イイ_BH_ うぅ…好きだよぉ…_BH_」_W	CALL PRINT_STR, @"「啊啊_BH_ 好酥服…っ_BH_ 呜_BH_ 那里、舒服_BH_ 呜…好喜欢…_BH_」_W
CALL PRINT_STR, @"「%CNAME("二人称")%、そのまま…_BH_ 今度はおちんぽで、ソコ突いて欲しいかも…_BH_」_W	CALL PRINT_STR, @"「%CNAME("二人称")%、就这样…_BH_ 把鸡鸡、插进来吧、好想要…_BH_」_W
CALL PRINT_STR, @"「バイブも…気持ち、いいけどっ_BH_ %CNAME("二人称")%のが、欲しいなぁ_BH_」_W	CALL PRINT_STR, @"「震动棒…虽然很舒服、但是_BH_ %CNAME("二人称")%的那里、更想要_BH_」_W
CALL PRINT_STR, @"「こんなおもちゃじゃなくて…_BH_ %CNAME("二人称")%のからだ、感じたいよぉ…っ_BH_」_W	CALL PRINT_STR, @"「不要这样的玩具…_BH_ %CNAME("二人称")%的身体、想好好品尝一下…っ_BH_」_W
PRINTFORMW 「ねえ、%CNAME("二人称")%…？」	PRINTFORMW 「呐、%CNAME("二人称")%…？」
CALL PRINT_STR, @"「バイブ、抜いて欲しいなぁ…_BH_ こんなのじゃなくて、%CNAME("二人称")%のを感じたいなぁ…_BH_」_W	CALL PRINT_STR, @"「震动棒、拔出来好嘛…_BH_ 不要这个、我好好想品尝一下%CNAME("二人称")%呐…_BH_」_W
CALL PRINT_STR, @"「んっん_BH_ もぉ…_BH_ スイッチ弄っちゃ、だめだよ…_BH_」_W	CALL PRINT_STR, @"「嗯~嗯嗯_BH_ 真是的…_BH_ 这样开开关关的、不要啊…_BH_」_W
CALL PRINT_STR, @"「ねえ、%CNAME("二人称")%も%CNAME("一人称")%のおまんこ、好きでしょう…？_BH_」_W	CALL PRINT_STR, @"「呐、%CNAME("一人称")%的小穴、%CNAME("二人称")%喜欢吧…？_BH_」_W
CALL PRINT_STR, @"「%CNAME("二人称")%の大好きなところ…_BH_ こんなおもちゃなんかに楽しませていいの…？_BH_」_W	CALL PRINT_STR, @"「%CNAME("二人称")%最喜欢的地方…_BH_ 一直让个玩具享受着、真的可以吗…？_BH_」_W
PRINTFORMW %CALLNAME:MASTER%が%CALLNAME:TARGET%の股間に手のひらを当てると、すぐに%CALLNAME:TARGET%の身体が熱を帯び、むわっとした熱気を放ち始めた。	PRINTFORMW %CALLNAME:MASTER%仅仅是将手放在%CALLNAME:TARGET%的股间、很快就让%CALLNAME:TARGET%身体发热、开始散出淫靡的香气。
CALL PRINT_STR, @"「う…_BH_ 恥ずかしい…_BH_」_W	CALL PRINT_STR, @"「呜…_BH_ 羞死了…_BH_」_W
CALL PRINT_STR, @"「%CNAME("一人称")%のおまんこ、すっかりほかほかに蕩けてほぐれちゃってるの、バレちゃう…_BH_」_W	CALL PRINT_STR, @"「%CNAME("一人称")%的小穴、在你面前真的是过于诚实了、呜啊啊啊…_BH_」_W
PRINTFORMW 「もう…%CNAME("二人称")%ったら、やんちゃさん」	PRINTFORMW 「真是的…%CNAME("二人称")%啊、太欺负人了」
PRINTFORMW 「そんなに%CNAME("二人称")%のおまんこ、おもちゃにしたいの…？」	PRINTFORMW 「就那么想把%CNAME("二人称")%的小穴做成玩具吗…？」
CALL PRINT_STR, @"「…いいよ_BH_」_W	CALL PRINT_STR, @"「…可·以·哦_BH_」_W
CALL PRINT_STR, @"「ひっ…_BH_」_W	CALL PRINT_STR, @"「咿っ…_BH_」_W
CALL PRINT_STR, @"「これ、好き…_BH_」_W	CALL PRINT_STR, @"「这样、喜欢…_BH_」_W
CALL PRINT_STR, @"「ツガイの…オスの『モノ』にされてるみたいで、好きなの…_BH_」_W	CALL PRINT_STR, @"「就好像…好像被当成了雄性的【物品】一样、好喜欢…_BH_」_W
PRINTFORMW %CALLNAME:MASTER%は%CALLNAME:TARGET%のアソコをそっと割り開き、その間に指を滑らせた…	PRINTFORMW %CALLNAME:MASTER%轻轻拨开%CALLNAME:TARGET%的小穴、手指在其中划了一下…
PRINTFORMW 甘えるように媚肉が絡みつき、きゅうきゅうと吸い付く様は、まるで主人に尾を振る子犬のようだ。	PRINTFORMW 媚肉就撒娇似的缠过来、咕啾一下吸住了手指、像对主人摇尾巴的小狗一样。
PRINTFORMW %CALLNAME:TARGET%はすっかり顔を赤くして、%CALLNAME:MASTER%の指にじっと耐えている…	PRINTFORMW %CALLNAME:TARGET%脸颊红得滴血、默默忍受着%CALLNAME:MASTER%的手指…
PRINTFORMW 「%CNAME("一人称")%の肉厚まんこ、たっぷり味わってね…」	PRINTFORMW 「%CNAME("一人称")%的厚肉穴、要好好品味一下吧…」
PRINTFORMW 「ほら、%CNAME("二人称")%の専用まんこだよ…」	PRINTFORMW 「你瞧、这是%CNAME("二人称")%专用的小穴哦…」
PRINTFORMW 「そんなに遠くじゃ分からないでしょ…？」	PRINTFORMW 「在那么远的地方看不清楚吧…？」
PRINTFORMW 「もっと近くで、ほら…」	PRINTFORMW 「靠近点、来嘛…_BH_」
CALL PRINT_STR, @"「……_BH_」_W	CALL PRINT_STR, @"「……_BH_」_W
CALL PRINT_STR, @"「お願い聞いてくれてありがと、%CNAME("二人称")%…_BH_」_W	CALL PRINT_STR, @"「谢谢%CNAME("二人称")%愿意听我的话…_BH_」_W
CALL PRINT_STR, @"「いっぱいお礼、してあげるからね…_BH_」_W	CALL PRINT_STR, @"「万分感谢、会给你做的…_BH_」_W
CALL PRINT_STR, @"「ふふ…言うと思った_BH_」_W	CALL PRINT_STR, @"「呋呋…就知道你想这么干_BH_」_W
CALL PRINT_STR, @"「%CNAME("二人称")%、%CNAME("一人称")%のおっぱいずーっと見てたもんね」_W	CALL PRINT_STR, @"「%CNAME("二人称")%啊、可是一直盯着%CNAME("一人称")%的胸部看呢」_W
CALL PRINT_STR, @"「ううん、いいんだよ…_BH_」_W	CALL PRINT_STR, @"「唔呣、没关系的…_BH_」_W
CALL PRINT_STR, @"「こんなにおっきなおっぱいぶら下げてたら、気になっちゃうもんね_BH_」_W	CALL PRINT_STR, @"「毕竟这吊着一对那么大的东西、会很在意也很正常不是吗_BH_」_W
CALL PRINT_STR, @"「%CNAME("二人称")%は悪くないよ…_BH_ 悪いのは%CNAME("一人称")%のおっぱいだもん…_BH_」_W	CALL PRINT_STR, @"「%CNAME("二人称")%没有错哦…_BH_ 错的是%CNAME("一人称")%这过大的欧派嘛…_BH_」_W
CALL PRINT_STR, @"「だから…_BH_」_W	CALL PRINT_STR, @"「所以说…_BH_」_W
CALL PRINT_STR, @"「背徳的なお乳の感触、たっぷり味わいながら…_BH_」_W	CALL PRINT_STR, @"「如此背德的乳房、不想来品尝一下她们的触感吗…_BH_」_W
CALL PRINT_STR, @"「わるーいおっぱい…_BH_ こらしめちゃおうね…_BH_」_W	CALL PRINT_STR, @"「来好好惩罚一下吧…_BH_ 这下流的欧派吧…_BH_」_W
PRINTFORMW %CALLNAME:TARGET%はおもむろに自らの胸元へ手を運ぶと、その深い谷間に指を差込み、むっちりと開いて見せた…	PRINTFORMW %CALLNAME:TARGET%慢慢把手伸进自己的硕乳之中，手指深深插进里乳沟里，又一下子张开…
PRINTFORMW %CALLNAME:TARGET%の谷間は汗で僅かに湿り気を帯び、男を誘うフェロモンを放って%CALLNAME:MASTER%を誘惑している…	PRINTFORMW %CALLNAME:TARGET%的双峰被汗水微微润湿、散发出吸引男人的淫靡香气、诱惑着%CALLNAME:MASTER%…
CALL PRINT_STR, @"「吐息、荒いね…_BH_」_W	CALL PRINT_STR, @"「吐息、乱了呢…_BH_」_W
CALL PRINT_STR, @"「目つきもギラギラ…オスの眼差し…_BH_」_W	CALL PRINT_STR, @"「眼神也变锐利了…是雄性的眼神呢…_BH_」_W
CALL PRINT_STR, @"「いいよ…_BH_」_W	CALL PRINT_STR, @"「可以呦…_BH_」_W
CALL PRINT_STR, @"「%CNAME("一人称")%のおっぱいに、たくさん種付け、して…？_BH_」_W	CALL PRINT_STR, @"「在%CNAME("一人称")%的欧派里、射个爽、如何…？_BH_」_W
CALL PRINT_STR, @"「もう、我慢できない…？_BH_」_W	CALL PRINT_STR, @"「真是的、还在忍耐吗…？_BH_」_W
PRINTFORMW 「ね…」	PRINTFORMW 「呐…」
CALL PRINT_STR, @"「舐めて欲しいな…_BH_」_W"	CALL PRINT_STR, @"「不来舔一下吗…_BH_」_W"
CALL PRINT_STR, @"「これはサービスだよ…_BH_」_W"	CALL PRINT_STR, @"「这是杀必死哦…_BH_」_W"
CALL PRINT_STR, @"「淫魔のえっちな濃厚フェロモン…_BH_ たっぷり吸って気持ちよくなってね…_BH_」_W"	CALL PRINT_STR, @"「淫魔的浓厚荷尔蒙…_BH_ 吸几口就会变得很舒服的…_BH_」_W"
PRINTFORMW 「あ…舐めてくれるの…？」	PRINTFORMW 「啊…要舔我吗…？」
CALL PRINT_STR, @"「そっか…ふふ、嬉しい…_BH_」_W"	CALL PRINT_STR, @"「我明白了…呋呋、好高兴…_BH_」_W"
PRINTFORMW 「ん、いーよ…」	PRINTFORMW 「嗯、可以呦…」
CALL PRINT_STR, @"「%CNAME("二人称")%の大好きな…%CNAME("一人称")%のえっちなあそこ…_BH_」_W"	CALL PRINT_STR, @"「%CNAME("二人称")%最喜欢的…%CNAME("一人称")%的那里…_BH_」_W"
CALL PRINT_STR, @"「好きなだけ舐めて、しゃぶって…_BH_」_W"	CALL PRINT_STR, @"「你想怎么舔、怎么吸都可以哦…_BH_」_W"
CALL PRINT_STR, @"「気の済むまで、いじめてほしいな…_BH_」_W"	CALL PRINT_STR, @"「请随意欺负我、直到你过瘾为止吧…_BH_」_W"
CALL PRINT_STR, @"「あん…_BH_ そんなに激しく啜っちゃやだよ…_BH_」_W"	CALL PRINT_STR, @"「啊嗯…_BH_ 别吸得那么激烈啊…_BH_」_W"
CALL PRINT_STR, @"「もっと優しく、ゆっくり…ね…？_BH_」_W"	CALL PRINT_STR, @"「再温柔一点、慢慢地……呐…?_BH_」_W"
CALL PRINT_STR, @"「はい、どーぞ…_BH_」_W"	CALL PRINT_STR, @"「好的、请便…_BH_」_W"
CALL PRINT_STR, @"「…それにしても、淫魔のあそこを 直接ぺろぺろしたいなんて…_BH_」_W"	CALL PRINT_STR, @"「…即便这样、还想直接舔淫魔那里什么的…_BH_」_W"
CALL PRINT_STR, @"「命知らずだよね…%CNAME("二人称")%…_BH_」_W"	CALL PRINT_STR, @"「不要命了吧…%CNAME("二人称")%…_BH_」_W"
CALL PRINT_STR, @"「もう…_BH_」_W"	CALL PRINT_STR, @"「真是够了…_BH_」_W"
CALL PRINT_STR, @"「%CNAME("一人称")%のおまんこ、そんなに気に入っちゃったのかな…_BH_」_W"	CALL PRINT_STR, @"「%CNAME("一人称")%的小穴、就那么喜欢吗…_BH_」_W"
PRINTFORMW 「ん…っ」	PRINTFORMW 「嗯…っ」
PRINTFORMW 「そっちの方にも興味あるの？」	PRINTFORMW 「我对那边也有兴趣哦？」
CALL PRINT_STR, @"「んふ…いいよ_BH_」_W"	CALL PRINT_STR, @"「唔呋…好吧_BH_」_W"
PRINTFORMW 「わ、わ」	PRINTFORMW 「哇、哇啊」
PRINTFORMW 「%CNAME("一人称")%、そっちは不慣れだから…」	PRINTFORMW 「%CNAME("一人称")%、那边我不太习惯…」
PRINTFORMW 「もう少しほぐしてくれると、嬉しいな」	PRINTFORMW 「要是你能稍微再让我放松一下、那就太好了」
PRINTFORMW 「我慢できなくなったら、いつでもお触りおっけーだからね…？」	PRINTFORMW 「如果忍不住的话，随时都可以来帮我做哦…？」
CALL PRINT_STR, @"「それじゃ…ツガイのメスの誘惑オナニー…しっかり楽しんで…_BH_」_W"	CALL PRINT_STR, @"「接下来…请欣赏雌蛇的诱惑自慰秀…好好享受吧…_BH_」_W"
PRINTFORMW 「%CNAME("二人称")%、どうしたの…？」	PRINTFORMW 「%CNAME("二人称")%、怎么啦？…？」
CALL PRINT_STR, @"「こわーいお顔、しちゃってるよ…_BH_」_W"	CALL PRINT_STR, @"「你的表情、怎么变得那么可爱…_BH_」_W"
CALL PRINT_STR, @"「おちんぽの先から、ザーメンのにおいが漂ってきてるよ…_BH_」_W	CALL PRINT_STR, @"「从小鸡鸡的头上、飘来一股精液的味道哦…_BH_」_W
CALL PRINT_STR, @"「ぱんぱんに詰まって苦しいんだよね…？_BH_」_W	CALL PRINT_STR, @"「涨得鼓鼓的、很难受吧…？_BH_」_W
CALL PRINT_STR, @"「それ、このおっぱいにコき捨てたら…_BH_ きっとすごく気持ちいいよ…_BH_」_W	CALL PRINT_STR, @"「呐、不把它夹进来嘛…_BH_… 一定会很舒服哦…_BH_」_W
CALL PRINT_STR, @"「触ってるだけじゃ、満足できなくなってきちゃった…？_BH_」_W	CALL PRINT_STR, @"「光是摸几下的话、已经满足不了你了吧…？_BH_」_W
CALL PRINT_STR, @"「いいよ、それじゃあ…_BH_」_W	CALL PRINT_STR, @"「可以呦、那就来吧…_BH_」_W
CALL PRINT_STR, @"「おっぱい触って高めたむらむら…_BH_ ぜんぶ吐き出してすっきりしちゃお…_BH_」_W	CALL PRINT_STR, @"「把欧派搞得乱七八糟…_BH_ 满满地射出来、让自己变清爽起来吧…_BH_」_W
CALL PRINT_STR, @"「あ…_BH_ お腰、ぱんぱんって…_BH_ 我慢できなくなっちゃったんだ…_BH_」_W	CALL PRINT_STR, @"「啊…_BH_ 腰啪啦啪啦地停不下了…_BH_ 忍不住了吧…_BH_」_W
CALL PRINT_STR, @"「おっきいおっぱいにぎゅぅぅ～…_BH_ って搾られて…_BH_」_W	CALL PRINT_STR, @"「大奶奶呼扭呼扭～…_BH_不行了 要被榨干了…_BH_」_W
CALL PRINT_STR, @"「むちむちの濃厚な乳肉の中で…_BH_ ちっちゃな%CNAME("一人称")%のお胸の中で…_BH_」_W	CALL PRINT_STR, @"「在呼扭呼扭的浓厚乳肉里…_BH_ 再娇小的%CNAME("一人称")%的胸部…_BH_」_W
CALL PRINT_STR, @"「乳内射精…_BH_ したくなっちゃったんだ…_BH_」_W	CALL PRINT_STR, @"「乳内射精…_BH_ 要爆发了…_BH_」_W
CALL PRINT_STR, @"「いいよ…_BH_ 気持ちいいの我慢しないで…_BH_」_W	CALL PRINT_STR, @"「来吧…_BH_ 这么舒服就不要忍耐了…_BH_」_W
CALL PRINT_STR, @"「一番いいときに、びゅーって種付け…_BH_ しようね…_BH_」_W	CALL PRINT_STR, @"「在你喜欢的时候、射出来就好、射个爽…_BH_ 射吧射吧射吧…_BH_」_W
CALL PRINT_STR, @"「さっきまでにゅぽにゅぽ犯されてたおっぱいに…_BH_ 今度はぱちゅぱちゅ…_BH_ おちんぽぱこぱこ…_BH_」_W	CALL PRINT_STR, @"「刚才还只是 妞噗妞噗 地慢慢侵犯欧派…_BH_ 现在却是…啪啦啪啦_BH_ 啪啪啪啪啪…_BH_」_W
CALL PRINT_STR, @"「んふ…_BH_ もうびくびく激しくなってきてるよ…_BH_ パイズリセックス、興奮しちゃう…？_BH_」_W	CALL PRINT_STR, @"「嗯哼…_BH_ 越来越激烈了呢…_BH_ 乳内性交、让你兴奋起来了吧…？_BH_」_W
CALL PRINT_STR, @"「ほら、もっと奥まで腰入れて…？_BH_ きちんとおっぱいとセックスしなきゃね…？_BH_」_W	CALL PRINT_STR, @"「来、再多动动腰…？_BH_ 必须好好地和胸部做爱才行呢…？_BH_」_W
CALL PRINT_STR, @"「おちんぽぬちぬち甘やかす乳肉…_BH_ 掻き分けて掻き分けて…_BH_ 引き抜いて引き抜いて…_BH_」_W	CALL PRINT_STR, @"「肉棒蹂躏着甜美的乳肉…_BH_ 挤压挤压揉搓揉搓…_BH_ 一进一出一进一出…_BH_」_W
CALL PRINT_STR, @"「ぱんぱん…_BH_ ぱこぱこ…_BH_ ぱちゅぱちゅ…_BH_ にゅちにゅち…_BH_」_W	CALL PRINT_STR, @"「啪噗…_BH_ 啪啪啪啪…_BH_ 咕妞咕妞…_BH_ 呣啾呣啾…_BH_」_W
CALL PRINT_STR, @"「もちろん、これだけで終わりじゃないよ…_BH_ セックスの最後は当然、ね…？_BH_」_W	CALL PRINT_STR, @"「当然、这还不是结束哦…_BH_ 最后当然要以性交收尾、呐…？_BH_」_W
CALL PRINT_STR, @"「とびきり濃厚な種付けぴゅっぴゅ…_BH_ 期待してるよ、%CNAME("二人称")%…_BH_」_W	CALL PRINT_STR, @"「我可是非常期待哦…_BH_ %CNAME("二人称")%那浓厚异常的特酿精液…请盛大地射出来吧_BH_」_W
CALL PRINT_STR, @"「あらら…_BH_ こっそり焦らしズリしてたの、バレちゃったかな…？_BH_」_W	CALL PRINT_STR, @"「啊啦啦…_BH_ 着急了吧、被发现了吧…？_BH_」_W
CALL PRINT_STR, @"「ふふ…_BH_ %CNAME("二人称")%はそれでもぴゅっぴゅしちゃったみたいだけど…_BH_」_W	CALL PRINT_STR, @"「呋呋…_BH_ %CNAME("二人称")%还在biu、biu的射个不停呢…_BH_」_W



CALL PRINT_STR, @"「%CNAME("二人称")%の手、あったかい…_BH_」_W"	CALL PRINT_STR, @"「%CNAME("二人称")%的手很温暖…_BH_」_W"
CALL PRINT_STR, @"「%CNAME("一人称")%の身体触って、いっぱい興奮してくれてるんだね…_BH_」_W"	CALL PRINT_STR, @"「在触摸%CNAME("一人称")%身体的时候，心跳骤然变快了呢…_BH_」_W"
CALL PRINT_STR, @"「嬉しいな…_BH_ その調子で、どんどんむらむら高めていこうね…_BH_」_W"	CALL PRINT_STR, @"「真兴奋…_BH_ 就按这样的步调来吧，要慢慢触及绝顶了哦…_BH_」_W"
CALL PRINT_STR, @"「遠慮しなくていいからね…_BH_」_W"	CALL PRINT_STR, @"「别顾虑这么多，来吧………_BH_」_W"
CALL PRINT_STR, @"「%CNAME("一人称")%の身体の、好きなところを好きなだけ触って…_BH_」_W"	CALL PRINT_STR, @"「依照嗜好去摸去碰%CNAME("一人称")%的身体吧～_BH_」_W"
CALL PRINT_STR, @"「それでそのまま、好きなときにびゅーびゅーしちゃおうね…_BH_」_W"	CALL PRINT_STR, @"「就是这样～顺从冲动去摸索每个角落、去掘发新的性感带吧…_BH_」_W"
PRINTFORMW 「もっと触って…？」	PRINTFORMW 「再摸一下……」
PRINTFORMW 「%CNAME("一人称")%の、胸も、お尻も…」	PRINTFORMW 「无论是%CNAME("一人称")%的胸部还是臀部…」
CALL PRINT_STR, @"「みんなみんな、%CNAME("二人称")%のものなんだよ…_BH_」_W"	CALL PRINT_STR, @"「……都是%CNAME("二人称")%的玩具哟…_BH_」_W"
PRINTFORMW 「%CNAME("一人称")%の身体、どうかな？」	PRINTFORMW 「%CNAME("一人称")%的身体又是怎样呢？」
PRINTFORMW 「…いっぱいおせーし作れそう？」	PRINTFORMW 「…好像是能把子宫干得自主吸紧龟头的好货呢～」
CALL PRINT_STR, @"「こぽこぽこぽ…_BH_ って、きんたま興奮できそうかな…？_BH_」_W"	CALL PRINT_STR, @"「啊啦啊啦…_BH_ 变得更勃更有魅力了呀～_BH_」_W"
CALL PRINT_STR, @"「わ…_BH_ えっちな触り方…_BH_」_W"	CALL PRINT_STR, @"「哇…_BH_ 色色的摸法…_BH_」_W"
CALL PRINT_STR, @"「%CNAME("一人称")%、これからどうされちゃうのかな…_BH_ こわいなぁ…_BH_」_W"	CALL PRINT_STR, @"「接下来要对%CNAME("一人称")%做什么呢_BH_ 好可怕啊…_BH_」_W"
PRINTFORMW 「そのままぎゅってしてくれる…？」	PRINTFORMW 「就那样交给我…？」
CALL PRINT_STR, @"「えへへ…_BH_ ありがとう…_BH_」_W"	CALL PRINT_STR, @"「嘿嘿…_BH_ 谢谢…_BH_」_W"
PRINTFORMW 「%CNAME("一人称")%のからだ触って、いっぱいいっぱい興奮して」	PRINTFORMW 「摸了%CNAME("一人称")%的身体的时候，心跳骤然变快了呢_BH_」
CALL PRINT_STR, @"「%CNAME("二人称")%のきんたまの中身、たっぷり濃くしようね…_BH_」_W"	CALL PRINT_STR, @"「希望%CNAME("二人称")%睾丸里的精液浓稠到能把子宫口塞住呢…_BH_」_W"
PRINTFORMW 「もっと欲しいな…」	PRINTFORMW 「想要更多…」
PRINTFORMW 「もっともっと、%CNAME("一人称")%の身体全部、調べつくしちゃうみたいな…」	PRINTFORMW 「再多一点，把%CNAME("一人称")%的身体最隐私、最敏感的地方都找出来吧～」
CALL PRINT_STR, @"「そんな濃厚な愛撫…_BH_」_W"	CALL PRINT_STR, @"「那么舒服的爱抚…_BH_」_W"
CALL PRINT_STR, @"「%CNAME("二人称")%…_BH_ 出来るかな…？_BH_」_W"	CALL PRINT_STR, @"「%CNAME("二人称")%…_BH_ 能做到更好吗…？_BH_」_W"
PRINTFORMW 「お肌の手入れには気を使ってるから…」	PRINTFORMW 「因为对皮肤的保养很用心…」
PRINTFORMW 「触り心地、いいでしょ？」	PRINTFORMW 「摸起来很舒服吧？」
CALL PRINT_STR, @"「…あは_BH_ 素直な反応…_BH_」_W"	CALL PRINT_STR, @"「…啊_BH_ 真是坦率的反应…_BH_」_W"
CALL PRINT_STR, @"「かわいいね…_BH_ もっと大胆に触ってもいいよ…_BH_」_W"	CALL PRINT_STR, @"「好可爱啊…_BH_可以更大胆地摸哦…_BH_」_W"
CALL PRINT_STR, @"「ふふ、嬉しい…_BH_」_W"	CALL PRINT_STR, @"「呵呵，好开心…_BH_」_W"
CALL PRINT_STR, @"「そんなに遠慮しないでいいよ…_BH_」_W"	CALL PRINT_STR, @"「别顾虑这么多，来吧…_BH_」_W"
CALL PRINT_STR, @"「せっかくだもん_BH_ もっと気軽に気持ちよくなっちゃお…_BH_」_W"	CALL PRINT_STR, @"「好不容易_BH_变得这么舒服、愉快………_BH_」_W"


PRINTFORMW 「やっぱり、気になる？」	PRINTFORMW 「果然，你还是很在意吗?」
CALL PRINT_STR, @"「男の子の視線を無理矢理奪っちゃう、わるーいおっぱい…_BH_」_W"	CALL PRINT_STR, @"「这对能把雄性视线定在这里的硕大乳房…_BH_」_W"
CALL PRINT_STR, @"「好きなだけ触って、こらしめてね…_BH_」_W"	CALL PRINT_STR, @"「你想怎么玩就怎么玩吧，把乳房捏岀你喜欢的淫乱形状吧…_BH_」_W"
PRINTFORMW 「だめだよ…？」	PRINTFORMW 「不行啊…？」
PRINTFORMW 「%CNAME("二人称")%は、%CNAME("一人称")%のツガイなんだから…」	PRINTFORMW 「%CNAME("二人称")%是%CNAME("一人称")%的主人…」
CALL PRINT_STR, @"「もっと、ぐにぐにぃ…って_BH_」_W"	CALL PRINT_STR, @"「来……慢慢地……_BH_」_W"
CALL PRINT_STR, @"「えっちに揉み込んでくれないと、だめだよ…_BH_」_W"	CALL PRINT_STR, @"「不把它捏得留下你的刻印可不行～…_BH_」_W"
PRINTFORMW 「ふふ」	PRINTFORMW 「呵呵」
PRINTFORMW 「…%CNAME("二人称")%、おっぱい触るの楽しいかな」	PRINTFORMW 「…%CNAME("二人称")%、摸乳房开心吗」
CALL PRINT_STR, @"「たまたまさん…_BH_ 精子いっぱい作れそうかな…_BH_」_W"	CALL PRINT_STR, @"「那么………_BH_ 这里也是不是在努力地制造精液呢…_BH_」_W"
CALL PRINT_STR, @"「%CNAME("二人称")%のおてて、おっきいね…_BH_」_W"	CALL PRINT_STR, @"「%CNAME("二人称")%的手好大啊…_BH_」_W"
CALL PRINT_STR, @"「%CNAME("一人称")%のお胸包み込んで…あったかい…_BH_」_W"	CALL PRINT_STR, @"「%CNAME("一人称")%引以为豪的大胸部摸着很舒服吧…_BH_」_W"
CALL PRINT_STR, @"「ねえ、もっと押し付けて…_BH_」_W"	CALL PRINT_STR, @"「来，再用点力吧…_BH_」_W"
CALL PRINT_STR, @"「ね…_BH_ おっぱいのさきっぽ…もっといじって…_BH_」_W"	CALL PRINT_STR, @"「啊…_BH_ 再欺负一下乳头和胸部吧…_BH_」_W"
CALL PRINT_STR, @"「かりかりかり…ってひっかいて…_BH_」_W"	CALL PRINT_STR, @"「一次比一次来电呢，再用力点…_BH_」_W"
CALL PRINT_STR, @"「%CNAME("一人称")%のこと、いじめてほしいな…_BH_」_W"	CALL PRINT_STR, @"「再多多玩弄这里……%CNAME("一人称")%想被欺负这里…_BH_」_W"
PRINTFORMW 「もちもちって、素敵な感触でしょ…？」	PRINTFORMW 「软绵绵的，感觉很棒吧…？」
CALL PRINT_STR, @"「このおっぱいに挟まれたら、どんなちんぽも負けちゃう以外にないんだよ…_BH_」_W"	CALL PRINT_STR, @"「要是被这胸部夹着上下撸动，无论什么肉棒都会输给快乐呢_BH_」_W"
CALL PRINT_STR, @"「でも…%CNAME("二人称")%ならもしかしたら、このおっぱいを屈服させられるかも…？_BH_」_W"	CALL PRINT_STR, @"「若是%CNAME("二人称")%的话，说不定可以反过来把肉棒热量、触感及气味都刻入乳房主人的心里呢_BH_」_W"
PRINTFORMW 「じゃあその前に、いっぱい触って確かめておかないとね…」	PRINTFORMW 「在那之前，要多多反复摸索哦…」
CALL PRINT_STR, @"「屈服前の生意気おっぱい、ぐにぐにぐにって、弱点探そ…_BH_」_W"	CALL PRINT_STR, @"「然后把前面的狂妄巨乳压在身下，并尽情地玩弄着她的弱点吧…_BH_」_W"
PRINTFORMW 「かわいい…」	PRINTFORMW 「可爱…」
PRINTFORMW 「一生懸命おっぱい揉んで、すっかり孕ませる時の顔になっちゃってる…♪」	PRINTFORMW 「拼命地揉捏着胸部，完全变成小宝宝了呐………♪」
CALL PRINT_STR, @"「…実はね、女の子のおっぱいは揉みこめば揉みこむほど、いやらしくなるんだよ…_BH_」_W"	CALL PRINT_STR, @"「…其实呢、女人的胸部会越揉越敏感，甚会刺激乳腺发育……_BH_」_W"
CALL PRINT_STR, @"「おっぱい孕ませる前の下ごしらえ…_BH_ もっともっと、続けようね…_BH_」_W"	CALL PRINT_STR, @"「现在是怀孕前的准备工作…_BH_ 继续…再继续吧…_BH_」_W"
CALL PRINT_STR, @"「ねえ%CNAME("二人称")%、ふーっ_BH_ ふーっ_BH_ってオスの息遣いになっちゃってるよ…？」_W"	CALL PRINT_STR, @"「啊…%CNAME("二人称")%、呼_BH_ 呼_BH_呼吸节奏…变了…？」_W"
PRINTFORMW 「だめだよ…？ 冷静にならなきゃ、おっぱいに負けちゃうよ…？」	PRINTFORMW 「不行啊…? 不冷静的话、会输给胸部的…」
PRINTFORMW 「そんなのやだよね？ かっこよく、おっぱい征服したいよね？」	PRINTFORMW 「那样很讨厌吧? 你不想帅气地 征服胸部吗？」
CALL PRINT_STR, @"「負ける前に急いでたくさんおっぱい揉んで、早くこの感触に慣れなきゃ…_BH_」_W"	CALL PRINT_STR, @"「在输前赶紧多揉揉胸部，快点习惯这个触感吧…_BH_」_W"
PRINTFORMW 「まるで、脳みそに直接塗りこまれてるみたいなやわらかさでしょ…？」	PRINTFORMW 「这份柔软几乎要让脑浆蒸发了…？」
CALL PRINT_STR, @"「ねえ、%CNAME("一人称")%これ以上我慢できないよ…_BH_」_W"	CALL PRINT_STR, @"「啊、%CNAME("一人称")%再也忍不下去了…_BH_」_W"
CALL PRINT_STR, @"「犯されたがりのもちもちおっぱい_BH_ もう食べごろになってるよ_BH_」_W"	CALL PRINT_STR, @"「想被玩弄的香软胸部_BH_ 已经到了享用时间_BH_」_W"
PRINTFORMW 「%CNAME("一人称")%のおっぱい、すっかり%CNAME("二人称")%の遊び場にされちゃったね…」	PRINTFORMW 「%CNAME("一人称")%的乳房已经完全变成%CNAME("二人称")%的游乐场了呢…」
CALL PRINT_STR, @"「えへへ、調教済みの淫乱おっぱい、好きなだけ楽しんで…？_BH_」_W"	CALL PRINT_STR, @"「嘿嘿，调教完毕的淫乱胸部，尽情享受吧…_BH_」_W"
PRINTFORMW 「ふふっ…」	PRINTFORMW 「呵呵…」
CALL PRINT_STR, @"「%CNAME("二人称")%たら、鼻息あらーい…_BH_」_W"	CALL PRINT_STR, @"「%CNAME("二人称")%的鼻息好痒…_BH_」_W"
CALL PRINT_STR, @"「かわいいけど、ちょっとみっともないかな…？_BH_」_W"	CALL PRINT_STR, @"「虽然很可爱，但是有点不好看…？_BH_」_W"
PRINTFORMW 「指、たっぷり沈み込むでしょ…？」	PRINTFORMW 「手掌感到那沉甸甸的份量了吗…？」
PRINTFORMW 「このやわらかさで、男の子をたぶらかすんだよ…」	PRINTFORMW 「用这柔软又香喷喷的巨乳来引诱男生们…」
CALL PRINT_STR, @"「悪いおねーさんだよね…%CNAME("二人称")%、こらしめて…？_BH_」_W"	CALL PRINT_STR, @"「真是个不可饶恕的坏蛋呢～来，发泄%CNAME("二人称")%的正义怒火吧_BH_」_W"
CALL PRINT_STR, @"「ずいぶん集中してるけど…_BH_」_W"	CALL PRINT_STR, @"「虽然很专注…_BH_」_W"
CALL PRINT_STR, @"「%CNAME("一人称")%のおっぱいさわるの、そんなに楽しいのかな…？_BH_」_W"	CALL PRINT_STR, @"「摸%CNAME("一人称")%的胸部，有那么开心吗…？_BH_」_W"
PRINTFORMW %CALLNAME:TARGET%は自分の胸を好きにさせながら、%CALLNAME:MASTER%の頭を抱き寄せ優しく撫でた…	PRINTFORMW %CALLNAME:TARGET%放任%CALLNAME:MASTER%玩弄胸部的时候，一边摸着对方硬邦邦的肉棒…



CALL PRINT_STR, @"「ん…たくさん飲んでいいからね_BH_」_W"	CALL PRINT_STR, @"「嗯…可以喝很多哦_BH_」_W"
CALL PRINT_STR, @"「たくさんみるく…ごくごくのんで…_BH_」_W"	CALL PRINT_STR, @"「慢慢来…咕嘟咕嘟地喝吧…_BH_」_W"
CALL PRINT_STR, @"「しろーいちっち、いっぱいだそうね…_BH_」_W"	CALL PRINT_STR, @"「啊啦啊啦～溢出嘴角了呢…_BH_」_W"
CALL PRINT_STR, @"「ふふ…_BH_ たのしみ…_BH_」_W"	CALL PRINT_STR, @"「呋呋…_BH_ 真舒服…_BH_」_W"
CALL PRINT_STR, @"「ん…_BH_ しこしこ激しくしたら…ごくごく強くなったね…？_BH_」_W"	CALL PRINT_STR, @"「嗯…_BH_ 若激烈起来的话，吸力会不会有变化呢…？_BH_」_W"
CALL PRINT_STR, @"「いいよ、もっとしてあげる…_BH_」_W"	CALL PRINT_STR, @"「来吧，再多一点力气…_BH_」_W"
CALL PRINT_STR, @"「おっぱい飲むのにペース合わせて…_BH_ しこしこしこ_BH_ ってあやしてあげる…_BH_」_W"	CALL PRINT_STR, @"「咕啾咕啾…_BH_ 配合吸取乳头的节奏_BH_ 去揉捏另一个寂寞的胸部吧…_BH_」_W"
CALL PRINT_STR, @"「飲んだ分だけ、射精させてあげるから…_BH_」_W"	CALL PRINT_STR, @"「咕嘟咕嘟地喝下多少_BH_ 就要射出同量的浓浓精液哦…_BH_」_W"
CALL PRINT_STR, @"「今日はどれくらいお射精ぴゅっぴゅしたいのか…_BH_ %CNAME("一人称")%に教えてね…_BH_」_W"	CALL PRINT_STR, @"「今天想射出精液先告诉…_BH_ %CNAME("一人称")%一声哦…_BH_」_W"
CALL PRINT_STR, @"「ふふ…_BH_ そんなに飲んで大丈夫…？_BH_」_W"	CALL PRINT_STR, @"「呋呋…_BH_ 喝那么多没关系吧…？_BH_」_W"
CALL PRINT_STR, @"「お腰ゆらゆら…甘えちゃってるね…_BH_」_W"	CALL PRINT_STR, @"「摇摇晃晃的腰…在撒娇啊…_BH_」_W"
CALL PRINT_STR, @"「%CNAME("二人称")%の甘えんぼちんぽ…_BH_ %CNAME("一人称")%のおててのこと、気に入っちゃったのかな…？_BH_」_W"	CALL PRINT_STR, @"「%CNAME("二人称")%的粗壮小鸡鸡…_BH_ 是喜欢上了%CNAME("一人称")%的巨乳了吗…？_BH_」_W"
CALL PRINT_STR, @"「いいよー…_BH_」_W"	CALL PRINT_STR, @"「好啦ー…_BH_」_W"
CALL PRINT_STR, @"「お顔はおっぱいで甘やかしてあげるから…_BH_」_W"	CALL PRINT_STR, @"「看那闷苦的表情，会用香软软的胸部来慰抚的～_BH_」_W"
CALL PRINT_STR, @"「おちんぽはおててで、ね…_BH_」_W"	CALL PRINT_STR, @"「大鸡鸡又点点头了呢_BH_」_W"
PRINTFORMW 「%CNAME("一人称")%のおっぱい、%CNAME("二人称")%のおもちゃになっちゃってるね…」	PRINTFORMW 「%CNAME("一人称")%的胸部…已经变成了属于%CNAME("二人称")%的玩具呢……」
CALL PRINT_STR, @"「ちゅぷちゅぷちゅぷ…_BH_ お口でさきっぽ吸われるたびに…_BH_」_W"	CALL PRINT_STR, @"「嗯嗯嗯嗯～_BH_ 嘴巴好用力啊…_BH_」_W"
CALL PRINT_STR, @"「みるくを出しちゃう、おしゃぶりおもちゃ…_BH_」_W"	CALL PRINT_STR, @"「简直就是咬着奶嘴的小宝宝呐…_BH_」_W"
CALL PRINT_STR, @"「おちんぽのほうも、もっと遊ばせてあげる…_BH_」_W"	CALL PRINT_STR, @"「让小宝宝多玩一会他的玩具吧…_BH_」_W"
CALL PRINT_STR, @"「%CNAME("二人称")%のおちんぽ…%CNAME("一人称")%のおっぱいに甘えたくて震えちゃってるね…_BH_」_W"	CALL PRINT_STR, @"「%CNAME("二人称")%的小鸡鸡……因想向%CNAME("一人称")%的巨乳撒娇而溢出先走汁了吗…_BH_」_W"
CALL PRINT_STR, @"「ごめんね…？ %CNAME("一人称")%のおっぱいは、今%CNAME("二人称")%のお相手してるから…_BH_」_W"	CALL PRINT_STR, @"「对不起哦 %CNAME("一人称")%的胸部已经被%CNAME("二人称")%乱动的舌头占有了…_BH_」_W"
CALL PRINT_STR, @"「%CNAME("一人称")%のおててで…我慢してね…_BH_」_W"	CALL PRINT_STR, @"「先等一会…_%CNAME("一人称")%的胸部…_BH_」_W"
CALL PRINT_STR, @"「ほーら、がんばれ_BH_ がんばれ…_BH_」_W"	CALL PRINT_STR, @"「哇，加油!_BH_ 加油…_BH_」_W"
CALL PRINT_STR, @"「おっぱいちゅぱちゅぱ甘えながら、おててでおちんぽしこしこしゅっしゅ…_BH_」_W"	CALL PRINT_STR, @"「一边在向胸部撒娇，一边被手套弄着茎身…_BH_」_W"
CALL PRINT_STR, @"「上手なお射精…がんばれ、がんばれ…_BH_」_W"	CALL PRINT_STR, @"「%CNAME("二人称")%最擅长的射精…加油，加油…_BH_」_W"
CALL PRINT_STR, @"「ちんぽかわいい…_BH_ いつもはあんなにかっこいいのに、今は%CNAME("一人称")%に媚びきっちゃって…_BH_」_W"	CALL PRINT_STR, @"「小鸡鸡好可爱…_BH_ 明明平时那么威风凛凛、现在却完全向%CNAME("一人称")%献媚求欢呢…_BH_」_W"
CALL PRINT_STR, @"「そのままどんどん力抜いてこ…？_BH_ リラックスして…_BH_ おちんぽぴゅっぴゅ、準備しよ…_BH_」_W"	CALL PRINT_STR, @"「就这样慢慢放松…_BH_ 放松…_BH_ 准备好了吗…_BH_」_W"
CALL PRINT_STR, @"「しこしこ早くしていくね…_BH_ 出そうになったら我慢しないで…_BH_ 思いっきり、楽しんで…_BH_」_W"	CALL PRINT_STR, @"「真是令人兴奋的气味呢……_BH_别忍着了…_BH_尽情享受吧…_BH_」_W"
CALL PRINT_STR, @"「あ…_BH_ おちんぽ、びくびく…_BH_」_W"	CALL PRINT_STR, @"「嗯…_BH_ 小鸡鸡一点一点的…_BH_」_W"
CALL PRINT_STR, @"「とぷ、って_BH_ %CNAME("一人称")%のおててに、先走りのフライングザーメン、でちゃったよ…_BH_」_W"	CALL PRINT_STR, @"「嗯_BH_ 对着%CNAME("一人称")%止不往地溢出先走汁呢…_BH_」_W"
CALL PRINT_STR, @"「これじゃあかわいそうだから…_BH_」_W"	CALL PRINT_STR, @"「这样太可怜了…_BH_」_W"
CALL PRINT_STR, @"「きんたまの中のザーメンも、早くあわせてあげよっかな…_BH_」_W"	CALL PRINT_STR, @"「用胸部给小鸡鸡夹着，快快把蛋蛋里的精液射出来～…_BH_」_W"
CALL PRINT_STR, @"「みるく飲みながらのまったり快楽…どうかな…_BH_」_W"	CALL PRINT_STR, @"「一边吸奶一边享受纤细玉手的套弄服务～感觉怎么样呢…_BH_」_W"
CALL PRINT_STR, @"「%CNAME("二人称")%のおちんぽ、すっかり素直になっちゃって…_BH_」_W"	CALL PRINT_STR, @"「%CNAME("二人称")%小鸡鸡、完全变得坦率了…_BH_」_W"
CALL PRINT_STR, @"「%CNAME("一人称")%のおてての中で、とろとろになってるよ…_BH_」_W"	CALL PRINT_STR, @"「在%CNAME("一人称")%的手心里，变得粘糊糊的…_BH_」_W"
CALL PRINT_STR, @"「かわいすぎて…どうにかなっちゃいそう…_BH_」_W"	CALL PRINT_STR, @"「太可爱了……真是让人没办法呢…_BH_」_W"
CALL PRINT_STR, @"「ん…おちんぽのびくびく、もっと強くなってきた…_BH_」_W"	CALL PRINT_STR, @"「小鸡鸡先走计溢得更厉害了…_BH_」_W"
CALL PRINT_STR, @"「%CNAME("二人称")%はすっかり赤ちゃんになってるのに…_BH_ おちんぽはかっこよく、オスらしく、求愛してくれてるんだぁ…_BH_」_W"	CALL PRINT_STR, @"「%CNAME("二人称")%明明是小宝宝…_BH_ 但小鸡鸡却发散着能令雌性沦陷的魅力，还向我……献媚求欢呢…_BH_」_W"
CALL PRINT_STR, @"「負けちゃだめだよ…%CNAME("二人称")%…」_W"	CALL PRINT_STR, @"「不能输哦…%CNAME("二人称")%…」_W"
CALL PRINT_STR, @"「%CNAME("二人称")%もオスらしく…もっといっぱい、ちゅぱちゅぱして…？_BH_」_W"	CALL PRINT_STR, @"「%CNAME("二人称")%也很有男人味…再多吸一点吧_BH_」_W"
CALL PRINT_STR, @"「いい子だねー…%CNAME("二人称")%…_BH_」_W"	CALL PRINT_STR, @"「真是个好孩子啊…%CNAME("二人称")%…_BH_」_W"
CALL PRINT_STR, @"「満足するまで、おっぱいに甘えていいからね…_BH_」_W"	CALL PRINT_STR, @"「在满足之前、可以对胸部尽情撒娇哦…_BH_」_W"
CALL PRINT_STR, @"「おっぱいに顔押しつぶされながらしこしこされるの、好き？_BH_」_W"	CALL PRINT_STR, @"「想被被胸部压脸，并被手上下套弄小鸡鸡吗？_BH_」_W"
CALL PRINT_STR, @"「言わなくてもわかるよ…_BH_」_W"	CALL PRINT_STR, @"「不说也知道…_BH_」_W"
CALL PRINT_STR, @"「ちんぽがおててに甘えるみたいに…お顔もおっぱいにぐりぐりって…_BH_」_W"	CALL PRINT_STR, @"「像小鸡鸡朝作圈的手指撒娇一样，任脸被沉甸甸的乳肉埋没…_BH_」_W"
CALL PRINT_STR, @"「ふふ…_BH_ かわいい…_BH_」_W"	CALL PRINT_STR, @"「呋呋…_BH_ 可爱…_BH_」_W"
CALL PRINT_STR, @"「もっと顔押し付けていいよ…_BH_」_W"	CALL PRINT_STR, @"「可以把脸压得更紧一点…_BH_」_W"
CALL PRINT_STR, @"「もっと、もっと…_BH_」_W"	CALL PRINT_STR, @"「更紧、更紧…_BH_」_W"
CALL PRINT_STR, @"「%CNAME("一人称")%に甘えて…何もかも、委ねて…_BH_」_W"	CALL PRINT_STR, @"「把一切都交给%CNAME("一人称")%…_BH_」_W"
CALL PRINT_STR, @"「谷間から香る、淫魔のフェロモン…_BH_」_W"	CALL PRINT_STR, @"「从乳沟发出的淫魔荷尔蒙可是…_BH_」_W"
CALL PRINT_STR, @"「普通の人が嗅いじゃったら…_BH_ それだけでイっちゃうような、濃密な淫気…_BH_」_W"	CALL PRINT_STR, @"「足以让普通人变成雄犬雌猫的高级媚药…_BH_」_W"
CALL PRINT_STR, @"「いっぱい嗅いで…_BH_ いっぱいだしちゃお…_BH_」_W"	CALL PRINT_STR, @"「用鼻子把全部荷尔蒙吸进肺里吧…_BH_」_W"
CALL PRINT_STR, @"「ぐぅー…って、おっぱいを押し付けられるの、気持ちいいかな_BH_」_W"	CALL PRINT_STR, @"「哇…，被胸部压着，舒服吗_BH_」_W"
CALL PRINT_STR, @"「%CNAME("二人称")%のおちんぽも…_BH_ %CNAME("一人称")%のおっぱい欲しくて、ずるいずるいってわがまま言ってる…_BH_」_W"	CALL PRINT_STR, @"「%CNAME("二人称")%的小鸡鸡…_BH_ 很想要%CNAME("一人称")%的巨乳，并抱怨什么什么很狡猾呢.…_BH_」_W"
CALL PRINT_STR, @"「ごめんね、おちんぽ君…_BH_」_W"	CALL PRINT_STR, @"「对不起，小鸡鸡君…_BH_」_W"
CALL PRINT_STR, @"「%CNAME("一人称")%のおっぱい、今は%CNAME("二人称")%の相手してるから…_BH_」_W"	CALL PRINT_STR, @"「%CNAME("一人称")%的胸部，现在是%CNAME("二人称")%的对手…_BH_」_W"
CALL PRINT_STR, @"「%CNAME("二人称")%が満足するまで、おててで我慢していてね…_BH_」_W"	CALL PRINT_STR, @"「在%CNAME("二人称")%满意之前，一直忍耐吧…_BH_」_W"
PRINTFORMW 「%CNAME("二人称")%、息つらくないの…？」	PRINTFORMW 「%CNAME("二人称")%、不难受吗…？」
CALL PRINT_STR, @"「ずいぶん深く、谷間に潜っちゃってるけど…_BH_ ちゃんと、息継ぎできてるかな…？_BH_」_W"	CALL PRINT_STR, @"「埋得很深呢，整个头埋在乳沟里…_BH_ 能好好换气吗？_BH_」_W"
CALL PRINT_STR, @"「もし、おっぱいに埋もれて離れたくないなら…_BH_ そのまま深ぁく、息を吸って_BH_」_W"	CALL PRINT_STR, @"「嗯_BH_如果不想离开的话…_BH_ 就那样深深地吸一口气_BH_」_W"
CALL PRINT_STR, @"「淫魔のフェロモン、肺に満たして…_BH_」_W"	CALL PRINT_STR, @"「用淫魔荷尔蒙，把空荡荡的肺部填满吧…_BH_」_W"
CALL PRINT_STR, @"「身体の芯から、気持ちよくなっちゃおうね…_BH_」_W"	CALL PRINT_STR, @"「从身体内部开始，让鸡鸡变得舒服吧…_BH_」_W"
CALL PRINT_STR, @"「あん_BH_」_W"	CALL PRINT_STR, @"「啊_BH_」_W"
CALL PRINT_STR, @"「%CNAME("一人称")%の下乳に…%CNAME("二人称")%のふー_BH_ふー_BH_ って息があたっちゃってる_BH_」_W"	CALL PRINT_STR, @"「%CNAME("一人称")%的下乳被…%CNAME("二人称")%の呼_BH_呼_BH_ 灼热的呼吸弄得麻麻的_BH_」_W"
CALL PRINT_STR, @"「いいよー…_BH_」_W"	CALL PRINT_STR, @"「好啦…_BH_」_W"
CALL PRINT_STR, @"「そのままいっぱいむらむら高めて…_BH_ きんたま、ぎゅんぎゅん稼動させちゃお…_BH_」_W"	CALL PRINT_STR, @"「就那样…让麻麻的胸部蓄积更多更多的快感吧…_BH_」_W"
CALL PRINT_STR, @"「ほーら、がんばれ_BH_ がんばれ…_BH_」_W"	CALL PRINT_STR, @"「加ー油、加油_BH_ 加油…_BH_」_W"
CALL PRINT_STR, @"「おっぱいの奥までお顔を埋めて、ふがふがしながらおちんぽしこしこ…_BH_」_W"	CALL PRINT_STR, @"「把脸埋到胸部深处，一边用手扑哧扑哧地嚼着小肉棒…_BH_」_W"
CALL PRINT_STR, @"「上手に甘えられる%CNAME("二人称")%、とっても素敵だよ…_BH_」_W"	CALL PRINT_STR, @"「能很好地撒娇的%CNAME("二人称")%、非常好哟…_BH_」_W"
CALL PRINT_STR, @"「だからそのままかっこいいお射精も…_BH_ がんばれ、がんばれ…_BH_」_W"	CALL PRINT_STR, @"「所以 那帅气的射精也…加油，加油…_BH_」_W"

CALL PRINT_STR, @"「ちんぽかわいい…_BH_ いつもはあんなにかっこいいのに、今は%CNAME("一人称")%に媚びきっちゃって…_BH_」_W"	CALL PRINT_STR, @"「小鸡鸡好可爱…_BH_明明平时那么帅，现在却向%CNAME("一人称")%献媚…_BH_」_W"
CALL PRINT_STR, @"「そのままどんどん力抜いてこ…？_BH_ リラックスして…_BH_ おちんぽぴゅっぴゅ、準備しよ…_BH_」_W"	CALL PRINT_STR, @"「就这样不断地放松_BH_ 放松…_BH_ 小鸡鸡准备好嗖嗖嗖地射精了吗～_BH_」_W"
CALL PRINT_STR, @"「しこしこ早くしていくね…_BH_ 出そうになったら我慢しないで…_BH_ 思いっきり、楽しんで…_BH_」_W"	CALL PRINT_STR, @"「好快啊…_BH_ 快出来了不要忍耐…_BH_ 尽情享受吧……_BH_」_W"

CALL PRINT_STR, @"「あ…_BH_ おちんぽ、びくびくしてきたね…_BH_」_W"	CALL PRINT_STR, @"「啊…WH小鸡鸡、哆哆嗦嗦的…_BH_」_W"
CALL PRINT_STR, @"「とぷとぷ、って_BH_ 甘えるみたいなお漏らしミルク、しちゃってるよ_BH_」_W"	CALL PRINT_STR, @"「_BH_ 浓浓的牛奶在尿道里上升、上升…它刺鼻的腥臭不断蹂躏着手指的皮肤_BH_」_W"
CALL PRINT_STR, @"「かわいいなぁ、%CNAME("二人称")%…_BH_」_W"	CALL PRINT_STR, @"「好可爱啊、%CNAME("二人称")%…_BH_」_W"
CALL PRINT_STR, @"「お射精ぴゅっぴゅ待ちきれなくて、先にザーメンさんだけ出てきちゃったのかな…_BH_」_W"	CALL PRINT_STR, @"「是等不到射精，精液先出来了吗…_BH_」_W"

CALL PRINT_STR, @"「ごめんねー…%CNAME("二人称")%…_BH_」_W"	CALL PRINT_STR, @"「对不起啊ー…%CNAME("二人称")%…_BH_」_W"
CALL PRINT_STR, @"「%CNAME("一人称")%のおっぱい、まだミルクがでないんだ…_BH_」_W"	CALL PRINT_STR, @"「%CNAME("一人称")%的乳房，没有奶水…_BH_」_W"
CALL PRINT_STR, @"「そんなに%CNAME("一人称")%のミルクが飲みたかったら…_BH_ %CNAME("二人称")%に頑張ってもらわないと、だめなの…_BH_」_W"	CALL PRINT_STR, @"「那么想喝%CNAME("一人称")%奶水的话…_BH_ %CNAME("二人称")%不努力的话就不行…_BH_」_W"
CALL PRINT_STR, @"「ねえ…%CNAME("二人称")%…_BH_」_W"	CALL PRINT_STR, @"「呐…%CNAME("二人称")%…_BH_」_W"
CALL PRINT_STR, @"「飲みたくないかな…%CNAME("一人称")%のおっぱい…_BH_」_W"	CALL PRINT_STR, @"「不想喝吗…%CNAME("一人称")%的奶水…_BH_」_W"

CALL PRINT_STR, @"「ん、谷間にお顔埋めながら、おちんぽへこへこ気持ちいいね…_BH_」_W"	CALL PRINT_STR, @"「嗯，一边把脸埋在乳谷里，一边被爱抚小鸡鸡，好舒服啊…_BH_」_W"
CALL PRINT_STR, @"「%CNAME("一人称")%も手伝ってあげる…_BH_ サオをしこしこ…_BH_ さきっぽこねこね…_BH_」_W"	CALL PRINT_STR, @"「%CNAME("一人称")%也帮助你…_BH_ 让鼻腔汲入更多的香味吧…_BH_ 那乃是所谓的淫魔费洛蒙…_BH_」_W"
CALL PRINT_STR, @"「ふふ、谷間の汗まで舐めちゃって…喜んでくれてるんだね…_BH_」_W"	CALL PRINT_STR, @"「呋呋，连淌下的汗液也舔入口了…很兴奋呢…_BH_」_W"
CALL PRINT_STR, @"「いいよー…そのまま、おっぱいに甘えて、%CNAME("二人称")%の種付けぴゅっぴゅ、見せて_BH_」_W"	CALL PRINT_STR, @"「好啊…就这样对胸部撒娇、让我看看%CNAME("二人称")%的配种_BH_」_W"

CALL PRINT_STR, @"「%CNAME("二人称")%…%CNAME("一人称")%のおっぱい、やわらかい…？_BH_ 好き…？_BH_」_W"	CALL PRINT_STR, @"「%CNAME("二人称")%喜欢…%CNAME("一人称")%柔软的胸部…？_BH_ _BH_」_W"
CALL PRINT_STR, @"「ふふ、ありがと_BH_」_W"	CALL PRINT_STR, @"「呋呋、谢谢_BH_」_W"
CALL PRINT_STR, @"「褒めてくれたご褒美に…すっごい責め方、してあげるねー…_BH_」_W"	CALL PRINT_STR, @"「作为赞美我的奖赏…我会好好欺负你的ー…_BH_」_W"

CALL PRINT_STR, @"「ほら…_BH_ %CNAME("一人称")%に腰預けて…？_BH_」_W"	CALL PRINT_STR, @"「你看…_BH_ %CNAME("一人称")%的腰在颤抖呢…_BH_」_W"
CALL PRINT_STR, @"「そうそう、上手だよ…_BH_」_W"	CALL PRINT_STR, @"「对对，很厉害哦…_BH_」_W"
CALL PRINT_STR, @"「そのままリラックスしてていいからね…_BH_ %CNAME("一人称")%が全部やっちゃうから…_BH_」_W"	CALL PRINT_STR, @"「就这样放松一下也可以…_BH_ %CNAME("一人称")%全麻了…_BH_」_W"

CALL PRINT_STR, @"「%CNAME("二人称")%、目がとろんってしてるよ…_BH_ 」_W"	CALL PRINT_STR, @"「%CNAME("二人称")%、很引人注目呢…_BH_ 」_W"
CALL PRINT_STR, @"「ふふ…_BH_ 気持ちよくなってくれてるんだね…_BH_ ありがと…_BH_」_W"	CALL PRINT_STR, @"「呋呋…_BH_ 变得舒服了呢…_BH_ 谢谢…_BH_」_W"
CALL PRINT_STR, @"「このままお射精したくなったら、我慢しなくていいからね…_BH_」_W"	CALL PRINT_STR, @"「如果想就这样射精的话，不用忍耐了…_BH_」_W"

CALL PRINT_STR, @"「もー…_BH_ 甘えんぼさん…_BH_」_W"	CALL PRINT_STR, @"「嗯ー…_BH_ 真爱撒娇…_BH_」_W"
CALL PRINT_STR, @"「仕方ないなぁ…_BH_」_W"	CALL PRINT_STR, @"「没办法啊…_BH_」_W"
CALL PRINT_STR, @"「いいよ、そのままおっぱいで遊んでて…_BH_」_W"	CALL PRINT_STR, @"「好吧，就这样玩胸部吧…_BH_」_W"
CALL PRINT_STR, @"「おちんぽの方は、%CNAME("一人称")%がやってあげる…_BH_」_W"	CALL PRINT_STR, @"「小鸡鸡呢、%CNAME("一人称")%为你做…_BH_」_W"

CALL PRINT_STR, @"「このやり方、好き…？_BH_」_W"	CALL PRINT_STR, @"「喜欢这种做法…？_BH_」_W"
CALL PRINT_STR, @"「%CNAME("一人称")%は、好きだよ…_BH_」_W"	CALL PRINT_STR, @"「%CNAME("一人称")%我 喜欢…_BH_」_W"
PRINTFORMW 「男の子が、お腹向けて、何もかも無防備に差し出して…」	PRINTFORMW 「男孩对着我的肚子，毫无防备地把一切都暴露给我…」
CALL PRINT_STR, @"「とろとろに蕩けて、安心しきってるのが、好きなの…_BH_」_W"	CALL PRINT_STR, @"「我喜欢沉醉在恍惚之中，完全放松的样子…_BH_」_W"



CALL PRINT_STR, @"「触りもしないで、おちんぽの周りでおててをしこしこ…_BH_ 亀頭の先で、指をゆらゆら…_BH_」_W"	CALL PRINT_STR, @"「掌心都没与肉棒来一次拥抱，仅仅是做出虚握的样子上下摆动着就……WH_」_W"
CALL PRINT_STR, @"「手コキの素振りを見せてるだけで、もう呼吸が荒くなってるけど…_BH_」_W"	CALL PRINT_STR, @"「因为期待下一秒～下一分的手交，心跳就变得好快啊…_BH_」_W"
CALL PRINT_STR, @"「もしかして%CNAME("二人称")%…_BH_ もう精液昇ってきてる…？_BH_」_W"	CALL PRINT_STR, @"「难道%CNAME("二人称")%…_BH_ 已经溢出精液了吗…？_BH_」_W"
CALL PRINT_STR, @"「誤魔化してもだめだよ…_BH_ 鈴口からザーメンのにおい…_BH_ %CNAME("一人称")%まで届いてきてる…_BH_」_W"	CALL PRINT_STR, @"「蒙混过关可不行啊…_BH_ 从马眼飘出浓浓的精臭…_BH_ 已经被%CNAME("一人称")%吸入肺内了哦…_BH_」_W"
CALL PRINT_STR, @"「よっぽど興奮してるんだね…_BH_ それとも、%CNAME("一人称")%がえっちすぎる所為なのかな…？_BH_」_W"	CALL PRINT_STR, @"「是因为…_BH_ 太过兴奋呢、还是%CNAME("一人称")%所作的太过分了呢…？_BH_」_W"
CALL PRINT_STR, @"「どっちにしても、きちんと責任は取ってあげる…_BH_」_W"	CALL PRINT_STR, @"「不管怎么样，我都会好 好 负 责的…_BH_」_W"
CALL PRINT_STR, @"「おちんぽ、しっかり握り込んで…_BH_ がっつりちゅこちゅこ…_BH_ 扱いてあげる…_BH_」_W"	CALL PRINT_STR, @"「给肉棒君一次紧紧的拥抱…_BH_ 之后就是揉捏蛋蛋了…_BH_ 快快射精吧…_BH_」_W"
CALL PRINT_STR, @"「わ…_BH_ ずっしり…_BH_」_W"	CALL PRINT_STR, @"「哇…_BH_ 沉甸甸…_BH_」_W"
CALL PRINT_STR, @"「きんたま、重たくなっちゃってるね…_BH_」_W"	CALL PRINT_STR, @"「睾丸变得好重…_BH_」_W"
CALL PRINT_STR, @"「毎日何度もお射精してるのに…_BH_ すぐにお子種溜め込んじゃう…_BH_」_W"	CALL PRINT_STR, @"「明明每天射出的量一次比一次多…_BH_ 但转眼间就蓄积出更夸张的份量…_BH_」_W"
CALL PRINT_STR, @"「%CNAME("二人称")%のたまたまさんは…_BH_ とっても真面目で働き者だね…_BH_」_W"	CALL PRINT_STR, @"「%CNAME("二人称")%的肉棒……_BH_ 是鬼畜得不行不行的怪物呀…_BH_」_W"
CALL PRINT_STR, @"「ふふ…_BH_ これは、%CNAME("一人称")%がたっぷり労ってあげないと…_BH_」_W"	CALL PRINT_STR, @"「呋呋…_BH_ 若%CNAME("一人称")%不好好照顾它…可不行啊_BH_」_W"
CALL PRINT_STR, @"「袋のしわの一本一本まで…_BH_ 丹念に舐め上げて…_BH_ 揉み込んで…_BH_ 中のザーメンもほぐしてあげて…_BH_」_W"	CALL PRINT_STR, @"「把睾丸每条皱纹…_BH_ 舔得舒展开来……_BH_ 再把里面的精液也一同吸出…_BH_」_W"
CALL PRINT_STR, @"「しっかりたくさんお射精できるように…_BH_ %CNAME("一人称")%が癒してあげなきゃ…_BH_」_W"	CALL PRINT_STR, @"「为了更浓更稠的肉棒牛奶…_BH_ %CNAME("一人称")%必须治愈它…_BH_」_W"
CALL PRINT_STR, @"「押し倒されて、興奮してるのかな…？_BH_ おちんぽ、いつもよりバキバキになっちゃってるよ…_BH_」_W"	CALL PRINT_STR, @"「被推倒了，很兴奋吧…?_BH_ 小鸡鸡_BH_ 可是比平时还要硬邦邦的哦…_BH_」_W"
CALL PRINT_STR, @"「先っぽも、ほら…_BH_ おつゆがとくとくって…_BH_ とろとろに糸引いちゃってる…_BH_」_W"	CALL PRINT_STR, @"「龟头也红红的_BH_从马眼溢流的先走汁稠得可以拉丝啊…_BH_」_W"
CALL PRINT_STR, @"「手のひらで磨かれるの、好きになっちゃった…？_BH_ _BH_」_W"	CALL PRINT_STR, @"「很喜欢…用手做…？_BH_ _BH_」_W"
CALL PRINT_STR, @"「%CNAME("二人称")%のおちんぽ…_BH_ 正直で本当に可愛いね…_BH_」_W"	CALL PRINT_STR, @"「%CNAME("二人称")%的小鸡鸡…_BH_ 正直得很可爱呢…_BH_」_W"
CALL PRINT_STR, @"「%CNAME("二人称")%は、これからどんな風にされたいのかな…_BH_」_W"	CALL PRINT_STR, @"「%CNAME("二人称")%…今后想被怎样对待呢…_BH_」_W"
CALL PRINT_STR, @"「指で裏筋くすぐられるのも…_BH_ カリ溝ぞりぞり削られるのも…_BH_ 金玉揉まれたり…_BH_ 鈴口ほじほじも好きだよね…_BH_」_W"	CALL PRINT_STR, @"「是被上下套弄呢…_BH_ 还是被蹭刮龟头下的沟沟呢…_BH_ 或是揉捏蛋蛋好呢…_BH_ 也喜欢被弄着马眼吧…_BH_」_W"
CALL PRINT_STR, @"「%CNAME("二人称")%の好きなやり方…_BH_ %CNAME("一人称")%、みんな覚えてるよ…_BH_」_W"	CALL PRINT_STR, @"「%CNAME("二人称")%喜欢的做法…_BH_ %CNAME("一人称")%、大家都记得哦……_BH_」_W"
CALL PRINT_STR, @"「%CNAME("二人称")%の弱いところも…_BH_ %CNAME("一人称")%、ぜんぶ知ってるよ…_BH_」_W"	CALL PRINT_STR, @"「%CNAME("二人称")%的弱点也…_BH_ %CNAME("一人称")%、全部都知道哦…_BH_」_W"
CALL PRINT_STR, @"「これから%CNAME("一人称")%にどうされたいのか…_BH_ おちんぽでちゃんと返事して…？_BH_」_W"	CALL PRINT_STR, @"「今后想被%CNAME("一人称")%怎么做…_BH_ 请用小鸡鸡好好地回复我吧…？_BH_」_W"
CALL PRINT_STR, @"「%CNAME("二人称")%、%CNAME("一人称")%のおててのことしか考えられなくなっちゃってるみたい…_BH_」_W"	CALL PRINT_STR, @"「%CNAME("二人称")%、%CNAME("一人称")%好像只会想你的事情了…_BH_」_W"
CALL PRINT_STR, @"「だって、%CNAME("一人称")%の指がつつーって動くだけで…_BH_ ほら…_BH_」_W"	CALL PRINT_STR, @"「因为、%CNAME("一人称")%仅是动一动手指就……_BH_」_W"
CALL PRINT_STR, @"「こんなにえっちなびくびく、激しくしなってる…_BH_ ほらほら…_BH_ どう…？_BH_ 気持ちいい…？_BH_」_W"	CALL PRINT_STR, @"「颤抖得让人怜爱，止不住地溢流先走汁…_BH_ 看吧…怎么样…？_BH_ 舒服吗…？_BH_」_W"
CALL PRINT_STR, @"「ふふ…%CNAME("二人称")%は、本当に%CNAME("一人称")%を喜ばせるのが上手だね…_BH_」_W"	CALL PRINT_STR, @"「呋呋…%CNAME("二人称")%真的很擅长让%CNAME("一人称")%高兴呢…_BH_」_W"
CALL PRINT_STR, @"「お礼に…_BH_ %CNAME("一人称")%も%CNAME("二人称")%のこと、いっぱい悦ばせてあげるから…_BH_」_W"	CALL PRINT_STR, @"「作为答谢…_BH_ %CNAME("一人称")%也会做与%CNAME("二人称")%一样的事，让你舒服得欲仙欲死…_BH_」_W"
CALL PRINT_STR, @"「おちんぽのびくびく激しすぎだよぅ…_BH_」_W"	CALL PRINT_STR, @"「小鸡鸡颤动的样子好可怕啊…_BH_」_W"
CALL PRINT_STR, @"「口の端からよだれまで垂らして…_BH_ もうすっかり射精のことしか考えられなくなってるみたい_BH_」_W"	CALL PRINT_STR, @"「最前端的马眼仅溢着先走汁…_BH_ 好像全心全意地投入到射精前的准备了呢_BH_」_W"
CALL PRINT_STR, @"「とっても逞しいオスの姿…_BH_ %CNAME("一人称")%、どきどきしてきちゃった_BH_」_W"	CALL PRINT_STR, @"「非常强壮的雄性姿态…_BH_ %CNAME("一人称")%、忐忑不安起来了_BH_」_W"
CALL PRINT_STR, @"「%CNAME("二人称")%のツガイとして…_BH_ おちんぽに仕えるザー汁絞りメイドとして…_BH_」_W"	CALL PRINT_STR, @"「%CNAME("二人称")%的龟头……_BH_ 作为侍奉小鸡鸡的榨汁女仆…_BH_」_W"
CALL PRINT_STR, @"「テクニックの全てを駆使して、極楽射精に導いてあげるからね_BH_」_W"	CALL PRINT_STR, @"「将要运用所有的淫魔技巧、令射精快感达至极乐_BH_」_W"
CALL PRINT_STR, @"「とりあえず、きんたま揉み込んで子種をぐるぐる濃縮するから…_BH_」_W"	CALL PRINT_STR, @"「总之、先揉一揉蛋蛋让内部的精液变得更粘稠吧…_BH_」_W"
CALL PRINT_STR, @"「ちょっとむずむずしちゃうと思うけど、我慢してね…_BH_」_W"	CALL PRINT_STR, @"「会有点痒，不过请忍耐一下…_BH_」_W"
CALL PRINT_STR, @"「%CNAME("一人称")%の手の中で、%CNAME("二人称")%のきんたま、ふるふるって震えちゃってる…_BH_」_W"	CALL PRINT_STR, @"「在%CNAME("一人称")%的手里，是%CNAME("二人称")%那两颗沉甸甸的睾丸…_BH_」_W"
CALL PRINT_STR, @"「大丈夫だからね_BH_ 心配しなくても、%CNAME("一人称")%が%CNAME("二人称")%のせーしのこと、育ててあげる_BH_」_W"	CALL PRINT_STR, @"「不用担心啦_BH_ 没问题的、%CNAME("一人称")%会好好训练%CNAME("二人称")%的精液_BH_」_W"
CALL PRINT_STR, @"「%CNAME("二人称")%のどろどろせーし_BH_ いまよりずっと凶悪で強靭な、最強無慈悲の蛮族ザーメンに訓練してあげるからね…_BH_」_W"	CALL PRINT_STR, @"「%CNAME("二人称")%的精液_BH_ 要锤炼成比现在更凶更恶更加坚韧无情的、蛮族般的粘稠精液…_BH_」_W"
CALL PRINT_STR, @"「そのために…まずはマシンガン手コキ500往復から、いってみようか…_BH_」_W"	CALL PRINT_STR, @"「总之，先高速撸动鸡鸡500回吧…_BH_」_W"
CALL PRINT_STR, @"「きんたまかりかり…_BH_ さきっぽさわさわ…_BH_」_W"	CALL PRINT_STR, @"「蛋蛋靠近一点…_BH_ 再近一点…_BH_」_W"
CALL PRINT_STR, @"「手のひらきゅっきゅっ…_BH_ 亀さんぐりぐり…_BH_」_W"	CALL PRINT_STR, @"「手里的鸡鸡在颤抖呢…_BH_ 龟头也溢着先走汁…_BH_」_W"
CALL PRINT_STR, @"「裏筋の方もくすぐっていくね…_BH_ %CNAME("二人称")%のえっちなお腰、%CNAME("一人称")%に委ねてくれるかな…_BH_」_W"	CALL PRINT_STR, @"「系带周边很痒吧…_BH_ %CNAME("二人称")%有点摇晃晃的腰、能交给我%CNAME("一人称")%吗…_BH_」_W"
CALL PRINT_STR, @"「%CNAME("二人称")%専用の全自動オナサポリクライニングシートだよ…_BH_」_W"	CALL PRINT_STR, @"「这是%CNAME("二人称")%专用的全自动可控型人肉飞机杯哦…_BH_」_W"
CALL PRINT_STR, @"「ぴゅっぴゅの最中も、その後も…全部お世話してあげるからね_BH_」_W"	CALL PRINT_STR, @"「无论是在恋爱的过程中，还是之后……我都会照顾你的_BH_」_W"
CALL PRINT_STR, @"「%CNAME("二人称")%のおちんぽ、すっかりどろどろになっちゃった…_BH_」_W"	CALL PRINT_STR, @"「%CNAME("二人称")%的小鸡鸡、变得粘糊糊的…_BH_」_W"
CALL PRINT_STR, @"「後から後からとくとくとくーって_BH_ お汁が溢れてとまらない…_BH_」_W"	CALL PRINT_STR, @"「源源不断地溢出先走汁_BH_ 颤抖得让人怜爱…_BH_」_W"
CALL PRINT_STR, @"「…ねえ、%CNAME("二人称")%は知ってる…_BH_」_W"	CALL PRINT_STR, @"「…我知道%CNAME("二人称")%_BH_」_W"
CALL PRINT_STR, @"「おちんぽの先からでてくるお汁…はじめはほら…こんな風にさらさらだけど…_BH_」_W"	CALL PRINT_STR, @"「把小鸡鸡马眼流出的先走汁…涂涂抹抹一下，就润滑完毕了…_BH_」_W"
CALL PRINT_STR, @"「何度も何度も寸止めして、おちんぽの先っぽから根元まで、ザーメンを往復させるとね…_BH_」_W"	CALL PRINT_STR, @"「在即将射精的瞬间停下、令精液从两端不断流动、并再重复一遍又一遍…_BH_」_W"
CALL PRINT_STR, @"「このお汁…カウパーだけがちんぽの中から追い出されて…せーしがどんどん練り上げられて_BH_ 」_W"	CALL PRINT_STR, @"「仅有先走汁从鸡鸡中不断溢出，被手指反复涂到每个角落_BH_ 」_W"
CALL PRINT_STR, @"「…うどんみたいなごってりせーしが出来上がるんだよ_BH_」_W"	CALL PRINT_STR, @"「…像乌冬一样粘稠的精液就做好了哦_BH_」_W"
CALL PRINT_STR, @"「そしたら、ついには先走りにまで子種が混じり始めて…_BH_」_W"	CALL PRINT_STR, @"「然后，在尿道与先走汁混合为一…_BH_」_W"
CALL PRINT_STR, @"「カウパーとろとろお漏らしするだけの、射精未満の快楽ぴゅっぴゅで、種付けみたいな気持ちよさが味わえるの…_BH__」_W"	CALL PRINT_STR, @"「仅是漏了一丁点的、小小的、连射精都算不上的精液……就露出了已经受精成功般的陶醉表情…_BH__」_W"
CALL PRINT_STR, @"「だったら…もし_BH_ もし、だよ？_BH_」_W"	CALL PRINT_STR, @"「既然如此_BH_ 如果…__BH_」_W"
CALL PRINT_STR, @"「そんな状態でお射精なんかしちゃったら…どうなっちゃうんだろうね…？_BH_」_W"	CALL PRINT_STR, @"「如果在这种状态下射精的话…会怎么样呢…？_BH_」_W"
PRINTFORMW 「後ろから失礼しまーす…」	PRINTFORMW 「从后面开始…失礼了…」
PRINTFORMW 「えへへ…ちょっぴり恥ずかしいね」	PRINTFORMW 「嘿嘿…有点害羞呢」
PRINTFORMW 「ね、背中で%CNAME("一人称")%のおっぱい感じる…？」	PRINTFORMW 「在背上感到で%CNAME("一人称")%的胸部…？」
CALL PRINT_STR, @"「見かけよりもずっとずっと大きいでしょ…_BH_」_W"	CALL PRINT_STR, @"「比看上去的要大得多吧…_BH_」_W"
PRINTFORMW 「じゃあ、このままするね…」	PRINTFORMW 「那就这样吧…」
CALL PRINT_STR, @"「%CNAME("一人称")%のえっちなデカパイ、背中でたっぷり楽しみながら…_BH_」_W"	CALL PRINT_STR, @"「在背上尽情享受%CNAME("一人称")%沉甸甸的丰满巨乳吧…_BH_」_W"
CALL PRINT_STR, @"「ぐつぐつぐつぐつ_BH_ きんたまとおちんぽ興奮させよ…？_BH_」_W"	CALL PRINT_STR, @"「咕嘟咕嘟_BH_ 让你兴奋起来吧…_BH_」_W"
CALL PRINT_STR, @"「さきっぽのほう、責めていくね…_BH_」_W"	CALL PRINT_STR, @"「那个…我要开始了哦…_BH_」_W"
CALL PRINT_STR, @"「こうやって…亀さん手のひらで磨り潰すみたいにぐりぐりすると…ほら_BH_」_W"	CALL PRINT_STR, @"「你看…像这样用掌心把龟头先生压往，然后咕嘟咕嘟地磨动_BH_」_W"
CALL PRINT_STR, @"「ぴぴぴっ_BH_ って_BH_ 軽くお潮吹いちゃうくらい気持ちいいでしょ_BH_」_W"	CALL PRINT_STR, @"「噼噼噼_BH_舒服到要轻轻地吹潮了吧_BH_」_W"
CALL PRINT_STR, @"「そうして激しい快楽で疲れちゃったおちんぽをね…？_BH_」_W"	CALL PRINT_STR, @"「然后把因激烈快乐而萎缩的小鸡鸡……？_BH_」_W"
CALL PRINT_STR, @"「今度は竿から根元にかけて、ねっとりまったりマッサージしてくの…_BH_」_W"	CALL PRINT_STR, @"「从茎身到蛋蛋都来次粘糊糊的按摩…_BH_」_W"
CALL PRINT_STR, @"「%CNAME("二人称")%、これもう何回か続けるからね…気を失わないように、気をつけて…_BH_」_W"	CALL PRINT_STR, @"「%CNAME("二人称")%、这个已经持续几次了呢…注意…不要失去意识了…_BH_」_W"

CALL PRINT_STR, @"「前に回って、向かい合ってしこしこするね…_BH_」_W"	CALL PRINT_STR, @"「绕到前面，面对面地做个好孩子吧…_BH_」_W"
PRINTFORMW 「あ、だめだよ視線そらしちゃ」	PRINTFORMW 「啊，把视线移开可不行」
CALL PRINT_STR, @"「…どんなに恥ずかしくても_BH_ 情けなーいトロ顔してても…_BH_」_W"	CALL PRINT_STR, @"「…无论多么害羞_BH_ 就算一副可怜的表情…_BH_」_W"
CALL PRINT_STR, @"「%CNAME("一人称")%にとってはどれもみーんな…大切なツガイのオスの顔なの_BH_」_W"	CALL PRINT_STR, @"「对%CNAME("一人称")%来说，无论哪个都很美、都很可爱…这是非常重要的雄性的脸_BH_」_W"
PRINTFORMW 「だから変なこと気にしなくていいんだよ…？」	PRINTFORMW 「所以不用在意…」
CALL PRINT_STR, @"「素敵なお顔、たくさん見せて…_BH_」_W"	CALL PRINT_STR, @"「给我看很多很多漂亮的脸吧…_BH_」_W"
CALL PRINT_STR, @"「%CNAME("二人称")%のお耳かわいい…_BH_」_W"	CALL PRINT_STR, @"「%CNAME("二人称")%可爱的耳朵…_BH_」_W"
CALL PRINT_STR, @"「%CNAME("一人称")%の目の前でえっちに揺れて…舐めて_BH_ 舐めて_BH_ って誘ってるみたい_BH_」_W"	CALL PRINT_STR, @"「%CNAME("一人称")%的眼前摇晃…好像是在邀请别人去舔舐呢_BH_」_W"
CALL PRINT_STR, @"「ん…我慢できないから、お耳、舐めちゃお_BH_」_W_"	CALL PRINT_STR, @"「嗯…我忍不了了，舔耳朵吧_BH_」_W_"
CALL PRINT_STR, @"「んちゅ…_BH_ れる_BH_ れる_BH_ かぽかぽかぽ…_BH_ んふ_BH_ おいし…_BH_」_W"	CALL PRINT_STR, @"「嗯…_BH_ 嗯_BH_ 嗯_BH_ 暖洋洋…_BH_ 嗯_BH_ 好吃…_BH_」_W"
CALL PRINT_STR, @"「しこしこも続けるね…_BH_ 快楽塗れのドスケベ手コキ…耳でも楽しんで…_BH_」_W"	CALL PRINT_STR, @"「这个也要继续哦…_BH_ 在感受涂满快乐的小鸡鸡时…也要享受耳朵…_BH_」_W"
PRINTFORMW 「%CNAME("二人称")%…もしかして、手コキでおちんぽつらくなっちゃった…？」	PRINTFORMW 「%CNAME("二人称")%…难不成、是我用手捂得慌了…？」
CALL PRINT_STR, @"「じゃあ…おめめ、瞑ってみて…？_BH_」_W"	CALL PRINT_STR, @"「那……你闭上眼睛看看…？_BH_」_W"
CALL PRINT_STR, @"「ぐちゅぐちゅ、しこしこ_BH_ えっちな音がたくさんするよね…」_W"	CALL PRINT_STR, @"「噼噼噼噼、咕嘟咕嘟_BH_ 有很多奇怪的声音吧…」_W"
CALL PRINT_STR, @"「これ全部、%CNAME("二人称")%のおちんぽからしてるんだよ_BH_」_W"	CALL PRINT_STR, @"「这些全部、是从%CNAME("二人称")%的小鸡鸡那里来的_BH_」_W"
CALL PRINT_STR, @"「このぐちゅぐちゅは何の音かなー…？_BH_」_W"	CALL PRINT_STR, @"「这是什么声音啊——？_BH_」_W"
CALL PRINT_STR, @"「おちんぽの先磨かれてる音…？ それとも根元がおててで遊ばれてる音かな…？_BH_」_W"	CALL PRINT_STR, @"「小鸡鸡前端被磨蹭的声音？还是蛋蛋被揉玩的声音呢？_BH_」_W"
CALL PRINT_STR, @"「さわさわかりかり_BH_ おちんぽの表面くすぐる指は何本なんだろうね…？_BH_」_W"	CALL PRINT_STR, @"「啾啾啾啾_BH_ 在小鸡鸡身上动来动去的手背有几根呀…？_BH_」_W"
CALL PRINT_STR, @"「どんな風に動いて、次はどこを責めようとしてるんだろう…？_BH_」_W"	CALL PRINT_STR, @"「接下来会怎样行动，又会欺负哪里呢…？_BH_」_W"
CALL PRINT_STR, @"「ふふ、おっぱいの感触も忘れちゃだめだよ…_BH_ %CNAME("二人称")%に押し付けられた…ふんわりやわらかおっぱいの感触…_BH_」_W"	CALL PRINT_STR, @"「呋呋、不要忘记乳房的触感哦…_BH_ 强加给%CNAME("二人称")%…软绵绵的触感…_BH_」_W"
CALL PRINT_STR, @"「そうだよねー…_BH_ こんなの、かえっておちんぽどんどんいらいらしてきちゃうよね…_BH_」_W"	CALL PRINT_STR, @"「哦…_BH_ 这样反而会让小鸡鸡越来越烦躁吧…_BH_」_W"
CALL PRINT_STR, @"「でも我慢だよー…_BH_」_W"	CALL PRINT_STR, @"「但是要忍耐哦ー…_BH_」_W"
CALL PRINT_STR, @"「おちんぽの快楽、もっともっと高めたほうが…ぜーったい気持ちいいんだから…_BH_」_W"	CALL PRINT_STR, @"「小鸡鸡的快乐，应该再提高一点…在将要射的时候才会更爽呀…_BH_」_W"
CALL PRINT_STR, @"「ん、%CNAME("二人称")%の遺伝子ソース、%CNAME("一人称")%が濃くしてあげる…_BH_」_W"	CALL PRINT_STR, @"「嗯、%CNAME("二人称")%的遗传因子、给%CNAME("一人称")%浓浓的吧…_BH_」_W"
CALL PRINT_STR, @"「きんたまのおなべのなかで煮込んで煮込んで、煮凝りみたいに濃ゆ濃ゆにすれば_BH_」_W"	CALL PRINT_STR, @"「在金玉锅里炖煮、直至变成粘稠稠的浓汤_BH_」_W"
CALL PRINT_STR, @"「きっとお射精するときは、びっくりするぐらい気持ち良いよ…_BH_」_W"	CALL PRINT_STR, @"「在射精的时候、一定会舒服到让人欲仙欲死…_BH_」_W"
CALL PRINT_STR, @"「ふふ_BH_ もしかしたら、あたまぱーになっちゃうかもね…？_BH_ 」_W"	CALL PRINT_STR, @"「呋呋_BH_ 说不定会变成傻瓜呢…？_BH_ 」_W"
CALL PRINT_STR, @"「もしそうなっても、%CNAME("一人称")%がぜんぶ面倒見てあげるから…_BH_」_W"	CALL PRINT_STR, @"「如果变成那样、%CNAME("一人称")%会照顾你的…_BH_」_W"
CALL PRINT_STR, @"「%CNAME("二人称")%は何も心配しなくていいよ…_BH_」_W"	CALL PRINT_STR, @"「%CNAME("二人称")%你什么也不用担心…_BH_」_W"



CALL PRINT_STR, @"「%CNAME("二人称")%のおちんぽ…_BH_ もう待ちきれないって感じだね…_BH_」_W"	CALL PRINT_STR, @"「%CNAME("二人称")%的小鸡鸡…_BH_ 感觉已经迫不及待了呢…_BH_」_W"
CALL PRINT_STR, @"「服の上から擦ってるだけなのに、こんなにおつゆが漏れちゃってる…_BH_」_W"	CALL PRINT_STR, @"「只是被衣袖磨过，就流出这么多的先走汁…_BH_」_W"
CALL PRINT_STR, @"「あは_BH_ びくってした…_BH_ かわいー…_BH_」_W"	CALL PRINT_STR, @"「啊哈_BH_ 吓了一跳…_BH_ 真可爱…_BH_」_W"
CALL PRINT_STR, @"「もしかして、我慢できない…？_BH_ %CNAME("一人称")%の指、生で感じたい…？_BH_」_W"	CALL PRINT_STR, @"「也许是无法忍受…？_BH_ %CNAME("一人称")%的手指、带来的感觉…？_BH_」_W"
CALL PRINT_STR, @"「…%CNAME("一人称")%も、おんなじ気持ち_BH_」_W"	CALL PRINT_STR, @"「…%CNAME("一人称")%也是同样的心情_BH_」_W"
CALL PRINT_STR, @"「ううん、もっとすごいかも…_BH_」_W"	CALL PRINT_STR, @"「不，可能更厉害…_BH_」_W"
CALL PRINT_STR, @"「だって、むらむら高まってるときに、そんな可愛いこといわれたら、我慢できない…_BH_」_W"	CALL PRINT_STR, @"「在情绪高涨的时候，听到这么可爱的话，就要受不了了…_BH_」_W"
CALL PRINT_STR, @"「%CNAME("二人称")%のこと、どろどろに蕩かしてあげるから…_BH_」_W"	CALL PRINT_STR, @"「%CNAME("二人称")%、我会把你弄得欲仙欲死的…_BH_」_W"
CALL PRINT_STR, @"「…でも、まずはキスから、ね…_BH_」_W"	CALL PRINT_STR, @"「…但要从接吻先开始…_BH_」_W"
CALL PRINT_STR, @"「んっ_BH_ もう、んふ_BH_ ん、ちゅ…_BH_ ん…_BH_」_W"	CALL PRINT_STR, @"「嗯_BH_ 呀…_BH_ 嗯…_BH_ 呀…WH_」_W"
CALL PRINT_STR, @"「ぷぁ…_BH_ ちょっと、%CNAME("二人称")%…？_BH_」_W"	CALL PRINT_STR, @"「嗯啊…_BH_ %CNAME("二人称")%…？_BH_」_W"
CALL PRINT_STR, @"「急にがっつきすぎだよ…_BH_ まだ服も脱いでないのに、急に抱きついて、キスして…_BH_」_W"	CALL PRINT_STR, @"「太突然了…_BH_ 还没脱衣服…就急着来抱住我，又亲又吻的…_BH_」_W"
CALL PRINT_STR, @"「…その上、おちんぽまで擦りつけちゃって_BH_」_W"	CALL PRINT_STR, @"「…还隔着衣服把小鸡鸡压上来蹭_BH_」_W"
CALL PRINT_STR, @"「そんなに我慢できないのかな…_BH_ そっかぁ、わんちゃんみたいだねー…_BH_」_W"	CALL PRINT_STR, @"「就那么不能忍耐吗…_BH_ 这样啊，像小狗一样呢…_BH_」_W"
PRINTFORMW 「でも、このままじゃ%CNAME("二人称")%、服脱げないよ…？」	PRINTFORMW 「但是，就这样下去的话…可是很不好的 %CNAME("二人称")%」
PRINTFORMW 「服脱げなかったら、%CNAME("一人称")%ともえっちできなくなっちゃうけど…」	PRINTFORMW 「若不脱衣服、%CNAME("一人称")%就不能把小鸡鸡夹在胸里…」
PRINTFORMW 「それはいやだよね…？ …でも、お腰振るの、止めるのもいやなの…？」	PRINTFORMW 「那样很讨厌吧?…但是，不想弯下腰肢、也不想停下来…?」
CALL PRINT_STR, @"「…そっかぁ…_BH_ わがままさんだねー…_BH_」_W"	CALL PRINT_STR, @"「…这样啊…_BH_ 真是任性啊…_BH_」_W"
CALL PRINT_STR, @"「それじゃ…はい_BH_」_W"	CALL PRINT_STR, @"「那么…是_BH_」_W"
CALL PRINT_STR, @"「こうして、%CNAME("一人称")%の片手、おちんぽの先においててあげるから…_BH_」_W"	CALL PRINT_STR, @"「就这样、%CNAME("一人称")%的一只手，放在小鸡鸡的前面…_BH_」_W"
CALL PRINT_STR, @"「%CNAME("一人称")%が、%CNAME("二人称")%の服脱がし終えるまで、おててとえっちしてていいよ…_BH_」_W"	CALL PRINT_STR, @"「到%CNAME("一人称")%把%CNAME("二人称")%的衣服脱完为止、你可以先这样做…_BH_」_W"
CALL PRINT_STR, @"「ん_BH_ ちゅ、んれぅ…_BH_ ん…ふふ_BH_」_W"	CALL PRINT_STR, @"「嗯_BH_ 啊、呀……_BH_ 呋呋_BH_」_W"
CALL PRINT_STR, @"「あ…_BH_」_W"	CALL PRINT_STR, @"「啊…_BH_」_W"
CALL PRINT_STR, @"「ん、ぷぁ…_BH_ ふふ…おちんぽ、かちかち…_BH_」_W"	CALL PRINT_STR, @"「嗯，噗…_BH_ 呋呋…小鸡鸡、滴嗒滴嗒…_BH_」_W"
CALL PRINT_STR, @"「ちゅ…_BH_ んぅ…_BH_ ん…_BH_ ほら…_BH_ おててで、すりすり…_BH_」_W"	CALL PRINT_STR, @"「噗噗…_BH_ 哼…_BH_ 嗯…_BH_ 看…_BH_ 粘糊糊的…_BH_」_W"
CALL PRINT_STR, @"「あは…_BH_ 先汁ぴゅぴゅって、甘イキ…_BH_ かわいい…_BH_」_W"	CALL PRINT_STR, @"「啊哈…_BH_ 先走汁甜甜的…_BH_真可爱…_BH_」_W"
CALL PRINT_STR, @"「んちゅ…_BH_ ぴくぴく、すごいね…_BH_ ん…_BH_」_W"	CALL PRINT_STR, @"「嗯唔…_BH_ 嗖嗖、好厉害啊…_BH_ 嗯…_BH_」_W"
CALL PRINT_STR, @"「ぱちゅぱちゅって…水音、すごいよ…？_BH_」_W"	CALL PRINT_STR, @"「嗯唔…水声好厉害啊…？_BH_」_W"
CALL PRINT_STR, @"「ほら、恥ずかしがらないで…_BH_」_W"	CALL PRINT_STR, @"「别害羞啦…_BH_」_W"
CALL PRINT_STR, @"「キスすれば、きっと音も聞こえないよ…_BH_」_W"	CALL PRINT_STR, @"「接吻的话，肯定什么声音都没有…_BH_」_W"
CALL PRINT_STR, @"「だから、もっと、蕩けちゃお…_BH_」_W"	CALL PRINT_STR, @"「所以再放松一点吧…_BH_」_W"
CALL PRINT_STR, @"「太腿の間からちょこん_BH_ って、%CNAME("二人称")%の亀さんが顔出してるよ…_BH_」_W"	CALL PRINT_STR, @"「从大腿之间的缝隙_BH_ 嗯唔、%CNAME("二人称")%的小鸡鸡露脸了哟…_BH_」_W"
CALL PRINT_STR, @"「ぴくぴく震えて、とくとくって我慢汁漏らして…_BH_ 挟んでるだけなのに、すっごい気持ち良さそう…_BH_」_W"	CALL PRINT_STR, @"「不停地颤抖，咯吱咯吱地吐出先走汁…_BH_ 虽然只是夹着，但是感觉很舒服吧…_BH_」_W"
CALL PRINT_STR, @"「でも、やっぱりそれだけじゃ芸がないし…_BH_ %CNAME("二人称")%も、物足りないよね…_BH_」_W"	CALL PRINT_STR, @"「不过，光这样还是不够艺术啊…_BH_ %CNAME("二人称")%也有点欠缺呢…_BH_」_W"
CALL PRINT_STR, @"「ううん、遠慮しなくていいんだよ…_BH_ %CNAME("二人称")%は何もしなくていいから…_BH_」_W"	CALL PRINT_STR, @"「嗯，不用客气…_BH_ %CNAME("二人称")%什么都不用做…_BH_」_W"
CALL PRINT_STR, @"「ただ、このおちんぽだけ…ちょっとの間、貸してくれればいいからね…_BH_」_W"	CALL PRINT_STR, @"「只是，只有这个小鸡鸡…借我一段时间就好了…_BH_」_W"
CALL PRINT_STR, @"「…それじゃ、いじめちゃいまーす…_BH_」_W"	CALL PRINT_STR, @"「…那我就开始欺负你了…_BH_」_W"
CALL PRINT_STR, @"「おまたの間で、おちんぽすっごい暴れてる…_BH_」_W"	CALL PRINT_STR, @"「在缝隙里面瞎胡闹的是～小鸡鸡…_BH_」_W"
CALL PRINT_STR, @"「そんなに興奮しちゃった…？_BH_」_W"	CALL PRINT_STR, @"「那么兴奋了…？_BH_」_W"
CALL PRINT_STR, @"「%CNAME("一人称")%のおまんこと、触れ合うだけでこんなになるなら…_BH_」_W"	CALL PRINT_STR, @"「和%CNAME("一人称")%的大腿接触一下就成这样……_BH_」_W"
CALL PRINT_STR, @"「…太腿に挟んだまま、手コキなんてされたら、どうなちゃうかな…_BH_」_W"	CALL PRINT_STR, @"「…若是更进一步呢？那会如何呢？…_BH_」_W"
PRINTFORMW 「すっごいどろどろ…」	PRINTFORMW 「太粘稠了…」
CALL PRINT_STR, @"「もう、%CNAME("二人称")%のか%CNAME("一人称")%のか、わからないくらい…_BH_」_W"	CALL PRINT_STR, @"「已经不知道是%CNAME("二人称")%还是%CNAME("一人称")%的东西了…_BH_」_W"
CALL PRINT_STR, @"「ぬるぬるのてかてか…_BH_ ちょっと動くだけでもぬちゃぬちゃ音が鳴って…_BH_」_W"	CALL PRINT_STR, @"「滑溜溜的吗…_BH_ 只要稍微动一下就会发出咯吱咯吱的声音…_BH_」_W"
CALL PRINT_STR, @"「ふふ…_BH_ ねえ、%CNAME("二人称")%…_BH_」_W"	CALL PRINT_STR, @"「呋呋…_BH_ 呐、%CNAME("二人称")%…_BH_」_W"
CALL PRINT_STR, @"「おててで、すりすり塗り込んで…_BH_ もっとわからなくしちゃおっか…_BH_」_W"	CALL PRINT_STR, @"「唔呜呜、涂上爱液与先走汁制成的润滑剂…_BH_ 不明白的话就嗅一嗅吧…_BH_」_W"
CALL PRINT_STR, @"「うーわ…_BH_ おちんぽ、もうぱんぱん…_BH_」_W"	CALL PRINT_STR, @"「呜哇……_BH_ 小鸡鸡粘糊糊的…_BH_」_W"
CALL PRINT_STR, @"「中に詰まった精液で…_BH_ 内側から膨らんでるみたい…_BH_」_W"	CALL PRINT_STR, @"「里面装满了精液…_BH_ 就好像从内侧开始膨胀一样…_BH_」_W"
CALL PRINT_STR, @"「これじゃあ、きっとつらいよね…_BH_ むらむら…_BH_ うずうず…_BH_ 収まらないよね…_BH_」_W"	CALL PRINT_STR, @"「这样的话，一定很痛苦吧…_BH_ 滴嗒滴嗒…_BH_ 嗯唔嗯唔……_BH_」_W"
CALL PRINT_STR, @"「でも大丈夫…_BH_ %CNAME("一人称")%が…_BH_ 今からみーんな引っこ抜いてあげるから…_BH_」_W"	CALL PRINT_STR, @"「不过没关系…_BH_ %CNAME("一人称")%现在…_BH_ 就让你射出来…_BH_」_W"
CALL PRINT_STR, @"「%CNAME("二人称")%のおちんぽのこと…_BH_ ぴゅっぴゅで助けてあげるから…_BH_」_W"	CALL PRINT_STR, @"「%CNAME("二人称")%的小鸡鸡…_BH_我会好好地帮助你的…_BH_」_W"

CALL PRINT_STR, @"「ふふ…_BH_ %CNAME("二人称")%のザーメン、楽しみだな…_BH_」_W"	CALL PRINT_STR, @"「呋呋…_BH_ 好期待%CNAME("二人称")%的精液啊…_BH_」_W"
CALL PRINT_STR, @"「今回のはどんな感じなんだろうね…？_BH_ 古漬けされて黄色く濁った…_BH_ どろどろザーメンかな…？_BH_」_W"	CALL PRINT_STR, @"「这是什么呢…混浊发黄…像是尿液一样稀薄的精液…？_BH_」_W"
CALL PRINT_STR, @"「それとも…_BH_ 真っ白でぶっとい濃厚精子…？_BH_ おしっこみたいなさらさらぴゅっぴゅかも…_BH_」_W"	CALL PRINT_STR, @"「还是说…_BH_ 雪白的浓稠精液——它正确的模样是像撒尿那般潺潺的…？_BH_」_W"
CALL PRINT_STR, @"「くすくす…_BH_ %CNAME("二人称")%は、どう思う…？_BH_ 自分のことだもん…_BH_ わかるんじゃない…？_BH_」_W"	CALL PRINT_STR, @"「嘻嘻嘻嘻…_BH_ %CNAME("二人称")%怎么想…？_BH_ 因为是自己的事…还是…嗯？你是不知道吗…？_BH_」_W"
CALL PRINT_STR, @"「今…_BH_ %CNAME("一人称")%に一生懸命揉みこまれてる…_BH_ ぱんぱんに張り詰めたきんたまの中身…_BH_」_W"	CALL PRINT_STR, @"「现在…_BH_ 就由%CNAME("一人称")%来拼命地按摩、揉捏蛋蛋令其能够制造更好的精液吧_BH_」_W"
CALL PRINT_STR, @"「一体、どうなっちゃってると思う…？_BH_」_W"	CALL PRINT_STR, @"「到底会变成什么样呢…_BH_」_W"
CALL PRINT_STR, @"「%CNAME("一人称")%の両手…_BH_ すっかり真っ白になっちゃった…_BH_」_W"	CALL PRINT_STR, @"「%CNAME("一人称")%双手……_BH_ 完全变白了…_BH_」_W"
CALL PRINT_STR, @"「%CNAME("二人称")%のおちんぽせーしで…_BH_ 指の間までまんべんなく…_BH_」_W"	CALL PRINT_STR, @"「%CNAME("二人称")%的小鸡鸡…_BH_ 连十指之间的缝隙都涂白了…_BH_」_W"
CALL PRINT_STR, @"「%CNAME("一人称")%のおてて、%CNAME("二人称")%のザーメン置き場になっちゃったみたい…_BH_」_W"	CALL PRINT_STR, @"「%CNAME("一人称")%好像变成%CNAME("二人称")%的精液放置场了……_BH_」_W"
CALL PRINT_STR, @"「ほら、よーく耳を澄ませてみて…？_BH_ %CNAME("一人称")%のお肌の細胞が…_BH_」_W"	CALL PRINT_STR, @"「看，好好侧耳倾听吧 _BH_ %CNAME("一人称")%的皮肤细胞…_BH_」_W"
CALL PRINT_STR, @"「%CNAME("二人称")%のつよーい精子に…_BH_ ぱちゅぱちゅ犯されてる音…_BH_」_W"	CALL PRINT_STR, @"「被%CNAME("二人称")%的精子…_BH_ 噼啪噼啪地侵犯的声音…_BH_」_W"
CALL PRINT_STR, @"「%CNAME("二人称")%の大好きな…_BH_ %CNAME("一人称")%のすべすべお肌が…_BH_」_W"	CALL PRINT_STR, @"「%CNAME("二人称")%最喜欢的…_BH_ %CNAME("一人称")%的光滑肌肤…_BH_」_W"
CALL PRINT_STR, @"「今、%CNAME("二人称")%の精子に寝取られちゃってるんだよ…_BH_」_W"	CALL PRINT_STR, @"「现在、%CNAME("二人称")%被精子寝取了…_BH_」_W"
CALL PRINT_STR, @"「…うふふ_BH_ そんな音なんか聞こえるわけないって…？_BH_ うんうん…_BH_ 確かにそうかもねー…_BH_」_W"	CALL PRINT_STR, @"「…呋呋_BH_ 怎么可能听到那种声音呢…？_BH_ 嗯……_BH_ 确实可能是这样啊ー…_BH_」_W"
CALL PRINT_STR, @"「『%CNAME("二人称")%には』…_BH_ 聞こえないのかもねー…？_BH_」_W"	CALL PRINT_STR, @"「『%CNAME("二人称")%』…_BH_ 可能听不见吧ー…？_BH_」_W"

CALL PRINT_STR, @"「ザーメン、ダマになっちゃってるね…_BH_」_W"	CALL PRINT_STR, @"「精液，变成了汤汁啊…_BH_」_W"
CALL PRINT_STR, @"「お残しみるくでこれなんだもん…_BH_ ほんと、ますます好きになっちゃうな…_BH_」_W"	CALL PRINT_STR, @"「剩下的就是这个嘛…_BH_ 真的，越来越喜欢你了…_BH_」_W"
CALL PRINT_STR, @"「あっ…大丈夫、もちろん忘れてないよ…_BH_」_W"	CALL PRINT_STR, @"「啊…没关系，当然不会忘记的…_BH_」_W"
CALL PRINT_STR, @"「コキコキぴゅっぴゅ_BH_ はまだお預け…_BH_ 今は、お射精後の甘やかししこしこ…_BH_」_W"	CALL PRINT_STR, @"「还没用上本领呢…_BH_ 现在，仅是上次的残余啦…_BH_」_W"
CALL PRINT_STR, @"「%CNAME("二人称")%のおちんぽが…_BH_ もっと気持ちよくびゅーびゅー出来るようにするための…_BH_」_W"	CALL PRINT_STR, @"「为了能让%CNAME("二人称")%的小鸡鸡…_BH_ 更舒服地射出浓浓稠稠的精液…_BH_」_W"
CALL PRINT_STR, @"「大事な大事な…_BH_ 準備時間だもんね…_BH_」_W"	CALL PRINT_STR, @"「重要的重要的…_BH_ 准备时间到了…_BH_」_W"
CALL PRINT_STR, @"「…でもね、%CNAME("二人称")%…_BH_ ちょっとくらいなら…_BH_ お漏らししちゃっても、いいじゃないかな…？_BH_」_W"	CALL PRINT_STR, @"「…但是呢、%CNAME("二人称")%…_BH_ 如果只是一点点的话…_BH_ 即使泄出去，也没关系吧…？_BH_」_W"

CALL PRINT_STR, @"「あは…_BH_ おちんぽのしわにまでこびりついて…_BH_」_W"	CALL PRINT_STR, @"「啊哈…_BH_ 小鸡鸡的这里也粘上东西了啊…_BH_」_W"
CALL PRINT_STR, @"「よっぽど溜まっちゃってたんだねー…_BH_ 必死になって、ありもしない卵子探してる…_BH_」_W"	CALL PRINT_STR, @"「积了很多啊…_BH_ 拼命地寻找根本不存在的卵子…_BH_」_W"
CALL PRINT_STR, @"「あぁん…_BH_ くすくす…_BH_ おせーしコき取る%CNAME("一人称")%の指に…_BH_ こんなにいっぱいへばりついて…_BH_」_W"	CALL PRINT_STR, @"「啊啊…_BH_ %CNAME("一人称")%手也被粘稠稠的包裹起来了_」_W"
CALL PRINT_STR, @"「やっぱり本能的に、メスかどうかがわかっちゃうのかな…？_BH_ %CNAME("二人称")%に似て、ザーメンも優秀なんだねー…_BH_」_W"	CALL PRINT_STR, @"「果然是本能地知道、是否雌性的的一部分吧…？_BH_ 和%CNAME("二人称")%相似，精液也很优秀呢…_BH_」_W"
CALL PRINT_STR, @"「ちょっとおバカなところも、ね…_BH_ なーんて…_BH_ 冗談だよー…_BH_ だからおちんぽむくむくさせて、怒らないで…？_BH_」_W"	CALL PRINT_STR, @"「都有点傻傻的地方呢…_BH_ 嗯？为什么…_BH_ 开玩笑的哦_BH_ 所以请让我继续做下去…不要动怒～好吗？？_BH_」_W"
CALL PRINT_STR, @"「%CNAME("一人称")%、ちゃんと謝るから…_BH_」_W"	CALL PRINT_STR, @"「%CNAME("一人称")%、我会好好道歉的…_BH_」_W"
CALL PRINT_STR, @"「しっかりおてて擦り合わせて…_BH_ ごめんね…_BH_ ごめんね…_BH_ ってしてあげるから…_BH_」_W"	CALL PRINT_STR, @"「用力地紧紧搓揉…_BH_ 对不起啊…_BH_ 对不起啊…_BH_」_W"
CALL PRINT_STR, @"「だから、お許し射精、してほしいな…_BH_」_W"	CALL PRINT_STR, @"「以射精做为原谅我的信号吧…_BH_」_W"

CALL PRINT_STR, @"「ふふ…_BH_ ねばっこぉいザーメンで…_BH_ %CNAME("二人称")%のおちんぽどろどろ…_BH_」_W"	CALL PRINT_STR, @"「呋呋…_BH_ 被%CNAME("二人称")%的小鸡鸡用黏糊糊的精液涂满了…_BH_」_W"
CALL PRINT_STR, @"「おちんぽの先からきんたまの裏まで…_BH_ 濁ったザーメンソースでびたびたになってるよ…_BH_」_W"	CALL PRINT_STR, @"「但要报复回去了～从小鸡鸡的龟头到睾丸后处…都用浑浊的精液调味汁打个 蜡 吧…_BH_」_W"
CALL PRINT_STR, @"「あーぁ…_BH_ せっかくならお口で味わいたかったなぁ…_BH_」_W"	CALL PRINT_STR, @"「啊啊…_BH_ 好不容易这么来一次 真想用口来品尝啊…_BH_」_W"
CALL PRINT_STR, @"「でも、仕方ないもんね…_BH_ %CNAME("一人称")%にこんなどろどろちんぽ舐めさせちゃったら…_BH_」_W"	CALL PRINT_STR, @"「但是，没办法啊…_BH_ 如果让%CNAME("一人称")%舔了这么多黏糊糊的话…_BH_」_W"
CALL PRINT_STR, @"「%CNAME("二人称")%、どうなっちゃうかわかんないもんね…_BH_」_W"	CALL PRINT_STR, @"「不知道%CNAME("二人称")%会变成什么样…_BH_」_W"
CALL PRINT_STR, @"「くすくす…_BH_ その代わり…_BH_」_W"	CALL PRINT_STR, @"「唔呜呜…_BH_ 代替那个…_BH_」_W"
CALL PRINT_STR, @"「いつもよりねちっこく…_BH_ コキコキしちゃうから…_BH_」_W"	CALL PRINT_STR, @"「会比平时更执着…_BH_ 咯吱咯吱地玩弄哦…_BH_」_W"
CALL PRINT_STR, @"「わー…_BH_ すっごいお射精だったね…_BH_ ほら、手のひらから溢れちゃいそう…_BH_」_W"	CALL PRINT_STR, @"「哇ー…_BH_ 好厉害的射精啊…_BH_ 看，都要从手掌里溢出来了…_BH_」_W"
CALL PRINT_STR, @"「射精の余韻も長く続いて…_BH_ まだちょっと甘イきしちゃってるかな…？_BH_」_W"	CALL PRINT_STR, @"「射精的余韵也持续了很久…_BH_ 是不是还有点糖浆在里面呢…？_BH_」_W"
CALL PRINT_STR, @"「隠さなくてもわかるよ…_BH_ とくとく、ぴゅ…_BH_ って…_BH_ 追加のザーメン、出ちゃってるもん…_BH_」_W"	CALL PRINT_STR, @"「不用隐瞒也知道哦……_BH_ 看，追加的精液出来了…_BH_」_W"
CALL PRINT_STR, @"「先っぽがザーメン塗れだったら、バレないとでも思った…？_BH_ 残念でしたー…_BH_」_W"	CALL PRINT_STR, @"「如果先涂上精液的话，应该不会露馅的…？_BH_ 很遗憾——…_BH_」_W"
CALL PRINT_STR, @"「お腰の甘～い痺れと、おちんぽの嬉しそうな跳ね方…_BH_ %CNAME("一人称")%、詳しいんだよ…_BH_」_W"	CALL PRINT_STR, @"「腰部的甜蜜麻痹、和小鸡鸡开心的跳法…_BH_ %CNAME("一人称")%、我很熟悉的…_BH_」_W"
PRINTFORMW 「でも、あんまり長いとむしろおちんぽが疲れちゃうから…」	PRINTFORMW 「但是，太长的话反而会让小鸡鸡很累…」
PRINTFORMW 「お射精後の優しいマッサージ手コキで、ゆっくり労わってあげるねー…」	PRINTFORMW 「射精后用温柔的手法，慢慢地给你按摩…」
CALL PRINT_STR, @"「おちんぽもうお射精いいよ、気持ち良いの頑張らなくていいよって…%CNAME("一人称")%のおててで教えてあげるの…_BH_」_W"	CALL PRINT_STR, @"「小鸡鸡射精已经很好了，感觉舒服就行，不用特别努力再来一发…用%CNAME("一人称")%的手来告诉你吧…_BH_」_W"
PRINTFORMW 「余分な気持ちよさを、この細くて柔らかな指で濾し取って…」	PRINTFORMW 「用这纤细柔软的手指过滤掉多余的愉悦感…」
CALL PRINT_STR, @"「次のお射精を、もっと楽しめるように…_BH_ おちんぽの状態をリセットしてあげるんだよ…_BH_」_W"	CALL PRINT_STR, @"「为了更好地享受下次的射精…_BH_ 要帮你重置小鸡鸡的状态哦……_BH_」_W"
PRINTFORMW 「ほら、%CNAME("二人称")%、リラックスして、指の感覚だけ、感じていてね…」	PRINTFORMW 「看、%CNAME("二人称")%、放松，只享受手指的抚摸…」
CALL PRINT_STR, @"「%CNAME("一人称")%が、ぜーんぶ良くしてあげるから…_BH_」_W"	CALL PRINT_STR, @"「%CNAME("一人称")%我、会好好做的……_BH_」_W"

CALL PRINT_STR, @"「出したてザーメンでどろどろのおちんぽ…_BH_ すっごいえっち…_BH_」_W"	CALL PRINT_STR, @"「射出来后沾满了精液的小鸡鸡…_BH_ 太厉害了…_BH_」_W"
CALL PRINT_STR, @"「濃厚な精液でてかてか光って…_BH_ とってもかっこよくなってるよ…_BH_」_W"	CALL PRINT_STR, @"「浓厚的精液闪闪发光…_BH_ 看着很帅哦…_BH_」_W"
CALL PRINT_STR, @"「素敵だなぁ…_BH_ ちょっと手を動かすだけでほら、こんなにえっちな音まで立てて…_BH_」_W"	CALL PRINT_STR, @"「真漂亮啊…_BH_ 只要稍微动一下手，就可以发出这样H的声音…_BH_」_W"
CALL PRINT_STR, @"「将来有望な優等生ちんぽ君…_BH_ %CNAME("一人称")%、面倒見てあげたくなっちゃうな…_BH_」_W"	CALL PRINT_STR, @"「前途有为的优等生小鸡鸡君…_BH_ %CNAME("一人称")%、变得想照顾他了…_BH_」_W"
CALL PRINT_STR, @"「このちんぽに精液擦り込んで、もっともーっとえっちなおちんぽに、ね？…_BH_」_W"	CALL PRINT_STR, @"「把精液揉入茎身，令其变成最帅的小鸡鸡…吗？_BH_」_W"
CALL PRINT_STR, @"「もう…_BH_ そんなに遠慮しなくていいんだよー…？_BH_」_W"	CALL PRINT_STR, @"「已经…WH不用那么客气…？_BH_」_W"
CALL PRINT_STR, @"「ふふ…_BH_」_W"	CALL PRINT_STR, @"「呋呋…_BH_」_W"
CALL PRINT_STR, @"「じゃ、やっちゃいまーす…_BH_」_W"	CALL PRINT_STR, @"「那么，我就做了…_BH_」_W"

CALL PRINT_STR, @"「すごーい…_BH_ 溢れた精液がダマになって…_BH_ おちんぽのまわりにぷくぷくってくっついちゃってる…_BH_」_W"	CALL PRINT_STR, @"「好厉害…溢出来的精液变成了稠稠的固体…_BH_ 紧紧地粘在小鸡鸡周边…_BH_ 」_W"
CALL PRINT_STR, @"「ザーメンコーティングされたおちんぽ…_BH_ すっごいえっちだね…_BH_」_W"	CALL PRINT_STR, @"「被精液包裹的小鸡鸡…_BH_好厉害啊…_BH_」_W"
CALL PRINT_STR, @"「ちょっとおててを動かすたびに、ぐちゅ_BH_ ぶちゅ_BH_ って、大変な音、してる…_BH_」_W"	CALL PRINT_STR, @"「每次稍微动一下手的时候、就会发出_BH_ 咔嗒咔嗒_BH_ 的声音…_BH_」_W"
CALL PRINT_STR, @"「大丈夫だよ、%CNAME("一人称")%がすぐに綺麗にしてあげるから…_BH_」_W"	CALL PRINT_STR, @"「没关系、%CNAME("一人称")%会马上给你弄干净的…_BH_」_W"
CALL PRINT_STR, @"「この細い指で…真っ白せーし、からめとって…_BH_」_W"	CALL PRINT_STR, @"「就用这纤细的手指…打理干净…_BH_」_W"
CALL PRINT_STR, @"「ぴかぴかちんぽにしてあげるね…_BH_」_W"	CALL PRINT_STR, @"「弄个光溜溜的…_BH_」_W"

CALL PRINT_STR, @"「…すごいお射精だったね…_BH_」_W"	CALL PRINT_STR, @"「…好厉害的射精啊…_BH_」_W"
CALL PRINT_STR, @"「ほら、おちんぽ貸して…綺麗にしてあげるから…_BH_」_W"	CALL PRINT_STR, @"「来，将小鸡鸡放到这里…我会把它弄得干干净净的…_BH_」_W"
CALL PRINT_STR, @"「ん、すぅー…あは…_BH_ えっちなにおい、する…_BH_」_W"	CALL PRINT_STR, @"「嗯，嗯……啊哈…_BH_ 有股奇怪的味道…_BH_」_W"
CALL PRINT_STR, @"「このまま手コキでおちんぽに、ザーメンのにおい擦り付けてあげる…_BH_」_W"	CALL PRINT_STR, @"「就这样用手撸着，把精液的味道蹭上去…_BH_」_W"
CALL PRINT_STR, @"「大丈夫…_BH_ 綺麗にはなるよ、きちんと、外見上はね…_BH_」_W"	CALL PRINT_STR, @"「没关系…WH_ 外表上会好好地变干净的…_BH_」_W"

CALL PRINT_STR, @"「ん、おちんぽの中身、きちんとだせた…？_BH_」_W"	CALL PRINT_STR, @"「嗯，小鸡鸡里面的东西，全都出来了…？_BH_」_W"
CALL PRINT_STR, @"「残ザーメン感ないかな…？_BH_ おちんぽの管の中、からっぽになってる…？_BH_」_W"	CALL PRINT_STR, @"「有没有剩下的精液呢…？_BH_ 小鸡鸡的尿管里变得空空如也了…？_BH_」_W"
CALL PRINT_STR, @"「…%CNAME("一人称")%が、確かめてあげるね_BH_」_W"	CALL PRINT_STR, @"「…%CNAME("一人称")%我、来确认一下_BH_」_W"
CALL PRINT_STR, @"「このおててで…_BH_ おちんぽの中の精子も、外の精子も…_BH_」_W"	CALL PRINT_STR, @"「凭这一手…_BH_ 无论是小鸡鸡里面的，还是外面的…_BH_」_W"
CALL PRINT_STR, @"「ぜーんぶ綺麗に片付けてあげる…_BH_」_W"	CALL PRINT_STR, @"「我一定会帮你收拾干净…_BH_」_W"

CALL PRINT_STR, @"「カリ溝、指でくるくるなぞっちゃおーっと…_BH_」_W"	CALL PRINT_STR, @"「冠状沟，用手指不停地划着——…_BH_」_W"
CALL PRINT_STR, @"「ぐつぐつ_BH_ ぐつぐつ_BH_ って…きんたまのなかで精子が煮詰まってる音、聞こえてくるよ…_BH_」_W"	CALL PRINT_STR, @"「咕噜咕噜_BH_ 咕噜咕噜_BH_ 的…我能听到精液在蛋蛋里沸腾的声音…_BH_」_W"
CALL PRINT_STR, @"「こんなにザーメン溜め込んでたら、大変だったんじゃない…？_BH_」_W"	CALL PRINT_STR, @"「若是这样把精液储备起来的话，不会很辛苦吗…？_BH_」_W"
CALL PRINT_STR, @"「もう安心していいよ…_BH_」_W"	CALL PRINT_STR, @"「已经可以放心了…_BH_」_W"
CALL PRINT_STR, @"「実は%CNAME("一人称")%、男の子のきんたまからこってりせーし引っこ抜くの、得意なんだ…_BH_」_W"	CALL PRINT_STR, @"「其实%CNAME("一人称")%、很擅长从男孩子的蛋蛋里榨出东西…_BH_」_W"

CALL PRINT_STR, @"「もぉ…_BH_ 指でおちんぽなでなでするたび、びくびくびくって震えちゃって…_BH_」_W"	CALL PRINT_STR, @"「哦…_BH_ 每次用手指抚摸小鸡鸡的时候、会哆哆嗦嗦地颤动…_BH_」_W"
CALL PRINT_STR, @"「鈴口、人差し指でかりかりしたり…_BH_ 裏筋のとこ、親指でくりくりするだけで…_BH_」_W"	CALL PRINT_STR, @"「食指在马眼处上下划动，沿着系带滑落的大姆指在背部钻来钻去…_BH_」_W"
CALL PRINT_STR, @"「もうだめ_BH_ もうだめ_BH_ って、おちんちんが泣き出しちゃって…_BH_」_W"	CALL PRINT_STR, @"「快到极限了_BH_ 快到极限了_BH_ 小鸡鸡哭了出来…_BH_」_W"
CALL PRINT_STR, @"「おちんぽ、もう少し我慢強くならなきゃだめだよ…？_BH_」_W"	CALL PRINT_STR, @"「小鸡鸡君、你必须再忍耐一下才行…啊…？_BH_」_W"
CALL PRINT_STR, @"「ほら、お腰へこへこ動かしてみて…_BH_」_W"	CALL PRINT_STR, @"「喏，把腰挪一下吧…_BH_」_W"
CALL PRINT_STR, @"「おててなんかに負けないぞって…_BH_ %CNAME("一人称")%に見せて欲しいな…_BH_」_W"	CALL PRINT_STR, @"「那不服输的模样…_BH_ 让%CNAME("一人称")%好好观赏吧…_BH_」_W"

CALL PRINT_STR, @"「今、ぶぴぴぴぴっ_BH_ って音立てて甘イキしちゃったでしょ…_BH_」_W" 	CALL PRINT_STR, @"「现在，小鸡鸡和这里发出了啪啦啪啦啪啦的甜美声音呢，很舒服吧…_BH_」_W" 
CALL PRINT_STR, @"「誤魔化してもだーめ…_BH_ %CNAME("一人称")%はみんなお見通しなんだから…_BH_」_W"	CALL PRINT_STR, @"「就算糊弄过去也没关系…_BH_ 因为%CNAME("一人称")%都能预料到…_BH_」_W"
CALL PRINT_STR, @"「おちんぽの奥からザーメンが出てくるの…_BH_ おちんぽの震えで分かっちゃうんだよ…_BH_」_W"	CALL PRINT_STR, @"「接下来～就要从尿道溢出精液了吧，看小鸡鸡那可爱的颤抖就知道了…_BH_」_W"
CALL PRINT_STR, @"「ふふ…_BH_ 先輩に嘘つく%CNAME("二人称")%には、おしおきするね…_BH_」_W"	CALL PRINT_STR, @"「呋呋…_BH_ 对前辈撒谎的%CNAME("二人称")%、我要说清楚…_BH_」_W"
CALL PRINT_STR, @"「十本の指、全部使って…_BH_ とっても苦しい搾精かりかりで…_BH_ 亀頭虐めしちゃうから…_BH_」_W"	CALL PRINT_STR, @"「我将会用上十指进行非常非常闷苦的榨汁手交，并要重点关照一下龟头君…_BH_」_W"

CALL PRINT_STR, @"「おちんぽ、とっても切なさそう…_BH_」_W"	CALL PRINT_STR, @"「小鸡鸡、看起来很难过…_BH_」_W"
CALL PRINT_STR, @"「指でするする…_BH_ 撫でられてるだけじゃ我慢できなくなっちゃったんだね…_BH_」_W"	CALL PRINT_STR, @"「用手指轻轻地划…_BH_ 仅仅是被抚摸，就无法忍耐了呢…_BH_」_W"
CALL PRINT_STR, @"「うん、いいよ…_BH_ そろそろきんたまの中の精液も、十分に煮詰まってきた頃だろうし…_BH_」_W"	CALL PRINT_STR, @"「嗯，好啊…_BH_ 蛋蛋里的精液也差不多到…蒸腾的时候了…_BH_」_W"
CALL PRINT_STR, @"「%CNAME("一人称")%の細くてちっちゃいおててで、カリ首ぬちぬちぶちゅぶちゅコいて…_BH_」_W"	CALL PRINT_STR, @"「在%CNAME("一人称")%眼前，那令人悯爱的小鸡鸡、龟头不停地颤抖……_BH_」_W"
CALL PRINT_STR, @"「あつーくなったきんたま汁、どっぷりお射精しちゃおうね_BH_」_W"	CALL PRINT_STR, @"「溢流的先走汁好似在说——快点快点让我射精吧_BH_」_W"

CALL PRINT_STR, @"「下半身が溶けちゃうくらいの極楽ぴゅっぴゅ、させてあげる_BH_」_W"	CALL PRINT_STR, @"「这可是能让大脑觉得下半身要化了的极乐体验_BH_」_W"
CALL PRINT_STR, @"「イってもイっても終わらない、おちんぽコキコキ快楽ぴゅっぴゅ…_BH_」_W"	CALL PRINT_STR, @"「无论如何都不会停止的，属于小鸡鸡的至高享受…_BH_」_W"
CALL PRINT_STR, @"「一度味わったら、もう戻れないよ…？_BH_」_W"	CALL PRINT_STR, @"「一旦尝到了，就再也回不去了…吗？_BH_」_W"
CALL PRINT_STR, @"「脳みそ焦げ付いちゃうくらいの…_BH_ 一度昇ったら下りてこられない快楽の絶頂…_BH_」_W"	CALL PRINT_STR, @"「仿佛要将脑中突触烧坏般…_BH_ 不断不断地攀升的快感信号…滋味如何呢…？…_BH_」_W"
CALL PRINT_STR, @"「%CNAME("二人称")%に耐えられるかなー…？_BH_」_W"	CALL PRINT_STR, @"「%CNAME("二人称")%能忍受吗？_BH_」_W"

CALL PRINT_STR, @"「きんたまほぐして、中のザーメンどろっどろに溶かしてあげる_BH_」_W"	CALL PRINT_STR, @"「对这里进行刺激的时候，再用发带缠一圈根处绑紧…令蛋蛋里的精液沸腾起来_BH_」_W"
CALL PRINT_STR, @"「こうすれば、お射精のとき、びゅーびゅーびゅぅーっ_BH_ っておしっこみたいな勢いで尿道削りながらでてくるから…_BH_」_W"	CALL PRINT_STR, @"「这样做的话，射精时就会像尿尿一样射好久呢…_BH_」_W"
CALL PRINT_STR, @"「お射精の気持ちよさ、いつもの何倍にも引き上げられるんだよ…_BH_」_W"	CALL PRINT_STR, @"「快感也会比平时高好几倍哦…_BH_」_W"
CALL PRINT_STR, @"「普通は、気持ちよすぎて苦しくなっちゃうくらいなんだけど…_BH_」_W"	CALL PRINT_STR, @"「一般来说，舒服过头就会变得很痛苦…_BH_」_W"
CALL PRINT_STR, @"「%CNAME("二人称")%なら、絶対気に入ってくれると思うな…_BH_」_W"	CALL PRINT_STR, @"「%CNAME("二人称")%的话，绝对会喜欢的…_BH_」_W"

CALL PRINT_STR, @"「ほーら…_BH_きんたま持ち上げて…ふるふるふるーって揺らしてあげる_BH_」_W"	CALL PRINT_STR, @"「哎呀…_BH_托起蛋蛋…摇啊摇啊…按摩的感觉如何_BH_」_W"
CALL PRINT_STR, @"「たまたまの浮遊感ヤバいねー…？_BH_ ふわふわ浮かんで、不思議な感覚…_BH_」_W"	CALL PRINT_STR, @"「被托着的感觉不好吗？_BH_ 轻飘飘浮起，有种不可思议的感觉…_BH_」_W"
CALL PRINT_STR, @"「ふふ、もうむずむずしてきた…？_BH_ きんたま落ち着かなくて、精子さん怖がってるかな…？_BH_」_W"	CALL PRINT_STR, @"「呋呋、已经发痒了…?_BH_ 急不可待的滋味很棒吧～蛋蛋里的精液可是在叫着呢…_BH_」_W"
CALL PRINT_STR, @"「でも大丈夫…_BH_ きっと、すぐクセになっちゃうよ_BH_」_W"	CALL PRINT_STR, @"「但是没关系…一定很快就会上瘾的_BH_」_W"
CALL PRINT_STR, @"「これされた後は、きんたま弄られながらじゃないとお射精できなくなる人だっているんだから…_BH_」_W"	CALL PRINT_STR, @"「被这样做后，不被玩弄的话就无法射精的人也是有的…_BH_」_W"
CALL PRINT_STR, @"「何事も経験…_BH_ だよ…_BH_ ふふ…_BH_」_W"	CALL PRINT_STR, @"「这也是一种人生经验哦… 呋呋…_BH_」_W"

CALL PRINT_STR, @"「尿道つつーっ…_BH_ ってなぞってあげる_BH_」_W"	CALL PRINT_STR, @"「给你比划一下…_BH_ 尿道穴位_BH_」_W"
CALL PRINT_STR, @"「こうすれば、ぴゅーってするときスムーズにでるよ…_BH_」_W"	CALL PRINT_STR, @"「这样做的话，在紧张的时候会很顺利的…_BH_」_W"
CALL PRINT_STR, @"「どんなどろねば汚濁ザー汁でも、途中で引っかかることなく…_BH_」_W"	CALL PRINT_STR, @"「无论多么浑浊的汁液，都不会在中途被卡住…_BH_」_W"
CALL PRINT_STR, @"「びゅるびゅる_BH_ どぴゅどぴゅ_BH_ ぴゅっぴゅっぴゅー…っ_BH_ てね…_BH_」_W"	CALL PRINT_STR, @"「咕噜咕噜_BH_ 咕噜咕噜_BH_ 咕噜咕噜咕噜咕噜ー……_BH_」_W"
CALL PRINT_STR, @"「まあ、射精するまではむしろ鈴口開いてちんぽの疼きがヤバくなっちゃうんだけど…_BH_」_W"	CALL PRINT_STR, @"「不过，在射精之前，马眼张开的疼痛反而会加剧…_BH_」_W"
CALL PRINT_STR, @"「お射精ぴゅっぴゅの気持ちよさのためなら、いいよね…？_BH_」_W"	CALL PRINT_STR, @"「但为了嗖嗖地射精时的快感……就没问题吧…？_BH_」_W"

PRINTFORMW 「%CNAME("一人称")%のおてて、すっかり%CNAME("二人称")%のおちんぽのこと、覚えちゃった…」	PRINTFORMW 「因为%CNAME("一人称")%、完全记住了%CNAME("二人称")%的小鸡鸡…」
CALL PRINT_STR, @"「敏感なカリも…_BH_ ちょっぴり太めの尿道も…_BH_ くぅーっと反り返った竿の形も…_BH__」_W"	CALL PRINT_STR, @"「敏感的系带也是，尿道骤张的时机也是，茎身膨胀的瞬间也一样………_BH__」_W"
CALL PRINT_STR, @"「みんなみぃーんな、覚えちゃったよ…？_BH_」_W"	CALL PRINT_STR, @"「都记住了呢…_BH_」_W"

PRINTFORMW 「わわっ…%CNAME("二人称")%、おててに向かってハメ腰つかっちゃってる…？」	PRINTFORMW 「哇……%CNAME("二人称")%、小鸡鸡在手里的时候就任意妄为地动起腰肢…呢…？」
CALL PRINT_STR, @"「カリ首甘やかされながらシコシコされて、そんなに嬉しくなっちゃったの…？_BH_」_W"	CALL PRINT_STR, @"「龟头被娇惯地揉搓着的感觉很好吗，都溢出喜悦的先走汁了…？_BH_」_W"
CALL PRINT_STR, @"「そっか…_BH_ %CNAME("二人称")%、こういうのも好きなんだね…_BH_」_W"	CALL PRINT_STR, @"「这样啊…_BH_ %CNAME("二人称")%也喜欢这样的啊…_BH_」_W"
CALL PRINT_STR, @"「じゃあ、この責め、もう少し続けてあげる…_BH_」_W"	CALL PRINT_STR, @"「那么，这种欺负游戏就做久一点吧…_BH_」_W"
CALL PRINT_STR, @"「満足するまで、お腰かくかくさせてていいから…_BH_」_W"	CALL PRINT_STR, @"「在满足之前可不会停下来哦…_BH_」_W"
CALL PRINT_STR, @"「好きなだけ気持ちよくなって…_BH_ 好きなときにぴゅっぴゅしてね…_BH_」_W"	CALL PRINT_STR, @"「随心所欲涨升的快乐浪潮，在攀至顶点前…射精就太失礼了…_BH_」_W"

CALL PRINT_STR, @"「%CNAME("二人称")%、すっかりお腰ががくがくって…_BH_」_W"	CALL PRINT_STR, @"「%CNAME("二人称")%、腰都在发抖了…_BH_」_W"
PRINTFORMW 「…さすがに心配になっちゃうな…ちょっとおちんぽ休憩しよっか…」	PRINTFORMW 「…真让人担心啊…稍微休息一下吧…」
CALL PRINT_STR, @"「…かわりに、こっち_BH_」_W"	CALL PRINT_STR, @"「…作为代替…就由这边来吧_BH_」_W"
CALL PRINT_STR, @"「かまってかまってー_BH_ って、持ち上がって自己主張してるぱんぱんのきんたま…_BH_」_W"	CALL PRINT_STR, @"「只顾着产生侵犯卵子的精液…_BH_ 膨胀得愈来愈沉重的睾丸…_BH_」_W"
CALL PRINT_STR, @"「おててでたっぷりあやしてあげる…_BH_」_W"	CALL PRINT_STR, @"「用手好好哄哄…_BH_」_W"
CALL PRINT_STR, @"「おちんぽは休んでていいからね…_BH_」_W"	CALL PRINT_STR, @"「并把脸贴在一边说：小鸡鸡可以休息了…_BH_」_W"
CALL PRINT_STR, @"「でも、もし%CNAME("一人称")%が熱中しすぎて…_BH_ おちんぽが我慢できなくなっちゃったら…_BH_」_W"	CALL PRINT_STR, @"「但是，如果%CNAME("一人称")%过于热情…_BH_ 而导致小鸡鸡耐不住的话……_BH_」_W"
CALL PRINT_STR, @"「そのときは、何かの合図…_BH_ 『出して』くれたら気づけるかも…_BH_」_W"	CALL PRINT_STR, @"「会很在意之后的模样和其主人那闷苦的表情…_BH_」_W"
CALL PRINT_STR, @"「くす…_BH_」_W"	CALL PRINT_STR, @"「呐…_BH_」_W"

//40-AM 綾乃 ぱふぱふ手コキ
CALL PRINT_STR, @"「ん…たくさん飲んでいいからね_BH_」_W"	CALL PRINT_STR, @"「嗯…有很多可以喝哦_BH_」_W"
CALL PRINT_STR, @"「たくさんみるく…ごくごくのんで…_BH_」_W"	CALL PRINT_STR, @"「嘟噜嘟噜地喝了很多呢……_BH_」_W"
CALL PRINT_STR, @"「ふふ…_BH_ たのしみ…_BH_」_W"	CALL PRINT_STR, @"「呋呋…_BH_ 很兴奋呀…_BH_」_W"
CALL PRINT_STR, @"「ん…_BH_ しこしこ激しくしたら…ごくごく強くなったね…？_BH_」_W"	CALL PRINT_STR, @"「嗯…_BH_ 紧紧地吸着不放呢，可以再激烈一点吗…？_BH_」_W"
CALL PRINT_STR, @"「いいよ、もっとしてあげる…_BH_」_W"	CALL PRINT_STR, @"「来吧，请随意…_BH_」_W"
CALL PRINT_STR, @"「おっぱい飲むのにペース合わせて…_BH_ しこしこしこ_BH_ ってあやしてあげる…_BH_」_W"	CALL PRINT_STR, @"「要配合嘴巴的吮吸节奏，对小鸡鸡进行爱抚咯～_BH_」_W"
CALL PRINT_STR, @"「今日はどれくらいお射精ぴゅっぴゅしたいのか…_BH_ %CNAME("一人称")%に教えてね…_BH_」_W"	CALL PRINT_STR, @"「今天想射多少精液呢…_BH_ 请告诉%CNAME("一人称")%我…_BH_」_W"
CALL PRINT_STR, @"「ふふ…_BH_ そんなに飲んで大丈夫…？_BH_」_W"	CALL PRINT_STR, @"「呋呋…_BH_ 喝那么多没关系吗…？_BH_」_W"
CALL PRINT_STR, @"「いいよー…_BH_」_W"	CALL PRINT_STR, @"「啊呀ー…_BH_」_W"
CALL PRINT_STR, @"「お顔はおっぱいで甘やかしてあげるから…_BH_」_W"	CALL PRINT_STR, @"「我会用这重重的胸部在你陶醉的脸上碾来碾去…_BH_」_W"
CALL PRINT_STR, @"「おちんぽはおててで、ね…_BH_」_W"	CALL PRINT_STR, @"「小鸡鸡一听到这个，就变得更加勃立呢…_BH_」_W"
CALL PRINT_STR, @"「おちんぽのほうも、もっと遊ばせてあげる…_BH_」_W"	CALL PRINT_STR, @"「也该让小鸡鸡玩一会吧～呐～…_BH_」_W"
CALL PRINT_STR, @"「%CNAME("一人称")%のおててで…我慢してね…_BH_」_W"	CALL PRINT_STR, @"「在%CNAME("一人称")%的爱抚下…忍耐一会吧…_BH_」_W"
CALL PRINT_STR, @"「ほーら、がんばれ_BH_ がんばれ…_BH_」_W"	CALL PRINT_STR, @"「哇，加油_BH_ 加油…_BH_」_W"
CALL PRINT_STR, @"「おっぱいちゅぱちゅぱ甘えながら、おててでおちんぽしこしこしゅっしゅ…_BH_」_W"	CALL PRINT_STR, @"「一边向胸部撒娇、一边被爱抚小鸡鸡…_BH_」_W"
CALL PRINT_STR, @"「そのままどんどん力抜いてこ…？_BH_ リラックスして…_BH_ おちんぽぴゅっぴゅ、準備しよ…_BH_」_W"	CALL PRINT_STR, @"「就这样不断地放松_BH_ 放松…_BH_ 小鸡鸡准备好嗖嗖嗖地射精了吗～…_BH_」_W"
CALL PRINT_STR, @"「きんたまの中のザーメンも、早くあわせてあげよっかな…_BH_」_W"	CALL PRINT_STR, @"「承载精液的蛋蛋也要好好爱抚一下…_BH_」_W"
CALL PRINT_STR, @"「ん…おちんぽのびくびく、もっと強くなってきた…_BH_」_W"	CALL PRINT_STR, @"「嗯…小鸡鸡也颤得更厉害了～_BH_」_W"
CALL PRINT_STR, @"「負けちゃだめだよ…%CNAME("二人称")%…」_W"	CALL PRINT_STR, @"「不能输哦…%CNAME("二人称")%…」_W"
CALL PRINT_STR, @"「いい子だねー…%CNAME("二人称")%…_BH_」_W"	CALL PRINT_STR, @"「真乖啊ー…%CNAME("二人称")%…_BH_」_W"
CALL PRINT_STR, @"「言わなくてもわかるよ…_BH_」_W"	CALL PRINT_STR, @"「不说也能明白…_BH_」_W"
CALL PRINT_STR, @"「ふふ…_BH_ かわいい…_BH_」_W"	CALL PRINT_STR, @"「呋呋…_BH_ 可爱…_BH_」_W"
CALL PRINT_STR, @"「いっぱい嗅いで…_BH_ いっぱいだしちゃお…_BH_」_W"	CALL PRINT_STR, @"「但你不同，那特别的体质让能够你反复品尝我的身体…_BH_」_W"
CALL PRINT_STR, @"「ぐぅー…って、おっぱいを押し付けられるの、気持ちいいかな_BH_」_W"	CALL PRINT_STR, @"「…被这么对待…很舒服吗？_BH_」_W"
CALL PRINT_STR, @"「%CNAME("二人称")%のおちんぽも…_BH_ %CNAME("一人称")%のおっぱい欲しくて、ずるいずるいってわがまま言ってる…_BH_」_W"	CALL PRINT_STR, @"「%CNAME("二人称")%的小鸡鸡…_BH_狡猾且任性吵着说—— 想要%CNAME("一人称")%的胸部…_BH_」_W"
CALL PRINT_STR, @"「ごめんね、おちんぽ君…_BH_」_W"	CALL PRINT_STR, @"「对不起，小鸡鸡君…_BH_」_W"
CALL PRINT_STR, @"「%CNAME("一人称")%のおっぱい、今は%CNAME("二人称")%の相手してるから…_BH_」_W"	CALL PRINT_STR, @"「%CNAME("一人称")%的胸部、现在是%CNAME("二人称")%的…_BH_」_W"
CALL PRINT_STR, @"「ずいぶん深く、谷間に潜っちゃってるけど…_BH_ ちゃんと、息継ぎできてるかな…？_BH_」_W"	CALL PRINT_STR, @"「在乳谷里埋得相当深呢，不会感到呼吸困难吗？_BH_」_W"
CALL PRINT_STR, @"「淫魔のフェロモン、肺に満たして…_BH_」_W"	CALL PRINT_STR, @"「让淫魔费洛蒙，塞满肺部…_BH_」_W"
CALL PRINT_STR, @"「そのままいっぱいむらむら高めて…_BH_ きんたま、ぎゅんぎゅん稼動させちゃお…_BH_」_W"	CALL PRINT_STR, @"「就这样不断吸入…_BH_让蛋蛋努力生产吧…_BH_」_W"
//40-AM 綾乃 愛撫
CALL PRINT_STR, @"「%CNAME("二人称")%の手、あったかい…_BH_」_W"	CALL PRINT_STR, @"「%CNAME("二人称")%的手很温暖…_BH_」_W"
CALL PRINT_STR, @"「%CNAME("一人称")%の身体触って、いっぱい興奮してくれてるんだね…_BH_」_W"	CALL PRINT_STR, @"「在触摸%CNAME("一人称")%身体的时候，心跳骤然变快了呢…_BH_」_W"
CALL PRINT_STR, @"「嬉しいな…_BH_ その調子で、どんどんむらむら高めていこうね…_BH_」_W"	CALL PRINT_STR, @"「真兴奋…_BH_ 就按这样的步调来吧，要慢慢触及绝顶了哦…_BH_」_W"
CALL PRINT_STR, @"「遠慮しなくていいからね…_BH_」_W"	CALL PRINT_STR, @"「别顾虑这么多，来吧………_BH_」_W"
CALL PRINT_STR, @"「%CNAME("一人称")%の身体の、好きなところを好きなだけ触って…_BH_」_W"	CALL PRINT_STR, @"「依照嗜好去摸去碰%CNAME("一人称")%的身体吧～_BH_」_W"
CALL PRINT_STR, @"「それでそのまま、好きなときにびゅーびゅーしちゃおうね…_BH_」_W"	CALL PRINT_STR, @"「就是这样～顺从冲动去摸索每个角落、去掘发新的性感带吧…_BH_」_W"
PRINTFORMW 「もっと触って…？」	PRINTFORMW 「再摸一下……」
PRINTFORMW 「%CNAME("一人称")%の、胸も、お尻も…」	PRINTFORMW 「无论是%CNAME("一人称")%的胸部还是臀部…」
CALL PRINT_STR, @"「みんなみんな、%CNAME("二人称")%のものなんだよ…_BH_」_W"	CALL PRINT_STR, @"「……都是%CNAME("二人称")%的玩具哟…_BH_」_W"
PRINTFORMW 「%CNAME("一人称")%の身体、どうかな？」	PRINTFORMW 「%CNAME("一人称")%的身体又是怎样呢？」
PRINTFORMW 「…いっぱいおせーし作れそう？」	PRINTFORMW 「…好像是能把子宫干得自主吸紧龟头的好货呢～」
CALL PRINT_STR, @"「こぽこぽこぽ…_BH_ って、きんたま興奮できそうかな…？_BH_」_W"	CALL PRINT_STR, @"「啊啦啊啦…_BH_ 变得更勃更有魅力了呀～_BH_」_W"
CALL PRINT_STR, @"「わ…_BH_ えっちな触り方…_BH_」_W"	CALL PRINT_STR, @"「哇…_BH_ 准确的摸法…_BH_」_W"
CALL PRINT_STR, @"「%CNAME("一人称")%、これからどうされちゃうのかな…_BH_ こわいなぁ…_BH_」_W"	CALL PRINT_STR, @"「接下来要对%CNAME("一人称")%做什么呢_BH_ 好可怕啊…_BH_」_W"
PRINTFORMW 「そのままぎゅってしてくれる…？」	PRINTFORMW 「就那样交给我…？」
CALL PRINT_STR, @"「えへへ…_BH_ ありがとう…_BH_」_W"	CALL PRINT_STR, @"「嘿嘿…_BH_ 谢谢…_BH_」_W"
PRINTFORMW 「%CNAME("一人称")%のからだ触って、いっぱいいっぱい興奮して」	PRINTFORMW 「摸了%CNAME("一人称")%的身体的时候，心跳骤然变快了呢_BH_」_W"
CALL PRINT_STR, @"「%CNAME("二人称")%のきんたまの中身、たっぷり濃くしようね…_BH_」_W"	CALL PRINT_STR, @"「希望%CNAME("二人称")%睾丸里的精液浓稠到能把子宫口塞住呢…_BH_」_W"
PRINTFORMW 「もっと欲しいな…」	PRINTFORMW 「想要更多…」
PRINTFORMW 「もっともっと、%CNAME("一人称")%の身体全部、調べつくしちゃうみたいな…」	PRINTFORMW 「再多一点，把%CNAME("一人称")%的身体最隐私、最敏感的地方都找出来吧～」
CALL PRINT_STR, @"「そんな濃厚な愛撫…_BH_」_W"	CALL PRINT_STR, @"「那么舒服的爱抚…_BH_」_W"
CALL PRINT_STR, @"「%CNAME("二人称")%…_BH_ 出来るかな…？_BH_」_W"	CALL PRINT_STR, @"「%CNAME("二人称")%…_BH_ 能做到更好吗…？_BH_」_W"
PRINTFORMW 「お肌の手入れには気を使ってるから…」	PRINTFORMW 「因为对皮肤的保养很用心…」
PRINTFORMW 「触り心地、いいでしょ？」	PRINTFORMW 「摸起来很舒服吧？」
CALL PRINT_STR, @"「…あは_BH_ 素直な反応…_BH_」_W"	CALL PRINT_STR, @"「…啊_BH_ 真是坦率的反应…_BH_」_W"
CALL PRINT_STR, @"「かわいいね…_BH_ もっと大胆に触ってもいいよ…_BH_」_W"	CALL PRINT_STR, @"「好可爱啊…_BH_可以更大胆地摸哦…_BH_」_W"
CALL PRINT_STR, @"「ふふ、嬉しい…_BH_」_W"	CALL PRINT_STR, @"「呵呵，好开心…_BH_」_W"
CALL PRINT_STR, @"「そんなに遠慮しないでいいよ…_BH_」_W"	CALL PRINT_STR, @"「别顾虑这么多，来吧…_BH_」_W"
CALL PRINT_STR, @"「せっかくだもん_BH_ もっと気軽に気持ちよくなっちゃお…_BH_」_W"	CALL PRINT_STR, @"「好不容易_BH_变得这么舒服、愉快………_BH_」_W"
//40-AM 綾乃 手淫 手淫派生 后半部分-完毕
CALL PRINT_STR, @"「%CNAME("二人称")%のおちんぽ…_BH_ もう待ちきれないって感じだね…_BH_」_W"	CALL PRINT_STR, @"「%CNAME("二人称")%的小鸡鸡…_BH_ 感觉已经迫不及待了呢…_BH_」_W"
CALL PRINT_STR, @"「服の上から擦ってるだけなのに、こんなにおつゆが漏れちゃってる…_BH_」_W"	CALL PRINT_STR, @"「只是被衣袖磨过，就流出这么多的先走汁…_BH_」_W"
CALL PRINT_STR, @"「あは_BH_ びくってした…_BH_ かわいー…_BH_」_W"	CALL PRINT_STR, @"「啊哈_BH_ 吓了一跳…_BH_ 真可爱…_BH_」_W"
CALL PRINT_STR, @"「もしかして、我慢できない…？_BH_ %CNAME("一人称")%の指、生で感じたい…？_BH_」_W"	CALL PRINT_STR, @"「也许是无法忍受…？_BH_ %CNAME("一人称")%的手指、带来的感觉…？_BH_」_W"
CALL PRINT_STR, @"「…%CNAME("一人称")%も、おんなじ気持ち_BH_」_W"	CALL PRINT_STR, @"「…%CNAME("一人称")%也是同样的心情_BH_」_W"
CALL PRINT_STR, @"「ううん、もっとすごいかも…_BH_」_W"	CALL PRINT_STR, @"「不，可能更厉害…_BH_」_W"
CALL PRINT_STR, @"「だって、むらむら高まってるときに、そんな可愛いこといわれたら、我慢できない…_BH_」_W"	CALL PRINT_STR, @"「在情绪高涨的时候，听到这么可爱的话，就要受不了了…_BH_」_W"
CALL PRINT_STR, @"「%CNAME("二人称")%のこと、どろどろに蕩かしてあげるから…_BH_」_W"	CALL PRINT_STR, @"「%CNAME("二人称")%、我会把你弄得欲仙欲死的…_BH_」_W"
CALL PRINT_STR, @"「…でも、まずはキスから、ね…_BH_」_W"	CALL PRINT_STR, @"「…但要从接吻先开始…_BH_」_W"
CALL PRINT_STR, @"「んっ_BH_ もう、んふ_BH_ ん、ちゅ…_BH_ ん…_BH_」_W"	CALL PRINT_STR, @"「嗯_BH_ 呀…_BH_ 嗯…_BH_ 呀…WH_」_W"
CALL PRINT_STR, @"「ぷぁ…_BH_ ちょっと、%CNAME("二人称")%…？_BH_」_W"	CALL PRINT_STR, @"「嗯啊…_BH_ %CNAME("二人称")%…？_BH_」_W"
CALL PRINT_STR, @"「急にがっつきすぎだよ…_BH_ まだ服も脱いでないのに、急に抱きついて、キスして…_BH_」_W"	CALL PRINT_STR, @"「太突然了…_BH_ 还没脱衣服…就急着来抱住我，又亲又吻的…_BH_」_W"
CALL PRINT_STR, @"「…その上、おちんぽまで擦りつけちゃって_BH_」_W"	CALL PRINT_STR, @"「…还隔着衣服把小鸡鸡压上来蹭_BH_」_W"
CALL PRINT_STR, @"「そんなに我慢できないのかな…_BH_ そっかぁ、わんちゃんみたいだねー…_BH_」_W"	CALL PRINT_STR, @"「就那么不能忍耐吗…_BH_ 这样啊，像小狗一样呢…_BH_」_W"
PRINTFORMW 「でも、このままじゃ%CNAME("二人称")%、服脱げないよ…？」	PRINTFORMW 「但是，就这样下去的话…可是很不好的 %CNAME("二人称")%」
PRINTFORMW 「服脱げなかったら、%CNAME("一人称")%ともえっちできなくなっちゃうけど…」	PRINTFORMW 「若不脱衣服、%CNAME("一人称")%就不能把小鸡鸡夹在胸里…」
PRINTFORMW 「それはいやだよね…？ …でも、お腰振るの、止めるのもいやなの…？」	PRINTFORMW 「那样很讨厌吧?…但是，不想弯下腰肢、也不想停下来…?」
CALL PRINT_STR, @"「…そっかぁ…_BH_ わがままさんだねー…_BH_」_W"	CALL PRINT_STR, @"「…这样啊…_BH_ 真是任性啊…_BH_」_W"
CALL PRINT_STR, @"「それじゃ…はい_BH_」_W"	CALL PRINT_STR, @"「那么…是_BH_」_W"
CALL PRINT_STR, @"「こうして、%CNAME("一人称")%の片手、おちんぽの先においててあげるから…_BH_」_W"	CALL PRINT_STR, @"「就这样、%CNAME("一人称")%的一只手，放在小鸡鸡的前面…_BH_」_W"
CALL PRINT_STR, @"「%CNAME("一人称")%が、%CNAME("二人称")%の服脱がし終えるまで、おててとえっちしてていいよ…_BH_」_W"	CALL PRINT_STR, @"「到%CNAME("一人称")%把%CNAME("二人称")%的衣服脱完为止、你可以先这样做…_BH_」_W"
CALL PRINT_STR, @"「ん_BH_ ちゅ、んれぅ…_BH_ ん…ふふ_BH_」_W"	CALL PRINT_STR, @"「嗯_BH_ 啊、呀……_BH_ 呋呋_BH_」_W"
CALL PRINT_STR, @"「あ…_BH_」_W"	CALL PRINT_STR, @"「啊…_BH_」_W"
CALL PRINT_STR, @"「ん、ぷぁ…_BH_ ふふ…おちんぽ、かちかち…_BH_」_W"	CALL PRINT_STR, @"「嗯，噗…_BH_ 呋呋…小鸡鸡、滴嗒滴嗒…_BH_」_W"
CALL PRINT_STR, @"「ちゅ…_BH_ んぅ…_BH_ ん…_BH_ ほら…_BH_ おててで、すりすり…_BH_」_W"	CALL PRINT_STR, @"「噗噗…_BH_ 哼…_BH_ 嗯…_BH_ 看…_BH_ 粘糊糊的…_BH_」_W"
CALL PRINT_STR, @"「あは…_BH_ 先汁ぴゅぴゅって、甘イキ…_BH_ かわいい…_BH_」_W"	CALL PRINT_STR, @"「啊哈…_BH_ 先走汁甜甜的…_BH_真可爱…_BH_」_W"
CALL PRINT_STR, @"「んちゅ…_BH_ ぴくぴく、すごいね…_BH_ ん…_BH_」_W"	CALL PRINT_STR, @"「嗯唔…_BH_ 嗖嗖、好厉害啊…_BH_ 嗯…_BH_」_W"
CALL PRINT_STR, @"「ぱちゅぱちゅって…水音、すごいよ…？_BH_」_W"	CALL PRINT_STR, @"「嗯唔…水声好厉害啊…？_BH_」_W"
CALL PRINT_STR, @"「ほら、恥ずかしがらないで…_BH_」_W"	CALL PRINT_STR, @"「别害羞啦…_BH_」_W"
CALL PRINT_STR, @"「キスすれば、きっと音も聞こえないよ…_BH_」_W"	CALL PRINT_STR, @"「接吻的话，肯定什么声音都没有…_BH_」_W"
CALL PRINT_STR, @"「だから、もっと、蕩けちゃお…_BH_」_W"	CALL PRINT_STR, @"「所以再放松一点吧…_BH_」_W"
CALL PRINT_STR, @"「太腿の間からちょこん_BH_ って、%CNAME("二人称")%の亀さんが顔出してるよ…_BH_」_W"	CALL PRINT_STR, @"「从大腿之间的缝隙_BH_ 嗯唔、%CNAME("二人称")%的小鸡鸡露脸了哟…_BH_」_W"
CALL PRINT_STR, @"「ぴくぴく震えて、とくとくって我慢汁漏らして…_BH_ 挟んでるだけなのに、すっごい気持ち良さそう…_BH_」_W"	CALL PRINT_STR, @"「不停地颤抖，咯吱咯吱地吐出先走汁…_BH_ 虽然只是夹着，但是感觉很舒服吧…_BH_」_W"
CALL PRINT_STR, @"「でも、やっぱりそれだけじゃ芸がないし…_BH_ %CNAME("二人称")%も、物足りないよね…_BH_」_W"	CALL PRINT_STR, @"「不过，光这样还是不够艺术啊…_BH_ %CNAME("二人称")%也有点欠缺呢…_BH_」_W"
CALL PRINT_STR, @"「ううん、遠慮しなくていいんだよ…_BH_ %CNAME("二人称")%は何もしなくていいから…_BH_」_W"	CALL PRINT_STR, @"「嗯，不用客气…_BH_ %CNAME("二人称")%什么都不用做…_BH_」_W"
CALL PRINT_STR, @"「ただ、このおちんぽだけ…ちょっとの間、貸してくれればいいからね…_BH_」_W"	CALL PRINT_STR, @"「只是，只有这个小鸡鸡…借我一段时间就好了…_BH_」_W"
CALL PRINT_STR, @"「…それじゃ、いじめちゃいまーす…_BH_」_W"	CALL PRINT_STR, @"「…那我就开始欺负你了…_BH_」_W"
CALL PRINT_STR, @"「おまたの間で、おちんぽすっごい暴れてる…_BH_」_W"	CALL PRINT_STR, @"「在缝隙里面瞎胡闹的是～小鸡鸡…_BH_」_W"
CALL PRINT_STR, @"「そんなに興奮しちゃった…？_BH_」_W"	CALL PRINT_STR, @"「那么兴奋了…？_BH_」_W"
CALL PRINT_STR, @"「%CNAME("一人称")%のおまんこと、触れ合うだけでこんなになるなら…_BH_」_W"	CALL PRINT_STR, @"「和%CNAME("一人称")%的大腿接触一下就成这样……_BH_」_W"
CALL PRINT_STR, @"「…太腿に挟んだまま、手コキなんてされたら、どうなちゃうかな…_BH_」_W"	CALL PRINT_STR, @"「…若是更进一步呢？那会如何呢？…_BH_」_W"
PRINTFORMW 「すっごいどろどろ…」	PRINTFORMW 「太粘稠了…」
CALL PRINT_STR, @"「もう、%CNAME("二人称")%のか%CNAME("一人称")%のか、わからないくらい…_BH_」_W"	CALL PRINT_STR, @"「已经不知道是%CNAME("二人称")%还是%CNAME("一人称")%的东西了…_BH_」_W"
CALL PRINT_STR, @"「ぬるぬるのてかてか…_BH_ ちょっと動くだけでもぬちゃぬちゃ音が鳴って…_BH_」_W"	CALL PRINT_STR, @"「滑溜溜的吗…_BH_ 只要稍微动一下就会发出咯吱咯吱的声音…_BH_」_W"
CALL PRINT_STR, @"「ふふ…_BH_ ねえ、%CNAME("二人称")%…_BH_」_W"	CALL PRINT_STR, @"「呋呋…_BH_ 呐、%CNAME("二人称")%…_BH_」_W"
CALL PRINT_STR, @"「おててで、すりすり塗り込んで…_BH_ もっとわからなくしちゃおっか…_BH_」_W"	CALL PRINT_STR, @"「唔呜呜、涂上爱液与先走汁制成的润滑剂…_BH_ 不明白的话就嗅一嗅吧…_BH_」_W"
CALL PRINT_STR, @"「うーわ…_BH_ おちんぽ、もうぱんぱん…_BH_」_W"	CALL PRINT_STR, @"「呜哇……_BH_ 小鸡鸡粘糊糊的…_BH_」_W"
CALL PRINT_STR, @"「中に詰まった精液で…_BH_ 内側から膨らんでるみたい…_BH_」_W"	CALL PRINT_STR, @"「里面装满了精液…_BH_ 就好像从内侧开始膨胀一样…_BH_」_W"
CALL PRINT_STR, @"「これじゃあ、きっとつらいよね…_BH_ むらむら…_BH_ うずうず…_BH_ 収まらないよね…_BH_」_W"	CALL PRINT_STR, @"「这样的话，一定很痛苦吧…_BH_ 滴嗒滴嗒…_BH_ 嗯唔嗯唔……_BH_」_W"
CALL PRINT_STR, @"「でも大丈夫…_BH_ %CNAME("一人称")%が…_BH_ 今からみーんな引っこ抜いてあげるから…_BH_」_W"	CALL PRINT_STR, @"「不过没关系…_BH_ %CNAME("一人称")%现在…_BH_ 就让你射出来…_BH_」_W"
CALL PRINT_STR, @"「%CNAME("二人称")%のおちんぽのこと…_BH_ ぴゅっぴゅで助けてあげるから…_BH_」_W"	CALL PRINT_STR, @"「%CNAME("二人称")%的小鸡鸡…_BH_我会好好地帮助你的…_BH_」_W"
CALL PRINT_STR, @"「ふふ…_BH_ %CNAME("二人称")%のザーメン、楽しみだな…_BH_」_W"	CALL PRINT_STR, @"「呋呋…_BH_ 好期待%CNAME("二人称")%的精液啊…_BH_」_W"
CALL PRINT_STR, @"「今回のはどんな感じなんだろうね…？_BH_ 古漬けされて黄色く濁った…_BH_ どろどろザーメンかな…？_BH_」_W"	CALL PRINT_STR, @"「这是什么呢…混浊发黄…像是尿液一样稀薄的精液…？_BH_」_W"
CALL PRINT_STR, @"「それとも…_BH_ 真っ白でぶっとい濃厚精子…？_BH_ おしっこみたいなさらさらぴゅっぴゅかも…_BH_」_W"	CALL PRINT_STR, @"「还是说…_BH_ 雪白的浓稠精液——它正确的模样是像撒尿那般潺潺的…？_BH_」_W"
CALL PRINT_STR, @"「くすくす…_BH_ %CNAME("二人称")%は、どう思う…？_BH_ 自分のことだもん…_BH_ わかるんじゃない…？_BH_」_W"	CALL PRINT_STR, @"「嘻嘻嘻嘻…_BH_ %CNAME("二人称")%怎么想…？_BH_ 因为是自己的事…还是…嗯？你是不知道吗…？_BH_」_W"
CALL PRINT_STR, @"「今…_BH_ %CNAME("一人称")%に一生懸命揉みこまれてる…_BH_ ぱんぱんに張り詰めたきんたまの中身…_BH_」_W"	CALL PRINT_STR, @"「现在…_BH_ 就由%CNAME("一人称")%来拼命地按摩、揉捏蛋蛋令其能够制造更好的精液吧_BH_」_W"
CALL PRINT_STR, @"「一体、どうなっちゃってると思う…？_BH_」_W"	CALL PRINT_STR, @"「到底会变成什么样呢…_BH_」_W"
CALL PRINT_STR, @"「%CNAME("一人称")%の両手…_BH_ すっかり真っ白になっちゃった…_BH_」_W"	CALL PRINT_STR, @"「%CNAME("一人称")%双手……_BH_ 完全变白了…_BH_」_W"
CALL PRINT_STR, @"「%CNAME("二人称")%のおちんぽせーしで…_BH_ 指の間までまんべんなく…_BH_」_W"	CALL PRINT_STR, @"「%CNAME("二人称")%的小鸡鸡…_BH_ 连十指之间的缝隙都涂白了…_BH_」_W"
CALL PRINT_STR, @"「%CNAME("一人称")%のおてて、%CNAME("二人称")%のザーメン置き場になっちゃったみたい…_BH_」_W"	CALL PRINT_STR, @"「%CNAME("一人称")%好像变成%CNAME("二人称")%的精液放置场了……_BH_」_W"
CALL PRINT_STR, @"「ほら、よーく耳を澄ませてみて…？_BH_ %CNAME("一人称")%のお肌の細胞が…_BH_」_W"	CALL PRINT_STR, @"「看，好好侧耳倾听吧 _BH_ %CNAME("一人称")%的皮肤细胞…_BH_」_W"
CALL PRINT_STR, @"「%CNAME("二人称")%のつよーい精子に…_BH_ ぱちゅぱちゅ犯されてる音…_BH_」_W"	CALL PRINT_STR, @"「被%CNAME("二人称")%的精子…_BH_ 噼啪噼啪地侵犯的声音…_BH_」_W"
CALL PRINT_STR, @"「%CNAME("二人称")%の大好きな…_BH_ %CNAME("一人称")%のすべすべお肌が…_BH_」_W"	CALL PRINT_STR, @"「%CNAME("二人称")%最喜欢的…_BH_ %CNAME("一人称")%的光滑肌肤…_BH_」_W"
CALL PRINT_STR, @"「今、%CNAME("二人称")%の精子に寝取られちゃってるんだよ…_BH_」_W"	CALL PRINT_STR, @"「现在、%CNAME("二人称")%被精子寝取了…_BH_」_W"
CALL PRINT_STR, @"「…うふふ_BH_ そんな音なんか聞こえるわけないって…？_BH_ うんうん…_BH_ 確かにそうかもねー…_BH_」_W"	CALL PRINT_STR, @"「…呋呋_BH_ 怎么可能听到那种声音呢…？_BH_ 嗯……_BH_ 确实可能是这样啊ー…_BH_」_W"
CALL PRINT_STR, @"「『%CNAME("二人称")%には』…_BH_ 聞こえないのかもねー…？_BH_」_W"	CALL PRINT_STR, @"「『%CNAME("二人称")%』…_BH_ 可能听不见吧ー…？_BH_」_W"
CALL PRINT_STR, @"「ザーメン、ダマになっちゃってるね…_BH_」_W"	CALL PRINT_STR, @"「精液，变成了汤汁啊…_BH_」_W"
CALL PRINT_STR, @"「お残しみるくでこれなんだもん…_BH_ ほんと、ますます好きになっちゃうな…_BH_」_W"	CALL PRINT_STR, @"「剩下的就是这个嘛…_BH_ 真的，越来越喜欢你了…_BH_」_W"
CALL PRINT_STR, @"「あっ…大丈夫、もちろん忘れてないよ…_BH_」_W"	CALL PRINT_STR, @"「啊…没关系，当然不会忘记的…_BH_」_W"
CALL PRINT_STR, @"「コキコキぴゅっぴゅ_BH_ はまだお預け…_BH_ 今は、お射精後の甘やかししこしこ…_BH_」_W"	CALL PRINT_STR, @"「还没用上本领呢…_BH_ 现在，仅是上次的残余啦…_BH_」_W"
CALL PRINT_STR, @"「%CNAME("二人称")%のおちんぽが…_BH_ もっと気持ちよくびゅーびゅー出来るようにするための…_BH_」_W"	CALL PRINT_STR, @"「为了能让%CNAME("二人称")%的小鸡鸡…_BH_ 更舒服地射出浓浓稠稠的精液…_BH_」_W"
CALL PRINT_STR, @"「大事な大事な…_BH_ 準備時間だもんね…_BH_」_W"	CALL PRINT_STR, @"「重要的重要的…_BH_ 准备时间到了…_BH_」_W"
CALL PRINT_STR, @"「…でもね、%CNAME("二人称")%…_BH_ ちょっとくらいなら…_BH_ お漏らししちゃっても、いいじゃないかな…？_BH_」_W"	CALL PRINT_STR, @"「…但是呢、%CNAME("二人称")%…_BH_ 如果只是一点点的话…_BH_ 即使泄出去，也没关系吧…？_BH_」_W"
CALL PRINT_STR, @"「あは…_BH_ おちんぽのしわにまでこびりついて…_BH_」_W"	CALL PRINT_STR, @"「啊哈…_BH_ 小鸡鸡的这里也粘上东西了啊…_BH_」_W"
CALL PRINT_STR, @"「よっぽど溜まっちゃってたんだねー…_BH_ 必死になって、ありもしない卵子探してる…_BH_」_W"	CALL PRINT_STR, @"「积了很多啊…_BH_ 拼命地寻找根本不存在的卵子…_BH_」_W"
CALL PRINT_STR, @"「あぁん…_BH_ くすくす…_BH_ おせーしコき取る%CNAME("一人称")%の指に…_BH_ こんなにいっぱいへばりついて…_BH_」_W"	CALL PRINT_STR, @"「啊啊…_BH_ %CNAME("一人称")%手也被粘稠稠的包裹起来了_」_W"
CALL PRINT_STR, @"「やっぱり本能的に、メスかどうかがわかっちゃうのかな…？_BH_ %CNAME("二人称")%に似て、ザーメンも優秀なんだねー…_BH_」_W"	CALL PRINT_STR, @"「果然是本能地知道、是否雌性的的一部分吧…？_BH_ 和%CNAME("二人称")%相似，精液也很优秀呢…_BH_」_W"
CALL PRINT_STR, @"「ちょっとおバカなところも、ね…_BH_ なーんて…_BH_ 冗談だよー…_BH_ だからおちんぽむくむくさせて、怒らないで…？_BH_」_W"	CALL PRINT_STR, @"「都有点傻傻的地方呢…_BH_ 嗯？为什么…_BH_ 开玩笑的哦_BH_ 所以请让我继续做下去…不要动怒～好吗？？_BH_」_W"
CALL PRINT_STR, @"「%CNAME("一人称")%、ちゃんと謝るから…_BH_」_W"	CALL PRINT_STR, @"「%CNAME("一人称")%、我会好好道歉的…_BH_」_W"
CALL PRINT_STR, @"「しっかりおてて擦り合わせて…_BH_ ごめんね…_BH_ ごめんね…_BH_ ってしてあげるから…_BH_」_W"	CALL PRINT_STR, @"「用力地紧紧搓揉…_BH_ 对不起啊…_BH_ 对不起啊…_BH_」_W"
CALL PRINT_STR, @"「だから、お許し射精、してほしいな…_BH_」_W"	CALL PRINT_STR, @"「以射精做为原谅我的信号吧…_BH_」_W"
CALL PRINT_STR, @"「ふふ…_BH_ ねばっこぉいザーメンで…_BH_ %CNAME("二人称")%のおちんぽどろどろ…_BH_」_W"	CALL PRINT_STR, @"「呋呋…_BH_ 被%CNAME("二人称")%的小鸡鸡用黏糊糊的精液涂满了…_BH_」_W"
CALL PRINT_STR, @"「おちんぽの先からきんたまの裏まで…_BH_ 濁ったザーメンソースでびたびたになってるよ…_BH_」_W"	CALL PRINT_STR, @"「但要报复回去了～从小鸡鸡的龟头到睾丸后处…都用浑浊的精液调味汁打个 蜡 吧…_BH_」_W"
CALL PRINT_STR, @"「あーぁ…_BH_ せっかくならお口で味わいたかったなぁ…_BH_」_W"	CALL PRINT_STR, @"「啊啊…_BH_ 好不容易这么来一次 真想用口来品尝啊…_BH_」_W"
CALL PRINT_STR, @"「でも、仕方ないもんね…_BH_ %CNAME("一人称")%にこんなどろどろちんぽ舐めさせちゃったら…_BH_」_W"	CALL PRINT_STR, @"「但是，没办法啊…_BH_ 如果让%CNAME("一人称")%舔了这么多黏糊糊的话…_BH_」_W"
CALL PRINT_STR, @"「%CNAME("二人称")%、どうなっちゃうかわかんないもんね…_BH_」_W"	CALL PRINT_STR, @"「不知道%CNAME("二人称")%会变成什么样…_BH_」_W"
CALL PRINT_STR, @"「くすくす…_BH_ その代わり…_BH_」_W"	CALL PRINT_STR, @"「唔呜呜…_BH_ 代替那个…_BH_」_W"
CALL PRINT_STR, @"「いつもよりねちっこく…_BH_ コキコキしちゃうから…_BH_」_W"	CALL PRINT_STR, @"「会比平时更执着…_BH_ 咯吱咯吱地玩弄哦…_BH_」_W"
CALL PRINT_STR, @"「わー…_BH_ すっごいお射精だったね…_BH_ ほら、手のひらから溢れちゃいそう…_BH_」_W"	CALL PRINT_STR, @"「哇ー…_BH_ 好厉害的射精啊…_BH_ 看，都要从手掌里溢出来了…_BH_」_W"
CALL PRINT_STR, @"「射精の余韻も長く続いて…_BH_ まだちょっと甘イきしちゃってるかな…？_BH_」_W"	CALL PRINT_STR, @"「射精的余韵也持续了很久…_BH_ 是不是还有点糖浆在里面呢…？_BH_」_W"
CALL PRINT_STR, @"「隠さなくてもわかるよ…_BH_ とくとく、ぴゅ…_BH_ って…_BH_ 追加のザーメン、出ちゃってるもん…_BH_」_W"	CALL PRINT_STR, @"「不用隐瞒也知道哦……_BH_ 看，追加的精液出来了…_BH_」_W"
CALL PRINT_STR, @"「先っぽがザーメン塗れだったら、バレないとでも思った…？_BH_ 残念でしたー…_BH_」_W"	CALL PRINT_STR, @"「如果先涂上精液的话，应该不会露馅的…？_BH_ 很遗憾——…_BH_」_W"
CALL PRINT_STR, @"「お腰の甘～い痺れと、おちんぽの嬉しそうな跳ね方…_BH_ %CNAME("一人称")%、詳しいんだよ…_BH_」_W"	CALL PRINT_STR, @"「腰部的甜蜜麻痹、和小鸡鸡开心的跳法…_BH_ %CNAME("一人称")%、我很熟悉的…_BH_」_W"
PRINTFORMW 「でも、あんまり長いとむしろおちんぽが疲れちゃうから…」	PRINTFORMW 「但是，太长的话反而会让小鸡鸡很累…」
PRINTFORMW 「お射精後の優しいマッサージ手コキで、ゆっくり労わってあげるねー…」	PRINTFORMW 「射精后用温柔的手法，慢慢地给你按摩…」
CALL PRINT_STR, @"「おちんぽもうお射精いいよ、気持ち良いの頑張らなくていいよって…%CNAME("一人称")%のおててで教えてあげるの…_BH_」_W"	CALL PRINT_STR, @"「小鸡鸡射精已经很好了，感觉舒服就行，不用特别努力再来一发…用%CNAME("一人称")%的手来告诉你吧…_BH_」_W"
PRINTFORMW 「余分な気持ちよさを、この細くて柔らかな指で濾し取って…」	PRINTFORMW 「用这纤细柔软的手指过滤掉多余的愉悦感…」
CALL PRINT_STR, @"「次のお射精を、もっと楽しめるように…_BH_ おちんぽの状態をリセットしてあげるんだよ…_BH_」_W"	CALL PRINT_STR, @"「为了更好地享受下次的射精…_BH_ 要帮你重置小鸡鸡的状态哦……_BH_」_W"
PRINTFORMW 「ほら、%CNAME("二人称")%、リラックスして、指の感覚だけ、感じていてね…」	PRINTFORMW 「看、%CNAME("二人称")%、放松，只享受手指的抚摸…」
CALL PRINT_STR, @"「%CNAME("一人称")%が、ぜーんぶ良くしてあげるから…_BH_」_W"	CALL PRINT_STR, @"「%CNAME("一人称")%我、会好好做的……_BH_」_W"
CALL PRINT_STR, @"「出したてザーメンでどろどろのおちんぽ…_BH_ すっごいえっち…_BH_」_W"	CALL PRINT_STR, @"「射出来后沾满了精液的小鸡鸡…_BH_ 太厉害了…_BH_」_W"
CALL PRINT_STR, @"「濃厚な精液でてかてか光って…_BH_ とってもかっこよくなってるよ…_BH_」_W"	CALL PRINT_STR, @"「浓厚的精液闪闪发光…_BH_ 看着很帅哦…_BH_」_W"
CALL PRINT_STR, @"「素敵だなぁ…_BH_ ちょっと手を動かすだけでほら、こんなにえっちな音まで立てて…_BH_」_W"	CALL PRINT_STR, @"「真漂亮啊…_BH_ 只要稍微动一下手，就可以发出这样H的声音…_BH_」_W"
CALL PRINT_STR, @"「将来有望な優等生ちんぽ君…_BH_ %CNAME("一人称")%、面倒見てあげたくなっちゃうな…_BH_」_W"	CALL PRINT_STR, @"「前途有为的优等生小鸡鸡君…_BH_ %CNAME("一人称")%、变得想照顾他了…_BH_」_W"
CALL PRINT_STR, @"「このちんぽに精液擦り込んで、もっともーっとえっちなおちんぽに、ね？…_BH_」_W"	CALL PRINT_STR, @"「把精液揉入茎身，令其变成最帅的小鸡鸡…吗？_BH_」_W"
CALL PRINT_STR, @"「もう…_BH_ そんなに遠慮しなくていいんだよー…？_BH_」_W"	CALL PRINT_STR, @"「已经…WH不用那么客气…？_BH_」_W"
CALL PRINT_STR, @"「ふふ…_BH_」_W"	CALL PRINT_STR, @"「呋呋…_BH_」_W"
CALL PRINT_STR, @"「じゃ、やっちゃいまーす…_BH_」_W"	CALL PRINT_STR, @"「那么，我就做了…_BH_」_W"
CALL PRINT_STR, @"「すごーい…_BH_ 溢れた精液がダマになって…_BH_ おちんぽのまわりにぷくぷくってくっついちゃってる…_BH_」_W"	CALL PRINT_STR, @"「好厉害…溢出来的精液变成了稠稠的固体…_BH_ 紧紧地粘在小鸡鸡周边…_BH_ 」_W"
CALL PRINT_STR, @"「ザーメンコーティングされたおちんぽ…_BH_ すっごいえっちだね…_BH_」_W"	CALL PRINT_STR, @"「被精液包裹的小鸡鸡…_BH_好厉害啊…_BH_」_W"
CALL PRINT_STR, @"「ちょっとおててを動かすたびに、ぐちゅ_BH_ ぶちゅ_BH_ って、大変な音、してる…_BH_」_W"	CALL PRINT_STR, @"「每次稍微动一下手的时候、就会发出_BH_ 咔嗒咔嗒_BH_ 的声音…_BH_」_W"
CALL PRINT_STR, @"「大丈夫だよ、%CNAME("一人称")%がすぐに綺麗にしてあげるから…_BH_」_W"	CALL PRINT_STR, @"「没关系、%CNAME("一人称")%会马上给你弄干净的…_BH_」_W"
CALL PRINT_STR, @"「この細い指で…真っ白せーし、からめとって…_BH_」_W"	CALL PRINT_STR, @"「就用这纤细的手指…打理干净…_BH_」_W"
CALL PRINT_STR, @"「ぴかぴかちんぽにしてあげるね…_BH_」_W"	CALL PRINT_STR, @"「弄个光溜溜的…_BH_」_W"
CALL PRINT_STR, @"「…すごいお射精だったね…_BH_」_W"	CALL PRINT_STR, @"「…好厉害的射精啊…_BH_」_W"
CALL PRINT_STR, @"「ほら、おちんぽ貸して…綺麗にしてあげるから…_BH_」_W"	CALL PRINT_STR, @"「来，将小鸡鸡放到这里…我会把它弄得干干净净的…_BH_」_W"
CALL PRINT_STR, @"「ん、すぅー…あは…_BH_ えっちなにおい、する…_BH_」_W"	CALL PRINT_STR, @"「嗯，嗯……啊哈…_BH_ 有股奇怪的味道…_BH_」_W"
CALL PRINT_STR, @"「このまま手コキでおちんぽに、ザーメンのにおい擦り付けてあげる…_BH_」_W"	CALL PRINT_STR, @"「就这样用手撸着，把精液的味道蹭上去…_BH_」_W"
CALL PRINT_STR, @"「大丈夫…_BH_ 綺麗にはなるよ、きちんと、外見上はね…_BH_」_W"	CALL PRINT_STR, @"「没关系…WH_ 外表上会好好地变干净的…_BH_」_W"
CALL PRINT_STR, @"「ん、おちんぽの中身、きちんとだせた…？_BH_」_W"	CALL PRINT_STR, @"「嗯，小鸡鸡里面的东西，全都出来了…？_BH_」_W"
CALL PRINT_STR, @"「残ザーメン感ないかな…？_BH_ おちんぽの管の中、からっぽになってる…？_BH_」_W"	CALL PRINT_STR, @"「有没有剩下的精液呢…？_BH_ 小鸡鸡的尿管里变得空空如也了…？_BH_」_W"
CALL PRINT_STR, @"「…%CNAME("一人称")%が、確かめてあげるね_BH_」_W"	CALL PRINT_STR, @"「…%CNAME("一人称")%我、来确认一下_BH_」_W"
CALL PRINT_STR, @"「このおててで…_BH_ おちんぽの中の精子も、外の精子も…_BH_」_W"	CALL PRINT_STR, @"「凭这一手…_BH_ 无论是小鸡鸡里面的，还是外面的…_BH_」_W"
CALL PRINT_STR, @"「ぜーんぶ綺麗に片付けてあげる…_BH_」_W"	CALL PRINT_STR, @"「我一定会帮你收拾干净…_BH_」_W"
CALL PRINT_STR, @"「カリ溝、指でくるくるなぞっちゃおーっと…_BH_」_W"	CALL PRINT_STR, @"「冠状沟，用手指不停地划着——…_BH_」_W"
CALL PRINT_STR, @"「ぐつぐつ_BH_ ぐつぐつ_BH_ って…きんたまのなかで精子が煮詰まってる音、聞こえてくるよ…_BH_」_W"	CALL PRINT_STR, @"「咕噜咕噜_BH_ 咕噜咕噜_BH_ 的…我能听到精液在蛋蛋里沸腾的声音…_BH_」_W"
CALL PRINT_STR, @"「こんなにザーメン溜め込んでたら、大変だったんじゃない…？_BH_」_W"	CALL PRINT_STR, @"「若是这样把精液储备起来的话，不会很辛苦吗…？_BH_」_W"
CALL PRINT_STR, @"「もう安心していいよ…_BH_」_W"	CALL PRINT_STR, @"「已经可以放心了…_BH_」_W"
CALL PRINT_STR, @"「実は%CNAME("一人称")%、男の子のきんたまからこってりせーし引っこ抜くの、得意なんだ…_BH_」_W"	CALL PRINT_STR, @"「其实%CNAME("一人称")%、很擅长从男孩子的蛋蛋里榨出东西…_BH_」_W"
CALL PRINT_STR, @"「もぉ…_BH_ 指でおちんぽなでなでするたび、びくびくびくって震えちゃって…_BH_」_W"	CALL PRINT_STR, @"「哦…_BH_ 每次用手指抚摸小鸡鸡的时候、会哆哆嗦嗦地颤动…_BH_」_W"
CALL PRINT_STR, @"「鈴口、人差し指でかりかりしたり…_BH_ 裏筋のとこ、親指でくりくりするだけで…_BH_」_W"	CALL PRINT_STR, @"「食指在马眼处上下划动，沿着系带滑落的大姆指在背部钻来钻去…_BH_」_W"
CALL PRINT_STR, @"「もうだめ_BH_ もうだめ_BH_ って、おちんちんが泣き出しちゃって…_BH_」_W"	CALL PRINT_STR, @"「快到极限了_BH_ 快到极限了_BH_ 小鸡鸡哭了出来…_BH_」_W"
CALL PRINT_STR, @"「おちんぽ、もう少し我慢強くならなきゃだめだよ…？_BH_」_W"	CALL PRINT_STR, @"「小鸡鸡君、你必须再忍耐一下才行…啊…？_BH_」_W"
CALL PRINT_STR, @"「ほら、お腰へこへこ動かしてみて…_BH_」_W"	CALL PRINT_STR, @"「喏，把腰挪一下吧…_BH_」_W"
CALL PRINT_STR, @"「おててなんかに負けないぞって…_BH_ %CNAME("一人称")%に見せて欲しいな…_BH_」_W"	CALL PRINT_STR, @"「那不服输的模样…_BH_ 让%CNAME("一人称")%好好观赏吧…_BH_」_W"
CALL PRINT_STR, @"「今、ぶぴぴぴぴっ_BH_ って音立てて甘イキしちゃったでしょ…_BH_」_W" 	CALL PRINT_STR, @"「现在，小鸡鸡和这里发出了啪啦啪啦啪啦的甜美声音呢，很舒服吧…_BH_」_W" 
CALL PRINT_STR, @"「誤魔化してもだーめ…_BH_ %CNAME("一人称")%はみんなお見通しなんだから…_BH_」_W"	CALL PRINT_STR, @"「就算糊弄过去也没关系…_BH_ 因为%CNAME("一人称")%都能预料到…_BH_」_W"
CALL PRINT_STR, @"「おちんぽの奥からザーメンが出てくるの…_BH_ おちんぽの震えで分かっちゃうんだよ…_BH_」_W"	CALL PRINT_STR, @"「接下来～就要从尿道溢出精液了吧，看小鸡鸡那可爱的颤抖就知道了…_BH_」_W"
CALL PRINT_STR, @"「ふふ…_BH_ 先輩に嘘つく%CNAME("二人称")%には、おしおきするね…_BH_」_W"	CALL PRINT_STR, @"「呋呋…_BH_ 对前辈撒谎的%CNAME("二人称")%、我要说清楚…_BH_」_W"
CALL PRINT_STR, @"「十本の指、全部使って…_BH_ とっても苦しい搾精かりかりで…_BH_ 亀頭虐めしちゃうから…_BH_」_W"	CALL PRINT_STR, @"「我将会用上十指进行非常非常闷苦的榨汁手交，并要重点关照一下龟头君…_BH_」_W"
CALL PRINT_STR, @"「おちんぽ、とっても切なさそう…_BH_」_W"	CALL PRINT_STR, @"「小鸡鸡、看起来很难过…_BH_」_W"
CALL PRINT_STR, @"「指でするする…_BH_ 撫でられてるだけじゃ我慢できなくなっちゃったんだね…_BH_」_W"	CALL PRINT_STR, @"「用手指轻轻地划…_BH_ 仅仅是被抚摸，就无法忍耐了呢…_BH_」_W"
CALL PRINT_STR, @"「うん、いいよ…_BH_ そろそろきんたまの中の精液も、十分に煮詰まってきた頃だろうし…_BH_」_W"	CALL PRINT_STR, @"「嗯，好啊…_BH_ 蛋蛋里的精液也差不多到…蒸腾的时候了…_BH_」_W"
CALL PRINT_STR, @"「%CNAME("一人称")%の細くてちっちゃいおててで、カリ首ぬちぬちぶちゅぶちゅコいて…_BH_」_W"	CALL PRINT_STR, @"「在%CNAME("一人称")%眼前，那令人悯爱的小鸡鸡、龟头不停地颤抖……_BH_」_W"
CALL PRINT_STR, @"「あつーくなったきんたま汁、どっぷりお射精しちゃおうね_BH_」_W"	CALL PRINT_STR, @"「溢流的先走汁好似在说——快点快点让我射精吧_BH_」_W"
CALL PRINT_STR, @"「下半身が溶けちゃうくらいの極楽ぴゅっぴゅ、させてあげる_BH_」_W"	CALL PRINT_STR, @"「这可是能让大脑觉得下半身要化了的极乐体验_BH_」_W"
CALL PRINT_STR, @"「イってもイっても終わらない、おちんぽコキコキ快楽ぴゅっぴゅ…_BH_」_W"	CALL PRINT_STR, @"「无论如何都不会停止的，属于小鸡鸡的至高享受…_BH_」_W"
CALL PRINT_STR, @"「一度味わったら、もう戻れないよ…？_BH_」_W"	CALL PRINT_STR, @"「一旦尝到了，就再也回不去了…吗？_BH_」_W"
CALL PRINT_STR, @"「脳みそ焦げ付いちゃうくらいの…_BH_ 一度昇ったら下りてこられない快楽の絶頂…_BH_」_W"	CALL PRINT_STR, @"「仿佛要将脑中突触烧坏般…_BH_ 不断不断地攀升的快感信号…滋味如何呢…？…_BH_」_W"
CALL PRINT_STR, @"「%CNAME("二人称")%に耐えられるかなー…？_BH_」_W"	CALL PRINT_STR, @"「%CNAME("二人称")%能忍受吗？_BH_」_W"
CALL PRINT_STR, @"「きんたまほぐして、中のザーメンどろっどろに溶かしてあげる_BH_」_W"	CALL PRINT_STR, @"「对这里进行刺激的时候，再用发带缠一圈根处绑紧…令蛋蛋里的精液沸腾起来_BH_」_W"
CALL PRINT_STR, @"「こうすれば、お射精のとき、びゅーびゅーびゅぅーっ_BH_ っておしっこみたいな勢いで尿道削りながらでてくるから…_BH_」_W"	CALL PRINT_STR, @"「这样做的话，射精时就会像尿尿一样射好久呢…_BH_」_W"
CALL PRINT_STR, @"「お射精の気持ちよさ、いつもの何倍にも引き上げられるんだよ…_BH_」_W"	CALL PRINT_STR, @"「快感也会比平时高好几倍哦…_BH_」_W"
CALL PRINT_STR, @"「普通は、気持ちよすぎて苦しくなっちゃうくらいなんだけど…_BH_」_W"	CALL PRINT_STR, @"「一般来说，舒服过头就会变得很痛苦…_BH_」_W"
CALL PRINT_STR, @"「%CNAME("二人称")%なら、絶対気に入ってくれると思うな…_BH_」_W"	CALL PRINT_STR, @"「%CNAME("二人称")%的话，绝对会喜欢的…_BH_」_W"
CALL PRINT_STR, @"「ほーら…_BH_きんたま持ち上げて…ふるふるふるーって揺らしてあげる_BH_」_W"	CALL PRINT_STR, @"「哎呀…_BH_托起蛋蛋…摇啊摇啊…按摩的感觉如何_BH_」_W"
CALL PRINT_STR, @"「たまたまの浮遊感ヤバいねー…？_BH_ ふわふわ浮かんで、不思議な感覚…_BH_」_W"	CALL PRINT_STR, @"「被托着的感觉不好吗？_BH_ 轻飘飘浮起，有种不可思议的感觉…_BH_」_W"
CALL PRINT_STR, @"「ふふ、もうむずむずしてきた…？_BH_ きんたま落ち着かなくて、精子さん怖がってるかな…？_BH_」_W"	CALL PRINT_STR, @"「呋呋、已经发痒了…?_BH_ 急不可待的滋味很棒吧～蛋蛋里的精液可是在叫着呢…_BH_」_W"
CALL PRINT_STR, @"「でも大丈夫…_BH_ きっと、すぐクセになっちゃうよ_BH_」_W"	CALL PRINT_STR, @"「但是没关系…一定很快就会上瘾的_BH_」_W"
CALL PRINT_STR, @"「これされた後は、きんたま弄られながらじゃないとお射精できなくなる人だっているんだから…_BH_」_W"	CALL PRINT_STR, @"「被这样做后，不被玩弄的话就无法射精的人也是有的…_BH_」_W"
CALL PRINT_STR, @"「何事も経験…_BH_ だよ…_BH_ ふふ…_BH_」_W"	CALL PRINT_STR, @"「这也是一种人生经验哦… 呋呋…_BH_」_W"
CALL PRINT_STR, @"「尿道つつーっ…_BH_ ってなぞってあげる_BH_」_W"	CALL PRINT_STR, @"「给你比划一下…_BH_ 尿道穴位_BH_」_W"
CALL PRINT_STR, @"「こうすれば、ぴゅーってするときスムーズにでるよ…_BH_」_W"	CALL PRINT_STR, @"「这样做的话，在紧张的时候会很顺利的…_BH_」_W"
CALL PRINT_STR, @"「どんなどろねば汚濁ザー汁でも、途中で引っかかることなく…_BH_」_W"	CALL PRINT_STR, @"「无论多么浑浊的汁液，都不会在中途被卡住…_BH_」_W"
CALL PRINT_STR, @"「びゅるびゅる_BH_ どぴゅどぴゅ_BH_ ぴゅっぴゅっぴゅー…っ_BH_ てね…_BH_」_W"	CALL PRINT_STR, @"「咕噜咕噜_BH_ 咕噜咕噜_BH_ 咕噜咕噜咕噜咕噜ー……_BH_」_W"
CALL PRINT_STR, @"「まあ、射精するまではむしろ鈴口開いてちんぽの疼きがヤバくなっちゃうんだけど…_BH_」_W"	CALL PRINT_STR, @"「不过，在射精之前，马眼张开的疼痛反而会加剧…_BH_」_W"
CALL PRINT_STR, @"「お射精ぴゅっぴゅの気持ちよさのためなら、いいよね…？_BH_」_W"	CALL PRINT_STR, @"「但为了嗖嗖地射精时的快感……就没问题吧…？_BH_」_W"
PRINTFORMW 「%CNAME("一人称")%のおてて、すっかり%CNAME("二人称")%のおちんぽのこと、覚えちゃった…」	PRINTFORMW 「因为%CNAME("一人称")%、完全记住了%CNAME("二人称")%的小鸡鸡…」
CALL PRINT_STR, @"「敏感なカリも…_BH_ ちょっぴり太めの尿道も…_BH_ くぅーっと反り返った竿の形も…_BH__」_W"	CALL PRINT_STR, @"「敏感的系带也是，尿道骤张的时机也是，茎身膨胀的瞬间也一样………_BH__」_W"
CALL PRINT_STR, @"「みんなみぃーんな、覚えちゃったよ…？_BH_」_W"	CALL PRINT_STR, @"「都记住了呢…_BH_」_W"
PRINTFORMW 「わわっ…%CNAME("二人称")%、おててに向かってハメ腰つかっちゃってる…？」	PRINTFORMW 「哇……%CNAME("二人称")%、小鸡鸡在手里的时候就任意妄为地动起腰肢…呢…？」
CALL PRINT_STR, @"「カリ首甘やかされながらシコシコされて、そんなに嬉しくなっちゃったの…？_BH_」_W"	CALL PRINT_STR, @"「龟头被娇惯地揉搓着的感觉很好吗，都溢出喜悦的先走汁了…？_BH_」_W"
CALL PRINT_STR, @"「そっか…_BH_ %CNAME("二人称")%、こういうのも好きなんだね…_BH_」_W"	CALL PRINT_STR, @"「这样啊…_BH_ %CNAME("二人称")%也喜欢这样的啊…_BH_」_W"
CALL PRINT_STR, @"「じゃあ、この責め、もう少し続けてあげる…_BH_」_W"	CALL PRINT_STR, @"「那么，这种欺负游戏就做久一点吧…_BH_」_W"
CALL PRINT_STR, @"「満足するまで、お腰かくかくさせてていいから…_BH_」_W"	CALL PRINT_STR, @"「在满足之前可不会停下来哦…_BH_」_W"
CALL PRINT_STR, @"「好きなだけ気持ちよくなって…_BH_ 好きなときにぴゅっぴゅしてね…_BH_」_W"	CALL PRINT_STR, @"「随心所欲涨升的快乐浪潮，在攀至顶点前…射精就太失礼了…_BH_」_W"
CALL PRINT_STR, @"「%CNAME("二人称")%、すっかりお腰ががくがくって…_BH_」_W"	CALL PRINT_STR, @"「%CNAME("二人称")%、腰都在发抖了…_BH_」_W"
PRINTFORMW 「…さすがに心配になっちゃうな…ちょっとおちんぽ休憩しよっか…」	PRINTFORMW 「…真让人担心啊…稍微休息一下吧…」
CALL PRINT_STR, @"「…かわりに、こっち_BH_」_W"	CALL PRINT_STR, @"「…作为代替…就由这边来吧_BH_」_W"
CALL PRINT_STR, @"「かまってかまってー_BH_ って、持ち上がって自己主張してるぱんぱんのきんたま…_BH_」_W"	CALL PRINT_STR, @"「只顾着产生侵犯卵子的精液…_BH_ 膨胀得愈来愈沉重的睾丸…_BH_」_W"
CALL PRINT_STR, @"「おててでたっぷりあやしてあげる…_BH_」_W"	CALL PRINT_STR, @"「用手好好哄哄…_BH_」_W"
CALL PRINT_STR, @"「おちんぽは休んでていいからね…_BH_」_W"	CALL PRINT_STR, @"「并把脸贴在一边说：小鸡鸡可以休息了…_BH_」_W"
CALL PRINT_STR, @"「でも、もし%CNAME("一人称")%が熱中しすぎて…_BH_ おちんぽが我慢できなくなっちゃったら…_BH_」_W"	CALL PRINT_STR, @"「但是，如果%CNAME("一人称")%过于热情…_BH_ 而导致小鸡鸡耐不住的话……_BH_」_W"
CALL PRINT_STR, @"「そのときは、何かの合図…_BH_ 『出して』くれたら気づけるかも…_BH_」_W"	CALL PRINT_STR, @"「会很在意之后的模样和其主人那闷苦的表情…_BH_」_W"
CALL PRINT_STR, @"「くす…_BH_」_W"	CALL PRINT_STR, @"「呐…_BH_」_W"
CALL PRINT_STR, @"「裏筋寂しい…？ カウパーとろとろあふれさせて、つやつやになっちゃってるけど…_BH_」_W_"	CALL PRINT_STR, @"「这里很寂寞…？但刺激它会溢出更多更多的先走汁，令整个小鸡鸡都变得光滑油亮的…_BH_」_W_"
CALL PRINT_STR, @"「もう…_BH_ いいんだよ、遠慮しないで…？_BH_」_W"	CALL PRINT_STR, @"「没关系、别不好意思嘛…_BH_」_W"
CALL PRINT_STR, @"「どこが寂しいかなんて考えられなくなるくらい、おちんぽ全体、一気に高めてあげるから…_BH_」_W"	CALL PRINT_STR, @"「我要让整个小鸡鸡一下子high起来，让你无法想象它有多寂寞…_BH_」_W"
CALL PRINT_STR, @"「うふふっ_BH_ %CNAME("二人称")%、きっとすごいことになっちゃうよ_BH_ 意識しっかりつなぎとめててね…_BH_」_W"	CALL PRINT_STR, @"「呼呼_BH_ %CNAME("二人称")%、接下来会变成很不得了的状况哦_BH_ 好好维持意识吧…_BH_」_W"
CALL PRINT_STR, @"「…もし気を失っても安心して_BH_、%CNAME("一人称")%が何度でも_BH_ しこしこ快楽、送り込んであげるから…_BH_」_W"	CALL PRINT_STR, @"「…如果你失去了意识、请放心_BH_%CNAME("一人称")%会多次给你带来_BH_ 快乐…_BH_」_W"
CALL PRINT_STR, @"「おきゃくさーん_BH_」_W"	CALL PRINT_STR, @"「客人_BH_」_W"
CALL PRINT_STR, @"「かゆいところはないですかー…？_BH_」_W"	CALL PRINT_STR, @"「有没有哪里很痒呢…？_BH_」_W"
CALL PRINT_STR, @"「はい、はい…_BH_ かしこまりました…_BH_」_W"	CALL PRINT_STR, @"「好的，好的_BH_ 知道了…_BH_」_W"
CALL PRINT_STR, @"「おちんぽ、ですね_BH_」_W"	CALL PRINT_STR, @"「小鸡鸡，是吧_BH_」_W"
CALL PRINT_STR, @"「…それでは、お客様のムキムキちんぽ_BH_ 誠心誠意、掻かせていただきます…_BH_」_W"	CALL PRINT_STR, @"「…那么，请允许我诚心诚意地为您平息这份痒痛…_BH_」_W"
CALL PRINT_STR, @"「後から後からとくとくとくーって_BH_ お汁が溢れてとまらない…_BH_」_W"	CALL PRINT_STR, @"「源源不断地溢出汁液_BH_ 沿着系带滑到蛋蛋下方的地面…_BH_」_W"
CALL PRINT_STR, @"「…ねえ、%CNAME("二人称")%は知ってる…？_BH_」_W"	CALL PRINT_STR, @"「…我知道%CNAME("二人称")%_BH_」_W"
CALL PRINT_STR, @"「おちんぽの先からでてくるお汁…はじめはほら…こんな風にさらさらだけど…_BH_」_W"	CALL PRINT_STR, @"「最先从小鸡鸡前端漫溢出来的部分，看，就像油一样滑滑的…_BH_」_W"
CALL PRINT_STR, @"「何度も何度も寸止めして、おちんぽの先っぽから根元まで、ザーメンを往復させるとね…_BH_」_W"	CALL PRINT_STR, @"「不断不断地寸止，让精液在马眼与睾丸之间徘徊…_BH_」_W"
CALL PRINT_STR, @"「このお汁…カウパーだけがちんぽの中から追い出されて…せーしがどんどん練り上げられて…_BH_ 」_W"	CALL PRINT_STR, @"「将多佘的从小鸡鸡里赶走，再不断搅拌精液…_BH_ 」_W"
CALL PRINT_STR, @"「カウパーとろとろお漏らしするだけの、射精未満の快楽ぴゅっぴゅで、種付けみたいな気持ちよさが味わえるの…_BH__」_W"	CALL PRINT_STR, @"「嗯…？仅是漏了一点点，连射精快感的兆万之一都算不上的快乐就让你露出这种表情呢……_BH__」_W"
CALL PRINT_STR, @"「だったら…もし_BH_ もし、だよ？_BH_」_W"	CALL PRINT_STR, @"「既然如此 _BH_」_W"
CALL PRINT_STR, @"「そんな状態でお射精なんかしちゃったら…どうなっちゃうんだろうね…？_BH_」_W"	CALL PRINT_STR, @"「在这种状态下射精的话…会变成什么样呢…？_BH_」_W"
PRINTFORMW 「きゅぽきゅぽ、きゅぽきゅぽ…」	PRINTFORMW 「咕噜咕噜、咕噜咕噜…」
PRINTFORMW 「えへへ…どうかな、%CNAME("一人称")%のおちんぽリング…」	PRINTFORMW 「嘿嘿…怎么样、%CNAME("一人称")%的的小鸡鸡按摩术…」
PRINTFORMW 「%CNAME("一人称")%、あんまりおてては大きくないけど…」	PRINTFORMW 「%CNAME("一人称")%虽然不是很大…但相当有份量」
PRINTFORMW 「指は細くてやわらかいから、%CNAME("二人称")%が自分でするのとは、また違った感じじゃないかな…？」	PRINTFORMW 「手指又细又软、%CNAME("二人称")%自己做的感觉不一样吗…？」
CALL PRINT_STR, @"「……_BH_ もう、そんなに嬉しいことばかり言って…_BH_」_W"	CALL PRINT_STR, @"「……真是的_BH_ 净说那么令人高兴的话…_BH_」_W"
CALL PRINT_STR, @"「こんな状況でツガイのメスをその気にさせたらどうなるか…_BH_」_W"	CALL PRINT_STR, @"「在这种情况下，如果让让淫魔认真地、全力以赴做手交的话，会怎么样呢…_BH_」_W"
CALL PRINT_STR, @"「%CNAME("一人称")%が教えてあげるんだから…_BH_」_W"	CALL PRINT_STR, @"「就让%CNAME("一人称")%来告诉你吧…_BH_」_W"
CALL PRINT_STR, @"「こうやって…亀さん手のひらで磨り潰すみたいにぐりぐりすると…ほら_BH_」_W"	CALL PRINT_STR, @"「这样做…把手掌压龟头上咕噜咕噜地磨的话～_BH_」_W"
CALL PRINT_STR, @"「ぴぴぴっ_BH_ って_BH_ 軽くお潮吹いちゃうくらい気持ちいいでしょ_BH_」_W"	CALL PRINT_STR, @"「咻咻咻咻_BH_  就像吹潮一样舒服啊吧_BH_」_W"
CALL PRINT_STR, @"「そうして激しい快楽で疲れちゃったおちんぽを、今度は竿から根元にかけて、ねっとりまったりマッサージしてくの…_BH_」_W"	CALL PRINT_STR, @"「然后就把疲软的小鸡鸡扶起来，从茎身到蛋蛋都仔细细地按摩一遍…_BH_」_W"
CALL PRINT_STR, @"「%CNAME("二人称")%これ、もう何回か続けるからね…気を失わないように、気をつけて…_BH_」_W"	CALL PRINT_STR, @"「%CNAME("二人称")%、已经持续几次了呢…不要失去意识了…_BH_」_W"
CALL PRINT_STR, @"「%CNAME("二人称")%のおちんぽしこしこするときって、いつもちょっぴり緊張しちゃうな…_BH_」_W"	CALL PRINT_STR, @"「%CNAME("二人称")%的小鸡鸡、总是在一颤一颤的…看着真帅气呀～_BH_」_W"
PRINTFORMW 「…ふふ、嘘じゃないよ」	PRINTFORMW 「…呋呋、没骗你」
CALL PRINT_STR, @"「…だって、%CNAME("一人称")%のこと、生まれ変わらせてくれた王子様のちんぽだよ…？_BH_」_W"	CALL PRINT_STR, @"「…因为这是让%CNAME("一人称")%获得重生的，王子大人的的小鸡鸡呐 _BH_」_W"
PRINTFORMW 「女の子だったら、誰だって緊張しちゃうよ…」	PRINTFORMW 「如果是女孩子的话，谁都会紧张的…」
CALL PRINT_STR, @"「…ちょっと恥ずかしいこと言っちゃった…_BH_」_W"	CALL PRINT_STR, @"「…说了有点不好意思的话…_BH_」_W"
CALL PRINT_STR, @"「もう…_BH_ おててのしゅっしゅ、激しくしちゃうもん…_BH_」_W"	CALL PRINT_STR, @"「…你的主人，会变得很激烈嘛…_BH_」_W"
CALL PRINT_STR, @"「%CNAME("二人称")%のきんたま、けっこうずっしりしてきたね…_BH_」_W"	CALL PRINT_STR, @"「%CNAME("二人称")%的蛋蛋真沉啊…_BH_」_W"
CALL PRINT_STR, @"「%CNAME("一人称")%のこと犯したくて…_BH_ 精子の生産工場フル稼働してるんだぁ…_BH_」_W"	CALL PRINT_STR, @"「因为%CNAME("一人称")%的存在，精子产生工厂已经进入过载状态了呐…_BH_」_W"
CALL PRINT_STR, @"「ふふ、おててできんたまころころーって_BH_ %CNAME("一人称")%もお手伝いしたげる…_BH_」_W_"	CALL PRINT_STR, @"「呋呋、我会帮你的_BH_ 就用%CNAME("一人称")%的手来帮忙…_BH_」_W_"
CALL PRINT_STR, @"「たまたまころころ_BH_ おちんぽむらむら_BH_ 指先かりかり_BH_ ザーメンこぽこぽ_BH_ きんたまぐつぐつ_BH_ しあわせぴゅっぴゅっ…_BH_」_W"	CALL PRINT_STR, @"「全心全意地～_BH_ 撸动茎身的时候 _BH_ 也刮刮一下马眼_BH_ 载满精液的蛋蛋更要按摩一下_BH_ 咕嘟咕嘟…_BH_」_W"
CALL PRINT_STR, @"「しこしこもしてくよ…_BH_ いつでも好きなタイミングで…気持ちよくなっていいからね…_BH_」_W"	CALL PRINT_STR, @"「在喜欢的时候射精也没关系，舒服就ok…_BH_」_W"
CALL PRINT_STR, @"「はーい…_BH_」_W"	CALL PRINT_STR, @"「哈伊…_BH_」_W"
CALL PRINT_STR, @"「おちんぽ包んで、おててまんこの完成だよ…_BH_」_W"	CALL PRINT_STR, @"「包得满满当当，就这样完成了…_BH_」_W"
CALL PRINT_STR, @"「たまにはこうして%CNAME("二人称")%がお腰を振って…自分のペースで気持ちよくなるのもいいよね…_BH_」_W"	CALL PRINT_STR, @"「偶尔让%CNAME("二人称")%以自己的节奏去甩腰，令自己变得舒服也不错呀…_BH_」_W"
CALL PRINT_STR, @"「ちんぽの疼き、ヤバくしていくね…_BH__W"	CALL PRINT_STR, @"「小鸡鸡一颤一颤的，越来越厉害了呢…_BH__W"
CALL PRINT_STR, @"「手首のスナップ利かせた…_BH_ %CNAME("一人称")%のドスケベ手コキ…_BH_」_W"	CALL PRINT_STR, @"「在%CNAME("一人称")%的手心变得愈来愈热…_BH_」_W"
CALL PRINT_STR, @"「きっと、ふつうの女の子のおまんこよりも、気持ちいいと思うから…_BH_」_W"	CALL PRINT_STR, @"「我觉得～若是普通人的话，不到三秒就要射了呢…_BH_」_W"
CALL PRINT_STR, @"「イきそうになったら、我慢しないで…_BH_ おてての中に種付けしてね…？_BH_」_W"	CALL PRINT_STR, @"「要忍不住了吗？……那就射吧…_BH_」_W"
CALL PRINT_STR, @"「じゃあ、%CNAME("二人称")%は楽にしてていいよ…_BH_」_W"	CALL PRINT_STR, @"「那么、%CNAME("二人称")%可以放松哦…_BH_」_W"
CALL PRINT_STR, @"「腰をえっちにぐりぐりまわして、先っぽに置いた手のひらに擦りつけてあげる…_BH_ 」_W"	CALL PRINT_STR, @"「把腰咕噜咕噜地动来动去、给龟头来自手掌的磨蹭感…_BH_ 」_W"
CALL PRINT_STR, @"「これから、もっとえっちになっちゃうよ…_BH_」_W"	CALL PRINT_STR, @"「今后…会变得更色色的…_BH_」_W"
CALL PRINT_STR, @"「%CNAME("一人称")%ね、一個だけ得意なダンスがあるんだ…_BH_」_W"	CALL PRINT_STR, @"「%CNAME("一人称")%啊，只擅长一个舞蹈…_BH_」_W"
CALL PRINT_STR, @"「男の人に跨って、おちんぽ手で押さえながら、おまたを擦りつけるポールダンス…_BH_」_W"	CALL PRINT_STR, @"「是胯坐在小鸡鸡上方，双手抱颈，再甩动腰肢的求欢舞哦…_BH_」_W"
CALL PRINT_STR, @"「今から見せてあげるから、特等席で楽しんで…_BH_」_W"	CALL PRINT_STR, @"「现在，在特等席享受吧…_BH_」_W"
CALL PRINT_STR, @"「ん…_BH_ 今度はおててじゃなくて、おまたで扱くね…_BH_」_W"	CALL PRINT_STR, @"「呐…这次不直接进攻，反而要蹂躏入口吗…？_BH_」_W"
CALL PRINT_STR, @"「どこまでも蕩けて、一つになろ…？_BH_」_W"	CALL PRINT_STR, @"「不想射进去吗？_BH_」_W"
CALL PRINT_STR, @"「おまんこでぬるーって…_BH_ どうかな…」_W"	CALL PRINT_STR, @"「用阴丘来涂…_BH_ 怎么样…」_W"
CALL PRINT_STR, @"「いれちゃだめだよ…_BH_ このまま、擦り合わせるだけ…_BH_」_W"	CALL PRINT_STR, @"「不能放进去哦…_BH_ 就这样互相摩擦…_BH_」_W"
CALL PRINT_STR, @"「お互いの熱とか、感触とか、いっぱい感じながら…_BH_」_W"	CALL PRINT_STR, @"「一边感受着彼此的热度、触感…_BH_」_W"
CALL PRINT_STR, @"「おちんぽいっぱいむらむらさせようね…_BH_ 」_W"	CALL PRINT_STR, @"「让小鸡鸡多享受点吧…_BH_ 」_W"
CALL PRINT_STR, @"「あは…_BH_ 素敵なカタチ…_BH_」_W"	CALL PRINT_STR, @"「啊…_BH_ 漂亮的造型…_BH_」_W"
CALL PRINT_STR, @"「カタさもばっちり…_BH_ 亀頭もぷっくりふくれてて…」_W"	CALL PRINT_STR, @"「大小也很完美，龟头也鼓鼓的…」_W"
CALL PRINT_STR, @"「%CNAME("一人称")%、どきどきしちゃうなぁ…_BH_」_W"	CALL PRINT_STR, @"「%CNAME("一人称")%好激动啊…_BH_」_W"
CALL PRINT_STR, @"「ん…_BH_ %CNAME("二人称")%のと、%CNAME("一人称")%ので…_BH_」_W"	CALL PRINT_STR, @"「嗯…_BH_ %CNAME("二人称")%和%CNAME("一人称")%…_BH_」_W"
CALL PRINT_STR, @"「とろとろのぐちゃぐちゃに、デコレーションしちゃお…_BH_」_W"	CALL PRINT_STR, @"「都变得粘糊糊的了～_BH_」_W"
CALL PRINT_STR, @"「なでなで…_BH_ さすさす…_BH_」_W"	CALL PRINT_STR, @"「抚摸抚摸…_BH_ 射精…_BH_」_W"
CALL PRINT_STR, @"「ふふ、裏筋好きなの…？_BH_ ちょっとつつーってしてあげただけで、随分びくびくしてるけど…_BH_」_W"	CALL PRINT_STR, @"「呵呵，喜欢背筋啊…?_BH_ 只是稍微做了一下，就颤抖不已呢…_BH_」_W"
CALL PRINT_STR, @"「ほらほら、こことかもどうかな…_BH_ かりかりかりって…_BH_ あは…_BH_ かわいい…_BH_」_W_"	CALL PRINT_STR, @"「看，这里怎么样…_BH_ 我知道…_BH_ 我知道…_BH_ 好可爱…_BH_」_W_"
CALL PRINT_STR, @"「それじゃあこのまま、おちんぽのイイとこ…_BH_ ひとつひとつ責めていってあげる…_BH_」_W"	CALL PRINT_STR, @"「那就这样吧，这个小鸡鸡…_BH_ 要从敏感点一个一个地欺负你…_BH_」_W"
CALL PRINT_STR, @"「はい、このままシコシコしていくよ…_BH_」_W"	CALL PRINT_STR, @"「好的，就这样慢慢来吧…_BH_」_W"
CALL PRINT_STR, @"「%CNAME("二人称")%はどこが好きかな…？_BH_」_W"	CALL PRINT_STR, @"「%CNAME("二人称")%喜欢哪里呢…？_BH_」_W"
CALL PRINT_STR, @"「あ、言葉にしなくても大丈夫だよ_BH_」_W_"	CALL PRINT_STR, @"「啊，不说也没关系_BH_」_W_"
CALL PRINT_STR, @"「ぜーんぶ、おちんぽ君が教えてくれるからね…_BH_」_W"	CALL PRINT_STR, @"「因为小鸡鸡会告诉我的…_BH_」_W"
CALL PRINT_STR, @"「%CNAME("二人称")%の、さきっぽぷくって膨れてきたね…_BH_」_W"	CALL PRINT_STR, @"「%CNAME("二人称")%的、前额鼓起来了呢…_BH_」_W"
CALL PRINT_STR, @"「%CNAME("一人称")%の手のひらの中で、リラックスしてきたのかな…_BH_」_W"	CALL PRINT_STR, @"「在%CNAME("一人称")%的手掌中放松下来了吗…_BH_」_W"
CALL PRINT_STR, @"「ふふ、そのまま身体もリラックスだよ…？_BH_」_W_"	CALL PRINT_STR, @"「呋呋，这样身体也放松了…？_BH_」_W_"
CALL PRINT_STR, @"「そしたら、気持ちよくびゅびゅーって射精できるからね…_BH_」_W"	CALL PRINT_STR, @"「那样的话，就能愉快地射精了…_BH_」_W"
CALL PRINT_STR, @"「すっかりあつくなっちゃってる…_BH_」_W"	CALL PRINT_STR, @"「完全热起来了…_BH_」_W"
CALL PRINT_STR, @"「期待してくれてるんだね…_BH_ 嬉しいな…_BH_」_W"	CALL PRINT_STR, @"「期待着我呢…_BH_ 真高兴啊…_BH_」_W"
CALL PRINT_STR, @"「%CNAME("一人称")%、ばっちり応えちゃうから…！_BH_」_W"	CALL PRINT_STR, @"「%CNAME("一人称")%、会好好回应的…！_BH_」_W"
PRINTFORMW 「ザーメンぐらぐら煮え立ってきちゃった？」	PRINTFORMW 「精液咕嘟咕嘟地煮起来了？」
PRINTFORMW 「いいよ、%CNAME("一人称")%が責任もって…%CNAME("二人称")%のおちんぽの熱、冷ましてあげるね…」	PRINTFORMW 「好啊，由%CNAME("一人称")%负责……让%CNAME("二人称")%的小鸡鸡冷却下来吧…」
//40-AM 綾乃 手淫 手淫派生 前半部分-完毕
CALL PRINT_STR, @"「しろーいちっち、いっぱいだそうね…_BH_」_W"	CALL PRINT_STR, @"「啊啦啊啦～溢出嘴角了呢…_BH_」_W"
CALL PRINT_STR, @"「飲んだ分だけ、射精させてあげるから…_BH_」_W"	CALL PRINT_STR, @"「咕嘟咕嘟地喝下多少_BH_ 就要射出同量的浓浓精液哦…_BH_」_W"
CALL PRINT_STR, @"「お腰ゆらゆら…甘えちゃってるね…_BH_」_W"	CALL PRINT_STR, @"「摇摇晃晃的腰…在撒娇啊…_BH_」_W"
CALL PRINT_STR, @"「%CNAME("二人称")%の甘えんぼちんぽ…_BH_ %CNAME("一人称")%のおててのこと、気に入っちゃったのかな…？_BH_」_W"	CALL PRINT_STR, @"「%CNAME("二人称")%的粗壮小鸡鸡…_BH_ 是喜欢上了%CNAME("一人称")%的巨乳了吗…？_BH_」_W"
PRINTFORMW 「%CNAME("一人称")%のおっぱい、%CNAME("二人称")%のおもちゃになっちゃってるね…」	PRINTFORMW 「%CNAME("一人称")%的胸部…已经变成了属于%CNAME("二人称")%的玩具呢……」
CALL PRINT_STR, @"「ちゅぷちゅぷちゅぷ…_BH_ お口でさきっぽ吸われるたびに…_BH_」_W"	CALL PRINT_STR, @"「嗯嗯嗯嗯～_BH_ 嘴巴好用力啊…_BH_」_W"
CALL PRINT_STR, @"「みるくを出しちゃう、おしゃぶりおもちゃ…_BH_」_W"	CALL PRINT_STR, @"「简直就是咬着奶嘴的小宝宝呐…_BH_」_W"
CALL PRINT_STR, @"「%CNAME("二人称")%のおちんぽ…%CNAME("一人称")%のおっぱいに甘えたくて震えちゃってるね…_BH_」_W"	CALL PRINT_STR, @"「%CNAME("二人称")%的小鸡鸡……因想向%CNAME("一人称")%的巨乳撒娇而溢出先走汁了吗…_BH_」_W"
CALL PRINT_STR, @"「ごめんね…？ %CNAME("一人称")%のおっぱいは、今%CNAME("二人称")%のお相手してるから…_BH_」_W"	CALL PRINT_STR, @"「对不起哦 %CNAME("一人称")%的胸部已经被%CNAME("二人称")%乱动的舌头占有了…_BH_」_W"
CALL PRINT_STR, @"「上手なお射精…がんばれ、がんばれ…_BH_」_W"	CALL PRINT_STR, @"「%CNAME("二人称")%最擅长的射精…加油，加油…_BH_」_W"
CALL PRINT_STR, @"「ちんぽかわいい…_BH_ いつもはあんなにかっこいいのに、今は%CNAME("一人称")%に媚びきっちゃって…_BH_」_W"	CALL PRINT_STR, @"「小鸡鸡好可爱…_BH_ 明明平时那么威风凛凛、现在却完全向%CNAME("一人称")%献媚求欢呢…_BH_」_W"
CALL PRINT_STR, @"「あ…_BH_ おちんぽ、びくびく…_BH_」_W"	CALL PRINT_STR, @"「嗯…_BH_ 小鸡鸡一点一点的…_BH_」_W"
CALL PRINT_STR, @"「とぷ、って_BH_ %CNAME("一人称")%のおててに、先走りのフライングザーメン、でちゃったよ…_BH_」_W"	CALL PRINT_STR, @"「嗯_BH_ 对着%CNAME("一人称")%止不往地溢出先走汁呢…_BH_」_W"
CALL PRINT_STR, @"「これじゃあかわいそうだから…_BH_」_W"	CALL PRINT_STR, @"「这样太可怜了…_BH_」_W"
CALL PRINT_STR, @"「みるく飲みながらのまったり快楽…どうかな…_BH_」_W"	CALL PRINT_STR, @"「一边吸奶一边享受纤细玉手的套弄服务～感觉怎么样呢…_BH_」_W"
CALL PRINT_STR, @"「%CNAME("二人称")%のおちんぽ、すっかり素直になっちゃって…_BH_」_W"	CALL PRINT_STR, @"「%CNAME("二人称")%小鸡鸡、完全变得坦率了…_BH_」_W"
CALL PRINT_STR, @"「%CNAME("一人称")%のおてての中で、とろとろになってるよ…_BH_」_W"	CALL PRINT_STR, @"「在%CNAME("一人称")%的手心里，变得粘糊糊的…_BH_」_W"
CALL PRINT_STR, @"「かわいすぎて…どうにかなっちゃいそう…_BH_」_W"	CALL PRINT_STR, @"「太可爱了……真是让人没办法呢…_BH_」_W"
CALL PRINT_STR, @"「%CNAME("二人称")%はすっかり赤ちゃんになってるのに…_BH_ おちんぽはかっこよく、オスらしく、求愛してくれてるんだぁ…_BH_」_W"	CALL PRINT_STR, @"「%CNAME("二人称")%明明是小宝宝…_BH_ 但小鸡鸡却发散着能令雌性沦陷的魅力，还向我……献媚求欢呢…_BH_」_W"
CALL PRINT_STR, @"「負けちゃだめだよ…%CNAME("二人称")%…」_W"	CALL PRINT_STR, @"「不能输哦…%CNAME("二人称")%…」_W"
CALL PRINT_STR, @"「%CNAME("二人称")%もオスらしく…もっといっぱい、ちゅぱちゅぱして…？_BH_」_W"	CALL PRINT_STR, @"「%CNAME("二人称")%也很有男人味…再多吸一点吧_BH_」_W"
CALL PRINT_STR, @"「満足するまで、おっぱいに甘えていいからね…_BH_」_W"	CALL PRINT_STR, @"「在满足之前、可以对胸部尽情撒娇哦…_BH_」_W"
CALL PRINT_STR, @"「おっぱいに顔押しつぶされながらしこしこされるの、好き？_BH_」_W"	CALL PRINT_STR, @"「想被被胸部压脸，并被手上下套弄小鸡鸡吗？_BH_」_W"
CALL PRINT_STR, @"「ちんぽがおててに甘えるみたいに…お顔もおっぱいにぐりぐりって…_BH_」_W"	CALL PRINT_STR, @"「像小鸡鸡朝作圈的手指撒娇一样，任脸被沉甸甸的乳肉埋没…_BH_」_W"
CALL PRINT_STR, @"「ふふ…_BH_ かわいい…_BH_」_W"	CALL PRINT_STR, @"「呋呋…_BH_ 可爱…_BH_」_W"
CALL PRINT_STR, @"「もっと顔押し付けていいよ…_BH_」_W"	CALL PRINT_STR, @"「可以把脸压得更紧一点…_BH_」_W"
CALL PRINT_STR, @"「もっと、もっと…_BH_」_W"	CALL PRINT_STR, @"「更紧、更紧…_BH_」_W"
CALL PRINT_STR, @"「%CNAME("一人称")%に甘えて…何もかも、委ねて…_BH_」_W"	CALL PRINT_STR, @"「把一切都交给%CNAME("一人称")%…_BH_」_W"
CALL PRINT_STR, @"「谷間から香る、淫魔のフェロモン…_BH_」_W"	CALL PRINT_STR, @"「从乳沟发出的淫魔荷尔蒙可是…_BH_」_W"
CALL PRINT_STR, @"「普通の人が嗅いじゃったら…_BH_ それだけでイっちゃうような、濃密な淫気…_BH_」_W"	CALL PRINT_STR, @"「足以让普通人变成雄犬雌猫的高级媚药…_BH_」_W"
CALL PRINT_STR, @"「ごめんね、おちんぽ君…_BH_」_W"	CALL PRINT_STR, @"「对不起，小鸡鸡君…_BH_」_W"
CALL PRINT_STR, @"「%CNAME("二人称")%が満足するまで、おててで我慢していてね…_BH_」_W"	CALL PRINT_STR, @"「在%CNAME("二人称")%满意之前，一直忍耐吧…_BH_」_W"
PRINTFORMW 「%CNAME("二人称")%、息つらくないの…？」	PRINTFORMW 「%CNAME("二人称")%、不难受吗…？」
CALL PRINT_STR, @"「もし、おっぱいに埋もれて離れたくないなら…_BH_ そのまま深ぁく、息を吸って_BH_」_W"	CALL PRINT_STR, @"「嗯_BH_如果不想离开的话…_BH_ 就那样深深地吸一口气_BH_」_W"
CALL PRINT_STR, @"「身体の芯から、気持ちよくなっちゃおうね…_BH_」_W"	CALL PRINT_STR, @"「从身体内部开始，让鸡鸡变得舒服吧…_BH_」_W"
CALL PRINT_STR, @"「あん_BH_」_W"	CALL PRINT_STR, @"「啊_BH_」_W"
CALL PRINT_STR, @"「%CNAME("一人称")%の下乳に…%CNAME("二人称")%のふー_BH_ふー_BH_ って息があたっちゃってる_BH_」_W"	CALL PRINT_STR, @"「%CNAME("一人称")%的下乳被…%CNAME("二人称")%の呼_BH_呼_BH_ 灼热的呼吸弄得麻麻的_BH_」_W"
CALL PRINT_STR, @"「おっぱいの奥までお顔を埋めて、ふがふがしながらおちんぽしこしこ…_BH_」_W"	CALL PRINT_STR, @"「把脸埋到胸部深处、一边感受小鸡鸡被揉蛋蛋的快感吧…_BH_」_W"
CALL PRINT_STR, @"「上手に甘えられる%CNAME("二人称")%、とっても素敵だよ…_BH_」_W"	CALL PRINT_STR, @"「能很好地撒娇的%CNAME("二人称")%、非常棒哦…_BH_」_W"
CALL PRINT_STR, @"「だからそのままかっこいいお射精も…_BH_ がんばれ、がんばれ…_BH_」_W"	CALL PRINT_STR, @"「所以就那样帅气地射精吧…_BH_ 加油、加油…_BH_」_W"
CALL PRINT_STR, @"「しこしこ早くしていくね…_BH_ 出そうになったら我慢しないで…_BH_ 思いっきり、楽しんで…_BH_」_W"	CALL PRINT_STR, @"「真是令人兴奋的气味呢……_BH_别忍着了…_BH_尽情享受吧…_BH_」_W"
CALL PRINT_STR, @"「あ…_BH_ おちんぽ、びくびくしてきたね…_BH_」_W"	CALL PRINT_STR, @"「啊…_BH_ 小鸡鸡一点一点的…_BH_」_W"
CALL PRINT_STR, @"「とぷとぷ、って_BH_ 甘えるみたいなお漏らしミルク、しちゃってるよ_BH_」_W"	CALL PRINT_STR, @"「噗噗噗的_BH_ 像撒娇一样止不往地溢出肉棒牛奶呢_BH_」_W"
CALL PRINT_STR, @"「かわいいなぁ、%CNAME("二人称")%…_BH_」_W"	CALL PRINT_STR, @"「好可爱啊、%CNAME("二人称")%…_BH_」_W"
CALL PRINT_STR, @"「お射精ぴゅっぴゅ待ちきれなくて、先にザーメンさんだけ出てきちゃったのかな…_BH_」_W"	CALL PRINT_STR, @"「是等不到嗖嗖地射精…只好让肉棒牛奶先出来…_BH_」_W"
CALL PRINT_STR, @"「ごめんねー…%CNAME("二人称")%…_BH_」_W"	CALL PRINT_STR, @"「对不起啊…%CNAME("二人称")%…_BH_」_W"
CALL PRINT_STR, @"「%CNAME("一人称")%のおっぱい、まだミルクがでないんだ…_BH_」_W"	CALL PRINT_STR, @"「%CNAME("一人称")%的巨乳，榨不出乳汁啊…_BH_」_W"
CALL PRINT_STR, @"「そんなに%CNAME("一人称")%のミルクが飲みたかったら…_BH_ %CNAME("二人称")%に頑張ってもらわないと、だめなの…_BH_」_W"	CALL PRINT_STR, @"「想喝%CNAME("一人称")%的乳汁的话…_BH_ %CNAME("二人称")%不努力侵犯小穴的话，可喝不上了哦…_BH_」_W"
CALL PRINT_STR, @"「ねえ…%CNAME("二人称")%…_BH_」_W"	CALL PRINT_STR, @"「呐…%CNAME("二人称")%…_BH_」_W"
CALL PRINT_STR, @"「飲みたくないかな…%CNAME("一人称")%のおっぱい…_BH_」_W"	CALL PRINT_STR, @"「不想喝吗…%CNAME("一人称")%的乳汁…_BH_」_W"
CALL PRINT_STR, @"「ん、谷間にお顔埋めながら、おちんぽへこへこ気持ちいいね…_BH_」_W"	CALL PRINT_STR, @"「嗯，把脸埋在乳沟里吸着荷尔蒙，并被淫魔玩弄小鸡鸡，%CNAME("二人称")%真是好舒服啊…_BH_」_W"
CALL PRINT_STR, @"「%CNAME("一人称")%も手伝ってあげる…_BH_ サオをしこしこ…_BH_ さきっぽこねこね…_BH_」_W"	CALL PRINT_STR, @"「对%CNAME("一人称")%的手交技术…感觉如何～是沿着系带滑去蛋蛋舒服呢？还是被指肚压着马眼的感觉更好呢？…_BH_」_W"
CALL PRINT_STR, @"「ふふ、谷間の汗まで舐めちゃって…喜んでくれてるんだね…_BH_」_W"	CALL PRINT_STR, @"「呋呋、连乳沟里的汗都舔了…你真很喜欢这样啊…_BH_」_W"
CALL PRINT_STR, @"「いいよー…そのまま、おっぱいに甘えて、%CNAME("二人称")%の種付けぴゅっぴゅ、見せて_BH_」_W"	CALL PRINT_STR, @"「就这样对胸部撒娇的时候、能不能让%CNAME("二人称")%的小鸡鸡嗖嗖地射精呢_BH_」_W"
CALL PRINT_STR, @"「%CNAME("二人称")%…%CNAME("一人称")%のおっぱい、やわらかい…？_BH_ 好き…？_BH_」_W"	CALL PRINT_STR, @"「%CNAME("二人称")%…%CNAME("一人称")%的胸部柔软、很喜欢…？_BH_」_W"
CALL PRINT_STR, @"「ふふ、ありがと_BH_」_W"	CALL PRINT_STR, @"「呋呋、谢谢_BH_」_W"
CALL PRINT_STR, @"「褒めてくれたご褒美に…すっごい責め方、してあげるねー…_BH_」_W"	CALL PRINT_STR, @"「作为赞美的回礼…我会好好服务你…_BH_」_W"
CALL PRINT_STR, @"「ほら…_BH_ %CNAME("一人称")%に腰預けて…？_BH_」_W"	CALL PRINT_STR, @"「啊…_BH_ %CNAME("一人称")%的腰很温暖？…？_BH_」_W"
CALL PRINT_STR, @"「そうそう、上手だよ…_BH_」_W"	CALL PRINT_STR, @"「还有种很安心的感觉…_BH_」_W"
CALL PRINT_STR, @"「そのままリラックスしてていいからね…_BH_ %CNAME("一人称")%が全部やっちゃうから…_BH_」_W"	CALL PRINT_STR, @"「那样放松就好…_BH_ 全部交给%CNAME("一人称")%…_BH_」_W"
CALL PRINT_STR, @"「%CNAME("二人称")%、目がとろんってしてるよ…_BH_ 」_W"	CALL PRINT_STR, @"「%CNAME("二人称")%、眼睛眯着呢…_BH_ 」_W"
CALL PRINT_STR, @"「ふふ…_BH_ 気持ちよくなってくれてるんだね…_BH_ ありがと…_BH_」_W"	CALL PRINT_STR, @"「呋呋…_BH_ 变得舒服了呢…_BH_」_W"
CALL PRINT_STR, @"「このままお射精したくなったら、我慢しなくていいからね…_BH_」_W"	CALL PRINT_STR, @"「想就这样射精的话，不用忍了…_BH_」_W"
CALL PRINT_STR, @"「もー…_BH_ 甘えんぼさん…_BH_」_W"	CALL PRINT_STR, @"「真是令人陶醉的气味_BH_」_W"
CALL PRINT_STR, @"「仕方ないなぁ…_BH_」_W"	CALL PRINT_STR, @"「没办法啊…_BH_」_W"
CALL PRINT_STR, @"「いいよ、そのままおっぱいで遊んでて…_BH_」_W"	CALL PRINT_STR, @"「好啊，就这样玩弄胸部吧…_BH_」_W"
CALL PRINT_STR, @"「おちんぽの方は、%CNAME("一人称")%がやってあげる…_BH_」_W"	CALL PRINT_STR, @"「小鸡鸡、由%CNAME("一人称")%服务…_BH_」_W"
CALL PRINT_STR, @"「このやり方、好き…？_BH_」_W"	CALL PRINT_STR, @"「我喜欢这种做法吗…？_BH_」_W"
CALL PRINT_STR, @"「%CNAME("一人称")%は、好きだよ…_BH_」_W"	CALL PRINT_STR, @"「%CNAME("一人称")%我喜欢…_BH_」_W"
PRINTFORMW 「男の子が、お腹向けて、何もかも無防備に差し出して…」	PRINTFORMW 「雄性向柔软且毫无防备的子宫伸出鸡鸡…」
CALL PRINT_STR, @"「とろとろに蕩けて、安心しきってるのが、好きなの…_BH_」_W"	CALL PRINT_STR, @"「并乐于见到龟头不断地亲吻子宫的时候…_BH_」_W"
CALL PRINT_STR, @"「触りもしないで、おちんぽの周りでおててをしこしこ…_BH_ 亀頭の先で、指をゆらゆら…_BH_」_W"	CALL PRINT_STR, @"「掌心都没与肉棒来一次拥抱，仅仅是做出虚握的样子上下摆动着就……WH_」_W"
CALL PRINT_STR, @"「手コキの素振りを見せてるだけで、もう呼吸が荒くなってるけど…_BH_」_W"	CALL PRINT_STR, @"「因为期待下一秒～下一分的手交，心跳就变得好快啊…_BH_」_W"
CALL PRINT_STR, @"「もしかして%CNAME("二人称")%…_BH_ もう精液昇ってきてる…？_BH_」_W"	CALL PRINT_STR, @"「难道%CNAME("二人称")%…_BH_ 已经溢出精液了吗…？_BH_」_W"
CALL PRINT_STR, @"「誤魔化してもだめだよ…_BH_ 鈴口からザーメンのにおい…_BH_ %CNAME("一人称")%まで届いてきてる…_BH_」_W"	CALL PRINT_STR, @"「蒙混过关可不行啊…_BH_ 从马眼飘出浓浓的精臭…_BH_ 已经被%CNAME("一人称")%吸入肺内了哦…_BH_」_W"
CALL PRINT_STR, @"「よっぽど興奮してるんだね…_BH_ それとも、%CNAME("一人称")%がえっちすぎる所為なのかな…？_BH_」_W"	CALL PRINT_STR, @"「是因为…_BH_ 太过兴奋呢、还是%CNAME("一人称")%所作的太过分了呢…？_BH_」_W"
CALL PRINT_STR, @"「どっちにしても、きちんと責任は取ってあげる…_BH_」_W"	CALL PRINT_STR, @"「不管怎么样，我都会好 好 负 责的…_BH_」_W"
CALL PRINT_STR, @"「おちんぽ、しっかり握り込んで…_BH_ がっつりちゅこちゅこ…_BH_ 扱いてあげる…_BH_」_W"	CALL PRINT_STR, @"「给肉棒君一次紧紧的拥抱…_BH_ 之后就是揉捏蛋蛋了…_BH_ 快快射精吧…_BH_」_W"
CALL PRINT_STR, @"「わ…_BH_ ずっしり…_BH_」_W"	CALL PRINT_STR, @"「哇…_BH_ 沉甸甸…_BH_」_W"
CALL PRINT_STR, @"「きんたま、重たくなっちゃってるね…_BH_」_W"	CALL PRINT_STR, @"「睾丸变得好重…_BH_」_W"
CALL PRINT_STR, @"「毎日何度もお射精してるのに…_BH_ すぐにお子種溜め込んじゃう…_BH_」_W"	CALL PRINT_STR, @"「明明每天射出的量一次比一次多…_BH_ 但转眼间就蓄积出更夸张的份量…_BH_」_W"
CALL PRINT_STR, @"「%CNAME("二人称")%のたまたまさんは…_BH_ とっても真面目で働き者だね…_BH_」_W"	CALL PRINT_STR, @"「%CNAME("二人称")%的肉棒……_BH_ 是鬼畜得不行不行的怪物呀…_BH_」_W"
CALL PRINT_STR, @"「ふふ…_BH_ これは、%CNAME("一人称")%がたっぷり労ってあげないと…_BH_」_W"	CALL PRINT_STR, @"「呋呋…_BH_ 若%CNAME("一人称")%不好好照顾它…可不行啊_BH_」_W"
CALL PRINT_STR, @"「袋のしわの一本一本まで…_BH_ 丹念に舐め上げて…_BH_ 揉み込んで…_BH_ 中のザーメンもほぐしてあげて…_BH_」_W"	CALL PRINT_STR, @"「把睾丸每条皱纹…_BH_ 舔得舒展开来……_BH_ 再把里面的精液也一同吸出…_BH_」_W"
CALL PRINT_STR, @"「しっかりたくさんお射精できるように…_BH_ %CNAME("一人称")%が癒してあげなきゃ…_BH_」_W"	CALL PRINT_STR, @"「为了更浓更稠的肉棒牛奶…_BH_ %CNAME("一人称")%必须治愈它…_BH_」_W"
CALL PRINT_STR, @"「押し倒されて、興奮してるのかな…？_BH_ おちんぽ、いつもよりバキバキになっちゃってるよ…_BH_」_W"	CALL PRINT_STR, @"「被推倒了，很兴奋吧…?_BH_ 小鸡鸡_BH_ 可是比平时还要硬邦邦的哦…_BH_」_W"
CALL PRINT_STR, @"「先っぽも、ほら…_BH_ おつゆがとくとくって…_BH_ とろとろに糸引いちゃってる…_BH_」_W"	CALL PRINT_STR, @"「龟头也红红的_BH_从马眼溢流的先走汁稠得可以拉丝啊…_BH_」_W"
CALL PRINT_STR, @"「手のひらで磨かれるの、好きになっちゃった…？_BH_ _BH_」_W"	CALL PRINT_STR, @"「很喜欢…用手做…？_BH_ _BH_」_W"
CALL PRINT_STR, @"「%CNAME("二人称")%のおちんぽ…_BH_ 正直で本当に可愛いね…_BH_」_W"	CALL PRINT_STR, @"「%CNAME("二人称")%的小鸡鸡…_BH_ 正直得很可爱呢…_BH_」_W"
CALL PRINT_STR, @"「%CNAME("二人称")%は、これからどんな風にされたいのかな…_BH_」_W"	CALL PRINT_STR, @"「%CNAME("二人称")%…今后想被怎样对待呢…_BH_」_W"
CALL PRINT_STR, @"「指で裏筋くすぐられるのも…_BH_ カリ溝ぞりぞり削られるのも…_BH_ 金玉揉まれたり…_BH_ 鈴口ほじほじも好きだよね…_BH_」_W"	CALL PRINT_STR, @"「是被上下套弄呢…_BH_ 还是被蹭刮龟头下的沟沟呢…_BH_ 或是揉捏蛋蛋好呢…_BH_ 也喜欢被弄着马眼吧…_BH_」_W"
CALL PRINT_STR, @"「%CNAME("二人称")%の好きなやり方…_BH_ %CNAME("一人称")%、みんな覚えてるよ…_BH_」_W"	CALL PRINT_STR, @"「%CNAME("二人称")%喜欢的做法…_BH_ %CNAME("一人称")%、大家都记得哦……_BH_」_W"
CALL PRINT_STR, @"「%CNAME("二人称")%の弱いところも…_BH_ %CNAME("一人称")%、ぜんぶ知ってるよ…_BH_」_W"	CALL PRINT_STR, @"「%CNAME("二人称")%的弱点也…_BH_ %CNAME("一人称")%、全部都知道哦…_BH_」_W"
CALL PRINT_STR, @"「ねえ…%CNAME("二人称")%…_BH_」_W"	CALL PRINT_STR, @"「呐…%CNAME("二人称")%…_BH_」_W"
CALL PRINT_STR, @"「これから%CNAME("一人称")%にどうされたいのか…_BH_ おちんぽでちゃんと返事して…？_BH_」_W"	CALL PRINT_STR, @"「今后想被%CNAME("一人称")%怎么做…_BH_ 请用小鸡鸡好好地回复我吧…？_BH_」_W"
CALL PRINT_STR, @"「%CNAME("二人称")%、%CNAME("一人称")%のおててのことしか考えられなくなっちゃってるみたい…_BH_」_W"	CALL PRINT_STR, @"「%CNAME("二人称")%、%CNAME("一人称")%好像只会想你的事情了…_BH_」_W"
CALL PRINT_STR, @"「だって、%CNAME("一人称")%の指がつつーって動くだけで…_BH_ ほら…_BH_」_W"	CALL PRINT_STR, @"「因为、%CNAME("一人称")%仅是动一动手指就……_BH_」_W"
CALL PRINT_STR, @"「こんなにえっちなびくびく、激しくしなってる…_BH_ ほらほら…_BH_ どう…？_BH_ 気持ちいい…？_BH_」_W"	CALL PRINT_STR, @"「颤抖得让人怜爱，止不住地溢流先走汁…_BH_ 看吧…怎么样…？_BH_ 舒服吗…？_BH_」_W"
CALL PRINT_STR, @"「ふふ…%CNAME("二人称")%は、本当に%CNAME("一人称")%を喜ばせるのが上手だね…_BH_」_W"	CALL PRINT_STR, @"「呋呋…%CNAME("二人称")%真的很擅长让%CNAME("一人称")%高兴呢…_BH_」_W"
CALL PRINT_STR, @"「お礼に…_BH_ %CNAME("一人称")%も%CNAME("二人称")%のこと、いっぱい悦ばせてあげるから…_BH_」_W"	CALL PRINT_STR, @"「作为答谢…_BH_ %CNAME("一人称")%也会做与%CNAME("二人称")%一样的事，让你舒服得欲仙欲死…_BH_」_W"
CALL PRINT_STR, @"「おちんぽのびくびく激しすぎだよぅ…_BH_」_W"	CALL PRINT_STR, @"「小鸡鸡颤动的样子好可怕啊…_BH_」_W"
CALL PRINT_STR, @"「口の端からよだれまで垂らして…_BH_ もうすっかり射精のことしか考えられなくなってるみたい_BH_」_W"	CALL PRINT_STR, @"「最前端的马眼仅溢着先走汁…_BH_ 好像全心全意地投入到射精前的准备了呢_BH_」_W"
CALL PRINT_STR, @"「とっても逞しいオスの姿…_BH_ %CNAME("一人称")%、どきどきしてきちゃった_BH_」_W"	CALL PRINT_STR, @"「非常强壮的雄性姿态…_BH_ %CNAME("一人称")%、忐忑不安起来了_BH_」_W"
CALL PRINT_STR, @"「%CNAME("二人称")%のツガイとして…_BH_ おちんぽに仕えるザー汁絞りメイドとして…_BH_」_W"	CALL PRINT_STR, @"「%CNAME("二人称")%的龟头……_BH_ 作为侍奉小鸡鸡的榨汁女仆…_BH_」_W"
CALL PRINT_STR, @"「テクニックの全てを駆使して、極楽射精に導いてあげるからね_BH_」_W"	CALL PRINT_STR, @"「将要运用所有的淫魔技巧、令射精快感达至极乐_BH_」_W"
CALL PRINT_STR, @"「とりあえず、きんたま揉み込んで子種をぐるぐる濃縮するから…_BH_」_W"	CALL PRINT_STR, @"「总之、先揉一揉蛋蛋让内部的精液变得更粘稠吧…_BH_」_W"
CALL PRINT_STR, @"「ちょっとむずむずしちゃうと思うけど、我慢してね…_BH_」_W"	CALL PRINT_STR, @"「会有点痒，不过请忍耐一下…_BH_」_W"
CALL PRINT_STR, @"「%CNAME("一人称")%の手の中で、%CNAME("二人称")%のきんたま、ふるふるって震えちゃってる…_BH_」_W"	CALL PRINT_STR, @"「在%CNAME("一人称")%的手里，是%CNAME("二人称")%那两颗沉甸甸的睾丸…_BH_」_W"
CALL PRINT_STR, @"「大丈夫だからね_BH_ 心配しなくても、%CNAME("一人称")%が%CNAME("二人称")%のせーしのこと、育ててあげる_BH_」_W"	CALL PRINT_STR, @"「不用担心啦_BH_ 没问题的、%CNAME("一人称")%会好好训练%CNAME("二人称")%的精液_BH_」_W"
CALL PRINT_STR, @"「%CNAME("二人称")%のどろどろせーし_BH_ いまよりずっと凶悪で強靭な、最強無慈悲の蛮族ザーメンに訓練してあげるからね…_BH_」_W"	CALL PRINT_STR, @"「%CNAME("二人称")%的精液_BH_ 要锤炼成比现在更凶更恶更加坚韧无情的、蛮族般的粘稠精液…_BH_」_W"
CALL PRINT_STR, @"「そのために…まずはマシンガン手コキ500往復から、いってみようか…_BH_」_W"	CALL PRINT_STR, @"「总之，先高速撸动鸡鸡500回吧…_BH_」_W"
CALL PRINT_STR, @"「きんたまかりかり…_BH_ さきっぽさわさわ…_BH_」_W"	CALL PRINT_STR, @"「蛋蛋靠近一点…_BH_ 再近一点…_BH_」_W"
CALL PRINT_STR, @"「手のひらきゅっきゅっ…_BH_ 亀さんぐりぐり…_BH_」_W"	CALL PRINT_STR, @"「手里的鸡鸡在颤抖呢…_BH_ 龟头也溢着先走汁…_BH_」_W"
CALL PRINT_STR, @"「裏筋の方もくすぐっていくね…_BH_ %CNAME("二人称")%のえっちなお腰、%CNAME("一人称")%に委ねてくれるかな…_BH_」_W"	CALL PRINT_STR, @"「系带周边很痒吧…_BH_ %CNAME("二人称")%有点摇晃晃的腰、能交给我%CNAME("一人称")%吗…_BH_」_W"
CALL PRINT_STR, @"「%CNAME("二人称")%専用の全自動オナサポリクライニングシートだよ…_BH_」_W"	CALL PRINT_STR, @"「这是%CNAME("二人称")%专用的全自动可控型人肉飞机杯哦…_BH_」_W"
CALL PRINT_STR, @"「ぴゅっぴゅの最中も、その後も…全部お世話してあげるからね_BH_」_W"	CALL PRINT_STR, @"「无论是在恋爱的过程中，还是之后……我都会照顾你的_BH_」_W"
CALL PRINT_STR, @"「%CNAME("二人称")%のおちんぽ、すっかりどろどろになっちゃった…_BH_」_W"	CALL PRINT_STR, @"「%CNAME("二人称")%的小鸡鸡、变得粘糊糊的…_BH_」_W"
CALL PRINT_STR, @"「…ねえ、%CNAME("二人称")%は知ってる…_BH_」_W"	CALL PRINT_STR, @"「…我知道%CNAME("二人称")%_BH_」_W"
CALL PRINT_STR, @"「このお汁…カウパーだけがちんぽの中から追い出されて…せーしがどんどん練り上げられて_BH_ 」_W"	CALL PRINT_STR, @"「仅有先走汁从鸡鸡中不断溢出，被手指反复涂到每个角落_BH_ 」_W"
CALL PRINT_STR, @"「…うどんみたいなごってりせーしが出来上がるんだよ_BH_」_W"	CALL PRINT_STR, @"「…像乌冬一样粘稠的精液就做好了哦_BH_」_W"
CALL PRINT_STR, @"「そしたら、ついには先走りにまで子種が混じり始めて…_BH_」_W"	CALL PRINT_STR, @"「然后，在尿道与先走汁混合为一…_BH_」_W"
PRINTFORMW 「後ろから失礼しまーす…」	PRINTFORMW 「从后面开始…失礼了…」
PRINTFORMW 「えへへ…ちょっぴり恥ずかしいね」	PRINTFORMW 「嘿嘿…有点害羞呢」
PRINTFORMW 「ね、背中で%CNAME("一人称")%のおっぱい感じる…？」	PRINTFORMW 「在背上感到で%CNAME("一人称")%的胸部…？」
CALL PRINT_STR, @"「見かけよりもずっとずっと大きいでしょ…_BH_」_W"	CALL PRINT_STR, @"「比看上去的要大得多吧…_BH_」_W"
PRINTFORMW 「じゃあ、このままするね…」	PRINTFORMW 「那就这样吧…」
CALL PRINT_STR, @"「%CNAME("一人称")%のえっちなデカパイ、背中でたっぷり楽しみながら…_BH_」_W"	CALL PRINT_STR, @"「在背上尽情享受%CNAME("一人称")%沉甸甸的丰满巨乳吧…_BH_」_W"
CALL PRINT_STR, @"「ぐつぐつぐつぐつ_BH_ きんたまとおちんぽ興奮させよ…？_BH_」_W"	CALL PRINT_STR, @"「咕嘟咕嘟_BH_ 让你兴奋起来吧…_BH_」_W"
CALL PRINT_STR, @"「さきっぽのほう、責めていくね…_BH_」_W"	CALL PRINT_STR, @"「…我要开始了哦…_BH_」_W"
CALL PRINT_STR, @"「そうして激しい快楽で疲れちゃったおちんぽをね…？_BH_」_W"	CALL PRINT_STR, @"「然后把因激烈快乐而萎缩的小鸡鸡……？_BH_」_W"
CALL PRINT_STR, @"「今度は竿から根元にかけて、ねっとりまったりマッサージしてくの…_BH_」_W"	CALL PRINT_STR, @"「从茎身到蛋蛋都来次粘糊糊的按摩…_BH_」_W"
CALL PRINT_STR, @"「%CNAME("二人称")%、これもう何回か続けるからね…気を失わないように、気をつけて…_BH_」_W"	CALL PRINT_STR, @"「%CNAME("二人称")%、这个已经持续几次了呢…注意…不要失去意识了…_BH_」_W"
CALL PRINT_STR, @"「前に回って、向かい合ってしこしこするね…_BH_」_W"	CALL PRINT_STR, @"「绕到前面，面对面地做个好孩子吧…_BH_」_W"
PRINTFORMW 「あ、だめだよ視線そらしちゃ」	PRINTFORMW 「啊，把视线移开可不行」
CALL PRINT_STR, @"「…どんなに恥ずかしくても_BH_ 情けなーいトロ顔してても…_BH_」_W"	CALL PRINT_STR, @"「…无论多么害羞_BH_ 就算一副可怜的表情…_BH_」_W"
CALL PRINT_STR, @"「%CNAME("一人称")%にとってはどれもみーんな…大切なツガイのオスの顔なの_BH_」_W"	CALL PRINT_STR, @"「对%CNAME("一人称")%来说，无论哪个都很美、都很可爱…这是非常重要的雄性的脸_BH_」_W"
PRINTFORMW 「だから変なこと気にしなくていいんだよ…？」	PRINTFORMW 「所以不用在意…」
CALL PRINT_STR, @"「素敵なお顔、たくさん見せて…_BH_」_W"	CALL PRINT_STR, @"「给我看很多很多漂亮的脸吧…_BH_」_W"
CALL PRINT_STR, @"「%CNAME("二人称")%のお耳かわいい…_BH_」_W"	CALL PRINT_STR, @"「%CNAME("二人称")%可爱的耳朵…_BH_」_W"
CALL PRINT_STR, @"「%CNAME("一人称")%の目の前でえっちに揺れて…舐めて_BH_ 舐めて_BH_ って誘ってるみたい_BH_」_W"	CALL PRINT_STR, @"「%CNAME("一人称")%的眼前摇晃…好像是在邀请别人去舔舐呢_BH_」_W"
CALL PRINT_STR, @"「ん…我慢できないから、お耳、舐めちゃお_BH_」_W_"	CALL PRINT_STR, @"「嗯…我忍不了了，舔耳朵吧_BH_」_W_"
CALL PRINT_STR, @"「んちゅ…_BH_ れる_BH_ れる_BH_ かぽかぽかぽ…_BH_ んふ_BH_ おいし…_BH_」_W"	CALL PRINT_STR, @"「嗯…_BH_ 嗯_BH_ 嗯_BH_ 暖洋洋…_BH_ 嗯_BH_ 好吃…_BH_」_W"
CALL PRINT_STR, @"「しこしこも続けるね…_BH_ 快楽塗れのドスケベ手コキ…耳でも楽しんで…_BH_」_W"	CALL PRINT_STR, @"「这个也要继续哦…_BH_ 在感受涂满快乐的小鸡鸡时…也要享受耳朵…_BH_」_W"
PRINTFORMW 「%CNAME("二人称")%…もしかして、手コキでおちんぽつらくなっちゃった…？」	PRINTFORMW 「%CNAME("二人称")%…难不成、是我用手捂得慌了…？」
CALL PRINT_STR, @"「じゃあ…おめめ、瞑ってみて…？_BH_」_W"	CALL PRINT_STR, @"「那……你闭上眼睛看看…？_BH_」_W"
CALL PRINT_STR, @"「ぐちゅぐちゅ、しこしこ_BH_ えっちな音がたくさんするよね…」_W"	CALL PRINT_STR, @"「噼噼噼噼、咕嘟咕嘟_BH_ 有很多奇怪的声音吧…」_W"
CALL PRINT_STR, @"「これ全部、%CNAME("二人称")%のおちんぽからしてるんだよ_BH_」_W"	CALL PRINT_STR, @"「这些全部、是从%CNAME("二人称")%的小鸡鸡那里来的_BH_」_W"
CALL PRINT_STR, @"「このぐちゅぐちゅは何の音かなー…？_BH_」_W"	CALL PRINT_STR, @"「这是什么声音啊——？_BH_」_W"
CALL PRINT_STR, @"「おちんぽの先磨かれてる音…？ それとも根元がおててで遊ばれてる音かな…？_BH_」_W"	CALL PRINT_STR, @"「小鸡鸡前端被磨蹭的声音？还是蛋蛋被揉玩的声音呢？_BH_」_W"
CALL PRINT_STR, @"「さわさわかりかり_BH_ おちんぽの表面くすぐる指は何本なんだろうね…？_BH_」_W"	CALL PRINT_STR, @"「啾啾啾啾_BH_ 在小鸡鸡身上动来动去的手背有几根呀…？_BH_」_W"
CALL PRINT_STR, @"「どんな風に動いて、次はどこを責めようとしてるんだろう…？_BH_」_W"	CALL PRINT_STR, @"「接下来会怎样行动，又会欺负哪里呢…？_BH_」_W"
CALL PRINT_STR, @"「ふふ、おっぱいの感触も忘れちゃだめだよ…_BH_ %CNAME("二人称")%に押し付けられた…ふんわりやわらかおっぱいの感触…_BH_」_W"	CALL PRINT_STR, @"「呋呋、不要忘记乳房的触感哦…_BH_ 强加给%CNAME("二人称")%…软绵绵的触感…_BH_」_W"
CALL PRINT_STR, @"「そうだよねー…_BH_ こんなの、かえっておちんぽどんどんいらいらしてきちゃうよね…_BH_」_W"	CALL PRINT_STR, @"「哦…_BH_ 这样反而会让小鸡鸡越来越烦躁吧…_BH_」_W"
CALL PRINT_STR, @"「でも我慢だよー…_BH_」_W"	CALL PRINT_STR, @"「但是要忍耐哦ー…_BH_」_W"
CALL PRINT_STR, @"「おちんぽの快楽、もっともっと高めたほうが…ぜーったい気持ちいいんだから…_BH_」_W"	CALL PRINT_STR, @"「小鸡鸡的快乐，应该再提高一点…在将要射的时候才会更爽呀…_BH_」_W"
CALL PRINT_STR, @"「ん、%CNAME("二人称")%の遺伝子ソース、%CNAME("一人称")%が濃くしてあげる…_BH_」_W"	CALL PRINT_STR, @"「嗯、%CNAME("二人称")%的遗传因子、给%CNAME("一人称")%浓浓的吧…_BH_」_W"
CALL PRINT_STR, @"「きんたまのおなべのなかで煮込んで煮込んで、煮凝りみたいに濃ゆ濃ゆにすれば_BH_」_W"	CALL PRINT_STR, @"「在金玉锅里炖煮、直至变成粘稠稠的浓汤_BH_」_W"
CALL PRINT_STR, @"「きっとお射精するときは、びっくりするぐらい気持ち良いよ…_BH_」_W"	CALL PRINT_STR, @"「在射精的时候、一定会舒服到让人欲仙欲死…_BH_」_W"
CALL PRINT_STR, @"「ふふ_BH_ もしかしたら、あたまぱーになっちゃうかもね…？_BH_ 」_W"	CALL PRINT_STR, @"「呋呋_BH_ 说不定会变成傻瓜呢…？_BH_ 」_W"
CALL PRINT_STR, @"「もしそうなっても、%CNAME("一人称")%がぜんぶ面倒見てあげるから…_BH_」_W"	CALL PRINT_STR, @"「如果变成那样、%CNAME("一人称")%会照顾你的…_BH_」_W"
CALL PRINT_STR, @"「%CNAME("二人称")%は何も心配しなくていいよ…_BH_」_W"	CALL PRINT_STR, @"「%CNAME("二人称")%你什么也不用担心…_BH_」_W"
//40-AM 綾乃 素股
PRINTFORMW %CALLNAME:MASTER%が自慢げに見せ付けたペニスを、%CALLNAME:TARGET%は頬を紅潮させながら弄っている…	PRINTFORMW %CALLNAME:MASTER%将自胯部屹立的悍壮肉茎亮出、%CALLNAME:TARGET%双颊泛起潮红，忘我地凝视着它…
PRINTFORMW 上目遣いに媚びた視線を投げかけながらも驚くべき滑らかさで蠢く%CALLNAME:TARGET%の指はすぐに%CALLNAME:MASTER%の官能を高め、離れた指とペニスとの間に細く輝く橋を架けた…	PRINTFORMW 并仰首往上投去充满谄媚之意的煽情视线，%CALLNAME:TARGET%的纤指以惊人的极速玩弄、磨蹭着每个地方，未了…才离开%CALLNAME:MASTER%的阳根、其双手粘满了雄性溢流的先走汁…
CALL PRINT_STR, @"「ひゃー…_BH_ あっつ…_BH_」_W"	CALL PRINT_STR, @"「哎呀…_BH_ 有点多呢……_BH_」_W"
CALL PRINT_STR, @"「今にもびゅーって噴き出てきそう…_BH_」_W"	CALL PRINT_STR, @"「马上就要喷出来了…_BH_」_W"
CALL PRINT_STR, @"「相当溜め込んじゃってるねー…_BH_ これはぴゅっぴゅも期待できそう…_BH_」_W"	CALL PRINT_STR, @"「还真是攒了很多啊…_BH_ 这一点也值得期待…_BH_」_W"
CALL PRINT_STR, @"「ねね、%CNAME("二人称")%…_BH_ %CNAME("一人称")%、かっこいいお射精が見たいなぁ…_BH_」_W"	CALL PRINT_STR, @"「呐呐、%CNAME("二人称")%…_BH_ %CNAME("一人称")%好想看帅气的射精啊…_BH_」_W"
CALL PRINT_STR, @"「そのまま子宮を貫いちゃうくらいの…_BH_ かっこいーいオスのどぴゅどぴゅ…_BH_」_W"	CALL PRINT_STR, @"「以将要贯穿子宫的雄伟气势，在这英俊而悍壮的龟头涌出…_BH_」_W"
CALL PRINT_STR, @"「くっつけてるおまんこが…勝手に媚びちゃうくらいの…_BH_ 欲しいなぁ…_BH_」_W"	CALL PRINT_STR, @"「连粘到一块的阴唇都要…擅自谄媚的程度了…_BH_ 好想要啊…_BH_」_W"
CALL PRINT_STR, @"「お尻の下で、すっごいびくびく…_BH_ %CNAME("二人称")%のおちんぽくん…_BH_ とっても元気_BH_」_W"	CALL PRINT_STR, @"「在双腿中央的位置…真是让人兴奋不已呢……_BH_ %CNAME("二人称")%的小鸡鸡……_BH_ 非常有精神 _BH_」_W"
CALL PRINT_STR, @"「今にもぴゅぴゅって射精しちゃいそう…_BH_ どうかな…？_BH_ ちゃんとお射精、我慢できそう？_BH_」_W"	CALL PRINT_STR, @"「好像马上就要射精了…_BH_ 怎么样…？_BH_ 能把这兴致压下去吗？_BH_」_W"
CALL PRINT_STR, @"「無理そうだったら、遠慮しないで…_BH_ そのままびゅくびゅく_BH_ していいからね…_BH_」_W"	CALL PRINT_STR, @"「若是无法抑制射欲的话，那就不要忍耐了…_BH_ 就这样嗖嗖嗖地…_BH_ 射出来吧…_BH_」_W"
CALL PRINT_STR, @"「どっちでもいいよ…_BH_ すぐにびゅーびゅーしてもいいし…_BH_ 我慢してから、一気にどぷどぷも、きっと気持ちいいからね…_BH_」_W"	CALL PRINT_STR, @"「想怎样都可以哦～_BH_ 立马喷射也好、还是耐性等一会再射都可以～_BH_ 但是，选后者的话…会更舒服哦…_BH_」_W"
CALL PRINT_STR, @"「%CNAME("一人称")%、しばらくお尻押し付けてるから…_BH_ 焦らずじっくり選んでいいよ…_BH_」_W"	CALL PRINT_STR, @"「%CNAME("一人称")%、且先夹紧屁股吧…_BH_ 不要着急，踏踏实实地选择就好…_BH_」_W"
CALL PRINT_STR, @"「ん、お射精お疲れ様でした…_BH_」_W"	CALL PRINT_STR, @"「嗯，射精辛苦了…_BH_」_W"
CALL PRINT_STR, @"「%CNAME("二人称")%はそのまま、余韻に浸ってていいからね…_BH_」_W"	CALL PRINT_STR, @"「%CNAME("二人称")%就那样，沉浸在余韵里就好了…_BH_」_W"
CALL PRINT_STR, @"「その間に%CNAME("一人称")%が、おちんぽについた精液汚れ、おまんこで掃除してあげるから…_BH_」_W"	CALL PRINT_STR, @"「在此期间，%CNAME("一人称")%会把玷污了小鸡鸡的东西，打扫干净哦～_BH_」_W"
CALL PRINT_STR, @"「かっこいい射精だったよ、%CNAME("二人称")%…_BH_」_W"	CALL PRINT_STR, @"「好帅的射精啊、%CNAME("二人称")%…_BH_」_W"
CALL PRINT_STR, @"「ちょっと疲れちゃったかな…？_BH_」_W"	CALL PRINT_STR, @"「是不是有点累了…？_BH_」_W"
CALL PRINT_STR, @"「無理もないよね…あんなにかっこいいお射精だったもん…_BH_」_W"	CALL PRINT_STR, @"「也难怪啊…毕竟是那么酷的射精啊…_BH_」_W"
CALL PRINT_STR, @"「大丈夫だよ、%CNAME("二人称")%のおちんぽは、%CNAME("一人称")%のおまんこにまかせて…_BH_」_W"	CALL PRINT_STR, @"「没关系、%CNAME("二人称")%的小鸡鸡就交给%CNAME("一人称")%吧…_BH_」_W"
CALL PRINT_STR, @"「あは…_BH_ ザーメン、びゅーしたあとのちんぽ…_BH_ すごい…_BH_」_W"	CALL PRINT_STR, @"「啊哈…_BH_ 精液、和嗖嗖嗖射精后仍屹立不倒的小鸡鸡…_BH_ 厉害…_BH_」_W"
CALL PRINT_STR, @"「ご、ごめんね_BH_ %CNAME("二人称")%…_BH_ %CNAME("一人称")%ちょっと、興奮しちゃって…っ_BH_」_W"	CALL PRINT_STR, @"「对，对不起_BH_ %CNAME("二人称")%…_BH_ %CNAME("一人称")%有点兴奋…嗯_BH_」_W"
CALL PRINT_STR, @"「射精後のくったりお疲れちんぽ_BH_ ちょっとの間だけでいいから、%CNAME("一人称")%に貸してくれないかな…_BH_」_W"	CALL PRINT_STR, @"「仅要射精后的～那短短的休息时间就好…能不能在那时依靠一下%CNAME("一人称")%…_BH_」_W"
CALL PRINT_STR, @"「その代わり、おちんぽもっとどろどろにしてあげるから、ね…？_BH_」_W"	CALL PRINT_STR, @"「作为回报，我会让你的小鸡鸡更加粘糊糊的 _BH_」_W"
CALL PRINT_STR, @"「ぐりんぐりんって、グラインド…_BH_」_W"	CALL PRINT_STR, @"「咕噜咕噜咕噜扭腰…_BH_」_W"
CALL PRINT_STR, @"「これ…すっごいえっちだよ…_BH_」_W"	CALL PRINT_STR, @"「这个…你可真是坏心眼…_BH_」_W"
CALL PRINT_STR, @"「ねえ、もっと見て…_BH_ 目をそらさないで、もっと…_BH_」_W"	CALL PRINT_STR, @"「喂，不要移开视线…_BH_ 更地看着我 _BH_」_W"
CALL PRINT_STR, @"「%CNAME("一人称")%のおまたで擦るの、気に入っちゃった？_BH_」_W"	CALL PRINT_STR, @"「%CNAME("一人称")%的摩擦，你喜欢吗？_BH_」_W"
CALL PRINT_STR, @"「いいよ、%CNAME("二人称")%の好きなことは何でもしてあげる…_BH_」_W"	CALL PRINT_STR, @"「好啊、%CNAME("二人称")%喜欢的事情我都会帮你做…_BH_」_W"
CALL PRINT_STR, @"「満足するまで、%CNAME("一人称")%のおまたで、おちんぽ遊びしていいからね…_BH_」_W"	CALL PRINT_STR, @"「直到满足为止、%CNAME("一人称")%可以一直玩弄小鸡鸡…_BH_」_W"
CALL PRINT_STR, @"「%CNAME("一人称")%のふとももを犯すみたいに、必死にぱこぱこ、かわいいね～…_BH_」_W"	CALL PRINT_STR, @"「就像是要侵犯%CNAME("一人称")%的大腿一样，拼命地啪嗒啪嗒，好可爱啊 _BH_」_W"
CALL PRINT_STR, @"「そのすぐ近くに、ほんもののおまんこがあるって言うのに…_BH_ 一心不乱に腰動かして…_BH_」_W"	CALL PRINT_STR, @"「就在那附近，明明有真正的小穴…_BH_ 却全神贯注地扭动着腰…_BH_」_W"
CALL PRINT_STR, @"「そんなにおまたが好きなのかな…_BH_」_W"	CALL PRINT_STR, @"「那么喜欢大腿吗…_BH_」_W"
CALL PRINT_STR, @"「なら、もっと激しくしても、いいよ…_BH_」_W"	CALL PRINT_STR, @"「那么，再激烈一点也没关系…_BH_」_W"
CALL PRINT_STR, @"「ぱん、ぱん、ぱん、ぱん…_BH_」_W"	CALL PRINT_STR, @"「啪啪，啪啪，啪啪…_BH_」_W"
CALL PRINT_STR, @"「お肉とお肉のぶつかる音が、響いちゃってるね…_BH_」_W"	CALL PRINT_STR, @"「肉和肉碰撞的声音还在回响呢…_BH_」_W"
CALL PRINT_STR, @"「まるでセックスしてるみたいな、いやらし～い音…_BH_」_W"	CALL PRINT_STR, @"「简直就像在做爱一样，真是让人讨厌的声音…_BH_」_W"
CALL PRINT_STR, @"「実際に近くで見てみても、セックスしてるようにしか見えないのに…_BH_」_W"	CALL PRINT_STR, @"「实际上即使在附近看，也只会觉得是在做爱…_BH_」_W"
CALL PRINT_STR, @"「やってるのは、おまんこの入り口におちんぽ擦りつけてるだけの、おままごとみたいな素股なんて…_BH_」_W"	CALL PRINT_STR, @"「但所做的…仅不过是像过家家一样在阴道入口蹭来蹭去…_BH_」_W"
CALL PRINT_STR, @"「こういうのも、興奮しちゃうね…_BH_」_W"	CALL PRINT_STR, @"「这样的话，也会很兴奋呢…_BH_」_W"
CALL PRINT_STR, @"「おちんぽ疲れてきちゃったかな…？_BH_」_W"	CALL PRINT_STR, @"「小鸡鸡累了吧…？_BH_」_W"
CALL PRINT_STR, @"「じゃあ、%CNAME("二人称")%は楽にしてていいよ…_BH_」_W"	CALL PRINT_STR, @"「那么、%CNAME("二人称")%可以放松哦…_BH_」_W"
CALL PRINT_STR, @"「%CNAME("一人称")%が、ほら…_BH_ しっかりおちんぽ太腿で締めて…_BH_」_W"	CALL PRINT_STR, @"「%CNAME("一人称")%、你看…_BH_ 好好地用大腿收紧…_BH_」_W"
CALL PRINT_STR, @"「えへへ、えっちでしょ、これ…_BH_」_W"	CALL PRINT_STR, @"「嘿嘿，这个H吧…_BH_」_W"
CALL PRINT_STR, @"「%CNAME("二人称")%は、ダンスって好きかな…？_BH_」_W"	CALL PRINT_STR, @"「%CNAME("二人称")%、喜欢跳舞吗…?_BH_」_W"
CALL PRINT_STR, @"「男の人に跨って、おちんぽ手で押さえながら、おまたを擦りつけるポールダンス…_BH_」_W"	CALL PRINT_STR, @"「是胯坐在小鸡鸡上方，双手抱颈，再甩动腰肢的求欢舞哦…_BH_」_W"
CALL PRINT_STR, @"「今から見せてあげるから、特等席で楽しんで…_BH_」_W"	CALL PRINT_STR, @"「现在，在特等席享受吧…_BH_」_W"
CALL PRINT_STR, @"「ん…_BH_ 今度はおててじゃなくて、おまたで扱くね…_BH_」_W"	CALL PRINT_STR, @"「呐…这次不直接进攻，反而要蹂躏入口吗…？_BH_」_W"
CALL PRINT_STR, @"「お互いの、大事なところくっつけあいながら…_BH_」_W"	CALL PRINT_STR, @"「不把彼此最重要的部分连在一起吗…？_BH_」_W"
CALL PRINT_STR, @"「どこまでも蕩けて、一つになろ…？_BH_」_W"	CALL PRINT_STR, @"「不想射进去吗？_BH_」_W"
CALL PRINT_STR, @"「お互いの熱とか、感触とか、いっぱい感じながら…_BH_」_W"	CALL PRINT_STR, @"「一边感受着彼此的热度、触感…_BH_」_W"
CALL PRINT_STR, @"「おちんぽいっぱいむらむらさせようね…_BH_ 」_W"	CALL PRINT_STR, @"「让小鸡鸡多享受点吧…_BH_ 」_W"
CALL PRINT_STR, @"「あは…_BH_ 素敵なカタチ…_BH_」_W"	CALL PRINT_STR, @"「啊…_BH_ 漂亮的造型…_BH_」_W"
CALL PRINT_STR, @"「カタさもばっちり…_BH_ 亀頭もぷっくりふくれてて…」_W"	CALL PRINT_STR, @"「大小也很完美，龟头也鼓鼓的…」_W"
CALL PRINT_STR, @"「%CNAME("一人称")%、どきどきしちゃうなぁ…_BH_」_W"	CALL PRINT_STR, @"「%CNAME("一人称")%好激动啊…_BH_」_W"
CALL PRINT_STR, @"「ん…_BH_ %CNAME("二人称")%のと、%CNAME("一人称")%ので…_BH_」_W"	CALL PRINT_STR, @"「嗯…_BH_ %CNAME("二人称")%和%CNAME("一人称")%…_BH_」_W"
CALL PRINT_STR, @"「とろとろのぐちゃぐちゃに、デコレーションしちゃお…_BH_」_W"	CALL PRINT_STR, @"「都变得粘糊糊的了～_BH_」_W"
//40-AM 綾乃 胸愛撫
PRINTFORMW 「やっぱり、気になる？」	PRINTFORMW 「果然，你还是很在意吗?」
CALL PRINT_STR, @"「男の子の視線を無理矢理奪っちゃう、わるーいおっぱい…_BH_」_W"	CALL PRINT_STR, @"「这对能把雄性视线定在这里的硕大乳房…_BH_」_W"
CALL PRINT_STR, @"「好きなだけ触って、こらしめてね…_BH_」_W"	CALL PRINT_STR, @"「你想怎么玩就怎么玩吧，把乳房捏岀你喜欢的淫乱形状吧…_BH_」_W"
PRINTFORMW 「だめだよ…？」	PRINTFORMW 「不行啊…？」
PRINTFORMW 「%CNAME("二人称")%は、%CNAME("一人称")%のツガイなんだから…」	PRINTFORMW 「%CNAME("二人称")%是%CNAME("一人称")%的主人…」
CALL PRINT_STR, @"「もっと、ぐにぐにぃ…って_BH_」_W"	CALL PRINT_STR, @"「来……慢慢地……_BH_」_W"
CALL PRINT_STR, @"「えっちに揉み込んでくれないと、だめだよ…_BH_」_W"	CALL PRINT_STR, @"「不把它捏得留下你的刻印可不行～…_BH_」_W"
PRINTFORMW 「ふふ」	PRINTFORMW 「呵呵」
PRINTFORMW 「…%CNAME("二人称")%、おっぱい触るの楽しいかな」	PRINTFORMW 「…%CNAME("二人称")%、摸乳房开心吗」
CALL PRINT_STR, @"「たまたまさん…_BH_ 精子いっぱい作れそうかな…_BH_」_W"	CALL PRINT_STR, @"「那么………_BH_ 这里也是不是在努力地制造精液呢…_BH_」_W"
CALL PRINT_STR, @"「%CNAME("二人称")%のおてて、おっきいね…_BH_」_W"	CALL PRINT_STR, @"「%CNAME("二人称")%的手好大啊…_BH_」_W"
CALL PRINT_STR, @"「%CNAME("一人称")%のお胸包み込んで…あったかい…_BH_」_W"	CALL PRINT_STR, @"「%CNAME("一人称")%引以为豪的大胸部摸着很舒服吧…_BH_」_W"
CALL PRINT_STR, @"「ねえ、もっと押し付けて…_BH_」_W"	CALL PRINT_STR, @"「来，再用点力吧…_BH_」_W"
CALL PRINT_STR, @"「ね…_BH_ おっぱいのさきっぽ…もっといじって…_BH_」_W"	CALL PRINT_STR, @"「啊…_BH_ 再欺负一下乳头和胸部吧…_BH_」_W"
CALL PRINT_STR, @"「かりかりかり…ってひっかいて…_BH_」_W"	CALL PRINT_STR, @"「一次比一次来电呢，再用力点…_BH_」_W"
CALL PRINT_STR, @"「%CNAME("一人称")%のこと、いじめてほしいな…_BH_」_W"	CALL PRINT_STR, @"「再多多玩弄这里……%CNAME("一人称")%想被欺负这里…_BH_」_W"
PRINTFORMW 「もちもちって、素敵な感触でしょ…？」	PRINTFORMW 「软绵绵的，感觉很棒吧…？」
CALL PRINT_STR, @"「このおっぱいに挟まれたら、どんなちんぽも負けちゃう以外にないんだよ…_BH_」_W"	CALL PRINT_STR, @"「要是被这胸部夹着上下撸动，无论什么肉棒都会输给快乐呢_BH_」_W"
CALL PRINT_STR, @"「でも…%CNAME("二人称")%ならもしかしたら、このおっぱいを屈服させられるかも…？_BH_」_W"	CALL PRINT_STR, @"「若是%CNAME("二人称")%的话，说不定可以反过来把肉棒热量、触感及气味都刻入乳房主人的心里呢_BH_」_W"
PRINTFORMW 「じゃあその前に、いっぱい触って確かめておかないとね…」	PRINTFORMW 「在那之前，要多多反复摸索哦…」
CALL PRINT_STR, @"「屈服前の生意気おっぱい、ぐにぐにぐにって、弱点探そ…_BH_」_W"	CALL PRINT_STR, @"「然后把前面的狂妄巨乳压在身下，并尽情地玩弄着她的弱点吧…_BH_」_W"
PRINTFORMW 「かわいい…」	PRINTFORMW 「可爱…」
PRINTFORMW 「一生懸命おっぱい揉んで、すっかり孕ませる時の顔になっちゃってる…♪」	PRINTFORMW 「拼命地揉捏着胸部，完全变成小宝宝了呐………♪」
CALL PRINT_STR, @"「…実はね、女の子のおっぱいは揉みこめば揉みこむほど、いやらしくなるんだよ…_BH_」_W"	CALL PRINT_STR, @"「…其实呢、女人的胸部会越揉越敏感，甚会刺激乳腺发育……_BH_」_W"
CALL PRINT_STR, @"「おっぱい孕ませる前の下ごしらえ…_BH_ もっともっと、続けようね…_BH_」_W"	CALL PRINT_STR, @"「现在是怀孕前的准备工作…_BH_ 继续…再继续吧…_BH_」_W"
CALL PRINT_STR, @"「ねえ%CNAME("二人称")%、ふーっ_BH_ ふーっ_BH_ってオスの息遣いになっちゃってるよ…？」_W"	CALL PRINT_STR, @"「啊…%CNAME("二人称")%、呼_BH_ 呼_BH_呼吸节奏…变了…？」_W"
PRINTFORMW 「だめだよ…？ 冷静にならなきゃ、おっぱいに負けちゃうよ…？」	PRINTFORMW 「不行啊…? 不冷静的话、会输给胸部的…」
PRINTFORMW 「そんなのやだよね？ かっこよく、おっぱい征服したいよね？」	PRINTFORMW 「那样很讨厌吧? 你不想帅气地 征服胸部吗？」
CALL PRINT_STR, @"「負ける前に急いでたくさんおっぱい揉んで、早くこの感触に慣れなきゃ…_BH_」_W"	CALL PRINT_STR, @"「在输前赶紧多揉揉胸部，快点习惯这个触感吧…_BH_」_W"
PRINTFORMW 「まるで、脳みそに直接塗りこまれてるみたいなやわらかさでしょ…？」	PRINTFORMW 「这份柔软几乎要让脑浆蒸发了…？」
CALL PRINT_STR, @"「ねえ、%CNAME("一人称")%これ以上我慢できないよ…_BH_」_W"	CALL PRINT_STR, @"「啊、%CNAME("一人称")%再也忍不下去了…_BH_」_W"
CALL PRINT_STR, @"「犯されたがりのもちもちおっぱい_BH_ もう食べごろになってるよ_BH_」_W"	CALL PRINT_STR, @"「想被玩弄的香软胸部_BH_ 已经到了享用时间_BH_」_W"
PRINTFORMW 「%CNAME("一人称")%のおっぱい、すっかり%CNAME("二人称")%の遊び場にされちゃったね…」	PRINTFORMW 「%CNAME("一人称")%的乳房已经完全变成%CNAME("二人称")%的游乐场了呢…」
CALL PRINT_STR, @"「えへへ、調教済みの淫乱おっぱい、好きなだけ楽しんで…？_BH_」_W"	CALL PRINT_STR, @"「嘿嘿，调教完毕的淫乱胸部，尽情享受吧…_BH_」_W"
PRINTFORMW 「ふふっ…」	PRINTFORMW 「呵呵…」
CALL PRINT_STR, @"「%CNAME("二人称")%たら、鼻息あらーい…_BH_」_W"	CALL PRINT_STR, @"「%CNAME("二人称")%的鼻息好痒…_BH_」_W"
CALL PRINT_STR, @"「かわいいけど、ちょっとみっともないかな…？_BH_」_W"	CALL PRINT_STR, @"「虽然很可爱，但是有点不好看…？_BH_」_W"
PRINTFORMW 「指、たっぷり沈み込むでしょ…？」	PRINTFORMW 「手掌感到那沉甸甸的份量了吗…？」
PRINTFORMW 「このやわらかさで、男の子をたぶらかすんだよ…」	PRINTFORMW 「用这柔软又香喷喷的巨乳来引诱男生们…」
CALL PRINT_STR, @"「悪いおねーさんだよね…%CNAME("二人称")%、こらしめて…？_BH_」_W"	CALL PRINT_STR, @"「真是个不可饶恕的坏蛋呢～来，发泄%CNAME("二人称")%的正义怒火吧_BH_」_W"
CALL PRINT_STR, @"「ずいぶん集中してるけど…_BH_」_W"	CALL PRINT_STR, @"「虽然很专注…_BH_」_W"
PRINTFORMW %CALLNAME:TARGET%は自分の胸を好きにさせながら、%CALLNAME:MASTER%の頭を抱き寄せ優しく撫でた…	PRINTFORMW %CALLNAME:TARGET%放任%CALLNAME:MASTER%玩弄胸部的时候，一边摸着对方硬邦邦的肉棒…