
//EVENT_K41_栞.ERB

代々続く由緒正しき占星術師の家系に生まれた三女	出生于代代相传正统占星術師家族里的三女
星を詠むことにかけては一家でも飛び抜けた才を持ち、将来を嘱望されている	在詠星方面有着家族里最出众的天赋、备受期待
しかし彼女は自身の学ぶ占星術を先のない滅び行く魔術体系の一つと考えており	然而她自己却认为自己学习的占星術已经是一个、前方没有道路而只有毁滅的无望魔術体系
その所為か、常にどこか厭世的な雰囲気を漂わせている	也许是出于这种原因、总是漂散着一股厭世的雰囲
便宜上、学園では天文部に所属しているもののあまり熱心ではないようだ	为了便宜行事、在学校里虽然属于天文部但似乎并不熱心于社团活动
//PRINTFORMW 学園天文部の魔女、氷之守 栞。
PRINTFORMW 整った外見をしてはいるものの、床を擦るほどの長髪に冷淡な性格、壊滅的な人当たりの悪さ…	PRINTFORMW 外表端正、長髪及踝、性格冷淡、待人态度毁滅性的恶劣…
PRINTFORMW 加えて、多くの男に手を出しているという事実からそのように噂される彼女が、まさしく本当の魔女だとは。	PRINTFORMW 再加上、因为有着对很多男人出手的传闻、所以是正牌的真实魔女。
PRINTFORMW なかなかどうして、噂というものも侮れないものである。	PRINTFORMW 不管事实究竟如何、总之不应该轻视这些传闻。
PRINTFORMW 「%CNAMET(ARG, "一人称")%は占星術師だから、正規の魔女位を得ているわけではないのだけど、ね」	PRINTFORMW 「因为%CNAMET(ARG, "一人称")%是占星術師、所以其实并没有得到正規的魔女位、呢」
PRINTFORMW 「…でも、だからといって、契約の重さが変わるわけではないわ」	PRINTFORMW 「…但是、即便如此、契約的重量依然是无法轻视的」
PRINTFORMW 「これからあなたには、定期的な性交を通じて、%CNAMET(ARG, "一人称")%の正気の保証人となってもらう」	PRINTFORMW 「从现在开始、就通过和你定期的性交、来作为%CNAMET(ARG, "一人称")%理智正常的保証」
PRINTFORMW 「代わりに、%CNAMET(ARG, "一人称")%はあなたに快楽を提供する」	PRINTFORMW 「作为代价、%CNAMET(ARG, "一人称")%会向你提供性交时的快楽」
PRINTFORMW 「この契約に異議が無ければ、ここに名前を書きなさい」	PRINTFORMW 「对此契約没有異議的话、就在这里签字吧」
PRINTFORMW %CALLNAME:MASTER%は頷き、ペンを取った。	PRINTFORMW %CALLNAME:MASTER%点了点头、拿起了笔。
PRINTFORMW 「ええ、これでいいでしょう」	PRINTFORMW 「嗯、这样就契约成立」
PRINTFORMW 「それじゃあ、これからよろしくお願いするわ」	PRINTFORMW 「那么、从今天开始以后就请多多指教了」
PRINTFORMW 「ああ、それと」	PRINTFORMW 「啊、顺便一提」
PRINTFORMW 「申し訳ないのだけれど、%CNAMET(ARG, "一人称")%、男性経験はないの」	PRINTFORMW 「虽然非常抱歉、但其实%CNAMET(ARG, "一人称")%、没有男性的経験」
PRINTFORMW 「一応言っておくけれど、%CNAMET(ARG, "一人称")%は処女ではないわ」	PRINTFORMW 「话先说在前头、%CNAMET(ARG, "一人称")%已经不是処女了」
PRINTFORMW 「だからどうと言うわけでもないけれど」	PRINTFORMW 「所以不要说什么不解风情的话」
PRINTFORMW 「最低限、紳士らしい振る舞いを期待しているわ、ね」	PRINTFORMW 「最低限度、希望至少能期待一份紳士的风度、呢」
PRINTFORML 用意された%CALLNAME:ARG%の部屋には分厚い遮光カーテンが取り付けられている	PRINTFORML 为%CALLNAME:ARG%准备的房间里被挂上了厚厚的遮光窗帘
PRINTFORML 小さな卓上ランプを除いて、照明器具は一つも見受けられない…	PRINTFORML 除了桌子上的小台灯之外、房间里一个照明器具都没有…


//EVENT_K41_DAILY

PRINTFORMW 「おはよう」	PRINTFORMW 「早上好」
PRINTFORMW 「…もう少し、寝ててもいいの、よ」	PRINTFORMW 「…再稍微，睡一会儿也可以，哟」
PRINTFORMW 「ごめんなさい、魔が差してしまって…」	PRINTFORMW 「对不起，一时没控制住…」
PRINTFORMW 「おはよぅ…ん、あれ…？ え…？」	PRINTFORMW 「早上好…唔、啊嘞…？ 哎…？」
PRINTFORMW 「どうしてあなたが、ここに…」	PRINTFORMW 「为什么你会、在这里…」
PRINTFORMW 「……………………なるほど、ね」	PRINTFORMW 「……………………原来如此，呢」
PRINTFORMW 「…何？」	PRINTFORMW 「…怎么？」
PRINTFORMW 「…量が、少し多いと思う、わ」	PRINTFORMW 「…量，感觉有些多，啊」
PRINTFORMW 「定期的に発散したほうが、いいのではないかしら」	PRINTFORMW 「定期的帮你释放一下会，更好不是吗」
PRINTFORML 「水泳、か」	PRINTFORML 「游泳课、吗」
PRINTFORMW 「陸で暮らす人間が、何故水に浸からねばならないのかしら…」	PRINTFORMW 「在陆地上生活的人类，为什么非要把自己泡到水里不可呢…」
PRINTFORML 「今日は体育よ」	PRINTFORML 「今天是体育课哟」
PRINTFORMW 「せいぜい、怪我をしないようにしておくこと、ね」	PRINTFORMW 「尽量，确保自己不要受伤，哦」
PRINTFORMW 「今日の天気はどうかしら…」	PRINTFORMW 「今天的天气如何呢…」
PRINTFORML 「一番乗り、か」	PRINTFORML 「我是最早来的、吗」
PRINTFORMW 「こういう時に稚気を覚えるのは…%CNAMET(ARG, "一人称")%の未熟、なのかしら」	PRINTFORMW 「这种时候会感到幼稚是…%CNAMET(ARG, "一人称")%的不成熟，才会这样吗」
PRINTFORMW 「帰ったわ」	PRINTFORMW 「回来了啊」
PRINTFORMW 「お帰りなさい」	PRINTFORMW 「欢迎回来」
PRINTFORMW 「早く中に入ってちょうだい、星明りがまぶしいわ」	PRINTFORMW 「快点进来吧，星光有些太晃眼了啊」
PRINTFORMW 「お疲れ様、午後もしっかり頑張りなさい」	PRINTFORMW 「幸苦了，下午也请加油」
PRINTFORMW 「少しは、自重したらどうかしら」	PRINTFORMW 「稍微、自重一些如何」
PRINTFORMW 「お邪魔するわ」	PRINTFORMW 「打扰了啊」
PRINTFORMW 「…今日は、何か催しでもあるの？」	PRINTFORMW 「…今天，是有什么活动吗？」
PRINTFORMW 「お邪魔するわ、ね」	PRINTFORMW 「打扰了啊，呢」
PRINTFORMW 『お疲れ様です、先生』	PRINTFORMW 『您幸苦了，老师』
PRINTFORMW 『今日は遅いのね』	PRINTFORMW 『今天来迟了呢』
PRINTFORMW 『ドアはきちんと閉めなさい』	PRINTFORMW 『请把门好好带上』
PRINTFORMW 「…何の用？」	PRINTFORMW 「…什么事？」
PRINTFORMW 「…ここにいたのね」	PRINTFORMW 「…在这里啊」
PRINTFORMW 「ふぅん…」	PRINTFORMW 「哼…」
PRINTFORMW 「味の保障はしないわ」	PRINTFORMW 「我可没法保证味道啊」
PRINTFORMW 「それでもよければ、食べなさい」	PRINTFORMW 「如果不介意这点的话、就请吃吧」
PRINTFORMW 「それはだめよ」	PRINTFORMW 「这个不行哦」
PRINTFORMW 「これは焼けすぎ」	PRINTFORMW 「这个烧过头了」
PRINTFORMW 「これはあっちのと取り替えて」	PRINTFORMW 「这个和那边的换一下」
PRINTFORMW %CALLNAME:MASTER%が箸を動かすたび、%CALLNAME:ARG%はいちいち口出ししてくる…	PRINTFORMW %CALLNAME:MASTER%每动一下筷子，%CALLNAME:ARG%就会唠唠叨叨地指指点点…
PRINTFORMW %CALLNAME:ARG%は自分の食事には一切手をつけず、ひたすらに%CALLNAME:MASTER%を見続けている。	PRINTFORMW %CALLNAME:ARG%完全没顾着自己的午饭，只是一味地看着%CALLNAME:MASTER%。
PRINTFORMW 奇妙な緊張感の中で、昼食の時間は過ぎていった…	PRINTFORMW 就在这种奇妙的紧张感中度过了午餐的时间…
PRINTFORMW 「おいしい…」	PRINTFORMW 「好好吃…」
PRINTFORMW 「こうして誰かと食事なんて、久しくなかった気がする、わ」	PRINTFORMW 「已经很久没有，像这样和别人一起吃饭了，啊」
PRINTFORMW 「う、その…」	PRINTFORMW 「唔，那个…」
PRINTFORMW 「あ、あ、あー……ん、まり食が進んでいないのではないか、って」	PRINTFORMW 「我，我，我ー……唔，我是不是吃得有点多、什么的」
PRINTFORMW 「そんなことない？ そう…それは…よかった、わ…」	PRINTFORMW 「没有那种事？ 那…那就…就好、啊…」
PRINTFORMW なぜか%CALLNAME:ARG%はうなだれてしまった…	PRINTFORMW 不知为何%CALLNAME:ARG%有些垂头丧气…
PRINTFORMW 今日のお弁当は、妙に冷凍食品が多い。	PRINTFORMW 今天的便当里，速冻食品多得有些奇怪。
PRINTFORMW 「…悪い？」	PRINTFORMW 「…不好吗？」
PRINTFORMW %CALLNAME:ARG%は少し不機嫌そうだ…	PRINTFORMW %CALLNAME:ARG%看着有些不高兴…
PRINTFORML 「今日からよろしくお願いするわ、ね」	PRINTFORML 「从今天开始就请多多指教了，呢」
PRINTFORML 「チッ…なんて暑さ」	PRINTFORML 「啧…为什么这么热」
PRINTFORML %CALLNAME:TARGET%は鬱陶しそうに自分の髪を持ち上げ、うなじにぱたぱたと風を送っている…	PRINTFORML %CALLNAME:TARGET%不耐烦地将自己的头发扬起，让风呼啦呼啦地吹在脖颈上…
PRINTFORML 「魔術で代謝を抑制してなお、ここまでの汗を掻くなんて…」	PRINTFORML 「明明已经用魔术抑制了代谢，却还是出了这么多汗…」
PRINTFORML 僅かに身を起こした%CALLNAME:TARGET%は、胡乱げな眼差しで虚空を睨んでいる…	PRINTFORML 微微起身的%CALLNAME:TARGET%用可疑的目光盯着空气…
PRINTFORML 「何も言うな」	PRINTFORML 「什么都不准说」
PRINTFORML 「これは命令よ」	PRINTFORML 「这是命令哦」
PRINTFORML 「すごくおいしい…」	PRINTFORML 「难以置信的美味…」
PRINTFORML 「この味、私は好きよ」	PRINTFORML 「这个味道，我很喜欢哟」
PRINTFORML 「おいしいわね、これ」	PRINTFORML 「真的很好吃呢，这个」
PRINTFORML 「作り方、教えてもらおうかしら…」	PRINTFORML 「做法，可以教教我吗…」
PRINTFORML 「最近のお菓子って、色々あるのね…」	PRINTFORML 「说起最近的点心，种类不少呢…」
PRINTFORML 「少し濃いけど、とても美味しいわ」	PRINTFORML 「味道稍微有点重、但还是很美味啊」
PRINTFORML 「本当に…あなたはひどい人、ね」	PRINTFORML 「你还…真是个过分的人，呢」
PRINTFORML 「ここなら、きっと誰も来ないわ」	PRINTFORML 「在这的话，肯定谁都不会过来呢」
PRINTFORML 「あら、いらっしゃい」	PRINTFORML 「啊啦、欢迎」
PRINTFORML %CALLNAME:TARGET%は卓上ランプの電気を点けた。	PRINTFORML %CALLNAME:TARGET%打开了桌子上台灯的开关。
PRINTFORML 「窓は開けないでね」	PRINTFORML 「不要开窗哦」
PRINTFORML 「…来るなら、せめて一声かけなさい」	PRINTFORML 「…要来的话，起码事先说一声吧」
PRINTFORML 「…不覚、ね」	PRINTFORML 「…失策，呢」
PRINTFORML %CALLNAME:TARGET%は顔を真っ赤に染めて俯いた。	PRINTFORML %CALLNAME:TARGET%低着头，脸上被染得一片通红。
PRINTFORML 「見るだけで、満足？」	PRINTFORML 「光是看着，满足吗？」
PRINTFORML %CALLNAME:TARGET%は静かに%CALLNAME:MASTER%を見つめている…	PRINTFORML %CALLNAME:TARGET%静静地注视着%CALLNAME:MASTER%…
PRINTFORML 「今更こんな布切れに欲情するというのも、不思議ね」	PRINTFORML 「居然能对着这种布片产生如此的欲情还，真是不可思议呢」
PRINTFORML %CALLNAME:MASTER%の視線に気づいた%CALLNAME:TARGET%は、頭痛を堪えるような表情で黙っている…	PRINTFORML 注意到%CALLNAME:MASTER%的视线的%CALLNAME:TARGET%摆出一副头痛无比的样子沉默着…
PRINTFORML 「…せめて、勢いだけでも抑えてくれないかしら」	PRINTFORML 「…哪怕，就算再怎么想这么做也请给我忍住」
PRINTFORML 「これ以上を望むなら、相応の態度を取りなさい」	PRINTFORML 「如果想希求更多东西的话，就请拿出你相应的态度来」
PRINTFORML 「やれやれ…」	PRINTFORML 「哎呀哎呀…」
PRINTFORML 「別に…」	PRINTFORML 「没什么…」
PRINTFORML 「このまま相手をさせられる、他の女の子がかわいそうだと思っただけ、よ」	PRINTFORML 「只是被对方逼着做到这一步，感觉其他的女孩子好可怜，啊」
PRINTFORML 「…チッ」	PRINTFORML 「…嘁」
PRINTFORML 「あなたも服を脱いでみなさい。%CNAME("一人称")%の気持ちが良くわかるわ」	PRINTFORML 「请你也把衣服脱掉。请好好理解一下%CNAME("一人称")%的感受啊」
PRINTFORML 「他人の精神状態について、ここまで真剣に思い悩む日が来るなんて…」	PRINTFORML 「竟然会有一天我在这么认真烦恼着，关于他人的精神状态…」
PRINTFORML 「見て…」	PRINTFORML 「看吧…」
PRINTFORML 「その、この場所は、ええと…」	PRINTFORML 「那个，这个地方是，那个…」
PRINTFORML 「なんて頭の悪い標語…」	PRINTFORML 「这么弱智的标语…」
PRINTFORML 「従う%CNAME("一人称")%も大概、か」	PRINTFORML 「%CNAME("一人称")%大概也会照做，吧」
PRINTFORML 「魔術世界においては、たびたび『稀代の大天才』が現れ、特定の分野を大きく発展させることがある、わ」	PRINTFORML 「在魔术世界中，每每出现“稀世的大天才”，都会让特定的领域得到很大的发展，呢」
PRINTFORML 「表の世界にまで名の知られる、魔術師や錬金術師等がそれにあたる、わね」	PRINTFORML 「连外面的世界都知道的，魔术师和炼金术师等就是如此」
PRINTFORML 「しかし我々占星術師には、そうした人物は現れない」	PRINTFORML 「但是我们占星术师里面，并没有出现那种人」
PRINTFORML 「その理由、あなたにはわかるかしら？」	PRINTFORML 「至于理由，你知道吗？」
PRINTFORML 「占星術師に求められる才能とは、『人より多くの【星】が視える』こと、よ」	PRINTFORML 「占星术师所需求的才能，是『可以比别人看见更多的【星】』这样，哟」
PRINTFORML 「しかし、その【星】が当人以外の誰にも見えないとしたら？」	PRINTFORML 「但是，如果这些【星】除了当事人以外谁都看不见呢？」
PRINTFORML 「天才と狂人は紙一重、とはよく言うけれど…実際に、そうして心を壊す術師は多い」	PRINTFORML 「天才和疯子只有一步之遥，虽然话是这么说…但实际上，像这样心灵崩毁的术师非常多」
PRINTFORML 「鋭敏な感覚を備えた有能な術師ほど早くに失われ…生き残った未熟者が、天才の遺した僅かな言葉に悩み続ける」	PRINTFORML 「具有敏锐感官的有才能的术师们早早便消逝了…残存下来的没能掌握学问的人们，则只能因为天才们遗留下来的只言片语而烦恼着」
PRINTFORML 「我々占星術師が、『無能』のレッテルを貼られる所以、ね」	PRINTFORML 「我们占星术师，就因此被贴上了『无能』的标签，呢」
PRINTFORML 「新たな【星】を発見したとき、占星術師が第一に行うべきと師から教えられること」	PRINTFORML 「导师教育占星术师们，在发现新的【星】的时候首先该做的事情」
PRINTFORML 「それは、精神鑑定を受けること、よ」	PRINTFORML 「那就是，接受精神鉴定，哟」
PRINTFORML 「追い込まれた人間が都合のいい幻覚を見るように」	PRINTFORML 「就像被逼入绝境的人会看见自己得救的幻觉一样」
PRINTFORML 「新たに見えたその【星】が、未熟な術師の妄想でないとは言い切れない」	PRINTFORML 「新看见的那个【星】，有可能只是尚不成熟的术师的妄想也说不定」
PRINTFORML 「そうして【星】を発見するたびに、妄想ではないかと怯え、師からは否定され…」	PRINTFORML 「因此每次发现【星】的时候，都会害怕是不是妄想，而被老师否定…」
PRINTFORML 「そのうち誰も、新たな【星】を視ることが出来なくなるの」	PRINTFORML 「不久，再也没有谁能看见新的【星】了」
PRINTFORML 「…夢も希望もないでしょう？」	PRINTFORML 「…不管是希望还是梦都不存在对吧？」
PRINTFORML 「占星術師の狂気とは、孤独を糧に成長する精神の寄生虫だと、考えた先人がいた、わ」	PRINTFORML 「有前人认为，占星术师的疯狂，是以孤独为食粮成长的精神的寄生虫，呢」
PRINTFORML 「彼は他者との交流こそがこの寄生虫を駆逐する唯一の手段と考え、弟子達にこれを強制させた」	PRINTFORML 「他认为和他人的交流是驱逐这种寄生虫的唯一手段，于是强制他的弟子们照做」
PRINTFORML 「結果的に、その交流は凡人たちの妬心を煽り、多くの天才を壊しただけに終わったけれど…」	PRINTFORML 「结果，这种交流却只是煽动了凡夫俗子们的嫉妒心，以毁灭了许多天才为告终而已…」
PRINTFORML 「あなたといると、彼の試みは、決して的外れなことではなかったのだと、思うようになった、わ」	PRINTFORML 「和你在一起的时候，我开始觉得，他的尝试，绝对没有偏离目标」
PRINTFORML 「彼の間違いは、占星術師以外を『他者』と認めなかったこと」	PRINTFORML 「他的错误之处在于、不承认占星术师以外的『他人』」
PRINTFORML 「我々が生まれながらに抱える傲慢こそが、失敗の原因…」	PRINTFORML 「我们生来便抱有的这种傲慢才是，失败的原因…」
PRINTFORML 「今にして思えば、あなたとは随分と長い間一緒にいる気がする、わ」	PRINTFORML 「现在回想起来，感觉和你在一起已经有很长时间了，啊」
PRINTFORML 「…こんな、陰鬱で面白い話の一つもできない小娘を相手に、ご苦労様、ね」	PRINTFORML 「…和这么，阴沉而且一句有趣的话也说不出来的小姑娘待在一起，真是辛苦你了、呢」
PRINTFORML 「いえ、ごめんなさい…こんなことを言うつもりでは、なくて」	PRINTFORML 「不对，很抱歉…本来，没打算说这种话的」
PRINTFORML 「その、ありがとう」	PRINTFORML 「那个，谢谢你」
PRINTFORML 「あなたは、己のルーツに、不安を覚えることはないの？」	PRINTFORML 「你会、因为自己的出身、感到不安吗？」
PRINTFORML 「…いえ、ごめんなさい。不躾な質問だった、わ」	PRINTFORML 「…不，对不起。问了这种没礼貌的问题，啊」
PRINTFORML 「ただ、もしなにか…あるのなら」	PRINTFORML 「只是、如果…有的话」
PRINTFORML 「愚痴ぐらいなら、聞いてあげられるかもしれない、から」	PRINTFORML 「只是发发牢骚的话，也许可以讲给我听一听，吧」
PRINTFORML 「多くの人が気がつかないだけで、悪魔や天使、妖怪変化…」	PRINTFORML 「虽然大多数人都不在意但，天使恶魔，妖鬼精怪…」
PRINTFORML 「そういった類の怪異は、我々の身近に潜んでいるものよ」	PRINTFORML 「这些奇异生物、就在我们的身边潜藏着哦」
PRINTFORML 「あなたはそれを、身を持って知っているのでしょうけど」	PRINTFORML 「你也是，亲身经历着所以明白的吧」
PRINTFORML 「だからこそ、自分が人間であるということを、忘れては駄目、よ」	PRINTFORML 「正因如此，自己是人类这种事情，千万不要忘记，哟」
PRINTFORML 「最近、人当たりがよくなったと、言われるようになったわ」	PRINTFORML 「最近，有人开始说，我待人的态度变好了」
PRINTFORML 「そういう自覚は無かったのだけど…きっと、あなたのお陰かもしれない、わね」	PRINTFORML 「虽然我自己没有这种感觉…一定，是承你荫蔽的福也说不定，吧」
PRINTFORML 「あるいは毒されたと見るべき、かしら」	PRINTFORML 「还是应该说被你毒害了呢？」
PRINTFORML 「…ふふ、冗談よ」	PRINTFORML 「…呵呵、开玩笑哦」
PRINTFORML 「いざという時、頼れる人がいるというのは」	PRINTFORML 「在关键时刻，有可以依靠的人还真是」
PRINTFORML 「とても…とても、有難いことだと、思うわ」	PRINTFORML 「非常…非常，难得的事情，我觉得」
PRINTFORML 「最近、特にそう思うの」	PRINTFORML 「最近，这种想法更强烈了」
PRINTFORML 「ありがとう、%CALLNAME:MASTER%」	PRINTFORML 「谢谢你，%CALLNAME:MASTER%」
PRINTFORML 「尻軽というのは、こういう場合でも適用されるのかしら」	PRINTFORML 「轻浮这个词，在这种场合应该也适用吧」
PRINTFORML 「…まあ、いいわ」	PRINTFORML 「…嘛、好吧」
PRINTFORML 「あ、その…ごめんなさい」	PRINTFORML 「啊，那个…抱歉」
PRINTFORML %CALLNAME:TARGET%は%CALLNAME:MASTER%の背後に向かって軽く頭を下げた。	PRINTFORML %CALLNAME:TARGET%朝着%CALLNAME:MASTER%的背后轻轻低下了头。
PRINTFORML 「とても気まずいのだけど…」	PRINTFORML 「虽然很尴尬…」
PRINTFORML 「もっといい相手を選びなさい」	PRINTFORML 「请选个更好些的人吧」
PRINTFORML 「あなたに構ってほしいと願う人が、ここには他にいるのではなくて？」	PRINTFORML 「想被你玩弄的人，这里不止我一个吧？」
PRINTFORML 「もう少し、近くによってもいい、かしら」	PRINTFORML 「再稍微、靠近些可以、吗」
PRINTFORML 「あなたの鼓動を、感じたいの」	PRINTFORML 「想去感受、你的心跳」
PRINTFORML 「…んふふ」	PRINTFORML 「…嗯哼哼」
PRINTFORML 「好きよ、%CALLNAME:MASTER%…大好き」	PRINTFORML 「喜欢哟，超级喜欢…%CALLNAME:MASTER%」
PRINTFORML 「こういうのも、たまにはいいかも、しれないわ」	PRINTFORML 「这样，似乎，偶尔也不错啊」
PRINTFORML 「…ただ、ちょっと酒量には、気を付けないと…ぅん…」	PRINTFORML 「…不过，酒量，稍微不注意的话…唔嗯…」
PRINTFORML %CALLNAME:TARGET%はわけのわからないことを口走っては、一人で勝手に納得している…	PRINTFORML %CALLNAME:TARGET%有些胡言乱语地自顾自说着莫名其妙的话…
PRINTFORML 「あなたと過ごせるなら、この夜空も悪くはないわ、ね」	PRINTFORML 「如果能和你一起度过的话，这片夜空也没那么糟心了，呢」
PRINTFORML 「もっと、近くに来てちょうだい」	PRINTFORML 「再多，往这里靠近一点吧」
PRINTFORML 「夜明かりで、顔がよく見えないの、よ」	PRINTFORML 「月光太薄，看不清你的脸，了哟」
PRINTFORML 「ふふ…」	PRINTFORML 「呵呵…」
PRINTFORML %CALLNAME:TARGET%は穏やかな様子で%CALLNAME:MASTER%を見つめている。	PRINTFORML %CALLNAME:TARGET%一脸平静地注视着%CALLNAME:MASTER%。
PRINTFORML %CALLNAME:TARGET%は%CALLNAME:MASTER%の腰にそっと手を回し、上目遣いに見つめてきた。	PRINTFORML %CALLNAME:TARGET%轻轻地把手放在%CALLNAME:MASTER%的腰上、眼巴巴地向上瞟着%CALLNAME:MASTER%。
PRINTFORML 「何もしないの？」	PRINTFORML 「不做些什么吗？」
PRINTFORML %CALLNAME:TARGET%は%CALLNAME:MASTER%の手に自分のそれを重ね合わせた。	PRINTFORML %CALLNAME:TARGET%把自己的手和%CALLNAME:MASTER%的手盖在一起。
PRINTFORML 「こうして見ると、あなたの手は大きいわ、ね」	PRINTFORML 「这样一看，你的手还真是大啊，呢」
PRINTFORML 「今日は、月がきれいね」	PRINTFORML 「今夜、月色真美呢」
PRINTFORML 窓の方をちらとも見ずに、%CALLNAME:TARGET%は静かに呟いた。	PRINTFORML 明明根本没有看向窗外的方向，%CALLNAME:TARGET%却这样轻声呢喃着。
PRINTFORML 「見なくともわかるわ…だって、あなたが隣にいるのだもの」	PRINTFORML 「不用看也知道啊…因为你就在我身边」
PRINTFORML 「夜に女のところまで来て、そのまま何もせずにいるなんて」	PRINTFORML 「晚上来到女孩子旁边、然后却什么事都不做什么的」
PRINTFORML 「あなたらしくないわ、ね」	PRINTFORML 「还真是不像你啊，呢」
PRINTFORML %CALLNAME:TARGET%は椅子に腰掛けたまま、足を小さく揺らしている。	PRINTFORML %CALLNAME:TARGET%在椅子上坐着，轻轻地晃着腿。
PRINTFORML %CALLNAME:TARGET%は軽く首を回している。	PRINTFORML %CALLNAME:TARGET%轻轻转过头。
PRINTFORML 「あ」	PRINTFORML 「啊」
PRINTFORML %CALLNAME:MASTER%を見るなり声を上げた%CALLNAME:TARGET%は、取り出した手帳に何かを書き付けた。	PRINTFORML 看到%CALLNAME:MASTER%后发出了声响的%CALLNAME:TARGET%，取出了一本笔记开始写着什么。
PRINTFORML 「ごめんなさい、気にしないで」	PRINTFORML 「不好意思，不要在意」
PRINTFORML %CALLNAME:TARGET%は小さな文庫本を読んでいるようだ。	PRINTFORML %CALLNAME:TARGET%正在读一本不大的文库本。
PRINTFORML 卓上ランプの弱い明かりでは、そのタイトルを読み取ることは出来ない。	PRINTFORML 台灯的灯光过于昏暗，没法看清书名是什么。
PRINTFORML %CALLNAME:TARGET%は時折窓のほうへ視線を向け、奇妙な表情を浮かべている。	PRINTFORML %CALLNAME:TARGET%不时把视线投向窗户那里，露出一脸奇妙的表情。
PRINTFORML 「あなたの手」	PRINTFORML 「你的手」
PRINTFORML 「大きいわ、ね」	PRINTFORML 「好大，呢」
PRINTFORML 「…服に埃がついている、わ」	PRINTFORML 「…衣服上沾了好多灰，啊」
PRINTFORML 「少し、じっとしていなさい」	PRINTFORML 「请先，不要乱动」
PRINTFORML %CALLNAME:TARGET%は%CALLNAME:MASTER%の手を自分の指でそっとくすぐってきた。	PRINTFORML %CALLNAME:TARGET%用自己的手指在%CALLNAME:MASTER%的手上轻轻挠着痒。
PRINTFORML 「ふふ…なにかしら？」	PRINTFORML 「哼哼…怎么了？」
PRINTFORML 「その、えーと」	PRINTFORML 「唔唔、那个——」
PRINTFORML 「契約の履行が…いえ、契約だからというわけではなくて」	PRINTFORML 「契約的履行…不对，其实和契约无关」
PRINTFORML 「何と言えばいいのか…あの、わかるでしょう？」	PRINTFORML 「该怎么说好呢…那个，你知道的吧？」
PRINTFORML 慣れないながらに誘いの言葉を探す%CALLNAME:TARGET%の顔は真っ赤に染まっている。	PRINTFORML 虽然不习惯但是却努力斟酌着邀请的话语的%CALLNAME:TARGET%的脸被整个染得通红。
PRINTFORML 「あ、う…」	PRINTFORML 「啊，呜…」
PRINTFORML %CALLNAME:TARGET%は突然、顔を赤くして開いていた手帳を閉じた。	PRINTFORML %CALLNAME:TARGET%突然红着脸把摊开的笔记本合上了。
PRINTFORML 「み、見た…？」	PRINTFORML 「看，看见了…？」
PRINTFORML 「日の光はいいわね、まるで生き返るようだわ」	PRINTFORML 「阳光正好呢，感觉一下子活过来了啊」
PRINTFORML 日陰で本を読みながら、%CALLNAME:TARGET%は何か言っている。	PRINTFORML %CALLNAME:TARGET%一边在阴凉处读着书，一边说着什么。
PRINTFORML 「…何よ」	PRINTFORML 「…什么啊」
PRINTFORML 「あ」	PRINTFORML 「啊」
PRINTFORML %CALLNAME:TARGET%は詩集を読んでいる。	PRINTFORML %CALLNAME:TARGET%正在看本诗集。
PRINTFORML その表情はとても真剣だ。	PRINTFORML 那个表情也太认真了。
PRINTFORML 「昼はいいわ。目に優しい」	PRINTFORML 「白天真好啊。不费眼睛」
PRINTFORML 「…すー……すー……」	PRINTFORML 「…嘶ー……嘶ー……」
PRINTFORML 「…すー……」	PRINTFORML 「…嘶ー……」
PRINTFORML 「…すー……んっ……」	PRINTFORML 「…嘶ー……嗯……」
PRINTFORML 「……うぅん」	PRINTFORML 「……唔——嗯」
PRINTFORML 「殺すわよ」	PRINTFORML 「杀了你哦」
PRINTFORML 「すー…すー…」	PRINTFORML 「嘶ー…嘶ー…」
PRINTFORML 「…姉さん……」	PRINTFORML 「…姐姐……」
PRINTFORMW 「雨、か」	PRINTFORMW 「雨，吗」
PRINTFORMW 「傘…持ってきていたかしら」	PRINTFORMW 「伞…有带过来吗」
PRINTFORMW 「こうして、誰かと相合傘をするような関係になるなんて」	PRINTFORMW 「变成了，像这样和别人同撑一把伞的关系什么的」
PRINTFORMW 「かつての%CNAME("一人称")%は、考えもしていなかった、わ」	PRINTFORMW 「是曾经的%CNAME("一人称")%，无论如何都想象不到的，呢」
PRINTFORMW 「ありがとう、ね」	PRINTFORMW 「谢谢了，啊」
PRINTFORMW 「一つの傘に入る男女を見て、なんとも奇妙な事をしているものだと思っていたけれど」	PRINTFORMW 「每当看到同用一把伞的男女时，我都会觉得这是一件很奇怪的事情」
PRINTFORMW 「実際にやってみると、その理由もわかるわね…」	PRINTFORMW 「实际这样做了之后，我也明白大家会这么做的理由了呢…」
PRINTFORMW 「%CNAME("一人称")%の手、あたたかい、わ」	PRINTFORMW 「%CNAME("一人称")%的手，暖暖的，呢」
PRINTFORMW 「気が利くのね、ありがとう」	PRINTFORMW 「気が利くのね、ありがとう」
PRINTFORMW 「%CNAME("一人称")%は背が小さいから、そこまで無理して寄ってくれなくても大丈夫よ」	PRINTFORMW 「%CNAME("一人称")%个子很小，所以不需要这样勉强自己把伞偏过来也没关系哦」
PRINTFORMW 「ごめんなさいね、ありがとう」	PRINTFORMW 「真是不好意思，谢谢」
PRINTFORMW 「…優しいのね」	PRINTFORMW 「…很温柔呢」
PRINTFORMW 「あら…あの作者、新しいのを出していたのね」	PRINTFORMW 「啊啦…这个作者，出新作了呢」
PRINTFORMW 「折角ですもの、どこかに寄っていきましょう」	PRINTFORMW 「机会难得，稍微绕一点路吧」
PRINTFORMW 「早く帰りましょうか」	PRINTFORMW 「早点回去吧」
PRINTFORMW 「ええ、今日もよろしく」	PRINTFORMW 「嗯，今天也请多关照」
PRINTFORMW 「少し横になる、わ」	PRINTFORMW 「稍微躺会儿，啊」
PRINTFORMW 「…そんなあからさまなお世辞を言うなんて」	PRINTFORMW 「…居然这么露骨的恭维我」
PRINTFORMW 「なにやら、よっぽどのことを頼みたいようね」	PRINTFORMW 「这样的话，会让我想拜托你做更多的事情呢」
PRINTFORMW 「…そうやって、少し煽ててやれば」	PRINTFORMW 「…像那样子，稍微吹捧一下别人」
PRINTFORMW 「誰も彼もがあなたの言うことを聞くと思ったら、大間違い、よ」	PRINTFORMW 「就以为谁都会听你说话的话，就大错特错了，哟」
PRINTFORMW 「その手には、乗らないわ」	PRINTFORMW 「我可不会，上你的当啊」
PRINTFORMW 「…%CNAME("一人称")%を煽てて、何をさせるつもり？」	PRINTFORMW 「…奉承%CNAME("一人称")%，是有什么企图吗？」
PRINTFORMW 「あんまり、顔、みないで」	PRINTFORMW 「别一直，盯着我的脸，看啊」
PRINTFORMW 「…%CNAME("一人称")%、こんなに単純な女だったかしら」	PRINTFORMW 「…%CNAME("一人称")%，是这么单纯的女生吗」
PRINTFORMW 「…くっ」	PRINTFORMW 「…哼」
PRINTFORMW 「そんな陳腐なセリフで、喜んでしまった自分が憎い」	PRINTFORMW 「我厌恶对这么土的台词，感到欣喜的自己」
PRINTFORMW 「…ふふ、ひどい人」	PRINTFORMW 「…呵呵，讨厌鬼」
PRINTFORMW %CALLNAME:TARGET%は薄く微笑んでいる…	PRINTFORMW %CALLNAME:TARGET%露出淡淡的微笑…
PRINTFORMW 「…チッ」	PRINTFORMW 「…嘁」
PRINTFORMW %CALLNAME:TARGET%はそっぽを向いてしまった…	PRINTFORMW %CALLNAME:TARGET%把脸扭向一边…
PRINTFORMW 「そういうセリフは、他の子に言いなさい」	PRINTFORMW 「这种台词，也对其他人说一说吧」
PRINTFORMW 「…これは、ちょっと下世話な話だけど」	PRINTFORMW 「…虽然，这话有些俗套了但是」
PRINTFORMW 「他の魔術体系に比べて、占星術師は恋愛によって破滅を迎えるものが多い、わ」	PRINTFORMW 「和其他的魔术体系比起来，占星术师由于恋爱而迎来破灭的事情很多，呢」
PRINTFORMW 「時の先を見る%CNAME("一人称")%たちは、皆が自分の行く末に閉塞感を抱いているから…」	PRINTFORMW 「能够事先预知的%CNAME("一人称")%们，都会对自己的将来抱有一种闭塞感…」
PRINTFORMW 「ちょっとした恋をきっかけに、それに反抗してみたくなるのでしょうね」	PRINTFORMW 「都想着以恋爱为契机，不如去试着反抗一下吧」
PRINTFORMW 「そしてその果てに…普通の魔術師では考えられないようなミスをする」	PRINTFORMW 「而最终的结果就是…犯下普通魔术师无法想象的错误」
PRINTFORMW 「…他人事ではない、のよね」	PRINTFORMW 「…这可不是发生在别人身上的事，哦」
PRINTFORMW 「我々占星術師は、天蓋に浮かぶ【星】と呼ばれる詩を詠むことで、過去や未来に通じることが出来る」	PRINTFORMW 「我们占星术师，通过咏颂浮于天穹之上被称为【星】的诗，可以连通过去与未来」
PRINTFORMW 「しかし、なぜ文字なのか。いわゆる天啓のような、声や音、その他の感覚ではだめなのか」	PRINTFORMW 「可是，为什么偏偏是文字呢。像所谓的天启那样，用声音，或者其他的感觉难道不行吗」
PRINTFORMW 「そんなことを考えて、眼以外で【星】を詠む術を探求した天才がいた、わ」	PRINTFORMW 「考虑到这些，有个天才探寻了用眼睛以外对【星】进行咏唱的方法」
PRINTFORMW 「その結末は、同胞たちからの手酷い裏切りと、その末の死だった」	PRINTFORMW 「结果，却遭到了同胞们的残忍背叛，最后含恨而终」
PRINTFORMW 「…彼には、その未来が見えていたのかしら」	PRINTFORMW 「…他其实，早就预见到那个未来了吧」
PRINTFORMW 「見る、という行為には、強い呪術的な意味があるの」	PRINTFORMW 「『看』，这种行为，是具有很强的咒术意义的」
PRINTFORMW 「あなたも、石化の魔眼くらいは聞いたことがあるでしょう？」	PRINTFORMW 「你不也、听说过石化魔眼这种东西吗？」
PRINTFORMW 「我々占星術師の星見も、原理としてはそれと同じ、よ」	PRINTFORMW 「我们占星术师的观星，从原理上来说和那个是一样的，哟」
PRINTFORMW 「…ただ、その範囲と負担が重すぎるだけで、ね」	PRINTFORMW 「…只是，观星的范围和负担都要大很多罢了，呢」
PRINTFORMW 「%CNAME("一人称")%の魔術師としての階級は、そこまで高いものではないの」	PRINTFORMW 「%CNAME("一人称")%作为魔术师来说的阶级，并不是那么高」
PRINTFORMW 「現代においては、占星術の権威などあってないようなものだし」	PRINTFORMW 「毕竟在现代，占星术并没有什么权威」
PRINTFORMW 「かつての先達の妄執によって、素質ある術師の多くも潰えた」	PRINTFORMW 「由于过去祖辈们的执妄，很多有素质的术师都崩溃了」
PRINTFORMW 「残っているのは、過去にとらわれた老人たちと、ほんの一握りの雛たちだけ」	PRINTFORMW 「残存下来的，只有活在过去的老人们，和几个不成熟的雏鸟罢了」
PRINTFORMW 「…これでは、まともな評価など成されるはずがない、わ」	PRINTFORMW 「…这样一来，自然不可能有什么好名望，的」
PRINTFORMW 「占星術は、今ではほとんど使い手のいない、枯れた魔術体系なの」	PRINTFORMW 「占星术是个，如今几乎没有使用者的，已经枯萎的魔术体系」
PRINTFORMW 「存命の導師階級も、ほとんどが老齢だし…」	PRINTFORMW 「尚健在的导师阶级也，几乎年龄都很大了…」
PRINTFORMW 「おそらく今後二十年で、致命的なまでに衰退していくでしょう、ね」	PRINTFORMW 「恐怕接下来的二十年内，会一直衰退到一种致命的程度，吧」
PRINTFORMW 「…%CNAME("一人称")%にとっては、喜ばしいこと、よ」	PRINTFORMW 「…对%CNAME("一人称")%来说，是件可喜可贺的事情，哟」
PRINTFORMW 「眼球を術の媒介とする占星術師にとって、己の眼は何にも代えがたいものなの、よ」	PRINTFORMW 「对于以眼球为施术媒介的占星術師来说，自己的眼睛是任何事物都无法代替的东西，哟」
PRINTFORMW 「だから当然、幾重にも保険が掛けられている」	PRINTFORMW 「理所当然的，会对其加上好几重的保险」
PRINTFORMW 「邪視の類は言うに及ばず、呪いから何から、あらゆる外法が渦巻いている、の」	PRINTFORMW 「邪视之类自不必说，诅咒啊什么的，所有的旁门左道都包含其中」
PRINTFORMW 「%CNAME("一人称")%でさえ、己の眼球には二十以上の呪法を施している…上の階級なら、百は優に超えるでしょう」	PRINTFORMW 「连%CNAME("一人称")%也一样，在自己的眼球上施加了二十种以上的咒术…如果是地位更高的人的话，甚至会远远超过一百种」
PRINTFORMW 「だから決して、占星術師と対峙したときは、目を合わせてはいけない、わ」	PRINTFORMW 「所以千万，在和占星术师对峙的时候，不要去和对方对视，啊」
PRINTFORMW 「占星術師が見る夜空は、昼のそれよりなお明るいものよ」	PRINTFORMW 「占星术师眼中所见的夜空，是比白昼还要明亮的景象」
PRINTFORMW 「天蓋に無数に散らばった、数多の【星】の記述が光って、太陽のような光を放つの」	PRINTFORMW 「无数散落于天穹上，数不胜数的【星】的记号闪烁着，散发出太阳般的光芒」
PRINTFORMW 「それはある意味では、確かに美しい光景ではあるけれど…」	PRINTFORMW 「在某种意义上，确实是美不胜收的光景…」
PRINTFORMW 「夜闇の安寧と引き換えにするだけのものかどうかは、私には…」	PRINTFORMW 「但这都是用暗夜的安宁所换来的东西，对我来说…」
PRINTFORMW 「世界全てを見渡しても…」	PRINTFORMW 「即使纵览全世界…」
PRINTFORMW 「ここまで異能者の密度が高い空間は、そうないわ」	PRINTFORMW 「也没有，比这里的异能力者密度更高的空间了」
PRINTFORMW 「魔術や超能力から、果ては悪魔に天使まで…」	PRINTFORMW 「从魔术和超能力，到天使和恶魔…」
PRINTFORMW 「そうした魑魅魍魎を呼び寄せるこの学園は、いったい何なのか…」	PRINTFORMW 「这个能如此吸引着魑魅魍魎的学校，到底是什么呢…」
PRINTFORMW 「あなたと同じ夜空を、いつか見てみたいものね」	PRINTFORMW 「真想有一天，能和你看着相同的夜空呢」
PRINTFORMW 「黒くて、暗くて…きっととても落ち着くのでしょう」	PRINTFORMW 「漆黑，幽暗…一定很让人沉静吧」
PRINTFORMW 「星と星とを結び付ける占星の術は、やがて人と人とを結び付ける種々の占いへと転じていった」	PRINTFORMW 「将恒星与恒星联系起来的占星术，不久就变成了将人与人联系起来的各种占卜技术。」
PRINTFORMW 「それが果たしてどういう結果を生んだのかはさておき…」	PRINTFORMW 「暂且不说那个到底导致了怎样的结果…」
PRINTFORMW 「そうした時流の中で、頑迷なまでに過去のあり方に固執する我々の一派は」	PRINTFORMW 「在这样的时代潮流中，固执地执着于过去的存在方式的我们这一派」
PRINTFORMW 「…あるいは、同じ魔術師達から見ても、滑稽なものに映るのでしょう、ね」	PRINTFORMW 「…或许，即使同是魔术师看来，也是一副滑稽的模样，吧」
PRINTFORMW 「ふむ…市井の星占いも、たまには的を得たことを…」	PRINTFORMW 「嗯…市井里的占星摊，偶尔也是不错的东西呢…」
PRINTFORMW 「…あなたはどう思う？」	PRINTFORMW 「…你怎么想呢？」
PRINTFORMW 「あまり、騒がしいのは好きではなかった筈なのだけど」	PRINTFORMW 「我，应该不是很喜欢吵闹的地方」
PRINTFORMW 「あなたといると、例外みたい」	PRINTFORMW 「和你在一起的话，感觉是例外」
PRINTFORMW 「ふと思ったのだけど、この部はどんな活動をするものなのかしら…」	PRINTFORMW 「突然想起来，这个社团是做什么活动的呢…」
PRINTFORMW 「実態はどうあれ、部として成立しているからには事務課に書類を提出しているはず」	PRINTFORMW 「不管实际情况如何，既然作为社团成立了，就应该向事务科提交了文件」
PRINTFORMW 「…それとも、あのメイドの力…？」	PRINTFORMW 「…这也是，那个女仆的力量吗…？」
PRINTFORMW 「ふふっ」	PRINTFORMW 「呵呵——」
PRINTFORMW 「ああいえ、ちょっと面白くて…ふふ」	PRINTFORMW 「啊没什么、只是感觉有些有趣…哼哼」
PRINTFORMW 「たまには、あなたのことが聞きたいわ」	PRINTFORMW 「偶尔，想听一听你的事情」
PRINTFORMW 「ふふ…そんなに、緊張するようなことではない、わ」	PRINTFORMW 「呵呵…不需要，紧张成这样子，啊」
PRINTFORMW 「なんてことない、普通の話でかまわないから」	PRINTFORMW 「不用说什么特别的，普通的话也没关系」
PRINTFORMW 「あなたの言葉で、聞きたいの」	PRINTFORMW 「只是想听一听，你的话语」
PRINTFORMW 「今まで、一人でいることが随分と多かったものだから…」	PRINTFORMW 「至今为止，基本都是我自己一个人待着…」
PRINTFORMW 「雑談といわれても、いったい何を話すべきなのか、わからないの」	PRINTFORMW 「就算是闲聊，到底该说什么好，我也不知道」
PRINTFORMW 「…それでもよければ、少しだけ、お話しましょう」	PRINTFORMW 「…这样也没关系的话，就稍微，说说话吧」
PRINTFORMW 「%CNAME("一人称")%に話しかけるより、他にあなたを気にかける子のために時間を使ったほうが」	PRINTFORMW 「与其和%CNAME("一人称")%说话，不如为其他关心着你的孩子花花时间」
PRINTFORMW 「お互いにとって有意義だ、と思うのだけど…」	PRINTFORMW 「这样彼此来说都有意义，我是这么想的…」
PRINTFORMW 「…ああ、ごめんなさい、少し眠くて」	PRINTFORMW 「…啊啊，抱歉，有些没睡好」
PRINTFORMW 「いえ、退屈というわけではなくて…職業病、かしら」	PRINTFORMW 「不，并不是因为无聊…是职业病，这样」
PRINTFORMW 会話がひと段落した途端、%CALLNAME:TARGET%は本に目を落とした。	PRINTFORMW 会话告一段落后，%CALLNAME:TARGET%把目光投到了书上。
PRINTFORMW 「ああもう、暑いわね…」	PRINTFORMW 「啊啊真是，热死了啊…」
PRINTFORMW 「これはまったく関係の無い話だけど」	PRINTFORMW 「虽然这是完全没有关系的话」
PRINTFORMW 「窃盗犯に科せられる刑罰は、なんだったかしら」	PRINTFORMW 「盗窃犯会被处以的刑罚，是什么呢」
PRINTFORMW %CALLNAME:TARGET%は顔を赤くして%CALLNAME:MASTER%を睨んでいる。	PRINTFORMW %CALLNAME:TARGET%满脸通红地瞪着%CALLNAME:MASTER%。
PRINTFORMW 「気でも触れたの？」	PRINTFORMW 「你疯了吗？」
PRINTFORMW 「あら…ありがとう」	PRINTFORMW 「啊啦…多谢」
PRINTFORMW 「美味しい」	PRINTFORMW 「味道不错」
PRINTFORMW 「…失礼だけど、意外だった、わ」	PRINTFORMW 「…虽然这样说有些失礼，但是还真是让人意外，啊」
PRINTFORMW 「む…」	PRINTFORMW 「唔…」
PRINTFORMW 「…他の女の子と入ると、なぜかおもちゃにされるのよ」	PRINTFORMW 「…和其他女孩子一起进去的话，不知为何会被戏弄啊」
PRINTFORMW 「だったら、あなたと入ったほうがマシ、だわ」	PRINTFORMW 「所以、还是和你一起进去比较好，啊」
PRINTFORMW 「そんなに暇なら、%CNAME("一人称")%の相手をしても問題は無い、わね」	PRINTFORMW 「既然这么闲的话，和%CNAME("一人称")%一起做也没问题，对吧」
PRINTFORMW 「…これはあくまで、あなたの興奮を促し、効率的な搾精を行うためのもの、よ」	PRINTFORMW 「…这只是为了，促使你兴奋，方便进行高效的榨精，哟」
PRINTFORMW 「それ以上の意味はないから、くれぐれも勘違いはしないように」	PRINTFORMW 「并没有其他意思，可千万不要误会了」
PRINTFORMW 「…そんなに見たいなら、みっともない真似しないで言いなさい」	PRINTFORMW 「…如果那么想看的话，就不要做出那么丢人的样子请直接好好地说出来」
PRINTFORMW 「自分の体臭には気づきにくい、とは聞くけれど」	PRINTFORMW 「虽然听说过，人很难察觉到自己的体味」
PRINTFORMW 「精液の匂いでもそうなのかしら」	PRINTFORMW 「原来精液的味道也一样吗」
PRINTFORMW 「…仕方が無いから、掃除してあげるわ」	PRINTFORMW 「…没办法，帮你打扫一下吧」
PRINTFORMW 「今のうちに、多少なりとも契約を履行しておきましょう」	PRINTFORMW 「趁现在，多多少少来履行下合同吧」
PRINTFORMW 「あなたの髪、指の通りがいいわね。まるで猫のよう」	PRINTFORMW 「你的头发，擦过手指的感觉真舒服啊。就像猫一样呢」
PRINTFORMW 「…気にしないで、会話を続けて」	PRINTFORMW 「…不要在意，继续对话吧」
PRINTFORMW 「%CNAME("二人称")%…最近疲れているように見える、けど」	PRINTFORMW 「%CNAME("二人称")%…最近看起来很疲惫，所以」
PRINTFORMW 「…無理は、してはいけない、わ」	PRINTFORMW 「…也，不是不行，啊」
PRINTFORMW 「インスタントで悪いけど、%CNAME("一人称")%の淹れた%SAVESTR:お茶%よ」	PRINTFORMW 「虽然速溶的不是很好，但也是%CNAME("一人称")%泡出来的%SAVESTR:お茶%哟」
PRINTFORMW 「喉が渇いているなら飲みなさい…熱いから、ゆっくりね」	PRINTFORMW 「口渴的话就喝一些吧…还烫着，慢点喝啊」
PRINTFORMW 「%CNAME("一人称")%は、少し早まったのかもしれないわね」	PRINTFORMW 「%CNAME("一人称")%，是不是醒得有些早了呢」
PRINTFORMW 「なるべく早く満足して」	PRINTFORMW 「尽量快点满足吧」
PRINTFORMW 「女の裸体など見慣れているでしょうに、今更こんなものに惹かれるのかしら…」	PRINTFORMW 「明明已经看惯女生的裸体了才对，事到如今居然还会被这种东西吸引吗…」
PRINTFORMW 「なぜ人は…」	PRINTFORMW 「为什么人会…」
PRINTFORMW %CALLNAME:TARGET%は頭痛を堪えるように、額を抑えて顔を歪めている…	PRINTFORMW %CALLNAME:TARGET%一副头痛不已的样子，扶着额头把脸歪到一边…
PRINTFORMW 「まったく」	PRINTFORMW 「真是的」
PRINTFORMW 「見たいなら、せめて堂々と頼みなさい」	PRINTFORMW 「想看的话、就堂堂正正的拜托我就好了」
PRINTFORMW 「盗人のような真似はしないこと、ね」	PRINTFORMW 「不要像做贼一样，啊」
PRINTFORMW 「今日は、どうするの？」	PRINTFORMW 「今天的，怎么样？」
PRINTFORMW 「寒い……」	PRINTFORMW 「好冷……」
PRINTFORMW 「あなたは小学生か何か？」	PRINTFORMW 「你是小学生吗？」
PRINTFORMW 「それともどこか、未開の部族の出身なのかしら？」	PRINTFORMW 「还是说是哪里的，未开化的部落出身吗？」
PRINTFORMW 「…で、感想は？」	PRINTFORMW 「…那么，感想是？」
//PRINTFORMW 「閉鎖的かつ固定的な環境における、人間の狂気の発露、ね」
//PRINTFORMW 「…相手を選んでいることが、せめてもの救い、か」
PRINTFORMW 「盗撮は犯罪よ」	PRINTFORMW 「偷拍是犯罪哦」
PRINTFORMW 「勉強になったわね」	PRINTFORMW 「给我记好了啊」
PRINTFORMW 「そこまでしていいといった覚えはないわ」	PRINTFORMW 「我可不记得允许过你做到那种地步啊」
PRINTFORMW 「はぁ…やれやれ」	PRINTFORMW 「哈啊…真是的」
PRINTFORMW 「…これが見たかったのでしょう？」	PRINTFORMW 「…这么想看那边吗？」
PRINTFORMW 「いっそ清清しいとすら言える、わ」	PRINTFORMW 「甚至可以说是清爽，啊」
PRINTFORMW 「…やっていることには、清清しさの欠片もないけれど」	PRINTFORMW 「…虽然做出的事情，和清爽一点边都沾不上就是了」
PRINTFORMW 「…あまり、激しくはしないで頂戴」	PRINTFORMW 「…请不要，太过激烈」
PRINTFORMW 「ただ咥えるにしても、こちらは色々と気を使うのよ」	PRINTFORMW 「即使只是含着，这边也要费很多力气的哦」
PRINTFORMW 「…今、作業をしているのだけど…見てわからないかしら」	PRINTFORMW 「…现在正在工作之中…没看见吗」
PRINTFORMW 「…まあ、片手くらいなら貸してあげる、わ」	PRINTFORMW 「…算了，一只手的话还是能借你用一用，的」
PRINTFORMW 「貸すだけだから、細かいところはあなたが自分で調節しなさい、ね」	PRINTFORMW 「只是借用，所以细微之处你自己来把控，吧」
PRINTFORMW 「%CNAME("二人称")%、次の日曜日、予定はあるかしら」	PRINTFORMW 「%CNAME("二人称")%，下个周日，你有什么预约吗」
PRINTFORMW 「もし無ければ、空けておいてくれると、嬉しいわ」	PRINTFORMW 「如果没有的话，可以为我空出来吗，我会很高兴的」
PRINTFORMW 「…ありがとう」	PRINTFORMW 「…谢谢」
PRINTFORMW %CALLNAME:TARGET%は耳まで赤くしながら、小さく礼を言った…	PRINTFORMW %CALLNAME:TARGET%脸红到了耳根的同时小声道谢着…
PRINTFORMW 「…そう」	PRINTFORMW 「…这样啊」
PRINTFORMW 「…行くわ」	PRINTFORMW 「…可以啊」
PRINTFORMW 「有意義な休日にしましょう、ね」	PRINTFORMW 「度过一个有意义的周末，吧」
PRINTFORMW 「せめて、昨日のうちに一声かけなさい。最低限の礼儀、よ」	PRINTFORMW 「起码，昨天要给我说一声啊。这是最低限度的礼貌，哦」
PRINTFORMW 「…行かないとは言ってないでしょう」	PRINTFORMW 「…我也没说不去吧」
PRINTFORMW 「ええ、かまわないわ」	PRINTFORMW 「哎哎，没有关系啊」
PRINTFORMW 「予定も立てていないのだし…気ままな散策と行きましょう、ね」	PRINTFORMW 「反正我也没有预定计划…去随意散散步吧，如何」
PRINTFORMW 「ごめんなさい、待たせたかしら」	PRINTFORMW 「对不起，让你久等了」
PRINTFORMW 「じゃあ、行きましょうか」	PRINTFORMW 「那就，走吧」
PRINTFORMW 「下着に毛が生えた程度の布面積しかないのに」	PRINTFORMW 「布料覆盖面积明明和内裤差不了多少」
PRINTFORMW 「名前を変えただけで、多少なりとも見られることに抵抗がなくなるのは、不思議ね」	PRINTFORMW 「只是换了个名字，就感觉没那么抗拒被看见了，不可思议呢」
PRINTFORMW 「ふふ…こうして当て所なくただ町を歩くだけでも」	PRINTFORMW 「嘿嘿…只是这样毫无目的地在街上到处晃悠」
PRINTFORMW 「あなたと一緒なら、不思議と楽しいもの、ね」	PRINTFORMW 「但是是和你一起的话，就不可思议地变成了一件让人开心的事情，呢」
PRINTFORMW 「あまり量が食べられなくて…できれば、二人で分けてもいいかしら？」	PRINTFORMW 「量太多有些吃不完了…不介意的话，两个人分着吃可以吗？」
PRINTFORMW 「品の良い小物の一つでも買いましょうか」	PRINTFORMW 「去买些做工精良的小玩意吧」
PRINTFORMW 「ねえ」	PRINTFORMW 「我说啊」
PRINTFORMW 「…もう少し、ここを見ていたいわ」	PRINTFORMW 「…我有些，想多在这里看一会儿」
PRINTFORMW 「テーマパーク、か…」	PRINTFORMW 「主题公园，吗…」
PRINTFORMW 「いえ…ただ、自分の変化に驚いていただけ、よ」	PRINTFORMW 「不…只是，有些对自己的变化感到惊讶，哟」
PRINTFORMW 「静か、ね」	PRINTFORMW 「好安静，呢」
PRINTFORMW 「…もっと、近くに寄ってもいいわよ」	PRINTFORMW 「…再多往，我这里靠近些也可以哦」
PRINTFORMW 「昔は、散っていく花に、悲しみを覚えるばかりだったけれど」	PRINTFORMW 「以前，只会看着散落的花瓣，觉得悲从中来」
PRINTFORMW 「今は、咲いている花に、喜びを感じるわ」	PRINTFORMW 「如今，会对着盛放的花朵，感到喜悦了」
PRINTFORMW 「あなたのおかげ、かしら」	PRINTFORMW 「我想，都是你的功劳吧」
PRINTFORMW 「泳ぐの…？」	PRINTFORMW 「游泳…？」
PRINTFORMW 「正気…？」	PRINTFORMW 「认真的…？」
PRINTFORMW 「日差しもなくて、いいところね…」	PRINTFORMW 「连阳光也没有，是个好地方呢…」
PRINTFORMW 「連れてきてくれて、ありがとう」	PRINTFORMW 「把我一起带来，非常感谢」
PRINTFORMW 「こういう景色を見るたびに」	PRINTFORMW 「每当看到如此景色」
PRINTFORMW 「遥かな空より地上の方が、よほど美しいと感じるわ」	PRINTFORMW 「都会感觉，比起遥远的天空，还是地上的东西要美得多啊」
PRINTFORMW 「手、つないでてね…」	PRINTFORMW 「手，没牵上呢…」
PRINTFORMW 「あ…」	PRINTFORMW 「啊…」
PRINTFORMW %CALLNAME:TARGET%は僅かに声を漏らすと、その細い指先を%CALLNAME:MASTER%のそれに絡めた。	PRINTFORMW %CALLNAME:TARGET%漏出细微的声音，纤细的指尖和%CALLNAME:MASTER%的指尖交缠在一起。
PRINTFORMW 「着せるほうも着せるほうだけど、着るほうも着るほう、か」	PRINTFORMW 「一个巴掌拍不响，让别人穿的人有错，听了别人的话真去穿的人也有不对，吗」
PRINTFORMW 「…悪態をつくことで平静を保っているの。褒めないで」	PRINTFORMW 「…只是在通过自嘲来保持冷静罢了。不需要夸我」
PRINTFORMW 「…さすがに少し、恥ずかしい、わ」	PRINTFORMW 「…实在是有些，羞耻，啊」
PRINTFORMW 「…どう？」	PRINTFORMW 「…如何？」
PRINTFORMW 「これは流石に…」	PRINTFORMW 「这还真不愧是…」
PRINTFORMW 「…煽てれば、何でもすると思ってるのでは、ないでしょうね」	PRINTFORMW 「…只要请求我，我就什么都会做。你没有这么想吧」
PRINTFORMW 「ちょっと、少女趣味が過ぎるような気もするけど…」	PRINTFORMW 「虽然感觉，有些太过少女风就是了…」
PRINTFORMW 「…あまり、激しくしてはだめよ」	PRINTFORMW 「…太过，用力的话可不行哟」
PRINTFORMW 「少しは控えなさいな」	PRINTFORMW 「请稍微控制一下啊」
PRINTFORMW 「帰るには、まだ早いのではないかしら」	PRINTFORMW 「现在回去，是不是有些太早了」
PRINTFORMW 「…まだ、あなたと一緒にいたい、わ」	PRINTFORMW 「…还想，和你待在一起，啊」
PRINTFORMW 「もう終わり、か」	PRINTFORMW 「约会已经结束了，吗」
PRINTFORMW 「少し、名残惜しいわね」	PRINTFORMW 「感觉，有些不舍呢」


//EVENT_K41_SHOP

PRINTFORMW 「こんなときに…？」	PRINTFORMW 「在这种时候…？」
PRINTFORMW 「…用があるなら、早くして」	PRINTFORMW 「…如果有事的话、快点说吧」
PRINTFORMW 「なにかしら…？」	PRINTFORMW 「有什么事情呢…？」
PRINTFORMW 「え…？」	PRINTFORMW 「哎…？」
PRINTFORMW こちらに微笑を向ける%CALLNAME:TARGET%に、%CALLNAME:MASTER%は想いを伝えた…	PRINTFORMW %CALLNAME:MASTER%向朝着这边微笑的%CALLNAME:TARGET%传达了自己的想法…
PRINTFORMW %CALLNAME:TARGET%はなにを言われたのか、しばらくの間事態が飲み込めずにいたが	PRINTFORMW %CALLNAME:TARGET%一时之间没能很好地理解自己听到的话语
PRINTFORMW やがて全てを理解すると、そのまま崩れるように%CALLNAME:MASTER%の胸に飛び込み、か細い嗚咽を何度か漏らした…	PRINTFORMW 在最终反应过来之后，她好像突然失去了控制一样跳进了%CALLNAME:MASTER%的怀里，不停地发出细微的呜咽声…
PRINTFORMW 「…聞かなかったことにしておくわ」	PRINTFORMW 「…我会当作没听见的」
PRINTFORMW そう言う%CALLNAME:TARGET%の表情は、どこか悲しげだ…	PRINTFORMW 说着这种话的%CALLNAME:TARGET%的表情、不知为何很悲伤…
PRINTFORMW 「あなた…もしかして知っていて言ってるの？」	PRINTFORMW 「你啊…难不成其实知道吗？」
PRINTFORMW 「履いてないから、ないわ」	PRINTFORMW 「没有穿所以、没法给你啊」
PRINTFORMW 「……チッ」	PRINTFORMW 「……嘁」
PRINTFORMW 「いやよ」	PRINTFORMW 「才不给」
PRINTFORMW 「嫌」	PRINTFORMW 「不给」
PRINTFORMW 「性的に倒錯した人間を知ってはいるけど…」	PRINTFORMW 「虽然知道你是个性癖奇怪的人…」
PRINTFORMW 「得てしてそういう人種は、少なくとも価値を認めたものに対して誠実ではあった」	PRINTFORMW 「你这种人啊、至少在面对自己认为有价值的东西时还是很诚实的」
PRINTFORMW 「翻って、あなたのそれは…さしずめ、趣味未満の自己満足、かしら？」	PRINTFORMW 「反过来说、你这种行为…总结一下就是、连兴趣都算不上的自我满足吧？」
PRINTFORMW 「…あなたなら、触れられる女に困りはしないでしょうに」	PRINTFORMW 「…如果是被碰到内裤的话、当事人的女性应该不会感到为难吧」
PRINTFORMW 「そうまでして女性の肌着を求めるとは…」	PRINTFORMW 「不过对女性的贴身衣物渴求至如此地步…」
PRINTFORMW 「正直、理解に苦しむわ、ね」	PRINTFORMW 「还真是、难以理解、呢」
PRINTFORMW 「契約に含まれない行為を、あえて%CNAME("一人称")%に要求する理由は何？」	PRINTFORMW 「让我做这种不包括在契约范围内的行为、敢问你%CNAME("一人称")%提出这种要求的理由是什么呢？」
PRINTFORMW 「あなたに食事を作ってあげたいと思う女の子は、他に大勢いるのでしょう？」	PRINTFORMW 「愿意给你做便当吃的女孩子、除我以外还有很多人吧？」
PRINTFORMW 「努力はする、わ」	PRINTFORMW 「你还、挺执着的」
PRINTFORMW 「%CNAME("一人称")%にだって、好きな相手に自分の手料理を食べて欲しい、と」	PRINTFORMW 「对%CNAME("一人称")%来说、想吃喜欢的人亲手做的料理、之类的」
PRINTFORMW 「それぐらいの欲はあるもの」	PRINTFORMW 「也是会有这种想法的呢」
PRINTFORMW 「一応、胃薬は用意しておきなさい」	PRINTFORMW 「不过、最好提前准备好胃药」
PRINTFORMW 「正気？」	PRINTFORMW 「你认真的？」
PRINTFORMW 「いえ、%CNAME("一人称")%は別に構わないけれど」	PRINTFORMW 「不、虽然%CNAME("一人称")%是没什么关系啦」
PRINTFORMW 「ただ…%CNAME("一人称")%はあまり、料理の経験があるわけではないから」	PRINTFORMW 「可是…%CNAME("一人称")%几乎、没有什么下厨的经验」
PRINTFORMW 「正直なところ、ただ美味しい食事を求めているなら、他の女の子に頼んだほうがいいと思う、けど」	PRINTFORMW 「说实话、如果只是为了享受美味的食物的话、感觉其实还是拜托其他女孩子比较好」
PRINTFORMW 「ただ…もし%CNAME("二人称")%が今の%CNAME("一人称")%との間に、擬似的な恋愛関係のようなものを投影しているのなら」	PRINTFORMW 「但是…如果%CNAME("二人称")%是想在和%CNAME("一人称")%之间、伪造出一种近似于恋爱一样的关系的话」
PRINTFORMW 「きっと、お互いにとって不幸にしかならない、とだけ言っておくわ、ね」	PRINTFORMW 「一定、只会给彼此带来不幸、我把话先说在这里、懂吗」
PRINTFORMW 「それを理解してなお、あなたが求めるというのなら」	PRINTFORMW 「明白这一点之后、如果你还坚持的话」
PRINTFORMW 「%CNAME("一人称")%に拒否する理由はない、わ」	PRINTFORMW 「%CNAME("一人称")%就没有拒绝的理由了、呢」
PRINTFORMW 「あれだけやって、まだ足りないの？」	PRINTFORMW 「单纯做那些事、已经满足不了你了吗？」
PRINTFORMW 「定期的な性交は契約の本旨にも沿うことだけど…」	PRINTFORMW 「虽然确实是遵循定期的性交契约的宗旨…」
PRINTFORMW 「それにしたって、限度というものが…」	PRINTFORMW 「话虽如此、但也得有个限度啊…」
PRINTFORMW 「…それだけ強く%CNAME("一人称")%の身体を求めてくれている、と考えれば」	PRINTFORMW 「…正因如此才这么强烈地渴求%CNAME("一人称")%的身体、这样想的话」
PRINTFORMW 「…いいでしょう」	PRINTFORMW 「…好吧」
PRINTFORMW 「親しくもない女に過剰な要求をして、悦に浸るような人種に覚えはあるけれど…」	PRINTFORMW 「对并不亲近的女生提出过多的要求、并沉浸于这种快感的人虽然我也遇到过…」
PRINTFORMW 「あなたがそのような人ではないと、信じたいもの、ね」	PRINTFORMW 「但我希望自己可以相信、你并不是那种人、呢」
PRINTFORMW 「親しき仲にも礼儀あり、よ」	PRINTFORMW 「就算对亲近的伙伴也要有礼貌、哟」
PRINTFORMW 「そうでないならなおのこと」	PRINTFORMW 「关系不亲近的话就更该如此了」
PRINTFORMW 「失望させないで」	PRINTFORMW 「不要让我失望」
PRINTFORMW 「まあ、いいでしょう」	PRINTFORMW 「嘛、那好吧」
PRINTFORMW 「かまわないわ」	PRINTFORMW 「我倒不在意」
PRINTFORMW 「それで、あなたの気が晴れるなら」	PRINTFORMW 「这样、你会高兴的话」
PRINTFORMW 「無駄遣いだけはしないように、ね」	PRINTFORMW 「不要买一些浪费钱的东西就好、呢」
PRINTFORMW 「あなたは気分がいいのでしょうけどね…」	PRINTFORMW 「你倒是心情挺不错呢…」
PRINTFORMW 「まあ、学生が体育の帰りにコンビニへ寄るようなものと考えれば…」	PRINTFORMW 「嘛、应该会被认为是刚上完体育课回来顺道去便利店的学生吧…」
PRINTFORMW 「…そもそも、学生が利用していい店、なのかしら…？」	PRINTFORMW 「…不过、本来就是学生也可以光顾的店铺、这样的吧…？」
PRINTFORMW 「正気…？」	PRINTFORMW 「认真的…？」
PRINTFORMW 「女性器を模した性玩具…」	PRINTFORMW 「模仿女性性器的性玩具…」
PRINTFORMW 「こういうのが好みなのかしら」	PRINTFORMW 「居然还有这种爱好吗」
PRINTFORMW 「正直、あなたの趣味は良くわからないけれど…」	PRINTFORMW 「老实说、真是搞不懂你的喜好…」
PRINTFORMW 「…これでいいかしら？」	PRINTFORMW 「…这样一来就可以了吗？」
PRINTFORMW 「望まぬ妊娠を避けるため、あるいは触媒としての男性の精を手軽に保存するため」	PRINTFORMW 「为了避免意外怀孕、或者说为了轻松地拦截住作为怀孕媒介的男性精液」
PRINTFORMW 「予めコンドームを用意しておく、というのは極めて大切なことよ」	PRINTFORMW 「因此要事先把避孕套准备好、这可是非常重要的事情哦」
PRINTFORMW 「…それを、あえて女に買わせることは別として、ね」	PRINTFORMW 「…不过、敢让女生去买就另当别论了、对吧」
PRINTFORMW %CALLNAME:TARGET%はいくつかのコンドームを手に取り、真剣な表情で吟味を重ねている…	PRINTFORMW %CALLNAME:TARGET%手里拿着几套避孕套，一脸认真地反复斟酌着…
