
//EVENT_K42_みなみ.ERB


%CALLNAME:MASTER%の実妹。	%CALLNAME:MASTER%的亲妹妹。
%CALLNAME:MASTER%よりも年若いため、普段は学校で顔を合わせることはない。	 因为比%CALLNAME:MASTER%年龄要小、所以平时在学校不怎么见得着面。
小柄ながらも発育がよいため男女ともに人気がある。	虽然个子不高但发育良好、因此在男女生中都很有人气。
PRINTFORMW 話は、数時間前にさかのぼる。……何気なく、朝の支度をしていた時のことだ。	PRINTFORMW 事情的原委要追溯到几个小時前。……大致上来说、是今天早上发生的事。
PRINTFORMW 今までずっと学校に行って、勉強して、という変わらない毎日に嫌気がさしていた。	PRINTFORMW 已经厌倦了毎天去学校上学、学习、放学回家的一成不変的无聊日子。
PRINTFORMW でも、その日常が非日常になるきっかけをフェリシエルからもらったならば…… 今まで渋っていた部活を立ち上げるのも悪くはない、と。	PRINTFORMW 但是、弗理希艾尔给了自己一个让日常变成非日常的契机…… 虽然一直都不太想参与社团活动、但自己建一个出来的话或许也不坏。
PRINTFORMW 部活もそれなりになんとか器具とかも揃ったし隠蔽工作も十分。	PRINTFORMW 作为社团活动的各种各样的器具都准备好了、隠蔽工作也做得很好。
PRINTFORMW そう思っていた矢先、帰り道のことだ。	PRINTFORMW 想到这里、我正在回家路上的时候。
PRINTFORMW 「……ねーえ。……部活、立ち上げたの？」	PRINTFORMW 「……那个。……你成立了个社团是吗？」
PRINTFORMW 「部活立ち上げたんだったら、%CNAMET(ARG, "一人称")%も部活入りたいんだけど」	PRINTFORMW 「既然你如果成立了社团、%CNAMET(ARG, "一人称")%也想加进去来着」
PRINTFORMW どこでその話を聞いてきた、とは思ったが%NAME:ARG%ならしょうがない、と思って話を聞いていると……	PRINTFORMW 虽然不知道是从哪里听来的、但一想毕竟是%NAME:ARG%所以也没有办法、决定继续听下去……
PRINTFORMW 「学校でも%CNAMET(ARG, "二人称")%と一緒に居たいんだ、だめ～？」	PRINTFORMW 「在学校里也想和%CNAMET(ARG, "二人称")%一直在一起、不行吗～？」
PRINTFORMW %NAME:ARG%の押しの強さは相変わらず、と思うと共に断る理由もなかったので承諾すると……	PRINTFORMW %NAME:ARG%的强硬态度还是老样子、这么想的话也没有拒绝的理由了、只好答应下来……
PRINTFORMW 「やった～！%CNAMET(ARG, "二人称")%と学校でも部活一緒～！」	PRINTFORMW 「太好了～！学校的社团活动里也和%CNAMET(ARG, "二人称")%在一起～！」
PRINTFORMW いたく喜んでくれたようだ。	PRINTFORMW 似乎很高兴的样子。
PRINTFORMW でも、その日常が非日常になるきっかけをもらったならば…… 今まで渋っていた部活を立ち上げるのも悪くはない、と。	PRINTFORMW 但是、如果想要寻找一个让日常变成非日常的契机的话…… 虽然一直都不太想参与社团活动、但自己建一个出来的话或许也不坏。
PRINTFORMW 別に問題行動を起こしているわけでもないから、部活開始届けもすんなり受理してもらえるだろう。	PRINTFORMW 因为也不是会引起什么問題的事情、社团活动申报了之后就能顺利受理吧。
PRINTFORMW そう思っていた矢先のことだ。	PRINTFORMW 就在我这么想的时候。
PRINTFORMW 「……ねーえ。……んー、何かぶつぶつつぶやいていたようだけど……部活、立ち上げるの？」	PRINTFORMW 「……呐。…嗯、好像在嘟囔着什么……社团活动、你打算建社团吗？」
PRINTFORMW どうやら%NAME:ARG%に独り言を聞かれてしまっていたようだ。	PRINTFORMW 看样子应该是%NAME:ARG%听到了我的自言自语。
PRINTFORMW %NAME:ARG%はやや心配そうに、じぃっと%CALLNAME:MASTER%を見上げて見つめてきた。	PRINTFORMW %NAME:ARG%有点担心的样子、抬头看了看%CALLNAME:MASTER%。
PRINTFORMW 「学年も違うから……心配しようにも難しいけど……」	PRINTFORMW 「因为学年不同……虽然有些担心也很难自己参加……」
PRINTFORMW %NAME:ARG%の育ちの良さは知っているし、心配されるのも仕方ない、とは思える。	PRINTFORMW 因为知道%NAME:ARG%的教养很好、被担心也是没办法的事、我是这么觉得的。
PRINTFORMW が、しかし、自分にだってやりたいことがあると押し切ると……	PRINTFORMW 可是、就算是自己、也是想把自己打算去做的事情做到最后的……
PRINTFORMW 「そっかー……。心配だから、たまに見に行くね……？」	PRINTFORMW 「这样啊……。但是还是很担心、所以我偶尔去看看吧……？」
PRINTFORMW ……半ば押し掛け女房的に%NAME:ARG%が加入した。	PRINTFORMW ……大概有一半算是自己送上门的贤内助%NAME:ARG%加入了。
PRINTFORMW %CALLNAME:ARG%は%CALLNAME:MASTER%の"実妹"であると共に、常時"同棲中"となります。	PRINTFORMW %CALLNAME:ARG%作为%CALLNAME:MASTER%的"実妹"、一直都处于"同棲中"。
PRINTFORMW - ！システムメッセージ！ -	PRINTFORMW - ！系统信息！ -
PRINTFORML %CALLNAME:ARG%の%CALLNAME:MASTER%に対する二人称を設定できます。	PRINTFORML 可以設定%CALLNAME:ARG%対%CALLNAME:MASTER%的第二人称（即对玩家的称呼）。
PRINTFORML 現在の二人称は『%CNAMET(ARG, "二人称")%』です。変更しますか？	PRINTFORML 現在的第二人称是『%CNAMET(ARG, "二人称")%』。要変更吗？
PRINTFORML (後から取引でお願いすることで変更することもできます)	PRINTFORML (之後可以在交易中请求来进行変更)
CALL PRINT_SELECT, "変更する/変更しない"	CALL PRINT_SELECT, "変更/不変更"
PRINTFORMW  二人称を変更しません。	PRINTFORMW  不変更第二人称。
PRINTFORML 収納などは必要最低限にとどまっており、年頃の女の子とは思えないほど殺風景な部屋だ。	PRINTFORML 只収納了最低必要限度的东西、对这个年龄的女孩子来说是个殺風景的房间。
PRINTFORML それでも要所要所で花柄の小物が使われていたりと、やはり気にしてはいるのだろう。	PRINTFORML 不过即便如此、在重要的地方还是有花朵图案的小饰品、果然还是有在意的吧。
//历史的遗泽、到此为止了、rua

PRINTFORMW 「実の%NAMES("兄弟")%でえっちすることになるなんて、思ってなかったなあ……」	PRINTFORMW 「明明是亲%NAMES("兄弟")%、却要做这种事情、真是没想到呢……」
PRINTFORMW 「%CNAME("一人称")%、こう言うの初めてだから。やさしく……してね」	PRINTFORMW 「因为这对于%CNAME("一人称")%来说还是第一次。请温柔一些……明白吗」
PRINTFORMW 「慣れちゃいけないって思ってるよ」	PRINTFORMW 「%CNAME("一人称")%觉得还是不能接受」
PRINTFORMW 「……だって、どんなに好きでも禁忌は禁忌だもの」	PRINTFORMW 「……因为、就算再怎么互相喜欢、禁忌也还是禁忌」

PRINTFORMW 「%CNAME("一人称")%はね、この状況に慣れてはいけないって思ってる」	PRINTFORMW 「%CNAME("一人称")%呢、已经开始觉得这种事情不是不能接受了」
PRINTFORMW 「……そう思ってるのに慣れてる自分が怖いの」	PRINTFORMW 「……有些害怕会这样想的自己」
PRINTFORMW 「ダメなことだって分かってるのにね」	PRINTFORMW 「明明%CNAME("一人称")%知道是不可以的」

PRINTFORMW 「最近思ってることがあって。……%NAMES("兄弟")%仲良くいられたらって」	PRINTFORMW 「最近一直在想。……%NAMES("兄弟")%之间如果能好好相处的话」
PRINTFORMW 「こういうことも含めてね」	PRINTFORMW 「包括这样的事情」
PRINTFORMW 「いけないって思っていてもどうしても今えっちを抜きにして仲良く、なんて考えることはできないから」	PRINTFORMW 「虽然觉得还是不可以、但现在也不能摆脱了、只能不去想、大家好好相处吧」
PRINTFORMW 「%CNAME("一人称")%は%CNAME("二人称")%もさくらお姉ちゃんも好きだしできることならこのままでいたい」	PRINTFORMW 「%CNAME("一人称")%喜欢%CNAME("二人称")%和樱姐姐、如果可以的话、希望能一直这样在一起」

PRINTFORMW 「%CNAME("二人称")%としない日のムラムラ、すごくつらくて」	PRINTFORMW 「和%CNAME("二人称")%不在一起的日子、会很寂寞」
PRINTFORMW 「……ムラムラもあるけど……なんか、違う感じもあるんだ」	PRINTFORMW 「……虽然痛苦……但是、心里总有一种违和感」
PRINTFORMW 「もっと%CNAME("一人称")%のことを見て欲しいとか、独り占めしたいとか……」	PRINTFORMW 「想让%CNAME("二人称")%多看看%CNAME("一人称")%之类的、想要独占%CNAME("二人称")%之类的……」
PRINTFORMW 「ずっとダメって言い続けたけど、%CNAME("二人称")%に恋しちゃってるのかなって」	PRINTFORMW 「虽然一直都在说不可以、但是还是爱上了%CNAME("二人称")%什么的」
PRINTFORMW 「なんて……考えすぎもよくないかな」	PRINTFORMW 「嘛……想那么多也不太好吧」
PRINTFORMW 「お互いに、今日も一杯気持ちよくなろーねっ」	PRINTFORMW 「那就喝一杯、心情舒畅的继续吧」
//不太好搞、以后再想想吧

PRINTFORMW 「今更こういうこと言うのは恥ずかしいケド」	PRINTFORMW 「事到如今说这种话真的不好意思呢」
PRINTFORMW 「初めてじゃないのに、ドキドキしちゃうね」	PRINTFORMW 「虽然不是第一次、但内心还是止不住的悸动」
PRINTFORMW 「これが初夜に初めて逢瀬をするカップルの気持ちなのかな」	PRINTFORMW 「这就是夫妇之间在新婚初夜时的心情吗」

PRINTFORMW 「なーんて、冗談」	PRINTFORMW 「什么、开玩笑的」
PRINTFORMW 「……だって、近親相姦は禁忌だけど」	PRINTFORMW 「……因为、近亲之间的这种事是禁忌啊」
PRINTFORMW 「好きになったモノを止めろなんて誰にも言われる権利はないじゃない？」	PRINTFORMW 「但谁都没有权利要求别人停止追求自己的一生所爱、不是吗？」

PRINTFORMW 「だから、%CNAME("二人称")%のおちんちんになら、初めて捧げたいな」	PRINTFORMW 「所以、如果是%CNAME("二人称")%的话、第一次想要交给你」
PRINTFORMW 「これからも、%CNAME("一人称")%のこと……ずっと、見ててね」	PRINTFORMW 「从今以后、也请一直看着%CNAME("一人称")%啊……」

PRINTFORMW 「……気持ちよかったよぉ……」	PRINTFORMW 「……很舒服的呦……」

PRINTFORMW 「……%CNAME("一人称")%が一人でシてるとこ……見たいの？」	PRINTFORMW 「……只有%CNAME("一人称")%一个人的话……想要看吗？」
PRINTFORMW %CALLNAME:TARGET%はおずおずと自らの股間を触り始めた。	PRINTFORMW %CALLNAME:TARGET%小心翼翼地开始触碰着自己的股间。

PRINTFORMW 「恥ずかしいんだけど……コレ、咥えて？」	PRINTFORMW 「虽然很害羞……但是这个、要含住吗？」
PRINTFORMW %CALLNAME:TARGET%はもじもじしながら股間にある男根を差し出してきた。	PRINTFORMW %CALLNAME:TARGET%扭扭捏捏的向肉棒凑过来。

PRINTFORMW 「ひゃっ！？%CNAME("二人称")%、そんな、っとこ……！」	PRINTFORMW 「呀！？%CNAME("二人称")%、怎么……、这样……！」
PRINTFORMW %CALLNAME:TARGET%は未知の感覚に戸惑っているようだ……	PRINTFORMW %CALLNAME:TARGET%对从未接触过的快感感到困惑……

PRINTFORMW 「ねーぇ、コ・レ。咥えてよ」	PRINTFORMW 「呐、这个。要含住是吧」
PRINTFORMW %CALLNAME:TARGET%はずずいと股間にある男根を押しつけてきた。	PRINTFORMW %CALLNAME:TARGET%毫不客气的把肉棒插入了口中。

CALL PRINT_STR, "「はぅっ、んんっ、んっ_HH_」_W"	CALL PRINT_STR, "「呼呜……、嗯……、呜嗯……_HH_」_W"
CALL PRINT_STR, "「んっ、んっ_HH_ このキス、好きなのっ_HH_」_W"	CALL PRINT_STR, "「唔、嗯_HH_ 我喜欢、这样的吻_HH_」_W"
CALL PRINT_STR, "(頭が沸騰しちゃいそうなぐらい好きっ_HH__HH_)_W"	CALL PRINT_STR, "(满脸羞红的接受了你的亲吻_HH__HH_)_W"
//冲呀
PRINTFORMW 「%CNAME("二人称")%にはじめて捧げられるなんて……嬉しい……♪」	PRINTFORMW 「第一次能献给%CNAME("二人称")%……好开心……♪」
PRINTFORMW 「あぅ、そういうコトするってことは……」	PRINTFORMW 「啊、做了这种事之后……」
PRINTFORMW 「%CNAME("二人称")%がセキニン、とってくれるんだよね？」	PRINTFORMW 「%CNAME("二人称")%的话、会好好地负起责任的是吧？」
PRINTFORMW 「やっぱり%CNAME("二人称")%の、おちんちん……おっきぃ……」	PRINTFORMW 「果然%CNAME("二人称")%的、肉棒……好大啊……」
PRINTFORMW 「搾り取る感じがいいの？はぁい♪」	PRINTFORMW 「这样被榨取的感觉如何？很好吗♪」
CALL PRINT_STR, "「じっと見つめられると、どきどきしちゃう………_HH_」_W"	CALL PRINT_STR, "「如果一直被看着的话、心跳就会加速………_HH_」_W"
CALL PRINT_STR, "「はぁ……んっ_HH_」_W"	CALL PRINT_STR, "「哈啊……嗯唔……_HH_」_W"
CALL PRINT_STR, "「入れられるのっていつもゾクゾクしちゃう_HH_」_W"	CALL PRINT_STR, "「进来的时候总是让人很安心呢_HH_」_W"
PRINTFORMW 「今日もいっぱいしよーねっ♪」	PRINTFORMW 「今天也满满地射出来吧♪」
CALL PRINT_STR, " 「あぅぅ、イかせてぇ……_HH__HH_」_W"	CALL PRINT_STR, " 「啊呜、稍微让我……_HH__HH_」_W"
PRINTFORMW 「(イくの我慢させられちゃってる……っ)」	PRINTFORMW 「(正在忍耐着……)」
CALL PRINT_STR, "「後ろからぱんぱんっ_HH_てされるの好きなの_HH_」_W"	CALL PRINT_STR, "「喜欢被人从_HH_后面插入呢_HH_」_W"
CALL PRINT_STR, "「こういうの実は好き……なんだ_HH_」_W"	CALL PRINT_STR, "「我很喜欢……这个姿势……_HH_」_W"
CALL PRINT_STR, "「んぅ……挿れてるところが見えるのは恥ずかしいけど……_HH_」_W"	CALL PRINT_STR, "「唔……能看到被插入的地方让人很不好意思呢……_HH_」_W"
CALL PRINT_STR, @"「%CNAME("二人称")%が私のおまんこで気持ちよくなってる顔、いっぱいみせて_HH_」_W"	CALL PRINT_STR, @"「%CNAME("二人称")%的肉棒在我体内的时候、露出舒服的表情、请多让我看看_HH_」_W"
CALL PRINT_STR, "「繋がってるところ見えるの、恥ずかしくなっちゃう……_HH_」_W"	CALL PRINT_STR, "「身体相结合的地方、可以看见呢、稍微有些害羞……_HH_」_W"
PRINTFORMW 「顔が見えない方が私興奮するんだぁ……っ」	PRINTFORMW 「如果看不到脸的话、会变得兴奋起来……っ」
CALL PRINT_STR, "「顔が見えないと、後ろで何されてるかわかんなくて興奮しちゃう_HH_」_W"	CALL PRINT_STR, "「看不到脸的话、会因为不知道身后会被如何对待而兴奋_HH_」_W"
PRINTFORMW 「我慢しないでいっぱい気持ちよくなってね♪」	PRINTFORMW 「不要忍耐、让我们变得更加舒服吧♪」
PRINTFORMW 「えへへ……♪」	PRINTFORMW 「欸嘿嘿……♪」
PRINTFORMW 「%CNAME("一人称")%でいっぱい気持ちよくなってね♪」	PRINTFORMW 「请让%CNAME("一人称")%变得更加的舒服起来吧♪」
PRINTFORML 「処女より先にお尻の処女を%CNAME("二人称")%にあげるのって不思議な気分だけど……」	PRINTFORML 「在处女给を%CNAME("二人称")%之前先将后面的处女交给%CNAME("二人称")%、感觉有些奇怪……」
PRINTFORML 「どっちも%CNAME("一人称")%の初めては%CNAME("二人称")%に捧げるつもりだったから、ちゃんと%CNAME("一人称")%の初めては両方とももらってね、%CNAME("二人称")%♪」	PRINTFORML 「无论那一边的第一次%CNAME("一人称")%都想献给%CNAME("二人称")%、好好地享用%CNAME("一人称")%的两次初体验吧、%CNAME("二人称")%♪」
CALL PRINT_STRL, @"「処女もアナルも%CNAME("二人称")%に捧げられたなんて夢みたい。とっても嬉しいよ………_HH_」"	CALL PRINT_STRL, @"「处女和尻穴都被%CNAME("二人称")%占有了。如同在梦里一般、内心雀跃不止………_HH_」"
PRINT 「私達は	PRINT 「我们是
CALL PRINT_STRW, @"なのに超えちゃいけない一線を越えちゃったね_HH_」"	CALL PRINT_STRW, @"但是越过了禁忌的底限啊_HH_」"
PRINTFORML 「処女はあげられなかったけど……」	PRINTFORML 「虽然处女不能交给%CNAME("二人称")%了……」
CALL PRINT_STRW, @"「お尻は%CNAME("二人称")%にあげれて嬉しい_HH_これから%CNAME("一人称")%のお尻は%CNAME("二人称")%専用だからね_HH_」"	CALL PRINT_STRW, @"「但是%CNAME("一人称")%很高兴%CNAME("一人称")%还有后面的第一次可以交给%CNAME("二人称")%_HH_从此%CNAME("一人称")%的尻穴就是%CNAME("二人称")%专用的了_HH_」"
CALL PRINT_STRL, @"「んっ……あんまりお尻ばっかり弄るから_HH_初めてなのに気持ち良くなってきちゃった_HH_」"	CALL PRINT_STRL, @"「呐……总是玩弄那里的话_HH_明明还是第一次却变得这么舒服_HH_」"
CALL PRINT_STRW, @"「ちゃんと責任とってね……%CNAME("二人称")%_HH_」"	CALL PRINT_STRW, @"「……让%CNAME("一人称")%变得这么H的事情……%CNAME("二人称")%要好好负起责任啊_HH_」"
PRINTFORML 「くぅ……大丈夫」	PRINTFORML 「唔嗯……没关系的」
CALL PRINT_STRW, @"「ちょっと痛いけど……%CNAME("二人称")%が喜んでくれるなら%CNAME("一人称")%頑張れるの_HH_」"	CALL PRINT_STRW, @"「虽然有些痛……但是%CNAME("二人称")%喜欢的话、%CNAME("一人称")%也要努力才行_HH_」"
PRINTFORML 「お尻でえっちするのってアブノーマルな事なんだからね……」	PRINTFORML 「用屁股做H的事情本来应该是不正常的才对呢……」
PRINT 「それも……	PRINT 「比起那个……
CALL PRINT_STRW, @"でするなんて……%CNAME("二人称")%は本当にえっちなんだから_HH_」"	CALL PRINT_STRW, @"之间变成这样……也是因为%CNAME("二人称")%实在太H了的错_HH_」"
PRINTFORM 「%CNAME("一人称")%のお尻ね、%CNAME("二人称")%の	PRINTFORM 「%CNAME("一人称")%的后面、是只属于%CNAME("二人称")%的
PRINTFORMW おちんちん	PRINTFORMW 肉棒
PRINTFORMW 腰使い	PRINTFORMW 使用的呢
CALL PRINT_STRL, @"覚えちゃったんだからね_HH_」"	CALL PRINT_STRL, @"我记住了呢_HH_」"
CALL PRINT_STRW, @"「満足するまで%TEXTR("たっぷり/いっぱい")%してくれないと……嫌だからね？_HH_」"	CALL PRINT_STRW, @"「在满足之前%TEXTR("很多的/满满的")%射进来吧……不喜欢吗？_HH_」"
CALL PRINT_STRL, @"「はぁ_HH_……%CNAME("一人称")%、お尻の穴で気持ち良くなっちゃってる_HH_」"	CALL PRINT_STRL, @"「哈啊_HH_……%CNAME("一人称")%、尻穴已经变得很舒服了呢_HH_」"
CALL PRINT_STRW, @"「%CNAME("一人称")%も少しは慣れてきたから、ちゃんと動いていっぱいえっちな事してね、%CNAME("二人称")%_HH_」"	CALL PRINT_STRW, @"「%CNAME("一人称")%多少也习惯了、可以不用忍耐尽情的做H的事情了呢、%CNAME("二人称")%_HH_」"
PRINT 「少し痛いけど……これが	PRINT 「虽然有些痛……但这就是
PRINT お姉ちゃん	PRINT 姐姐
PRINT お兄ちゃん	PRINT 欧尼酱
PRINTFORMW の望みなら耐えてみせるからね」	PRINTFORMW 想要的呢、我会好好接受的」
PRINTFORML 「まだ少し……」	PRINTFORML 「稍等一下……」
PRINTFORMW 「お尻でするの%TEXTR("怖い/痛い")%から……優しくしてね？」	PRINTFORMW 「因为用屁股做会很%TEXTR("害怕/痛")%……所以温柔些可以吗？」
CALL PRINT_STRL, @"「%TEXTR("んっ/んんっ")%_HH_%CNAME("二人称")%の大きい……」"	CALL PRINT_STRL, @"「%TEXTR("んっ/んんっ")%_HH_%CNAME("二人称")%好大……」"
CALL PRINT_STRW, @"「そんな%TEXTR("大きい/立派なの")%で%TEXTR("お尻/アナル")%犯されたら_HH_%CNAME("一人称")%、%TEXTR("壊れちゃいそう/おかしくなっちゃいそう")%_HH_」"	CALL PRINT_STRW, @"「这样%TEXTR("巨大的/了不起的")%肉棒、如果侵犯%TEXTR("屁股/尻穴")%的话_HH_%CNAME("一人称")%、%TEXTR("会坏掉的/会变得奇怪的")%_HH_」"
CALL PRINT_STRL, @"「%CNAME("二人称")%%TEXTR("に跨っ/をたっぷり搾り取っ")%ちゃうんだからね_HH_」"	CALL PRINT_STRL, @"「一定要%TEXTR("努力的侍奉/充分地榨取")%%CNAME("二人称")%的身体呢_HH_」"
CALL PRINT_STRL, @"「%TEXTR("女の子同士/同性")%なのにお尻でえっちしちゃうなんて%CNAME("一人称")%達って%TEXTR("変態さんだよね/ちょっとアブノーマルかも")%_HH_」"	CALL PRINT_STRL, @"「明明都是%TEXTR("女孩子/同性")%却在做这样的事情%CNAME("一人称")%觉得%TEXTR("很变态的样子/不太正常呢")%_HH_」"
CALL PRINT_STRW, @"（%TEXTR("上手に出来るかな……あっ、入ってきちゃう/恥ずかしいけど……頑張らないといけないよね。んっ、入れただけなのに……お尻気持ちいい")%_HH_）"	CALL PRINT_STRW, @"（%TEXTR("我能做的好吗……啊……、插进来了/虽然很害羞……但是只能加油了。啊……、明明只是插进来而已……就变的这样舒服起来")%_HH_）"
CALL PRINT_STRL, @"「%TEXTR("恥ずかしいけど/ちょっと嬉しいな")%_HH_こうしてるとまるで恋人同士みたい_HH_」"	CALL PRINT_STRL, @"「%TEXTR("虽然不太好意思/稍微有些高兴")%_HH_就像一对恋人一样_HH_」"
PRINTFORM 「普通の恋人は%TEXTR("お尻/アナル")%でえっちしたりしないのかな？%CNAME("一人称")%達は	PRINTFORM 「一般的恋人会用热衷于用%TEXTR("后面/尻穴")%做爱吗？%CNAME("一人称")%明明我们还是
CALL PRINT_STRW, @"だから普通じゃない恋人だもの_HH_禁断の関係なんだから%TEXTR("お尻/アナル")%でする方が自然%TEXTR("かもね/だよね/かな？")%_HH_」"	CALL PRINT_STRW, @"所以作为不寻常的恋人_HH_因为是禁断的关系、所以才会用%TEXTR("后面/尻穴")%做爱吗_HH_」"
CALL PRINT_STRL, @"「%CNAME("二人称")%は%TEXTR("お尻/アナル")%好きなの？_HH_」"	CALL PRINT_STRL, @"「%CNAME("二人称")%是喜欢使用%CNAME("一人称")%的%TEXTR("后面/尻穴")%吗？_HH_」"
PRINTFORM 「%CNAME("一人称")%はあんまり好きじゃなかったけど……	PRINTFORM 「虽然%CNAME("一人称")%觉得这样不太对……但
CALL PRINT_STRW, @"「が%TEXTR("喜んでくれるから/したがるから")%%TEXTR("好きになっちゃった/気持ち良くなれるようになっちゃったの")%_HH_」"	CALL PRINT_STRW, @"「%TEXTR("喜欢的话/想做的话")%%TEXTR("我也会喜欢/心情也会变好")%_HH_」"
CALL PRINT_STRL, @"「%TEXTR("ちゃんとゴムをつけて偉い/ゴムをしてくれるなんて嬉しい")%_HH_」"	CALL PRINT_STRL, @"「%TEXTR("有好好戴上避孕套呢/能这样尊重我我很开心")%_HH_」"
CALL PRINT_STRW, @"「%TEXTR("お尻/アナル")%に%TEXTR("出されちゃう瞬間/射精される感覚")%も嫌いじゃないけど_HH_……%TEXTR("中からトロトロ出て来ちゃうのは恥ずかしいの_HH_/溢れてきちゃうとちょっと汚いから……")%」"	CALL PRINT_STRW, @"「%TEXTR("在屁股里/在尻穴里")%に%TEXTR("射精的瞬间/射精的感觉")%也不讨厌的样子_HH_……%TEXTR("但是从里面流出来会很不好意思_HH_/溢出来的话感觉有点脏……")%」"
CALL PRINT_STRL, @"「%CNAME("二人称")%、%TEXTR("お尻/アナル")%なら%TEXTR("どれだけ出しても妊娠しないから/妊娠しないから好きなだけ射精してね")%_HH_」"	CALL PRINT_STRL, @"「%CNAME("二人称")%、%TEXTR("屁股/尻穴")%なら%TEXTR("无论中出多少次都不会怀孕的/不会怀孕所以可以尽情的射进来哦")%_HH_」"
CALL PRINT_STRW, @"（%TEXTR(@"%CNAME("一人称")%のお腹がいっぱいになるまで注がれちゃうのかな……ドキドキしちゃう/妊娠しないけど……沢山出されちゃったらどうしよう……はぁ_HH_想像しちゃった")%_HH_」"	CALL PRINT_STRW, @"（%TEXTR(@"%CNAME("一人称")%的肚子被满满地注入了呢……有些心跳加速/虽然不会怀孕……但是被人看出来怎么办……哈啊_HH_想象一下就会很羞耻")%_HH_」"
CALL PRINT_STRL, @"「%TEXTR("女の子同士/同性")%でも……%TEXTR("アナルセックス/お尻でえっち")%%TEXTR("するんだ/しちゃうんだ")%_HH_」"	CALL PRINT_STRL, @"「虽然是%TEXTR("女孩子/同性")%但是……%TEXTR("肛交/用尻穴做")%%TEXTR("也是不对的/也是错误的")%_HH_」"
CALL PRINT_STRW, @"「もちろん、%CNAME("二人称")%となら%CNAME("一人称")%は%TEXTR("安心だけど……優しくしてね/心配してないんだけど……ちょっとアブノーマルだなぁって思っちゃう")%_HH_」"	CALL PRINT_STRW, @"「当然、如果是%CNAME("二人称")%那么%CNAME("一人称")%就会%TEXTR("安下心来……因为很温柔/不太担心……虽然我也知道这有些不正常")%_HH_」"
PRINTFORMW 「これ、おちんちんをわたしのここでこすれば良いの？」	PRINTFORMW 「啊喏、这样用腿夹着摩擦就可以了吗？」
PRINTFORMW 「――あ、違う？」	PRINTFORMW 「――啊、不是吗？」
PRINTFORMW 「ふとももでおちんちんを挟んで擦るんだ」	PRINTFORMW 「这样用大腿摩擦肉棒的话」
CALL PRINT_STR, "「……どさくさに紛れて入れても……いいんだよっ_HH_」_W"	CALL PRINT_STR, "「……如果趁乱插入小穴的话……也是有可能的_HH_」_W"
PRINTFORMW 「もっと足をぎゅっとしたら気持ちいいかな……？」	PRINTFORMW 「再稍微用力一些会更舒服吗……？」
CALL PRINT_STR, "「がんばれっ_HH_がんばれっ_HH_」_W"	CALL PRINT_STR, "「加油_HH_努力_HH_」_W"
PRINTFORMW 「本番でしちゃっても良いんだよっ」	PRINTFORMW 「就算直接插入小穴也可以哟」
PRINTFORMW 「……え、恋人になってないから本番はだめ？」	PRINTFORMW 「……欸、因为没有正式成为恋人所以不行？」
PRINTFORMW みなみはかなり不満そうだ。	PRINTFORMW 南实似乎相当不满的样子。
PRINTFORMW 「%CNAME("二人称")%の……出っ張ってるところが、こすれてる……っ」	PRINTFORMW 「%CNAME("二人称")%的肉棒……正在摩擦着敏感的地方……唔嗯……っ」
PRINTFORMW 「気持ちい……っ、ぁ、んっ」	PRINTFORMW 「好舒服……嗯……唔……呜…………」
PRINTFORMW 「もっと足をぎゅっとしたら気持ちいいのかな？」	PRINTFORMW 「大腿夹的紧一些会变得更舒服吗？」
PRINTFORMW 「あぅ、%CNAME("二人称")%の熱いよぉ……」	PRINTFORMW 「啊呜、%CNAME("二人称")%的肉棒……好灼热……」
PRINTFORMW 「ぱんつで扱くの？ あんまり綺麗じゃ無いと思うけど……」	PRINTFORMW 「真的要这样做吗？ 我觉得不会很舒服的样子……」
//焊、就乱焊
PRINTFORMW 「えっとね……わたし、ピアスするの苦手なんだけど……ダメ、かな」	PRINTFORMW 「那个呢……我呢、对于这种事情不太擅长呢……不要了、好吗」
PRINTFORMW みなみは自分の身体にピアスをする、と言われ困っているようだが渋々従った。	PRINTFORMW 南实被要求打耳孔、好像很为难、但还是不情愿的遵从了你的要求。
PRINTFORMW みなみは自分の身体にピアスをする、と言われ困っているようだが、渋々従った。	PRINTFORMW 南实被要求打耳孔、好像很为难、但还是勉强遵从了你的要求。
PRINTFORMW 「……まだつけるの？」	PRINTFORMW 「……还没戴上？」
PRINTFORMW みなみはさらにピアスをすることに嫌悪感はあるようだが、渋々従った。	PRINTFORMW 南实虽然十分讨厌戴耳环、但还是不情愿的听从了你的要求。
PRINTFORMW 「ねーぇ、ちゃんと%CNAME("一人称")%達がいちゃついてるとこちゃんととってよ？」	PRINTFORMW 「呐、只有%CNAME("一人称")%自己可以观看录下来的东西吧？」
//存疑、乱焊
PRINTFORMW 「下準備は大事だもんね！」	PRINTFORMW 「事前准备是很重要的！」
PRINTFORMW 「……ねーぇ、%CNAME("二人称")%何してるの？」	PRINTFORMW 「……啊咧、%CNAME("二人称")%在干什么呢？」
PRINTFORMW 「%CNAME("一人称")%、そういうの使ったことないし……」	PRINTFORMW 「%CNAME("一人称")%、没有使用过那种东西……」

CALL PRINT_STR, @"%CALLNAME:MASTER%がバイブの用意をしていると、横から顔を出した%CALLNAME:TARGET%が",\@ TEQUIP:口枷 == 1 ? ボール # リング \@,"ギャグを外すように合図を送ってきた_W_"	CALL PRINT_STR, @"%CALLNAME:MASTER%一准备好了振動棒、从旁边探出头的%CALLNAME:TARGET%就暗示要取下",\@ TEQUIP:口枷 == 1 ? 球型 # 环形 \@,"口枷_W_"
//我裂开来
PRINTFORMW 「……ねーぇ、%CNAME("二人称")%何してるの？」	PRINTFORMW 「……呐……、%CNAME("二人称")%这是想要做什么啊？」
PRINTFORMW 「そもそも肉体関係持ったのって%CNAME("二人称")%が初めてだよ？」	PRINTFORMW 「这还是第一次和%CNAME("二人称")%保持这样的肉体关系呢？」
PRINTFORMW 「……えっと、言わないとわかんないかな……」	PRINTFORMW 「……哪个、好像有些说不太明白呢……」
PRINTFORMW 「%CNAME("一人称", "かな")%、その……処女だから……」	PRINTFORMW 「%CNAME("一人称", "かな")%、因为……还是处女的说……」
PRINTFORMW 「初めてがそういうおもちゃになってしまうのはイヤなの」	PRINTFORMW 「不希望一开始就接触这样奇怪的玩法呢」
PRINTFORMW 「それに、その……そんなおっきいのは入りそうにないし」	PRINTFORMW 「还有呐、哪个……那么大的东西真的能够塞进来吗」
PRINTFORMW 「……考え直してくれない？」	PRINTFORMW 「……能重新再考虑一下吗？」
CALL PRINT_SELECT, "やだ/考え直す"	CALL PRINT_SELECT, "不要/重新考虑"
PRINTFORMW 「う、うぅぅ、%CNAME("二人称")%のばか、ばかぁっ」	PRINTFORMW 「唔、呜呜呜、%CNAME("二人称")%喏baka、大笨蛋！」
PRINTFORMW 「好きな人にあげたいって、気づいてよ……もうっ」	PRINTFORMW 「想要留给喜欢的人呢、稍微注意一下啊……真是的」
PRINTFORMW 「……ありがと」	PRINTFORMW 「……十分感谢」
PRINTFORMW 「叶うかどうかはわかんないけど……」	PRINTFORMW 「虽然不知道能不能实现……」
PRINTFORMW 「初めては……その、大好きな人にあげたいって思ってたから……」	PRINTFORMW 「但是……第一次的话、想要送给最喜欢的人呢……」
PRINTFORMW 「%CNAME("二人称")%のおちんちん、びくびくしてておいしそー……♪」	PRINTFORMW 「%CNAME("二人称")%的肉棒、一颤一颤地看起来很美味呢……♪」
PRINTFORMW %CALLNAME:MASTER%は%CALLNAME:TARGET%を――	PRINTFORMW %CALLNAME:MASTER%……唔……%CALLNAME:TARGET%呜――
CALL PRINT_SELECT, "止める/止めない"	CALL PRINT_SELECT, "停下/继续"
PRINTFORMW ちょっと待て、と――%CALLNAME:MASTER%は%CALLNAME:TARGET%に我慢するように命じた	PRINTFORMW 稍微等一下、欸――%CALLNAME:MASTER%要求%CALLNAME:TARGET%稍微忍耐一下
PRINTFORMW 「――だったら、キスしてよ。%CNAME("二人称")%がファーストキスして欲しいなっ」	PRINTFORMW 「――那样的话、来接吻吧。我想要%CNAME("二人称")%先亲我一下呢」
PRINTFORMW 「約束して、%CNAME("二人称")%っ」	PRINTFORMW 「约好了哦、%CNAME("二人称")%」
CALL SET_CEVENT, "先にキスする約束"	CALL SET_CEVENT, "接吻的约定"
PRINTFORMW %CALLNAME:MASTER%がフェラチオをさせようとペニスを突きつけると、%CALLNAME:TARGET%が口枷を外すように合図を送ってきた	PRINTFORMW %CALLNAME:MASTER%想要进行口穴的插入、%CALLNAME:TARGET%示意口球还没有摘下来
PRINTFORMW 「……えっとね、%CNAME("二人称")%。少しいい？」	PRINTFORMW 「……那个、%CNAME("二人称")%。可以吗？」
PRINTFORMW 「%CNAME("二人称")%はその、%CNAME("一人称")%に……おちんちんを舐めさせたいのはわかるよ」	PRINTFORMW 「%CNAME("二人称")%的话、……就算要%CNAME("一人称")%舔你的肉棒……也是可以的哦」
PRINTFORMW 「%CNAME("一人称", "かな")%ね、えっと……キス……したこと、なくって」	PRINTFORMW 「%CNAME("一人称", "かな")%的话、怎么说呢……那个……要舔了哦……」
PRINTFORMW 「初めてのキスは%CNAME("二人称")%と、口同士でしたいなぁ」	PRINTFORMW 「这里的第一次、也是%CNAME("二人称")%的呢、我的嘴巴已经完全属于%CNAME("二人称")%了呢」
//乱焊
PRINTFORMW 「%CNAME("二人称")%のおちんちんよりも先に、%CNAME("一人称", "かな")%とキスしてくれない……？」	PRINTFORMW 「在和%CNAME("二人称")%的肉棒接吻前、能不能先给%CNAME("一人称", "かな")%一个吻呢……？」
//乱焊
CALL PRINT_SELECT, "してあげる/あげない"	CALL PRINT_SELECT, "做/不做"
PRINTFORMW 「……ありがとう」	PRINTFORMW 「……十分感谢呢」
PRINTFORMW 「約束だよっ、%CNAME("二人称")%……」	PRINTFORMW 「越好了哦、%CNAME("二人称")%……」
//迷惑
CALL SET_CEVENT, "先にキスする約束"	CALL SET_CEVENT, "之前接吻的约定"
PRINTFORMW 「……%CNAME("二人称", "かな")%の、いじわる」	PRINTFORMW 「……欸……%CNAME("二人称", "かな")%、真狡猾」
PRINTFORMW 「もーっ、あとから欲しくなったってしらないっ」	PRINTFORMW 「真是的、之后会把我的初吻交给白的啦」
PRINTFORMW %CALLNAME:MASTER%は%CALLNAME:TARGET%に口枷を付けなおすと、その鼻先にあらためてペニスを突きつけた……	PRINTFORMW %CALLNAME:MASTER%给%CALLNAME:TARGET%再次戴上口球后、肉棒顶在了%CALLNAME:TARGET%的鼻尖上……
CALL PRINT_STR, @" 「%CNAME("二人称")%にはじめて、あげられて……よかったぁ……_HH_」_W"	CALL PRINT_STR, @" 「我的第一次能够交给%CNAME("二人称")%…真是……太好了…………_HH_」_W"
PRINT 「初めては……	PRINT 「想要献给
PRINTFORMW に捧げたかったなぁ……」	PRINTFORMW 呢……我的第一次」

PRINTFORMW 「また……%CNAME("二人称")%との子供、デキちゃった♪」	PRINTFORMW 「又生下了……%CNAME("二人称")%的孩子呢、好幸福♪」
PRINTFORMW 「あのね、びっくりしないで聞いて欲しいんだけど」	PRINTFORMW 「那个呢、稍微有些事要对%CNAME("二人称")%说、不要被吓到哦」
PRINTFORMW 「その……」	PRINTFORMW 「那个……」
PRINTFORMW 「%CNAME("二人称")%との子供が……ね、できちゃったの」	PRINTFORMW 「怀上了%CNAME("二人称")%的孩子呢……唔……」
PRINTFORMW 「%CNAME("一人称")%だって正直びっくりしてるんだけど……」	PRINTFORMW 「说实话……%CNAME("一人称")%也被吓到了呢……」
PRINTFORMW 「出来たからにはちゃんと子育てしたいし」	PRINTFORMW 「既然怀上了、就想要好好养育它」
PRINTFORMW 「何より、%CNAME("二人称")%との子供だから」	PRINTFORMW 「要说为什么的话、因为是和%CNAME("二人称")%生下的孩子呢」
PRINTFORMW 「%CNAME("二人称")%と二人でいっぱい子供に愛情注ぎたくて……」	PRINTFORMW 「%CNAME("二人称")%……我们两个要好好养育我们的孩子呢……」
PRINTFORMW 「もとよりイケナイ関係だなんてわかってる、けれど……」	PRINTFORMW 「虽然这段感情一开始就是不应该的、但是……」
PRINTFORMW 「……大事な大事な、%CNAME("一人称")%達のこどもだから……」	PRINTFORMW 「……但这是我%CNAME("一人称")%们两个最重要的孩子呢……」


PRINTFORMW ある日、%CALLNAME:MASTER%は%CALLNAME:TARGET%\@ COND("同棲中") ? の自室 # \@に呼び出された。	PRINTFORMW 某一天、%CALLNAME:MASTER%与%CALLNAME:TARGET%\@ COND("同棲中") ? 被从自己的房间 # \@叫出来了。
PRINTFORMW そこには実の母たるメリィエーナもおり、どうしたものか、と首をかしげていると……	PRINTFORMW 在那里等待的是是稍微侧倾着头、满脸疑惑的母亲、麦丽爱娜、她想知道你们之间究竟发生了什么……
PRINTFORMW 「……さて。2人とも揃った？」	PRINTFORMW 「……那么。两人都到了呢？」
PRINTFORMW 神妙な面持ちで、母を見る二人。	PRINTFORMW 带着奇妙的表情、母上看着两人。
PRINTFORMW 何か怒られるような事をしてしまったのか、あるいは……日々の淫行推奨か……どちらにせよ親に呼ばれるというのはいつだって怖いものだ。	PRINTFORMW 做了什么让母亲生气的事、不然的话……就是每天的淫行被发现了？……无论怎样、被母亲叫出来总是一件让人心虚的事情。
PRINTFORMW 「……フェリシエルさんから%CALLNAME:MASTER%がリザレクションっていう貴重な異能持ちっていうことと、私……メリィエーナが悪魔で実母だってことは、知っているわね？」	PRINTFORMW 「……フェリシエルさんから%CALLNAME:MASTER%从菲利夏尔先生那里得知了我的儿子拥有着贵重的特殊能力、其实……妈妈我是个恶魔哦、你们知道吗？」
PRINTFORMW %CALLNAME:MASTER%とみなみが顔を合わせてうなずくと決意したようにメリィエーナが口を開く。	PRINTFORMW %CALLNAME:MASTER%和南实点了点头、麦丽爱娜像是放下了心、开口道。
PRINTFORMW 「……ダメなお母さんよね、私。……%CALLNAME:MASTER%とみなみは……本当は人間ではないの。」	PRINTFORMW 「……真是个无能的母亲呢、我。……%CALLNAME:MASTER%和南实……其实并非是纯粹的人类。」
PRINTFORMW みなみは困惑しながら何を言っているのかわからない、と母に問いかける。	PRINTFORMW 南实露出了困惑的表情、向母亲问到。
PRINTFORMW 「お母さん、それ、いつから……分かってたの？」	PRINTFORMW 「母亲大人、关于这个、您是从什么时候……就知道了呢？」
PRINTFORMW 「……%CALLNAME:TARGET%が生まれた時から、よ。」	PRINTFORMW 「……从%CALLNAME:TARGET%出生的时候、就知道了哟。」
PRINTFORMW 「%CALLNAME:MASTER%が、リザレクションを持ってしまったように……。」	PRINTFORMW 「%CALLNAME:MASTER%、拥有复活的能力这件事……。」
PRINTFORMW なんともやるせない表情で、天井を仰ぐメリィエーヌ。	PRINTFORMW 麦丽爱娜露出了无法形容的表情、抬头向上方看去。
PRINTFORMW ……母が悪魔だってことは知っていたけど、自分と妹も……。	PRINTFORMW ……虽然已经知道了母亲的真实身份是恶魔、但自己和妹妹……。
PRINTFORMW 現にフェリシエルと契約してるわけだし、人ならざるものの可能性はあった。	PRINTFORMW 现在已经和弗理希艾尔签订了契约、也有着更多不为人知的可能性。
PRINTFORMW しかしいままでずっと人間として生きてきたのだ。	PRINTFORMW 但是到现在为止、自己一直是以人类的身份自居并生活着的。
PRINTFORMW この事実は%CALLNAME:TARGET%には受け入れがたいのではないだろうか……	PRINTFORMW 这个冲击性的事实对于%CALLNAME:TARGET%来说并不是很容易接受……
PRINTFORMW 「……%CALLNAME:TARGET%の悪魔としての血が、二人の性交渉で高まってるのよ。みなみには、辛いかもしれないけど。」	PRINTFORMW 「……%CALLNAME:TARGET%的恶魔血统、正因为你们两人之间的性事逐渐被激活。对于南实来讲、可能会是件比较辛苦的事情。」
PRINTFORMW 「じゃあ、%CNAME("二人称")%とえっちしちゃいけないの？」	PRINTFORMW 「那么、以后不能和%CNAME("二人称")%做H的事情了吗？」
PRINTFORMW 恋仲にまでなった%CALLNAME:TARGET%と今さら交わる出来なくなるなんて、それはもっと悲しい。	PRINTFORMW 事到如今竟然不能和已经成为恋人的%CALLNAME:TARGET%继续交往了、内心不由得有些悲伤起来。
PRINTFORMW 禁断の交わりで悪魔になるのが進むことをわかっていても……大切な人と体を交わらせたい。	PRINTFORMW 虽然知道禁断的情事会使自己进一步向恶魔靠拢……但还是想要与重要的人亲密的在一起。
PRINTFORMW 何よりそんなことをしたら自分も普段の事にが入らなくなりそうな……そんな感じがしたから。	PRINTFORMW 最重要的是、如果和南实分开的话、自己也会从此消沉下去吧……有这样的预感。
PRINTFORMW 「フェリシエルさんと私が見る限りでは、すごく強く暴走するってこともなさそうだから、変なことをしない限りは、大丈夫よ。%CALLNAME:TARGET%。%CALLNAME:MASTER%といっぱいしたいのは、私にも痛いくらいわかるもの。」	PRINTFORMW 「只要弗里希艾尔在的话、基本上不会有什么太出格的事情、所以只要别做些特别奇怪的事情、都可以哦。想和%CALLNAME:MASTER%尽情的做爱这件事情、%CALLNAME:TARGET%也是一直在煎熬的忍耐着。」
PRINTFORMW そうして%CALLNAME:TARGET%と%CALLNAME:MASTER%をハグするメリィエーナの頬には涙が流れていた……	PRINTFORMW 在那之后，麦丽爱娜一边流着泪一边拥抱着%CALLNAME:TARGET%与%CALLNAME:MASTER%……

PRINTFORMW %CALLNAME:TARGET%の種族が悪魔に変更されました。	PRINTFORMW %CALLNAME:TARGET%的种族变成了恶魔。
PRINTFORMW %CALLNAME:TARGET%のお願いに悪魔でのみ取引可能な項目が追加されます。	PRINTFORMW %CALLNAME:TARGET%的请求中添加了恶魔才可以交易的项目。
PRINTFORMW また、%CALLNAME:TARGET%が飲酒可能になります。	PRINTFORMW 另外、%CALLNAME:TARGET%可以喝酒了。
PRINTFORMW このシナリオはキャラ崩壊・死ネタを含みます。	PRINTFORMW 这个剧本包含角色崩坏、死亡等内容。
PRINTFORMW それでも閲覧しますか？	PRINTFORMW 即使这样也要阅览吗？
CALL PRINT_SELECT, "はい/いいえ"	CALL PRINT_SELECT, "是的/算了"
PRINTFORMW ねえ、%CNAME("二人称")%……、何でそんな女といるの？	PRINTFORMW 呐、%CNAME("二人称")%……、为什么会和这样的女人在一起？
PRINTFORMW %CNAME("二人称")%の女になっていいのは%CNAME("一人称")%とお母さんとさくらお姉ちゃんだけでしょ？	PRINTFORMW 能成为%CNAME("二人称")%的爱人的，只有%CNAME("一人称")%和妈妈还有樱姐姐的吧？
PRINTFORMW 血の繋がった大切な家族だから。	PRINTFORMW 因为是血脉相连的亲人呢。
PRINTFORMW そんな女私たちにいなくてもだいじょうぶだから。	PRINTFORMW 那样的女人，就算消失了也没有关系吧。
PRINTFORMW はじめてを%CNAME("二人称")%にすら捧げられないなら。	PRINTFORMW 如果连第一次都不能献给%CNAME("二人称")%的话。
PRINTFORMW %CNAME("二人称")%から幸せを独り占めにした女は……	PRINTFORMW 独占了%CNAME("二人称")%的宠爱的这个女人……
PRINTFORMW こ ろ し て 、 い い よ ね ？	PRINTFORMW 只 能 杀 掉 呢 、不 是 吗 ？
PRINTFORMW ああ、これ？ ……さくらお姉ちゃん殺した時に付いた返り血と、お母さんから奪ってそのままお母さんを殺した包丁だよ？	PRINTFORMW 啊啊、这个？ ……是杀掉樱姐的时候沾到的血迹，妈妈看到之后过来想要夺走我手上的刀呢、但是也被我一起杀掉了哦？
PRINTFORMW なんで！？なんでよ！？あの女は%CNAME("二人称")%を誑かそうとしてるんだよ！！	PRINTFORMW 为什么！？为什么啊！？为什么那个女人想要勾引%CNAME("二人称")%啊！！
PRINTFORMW %CNAME("二人称")%どいてッ！ そいつころせない！！	PRINTFORMW %CNAME("二人称")%让开！ 那个家伙必须杀掉！！
PRINTFORMW じゃあ……%CNAME("二人称")%も……死んで？	PRINTFORMW 不然……%CNAME("二人称")%也……一起死掉吧？
PRINTFORMW %CNAME("一人称")%もすぐ後を追いかけていくから。	PRINTFORMW %CNAME("一人称")%快速的像你逼近过来、并且紧追不舍。
PRINTFORMW なにやら胸くその悪い夢を見たような気がする……	PRINTFORMW 总觉得胸口透不过气，像是做了一个噩梦……
PRINTFORMW %CALLNAME:TARGET%がこんなことをするとは思えない。	PRINTFORMW 我并不认为%CALLNAME:TARGET%会做出这样的事情。
PRINTFORMW しかし……一歩間違えたら%CALLNAME:TARGET%もこうなるのかもしれないと思うと、いっぱい可愛がってあげないと後が怖い……	PRINTFORMW 但是……一想到如果自己做错了选择、%CALLNAME:TARGET%就会变成这样、那样可爱的妹妹竟然会因为自己变得那么恐怖……
PRINTFORMW そんな一抹の危うさを感じずには居られなかった。	PRINTFORMW 那种危机感一直萦绕在心头、久久不能散去。
PRINTFORMW 帰りに%TEXTR("ロールケーキ/シュークリーム/アイスクリーム/どらやき/果物/チョコ/ガトーショコラ/イチゴのショートケーキ")%でも買って帰ろうか、などと思案するのだった……	PRINTFORMW 这样想着，回去之前还是买些%TEXTR("蛋糕卷/奶油泡芙/冰淇淋/铜锣烧/水果/巧克力/草莓蛋糕")%带回去吧……






//EVENT_K42_COMM.ERB

PRINTFORML 「ん～ぽかぽかしてきた！」	PRINTFORML 「嗯~暖洋洋的!」
PRINTFORMW 「%CNAME("一人称")%、この季節が一番好きなんだよね！」	PRINTFORMW 「%CNAME("一人称")%、最喜欢这个季节了!」
PRINTFORML 「ねーねー、放課後に%TEXTR("お買い物とかどーお？/一緒に運動しない？/美味しいスイーツのお店を見つけたから、食べに行こうよ！")%」	PRINTFORML 「呐呐、放学后%TEXTR("去买东西怎么样？/一起运动吗?/找到了好吃的甜品店、一起去吃吧!")%」
//呐呐呐呐呐呐呐呐呐呐呐呐呐呐呐呐呐呐呐呐呐呐呐呐呐
PRINTFORML 「夏が近づいて来てるね。新しい水着は買ったのかな？」	PRINTFORML 「夏天快到了呢。新的泳衣买了吗?」
PRINTFORML 「%CNAME("主人")%に任せると恥ずかしいのを選ばれちゃいそうだから……普段着るのも変えたいなあって」	PRINTFORML 「如果交给%CNAME("主人")%选的话、感觉有些不好意思……平时穿的也想换一下」
PRINTFORMW 「良かったら今度……一緒に水着を見に行ってみない？」	PRINTFORMW 「方便的话、下次……一起去看看泳装怎么样?」
PRINTFORML 「夏本番だね！ 海と山だったらどっちの方が好き？」	PRINTFORML 「夏天到了呢！海滩与山中你更喜欢哪一个？」
PRINTFORMW 「%CNAME("一人称")%はどっちかと言えば山だけど、海でのバカンスも良いよね！」	PRINTFORMW 「%CNAME("一人称")%的话、虽然更喜欢山林中的感觉、但是去海边度假也是不错的选择呢！」
PRINTFORML 「秋っていろいろあるよね。スポーツ、読書、芸術、食欲……一番１年の中で季節としての時間が長いからかも？」	PRINTFORML 「秋天也有很多种呢。运动之秋、读书之秋、艺术之秋、食欲之秋……也许是因为秋季是时间最长的季节?」
PRINTFORML 「冬は部活でクリスマスパーティーやスキー合宿、色んなイベントがあって楽しみ！」	PRINTFORML 「冬天的社团有圣诞派对和滑雪集训等各种各样的社团活动呢！很期待!」
PRINTFORML 「%CNAME("一人称")%と%TEXTR("仲良くして欲しいな！/同じ部活の仲間だし好きな事とか知りたいな")%」	PRINTFORML 「%TEXTR("希望我们能好好相处。/是同一个社团的伙伴呢、有什么想知道的事情吗？")%」
PRINTFORMW 「%CNAME("一人称")%の方がこの部活に入って長いから、何でも気軽に聞いてね！」	PRINTFORMW 「%CNAME("一人称")%加入这个社团很久了、有什么问题都可以问我哦!」
PRINTFORMW 「%CNAME("主人")%について……こっそり情報交換しちゃお♪」	PRINTFORMW 「关于%CNAME("主人")%的事……偷偷交换情报吧~♪」
PRINTFORML 「%CNAME(CALLNAME:PLAYER)%先輩、今お話しても大丈夫ですか？」	PRINTFORML 「%CNAME(CALLNAME:PLAYER)%前辈、现在方便说话吗?」
PRINTFORMW 「%CNAME("主人")%の性欲って……よくわかんないけど年相応なんでしょうか？」	PRINTFORMW 「%CNAME("主人")%的性欲……虽然我不太清楚但是总感觉年龄不太相符。」
PRINT 「血の繋がった	PRINT 「因为是血脉相连的
CALL PRINT_STRW, @"だから、そういうのわからなくて……」"	CALL PRINT_STRW, @"所以说、那种事我不明白啦……」"
PRINTFORML 「%CNAME(CALLNAME:PLAYER)%先輩、お時間大丈夫でしょうか？」	PRINTFORML 「%CNAME(CALLNAME:PLAYER)%前辈、已经这个时间了、没问题吗?」
PRINTFORMW 「%CNAME("一人称")%は恋愛とかしたことなくて……よかったら、教えて貰えると嬉しいです」	PRINTFORMW 「%CNAME("一人称")%没有恋爱的经验……如果可以的话……请教教我、我会很高兴的。」
PRINTFORML 「%CNAME(CALLNAME:PLAYER)%先生、今お話しても大丈夫ですか？」	PRINTFORML 「%CNAME(CALLNAME:PLAYER)%老师、现在可以说话吗?」
//口上存疑



//EVENT_K42_DAILY.ERB
//有很多CASE和CALL开头的不知道该不该焊

PRINTFORML 「あ、起きちゃった？」	PRINTFORML 「啊、醒了吗?」
PRINTFORMW 「え、続き？その前に朝ご飯にしない？」	PRINTFORMW 「诶？继续？在那之前先吃早饭好吗？」
PRINTFORMW 「そろそろ学校行く時間だから、続きは学校でしよ。……えっ、だめ？」	PRINTFORMW 「差不多到去学校的时间了、接下来的就在学校里做吧。……诶、不行吗?」
//口上存疑
PRINTFORML 「あ、おはよ、%CNAMET(ARG, "二人称")%。」	PRINTFORML 「啊、早上好、%CNAMET(ARG, "二人称")%。」
//口上存疑
PRINTFORMW 「%CNAMET(ARG, "二人称")%っ、起きてよ～」	PRINTFORMW 「%CNAMET(ARG, "二人称")%起床啦～」
PRINTFORMW 「む～っ、下の体はもう起きてるのにぃ」	PRINTFORMW 「唔～、明明下面的身体已经醒了呢」
//直译有些僵硬、不太好直接润、魔改了一哈
PRINTFORMW 「今日は体育だよ。%CNAMET(ARG, "二人称")%、体操服忘れてない？」	PRINTFORMW 「今天有体育课。%CNAMET(ARG, "二人称")%、没有忘带体操服吧？」
PRINTFORMW 「今日は何か予定あるの？」	PRINTFORMW 「今天有什么预定的安排吗?」
PRINTFORMW 「ちょっと待って、お茶入れてくるね。」	PRINTFORMW 「请稍等一下、我去准备茶点。」
PRINTFORMW 「おはよー、%CNAMET(ARG, "二人称")%、しっかり寝れた？」	PRINTFORMW 「早上好、%CNAMET(ARG, "二人称")%、睡得还好吗？」
PRINTFORMW %CALLNAME:ARG%はいたずらっぽく微笑んだ。	PRINTFORMW %CALLNAME:ARG%俏皮地笑了笑。
PRINTFORMW 「あ、%CNAMET(ARG, "二人称")%。えへへ、今日は%CNAMET(ARG, "一人称")%が一番だね！」	PRINTFORMW 「啊、%CNAMET(ARG, "二人称")%。欸嘿嘿、今天%CNAMET(ARG, "一人称")%是第一名呢！」
//口上存疑
PRINTFORMW 「いっちばーん！」	PRINTFORMW 「第一名ー！」
//大概？
PRINTFORMW 「他に誰も来てないみたいだね。」	PRINTFORMW 「好像没有其他人来了呢。」
PRINTFORML 「ただいま～」	PRINTFORML 「我回来了～」
PRINTFORMW 「%CNAMET(ARG, "二人称")%、おかえりなさい。」	PRINTFORMW 「%CNAMET(ARG, "二人称")%、欢迎回家。」
//这玩意挺尬的、焊过来就感觉很生分
PRINTFORMW 「あ、待ってたよ。」	PRINTFORMW 「啊、我在等着呦。」
//空耳存疑
PRINTFORMW (あれっ、邪魔になっちゃうかな？)	PRINTFORMW (啊咧、妨碍到您了吗?)
PRINTFORMW 「ちょ、ちょっと何してるの……？」	PRINTFORMW 「欸？等等、在做什么呢……？」
PRINTFORMW 「お邪魔しまーす。」	PRINTFORMW 「打扰了。」
PRINTFORMW 「お邪魔しまーす…ってもう大体みんな集まってるんだ。」	PRINTFORMW 「我来晚了、基本大家都到了呢。」
//不听语音还真就分不出来
PRINTFORMW 「今日は何するの？」	PRINTFORMW 「今天要做什么呢？」
PRINTFORMW %CALLNAME:ARG%は軽く会釈した。	PRINTFORMW %CALLNAME:ARG%轻轻点头。
PRINTFORMW 「こんにちはー。」	PRINTFORMW 「午安。」
//存疑
PRINTFORMW 『こんにちは、%CNAMET(ARG, CSVNAME_ACTOR)%。』	PRINTFORMW 『下午好、%CNAMET(ARG, CSVNAME_ACTOR)%。』
//这简直就是问候语地狱、需要联系上下文来
PRINTFORMW 『もう大体揃ってるよ。』	PRINTFORMW 『差不多人都到齐了呦。』
PRINTFORMW 『%CNAMET(ARG, CSVNAME_ACTOR)%、こんにちは。』	PRINTFORMW 『%CNAMET(ARG, CSVNAME_ACTOR)%、您好。』
//又来了
PRINTFORMW 『こんにちはー。』	PRINTFORMW 『您好。』
PRINTFORMW 「戻ったよ～」	PRINTFORMW 「回来了哟～」
PRINTFORMW 「ただいま」	PRINTFORMW 「我回来了」
PRINTFORMW 「あっ、%CNAMET(ARG, "二人称")%……」	PRINTFORMW 「啊、%CNAMET(ARG, "二人称")%……」
PRINTFORMW %CALLNAME:ARG%が気まずそうにこっちを見てきたが、すぐにそっぽを向かれてしまった。	PRINTFORMW %CALLNAME:ARG%尴尬地看了看这边、马上就转向了其他地方。
PRINTFORMW 「あれっ、%CNAMET(ARG, "二人称")%、どこ～？」	PRINTFORMW 「啊咧、%CNAMET(ARG, "二人称")%、哪里~？」
PRINTFORMW 「あれっ？ %CNAMET(ARG, "対象")%と……%CNAMET(ARG, "二人称")%？」	PRINTFORMW 「啊咧？ %CNAMET(ARG, "対象")%和……%CNAMET(ARG, "二人称")%？」
PRINTFORMW %CALLNAME:ARG%の顔が真っ赤にふくれていて拗ねているのだが、当の本人は自覚がないようだ……	PRINTFORMW %CALLNAME:ARG%的脸肉眼可见的变红了、不过本人好像不知道的样子……
PRINTFORMW 「%CNAMET(ARG, "対象")%と用事？いってらっしゃい！」	PRINTFORMW 「%CNAMET(ARG, "対象")%有事吗？路上小心！」
PRINTFORMW %CALLNAME:ARG%は名残惜しそうに%CALLNAME:MASTER%を見送った	PRINTFORMW %CALLNAME:ARG%依依不舍地目送%CALLNAME:MASTER%离开
PRINTFORMW 「あれ、%CNAMET(ARG, "二人称")%、どこ～？」	PRINTFORMW 「啊咧、%CNAMET(ARG, "二人称")%、在哪里～？」
PRINTFORMW 「あっ、%CNAMET(ARG, "二人称")%……」	PRINTFORMW 「呀、%CNAMET(ARG, "二人称")%……」
PRINTFORMW 「%CNAMET(ARG, "二人称")%、帰っちゃったのかなあ……？」	PRINTFORMW 「%CNAMET(ARG, "二人称")%、是时候该回去了呢……？」
PRINTFORML 「今日はね、%TEXTR("海苔弁当/玉子焼き弁当/生姜焼き弁当/サンドイッチ/鮭の塩焼き弁当")%を作ってきたよ。」	PRINTFORML 「今天是亲手做的%TEXTR("海苔便当/玉子烧便当/生姜烧便当/饭团/盐烤三文鱼便当")%。」
PRINTFORML 「デザートの%TEXTR("梨/キウイ/みかん/りんご/ヨーグルト")%もどうぞ。」	PRINTFORML 「给、这是你的%TEXTR("梨/橘子/草莓/苹果/桃子")%。」
PRINTFORML 「%CNAMET(ARG, "一人称")%の自信作だよ。お味はいかが？」	PRINTFORML 「%CNAMET(ARG, "一人称")%的自信之作。味道如何？」
PRINTFORML %CALLNAME:ARG%は弁当の一部を%CALLNAME:MASTER%の口の前に差し出した。	PRINTFORML %CALLNAME:ARG%夹起便当、送到%CALLNAME:MASTER%嘴前。
PRINTFORML 「%CNAMET(ARG, "二人称")%、満足してくれたかな？」	PRINTFORML 「%CNAMET(ARG, "二人称")%、满足了吗？」
//存疑、需要联系上下文
PRINTFORML 「へぇー、部活、っていう割には結構いろいろなことするのかな。」	PRINTFORML 「诶、社团活动、这么说还是有很多事情要做的吧。」
PRINTFORML 「よろしくお願いしまーす！」	PRINTFORML 「请多多关照!」
PRINTFORML 「やっぱりよく動いて汗かくのは最高だよね！」	PRINTFORML 「果然好好运动出出汗是最棒的!！」
PRINTFORML 「……%CNAME("二人称")%……匂い、嗅ぎたいの？ ……あとで嗅がせてあげるから、待ってて♪」	PRINTFORML 「……%CNAME("二人称")%……想要知道味道吗？ ……稍后给你闻哦、稍等一下~♪」
PRINTFORML 「って、%CNAME("二人称")%。匂いかがないでよ」	PRINTFORML 「唔、%CNAME("二人称")%。不要闻啊……」
//存疑
PRINTFORML 「ふぁ、あふ……おはよー、%CNAME("二人称")%」	PRINTFORML 「唔、嗯~……早上好、%CNAME("二人称")%」
PRINTFORML 「えへへー、どう？似合う？」	PRINTFORML 「欸嘿嘿、怎么样?合适吗？」
PRINTFORML 「おじゃましまーす。」	PRINTFORML 「打扰了。」
PRINTFORML 「……やっぱり、%CNAME("二人称")%の部屋は落ち着くね。」	PRINTFORML 「……果然、%CNAME("二人称")%的房间果然很安静呢。」
PRINTFORML 「%CNAME("一人称")%の部屋で何しよっか。」	PRINTFORML 「要在%CNAME("一人称")%的房间里做什么呢。」
PRINTFORML 「ただいまー」	PRINTFORML 「我回来了」
PRINTFORML 「……！？ちょっと、%CNAME("二人称")%！？ あっちいってよっ、変態、えっち、ばかぁーーーー！」	PRINTFORML 「……！？什么？%CNAME("二人称")%！？ 不要看这里啊！变态、H、笨蛋ーーーー！」
PRINTFORML %CALLNAME:TARGET%は顔を真っ赤にしてこちらを見ないようにさせてきた。	PRINTFORML %CALLNAME:TARGET%红着脸低下了头、不想让你看见。
PRINTFORML 無自覚とはいえ、目のやり場に困らせていたのはどちらだか…とは思ったが、それは言わないことにしておこう。	PRINTFORML 虽说是不自觉的、但还是让你眼前一亮…思考了一下、还是暂时不要说了。
//存疑
PRINTFORML 「きゃっ！？ んもー、あんまりじろじろ見ないでよ……」	PRINTFORML 「欸！？ 呀！请不要盯着看……」
PRINTFORML 「……%CNAME("二人称")%だけだよ？こういうことしていいよって言うの……」	PRINTFORML 「……只是%CNAME("二人称")%呦？能让我做这种事的……」
PRINTFORML 「%CNAME("二人称")%、他の人にはやっちゃダメだよ……？」	PRINTFORML 「%CNAME("二人称")%、不可以和别人做同样的事哦……？」
PRINTFORML 「%CNAME("二人称")%……こういうことは、いけないことだと思うんだけどなぁ……」	PRINTFORML 「%CNAME("二人称")%……我觉得做这种事是不对的……」
PRINTFORML 「……しょーがないなぁ」	PRINTFORML 「……真是让人没办法呢」
PRINTFORML 「片手間になっちゃうけど、それでもいい？」	PRINTFORML 「我不太擅长呢、就算这样也可以吗？」
PRINTFORML 「……ちょっと、何してるの……？」	PRINTFORML 「等等……您在做什么呢……？」
PRINTFORML 「むー……みんなじろじろ見てる……」	PRINTFORML 「呜嗯……大家都在盯着看呢……」
PRINTFORML 「うう、外で裸は……」	PRINTFORML 「呜呜、在外面赤裸着……」
PRINTFORML 「いくら室内でも……これは……」	PRINTFORML 「就算在室内……这样子……」
PRINTFORML 「呼んでくれてありがとっ」	PRINTFORML 「能叫%CNAME("一人称")%来、%CNAME("一人称")%很高兴」
PRINTFORML 「%CNAME("二人称")%は、ここでしたいんだね。」	PRINTFORML 「是%CNAME("二人称")%呢、没想到在这里呢。」
PRINTFORML 「のど乾くとやっぱり気になっちゃうよね」	PRINTFORML 「渴了的话、果然还是会在意的吧」
PRINTFORML 「スポーツドリンクとかも部室におけないかな……あ、だめ？」	PRINTFORML 「把运动饮料也放到部室里吧……啊、不行吗？」
PRINTFORML 「んー、着替えたはいいけど」	PRINTFORML 「嗯、偶尔穿过来也不错呢」
PRINTFORML 「普段と違うから落ち着かない……」	PRINTFORML 「和平时有些不一样、有一点静不下心来……」
PRINTFORML 「やっぱり体操服はスパッツだよね。動きやすくて好き！」	PRINTFORML 「果然体操服很方便呢。怎么运动都可以！」
//一组
PRINTFORML 「%CNAME("二人称")%、なーに？……%CNAME("一人称")%の好きなもの？」	PRINTFORML 「%CNAME("二人称")%嗯？什么？……是问%CNAME("一人称")%有什么喜欢的东西吗？”」
PRINTFORML 「んー、最近はやっぱり食べ物かな。」	PRINTFORML 「嗯、最近的话果然是食物之类的吧。」
PRINTFORML 「お化粧とかも気にならない、ってわけじゃないけど……」	PRINTFORML 「也不是说不喜欢化妆品之类的呢……」
//一组
PRINTFORML 「お化粧はどうしたの、って？」	PRINTFORML 「我画的妆怎么样？」
PRINTFORML 「今はいろいろ試してみてる。」	PRINTFORML 「现在正在尝试各种各样的妆容。」
PRINTFORMW 「お披露目できるようになったらそのときはね。」	PRINTFORMW 「如果能评价一下就再好不过了。」
//存疑
PRINTFORML 「……じー……」	PRINTFORML 「……盯……」
PRINTFORML %CALLNAME:TARGET%はスマホで撮影した母とのツーショットを見て頬が緩んでいるようだ。	PRINTFORML %CALLNAME:TARGET%看着手机上与母亲的合照、露出了温柔的表情。
PRINTFORML %CALLNAME:TARGET%はスマホで撮影した姉とのツーショットを見て頬が緩んでいるようだ。	PRINTFORML %CALLNAME:TARGET%看着手机上与姐姐的合照、露出了温柔的表情。
PRINTFORML %CALLNAME:TARGET%はスマホで撮影した%CALLNAME:MASTER%とのツーショットを見て頬が緩んでいるようだ。	PRINTFORML %CALLNAME:TARGET%看着手机上与%CALLNAME:MASTER%的合照、露出了温柔的表情。
PRINTFORML %CALLNAME:TARGET%はスマホで撮影した写真を見ている……	PRINTFORML %CALLNAME:TARGET%看着手机上的照片……
PRINTFORML 不意に視線を感じたので辺りを見回すと、%CALLNAME:TARGET%がこちらを見て微笑んでいた。	PRINTFORML 突然感觉到了谁的视线、环顾四周、发现%CALLNAME:TARGET%正朝这边微笑着。
PRINTFORML 「……%CNAME("二人称")%、どうしたの？」	PRINTFORML 「……%CNAME("二人称")%、怎么了吗？」
PRINTFORML %CALLNAME:TARGET%はソファに腰掛けて本を読んでいる。	PRINTFORML %CALLNAME:TARGET%坐在沙发上安静地看着书。
PRINTFORML ぱっと見た感じ、%CALLNAME:TARGET%が読んでいるのは%TEXTR("雑誌/漫画本/レシピ本")%のようだ……。	PRINTFORML 仔细看了看、%CALLNAME:TARGET%似乎在读的是%TEXTR("杂志/漫画书/食谱")%的样子……。
PRINTFORML %CALLNAME:TARGET%はソファに腰掛けて参考書を読んでいる。	PRINTFORML %CALLNAME:TARGET%坐在沙发上阅读着参考书。
PRINTFORML ぱっと見た感じ、%CALLNAME:TARGET%が読んでいるのは%TEXTR("国語/数学/英語/理科/地歴公民")%の参考書のようだ……。	PRINTFORML 仔细观察了一下、%CALLNAME:TARGET%好像正在阅读%TEXTR("国语/数学/英语/理科/地歴公民")%的参考书……。
PRINTFORML %CALLNAME:TARGET%はヘッドホンを付けて%TEXTR("○ンテンドー3DS/スマートフォン/Button")%で遊んでいるようだ。	PRINTFORML %CALLNAME:TARGET%带上了耳机、好像在玩%TEXTR("任天堂3DS/手机/Button游戏机")%的样子。
PRINTFORML 「すぅ……すぅ……」	PRINTFORML 「嘶…………嘶…………」
PRINTFORML 「ん……それは……だめだよぉ……」	PRINTFORML 「唔……那样子………不可以……」
PRINTFORML 「%CNAME("二人称", "かな")%……んぅ、むにゃ……」	PRINTFORML 「%CNAME("二人称", "かな")%……唔、呜喵……」
PRINTFORML 「もー……%CNAME("二人称", "かな")%ってば……ふふ……♪」	PRINTFORML 「真是的……都是%CNAME("二人称", "かな")%的错啦……呼呼……♪」
CALL PRINT_STRL, @"「%CNAME("二人称", "かな")%は……ほんとに……えっちなんだね……_HH_」"	CALL PRINT_STRL, @"「%CNAME("二人称", "かな")%哇……真的是……很H的呢……_HH_」"
PRINTFORML 「あと……もうちょっと……」	PRINTFORML 「欸哆……再多来一点……」
CALL PRINT_STR, @" 『はぁい、じゃあそこで……_HH_』_W"	CALL PRINT_STR, @" 『好的、那么就到那里吧……_HH_』_W"
PRINTFORMW 『んっ、じゃあこれから行くね♪』	PRINTFORMW 『那么、我就要去了哦♪』
PRINTFORMW 『待ち合わせね、はーい』	PRINTFORMW 『约好了哟、要记住哦』
PRINTFORML 「急に雨に降られちゃって……　あっ、ありがとう%CNAME("二人称")%」	PRINTFORML 「突然就下雨了呢……　啊、谢谢您了、%CNAME("二人称")%」
PRINTFORML (ホントは折りたたみ傘あるんだけど……こういうのも、アリかな)	PRINTFORML (其实是带了折叠伞来着……不过现在的话、肯定是这种情节了)
//机翻没太看懂、润的
PRINTFORML 「%CNAME("二人称")%、ごめーん！傘持ってきてなかったのに雨降ってきちゃって……」	PRINTFORML 「%CNAME("二人称")%、抱歉呢！明明下雨了却没有带伞……」
PRINTFORML 「……え？　入れてくれるの？やったーっ♪」	PRINTFORML 「……欸？　可以一起吗？太棒了♪」
//存疑
PRINTFORMW 「新しいの選ぼうと思ってるんだけど、何がいいかな？」	PRINTFORMW 「想要买一件新的呢、有什么建议吗？」
PRINTFORMW 「ねーぇ、これから……その、寄っていかない？」	PRINTFORMW 「呐、比起那些……那个、不去一下吗？」
PRINTFORML 「%CNAME("二人称")%、一緒にお風呂入らない？」	PRINTFORML 「%CNAME("二人称")%、要一起泡澡吗？」
PRINTFORMW 「やったー♪」	PRINTFORMW 「太棒了♪」
PRINTFORMW 「そっか、そういう日もあるよね。」	PRINTFORMW 「这样啊、也有那种时候呢。」
PRINTFORMW 「今夜は寝かさないよ……なーんちゃって♪」	PRINTFORMW 「今晚不会让你睡觉的哦……开玩笑的♪」
PRINTFORMW 「冬はやっぱり、のんびりこたつでみかんだねぇ……」	PRINTFORMW 「冬天啊、果然就应该悠闲地在被炉里吃橘子呢……」
PRINTFORMW 「%CNAME("二人称")%、みかん剥けたよ～」	PRINTFORMW 「%CNAME("二人称")%、橘子剥好了哟～」
PRINTFORMW 「うぅぅ、こたつから出たくない……」	PRINTFORMW 「唔……、实在不想从被炉里出来呢……」
PRINTFORMW 「……%CNAME("二人称")%に部屋まで送って欲しいなぁ……」	PRINTFORMW 「……想让%CNAME("二人称")%送我回房间呢……」
PRINTFORMW 「……あれ、%CNAME("二人称")%起きてる？」	PRINTFORMW 「……啊咧、%CNAME("二人称")%醒过来了吗？」
PRINTFORMW 「……もしかして寝ちゃった？」	PRINTFORMW 「……莫非还在睡吗？」
PRINTFORMW 「じゃあせっかくだし私も隣で寝ちゃお……♪」	PRINTFORMW 「那么、难得的机会、我也来一起睡吧……♪」
PRINTFORMW 「エアコン動いてるのにあっつぅい……」	PRINTFORMW 「幸好有空调呢、好热啊……」
//存疑
PRINTFORMW 「冷蔵庫からアイス取ってくるね。」	PRINTFORMW 「从冰箱里取出冰淇淋。」
PRINTFORMW 「……あ、%CNAME("二人称")%はどれにする？」	PRINTFORMW 「……啊、%CNAME("二人称")%要哪一种呢？」
PRINTFORMW 「毎年いっつも思うけど夏の暑さっていやになるよね……」	PRINTFORMW 「虽然每年都会想、但是果然我还是讨厌夏天啊……」
//存疑
PRINTFORMW 「夏場は動いてなくてもちゃんと水分とってね」	PRINTFORMW 「夏天即使不运动也要好好补充水分呢」
PRINTFORMW 「ほっとくと簡単に熱中症になるから。」	PRINTFORMW 「不然的话就会很容易中暑的哦。」
PRINTFORMW 「……えへへ」	PRINTFORMW 「……欸嘿嘿」
PRINTFORMW 「%CNAME("二人称")%とこうやって過ごせる時間が、ずーっと続けばいいなぁって思ってたんだ」	PRINTFORMW 「和%CNAME("二人称")%这样在一起的时间、如果能一直持续下去就好了呢」
PRINTFORMW 「この時期は過ごしやすくていいよねぇ……」	PRINTFORMW 「这样的气氛下、时间总是会很快流逝呢……」
//润的
PRINTFORMW 「ちょっと油断すると\@TEXTS("季節") == "春" ? 寝坊しちゃったり # 食べすぎちゃったり \@するのは気をつけないとだけど」	PRINTFORMW 「稍微不注意就会\@TEXTS("季節") == "春" ? 睡过头了呢 # 吃太多了呢 \@要小心注意才行」
PRINTFORMW 「もうすっかり暖かくなってきたね」	PRINTFORMW 「天气越来越暖和了呢」
PRINTFORMW 「今度のお休みにお花見行かない？きっと楽しいよ！」	PRINTFORMW 「下次要一起去赏樱吗？一定会很开心的！」
PRINTFORMW 「夏も終わってようやく涼しくなってきたね……」	PRINTFORMW 「夏天结束了、终于凉快起来了呢……」
PRINTFORMW 「ちょっと前に%TEXTR("ぶどう/りんご/みかん/梨/柿")%が安かったから買ってきたんだけど、一緒に食べない？」	PRINTFORMW 「因为之前很便宜、所以买了%TEXTR("葡萄/苹果/橘子/梨/柿子")%、一起来吃吧？」
PRINTFORMW 「え、%CNAME("二人称")%これからまた寝るの？」	PRINTFORMW 「欸、%CNAME("二人称")%在这之后还要睡觉吗？」
PRINTFORMW 「ふわぁぁ、%CNAME("一人称")%もちょっと眠くて……一緒にお昼寝しよ？」	PRINTFORMW 「呼啊……、%CNAME("一人称")%也有些困了呢……一起睡午觉吧？」
PRINTFORMW 「お疲れ……夜更かしはあんまりしすぎないほうがいいよ」	PRINTFORMW 「有些累了……最好不要熬夜太深哦」
PRINTFORMW 「ん……、%CNAME("一人称")%も一緒にお昼寝しようかなぁ……」	PRINTFORMW 「嗯……、%CNAME("一人称")%也一起睡个午觉吧……」
PRINTFORMW 「昼間からこうやってのんびりできるのは日曜ならではだよね……」	PRINTFORMW 「只有周日才能这样悠闲的度过呢……」
PRINTFORMW 「せっかくだし飲み物とお菓子持ってくる？」	PRINTFORMW 「特地准备了饮料和点心哦？」
PRINTFORMW 「%CNAME("二人称")%、お疲れだね……」	PRINTFORMW 「%CNAME("二人称")%、辛苦了呢……」
PRINTFORMW 「ってあ、……昨日の夜遅くまでしちゃってたからかな……」	PRINTFORMW 「我的意思是、……可能是昨天晚上做到很晚的缘故吧……」
PRINTFORMW 「なんか元気なさそーだよ、%CNAME("二人称")%……」	PRINTFORMW 「好像很有精神呢、%CNAME("二人称")%……」
PRINTFORMW 「%CNAME("二人称")%だし昨日夜更かししたんでしょ？」	PRINTFORMW 「%CNAME("二人称")%昨天没有熬夜吗？」
PRINTFORMW 「暑いからってあんまりクーラーの風に当たってばかりいるとよくないよ」	PRINTFORMW 「热了的话、总是吹空调可不太好呢」
PRINTFORMW 「ほら%CNAME("二人称")%、こっちにきたらうちわで扇いであげるよ」	PRINTFORMW 「这样%CNAME("二人称")%、过来我给你扇一扇扇子吧」
PRINTFORMW ぱたぱたぱた……と小気味よい音を立てながら%CALLNAME:TARGET%がうちわで扇いでいる……	PRINTFORMW 发出啪嗒啪嗒的声音……%CALLNAME:TARGET%扇着扇子……
PRINTFORMW 「今年の冬もさっむい……」	PRINTFORMW 「今年冬天也很冷呢……」
PRINTFORMW 「%CNAME("二人称")%とぴったりくっついてたら……ほら、暖かい」	PRINTFORMW 「但是如果和%CNAME("二人称")%紧紧的贴在一起的话……看吧、很暖和吧」
PRINTFORMW 「……えへへー♪」	PRINTFORMW 「……欸嘿嘿♪」
PRINTFORMW 「%CNAME("二人称", "ー")%、そんなところで寝てると風邪引くよ。」	PRINTFORMW 「%CNAME("二人称", "ー")%、在那种地方睡觉会感冒的。」
PRINTFORMW 「ねえ、%CNAME("二人称", "ー")%？」	PRINTFORMW 「呐、%CNAME("二人称", "ー")%？」
PRINTFORMW 「しょうがないなぁ、何か掛けるもの持ってこよ……」	PRINTFORMW 「真没办法呀、拿点东西盖上吧……」
PRINTFORMW 「いつもおつかれさま%CNAME("二人称")%」	PRINTFORMW 「一直以来都受到%CNAME("二人称")%照顾呢」
PRINTFORMW 「……膝枕、してあげよっか？」	PRINTFORMW 「……膝枕、要来试试吗？」
//存疑
PRINTFORMW 「……え、あの、%CNAME("二人称")%？」	PRINTFORMW 「……欸、啊喏、%CNAME("二人称")%？」
PRINTFORMW 「ここまで来てやることは寝るだけ？」	PRINTFORMW 「到这里来只是为了睡觉吗？」
PRINTFORMW 「そんなぁ……ちょっと楽しみにしてたのに……」	PRINTFORMW 「怎么这样……明明蛮期待的……」
PRINTFORMW 「うんっ、%CNAME("二人称", "かな")%、%GREETING%♪」	PRINTFORMW 「唔……、%CNAME("二人称", "かな")%、%GREETING%♪」
PRINTFORMW 「んっ、%GREETING%」	PRINTFORMW 「嗯……、%GREETING%」
PRINTFORMW 「あ、%GREETING%、%CNAME("二人称")%」	PRINTFORMW 「啊、%GREETING%、%CNAME("二人称")%」
PRINTFORMW 「んん……ん、え……朝……？」	PRINTFORMW 「唔唔……嗯、欸……已经早上了……？」
PRINTFORMW 「ふぁ……ぅん、眠くなってきたから……部屋、戻るね。」	PRINTFORMW 「哈……呜、有些困了呢……回房间了哦。」
PRINTFORMW 「ううう、暑い……」	PRINTFORMW 「唔……、好热啊……」
PRINTFORMW 「はー、やっぱり涼しくて気持ちいいよね！」	PRINTFORMW 「哈啊、果然凉爽的环境才最舒服呢！」
PRINTFORMW 「って%CNAME("二人称")%、こっちあんまりじろじろ見ないでよ？」	PRINTFORMW 「欸%CNAME("二人称")%、为什么一直盯着这边看啊？」
PRINTFORML 「褒めても、何もでないよ？」	PRINTFORML 「就算夸奖我、也什么奖励都没有哦？」
PRINTFORML ……とはいうものの、%CALLNAME:TARGET%はどことなく嬉しそうだ。	PRINTFORML ……尽管如此、%CALLNAME:TARGET%看起来还是很开心。
CALL PRINT_STR, @" 「……嬉しい。%CNAME("一人称")%も……_HH_」_W"	CALL PRINT_STR, @" 「……好开心。%CNAME("一人称")%也是……_HH_」_W"
PRINTFORMW 「%CNAME("二人称")%、そういうのは%CNAME("一人称")%に言うことじゃないと思うんだけど……」	PRINTFORMW 「%CNAME("二人称")%、虽然我觉得这种话对%CNAME("一人称")%说应该是不对的、但是……」
PRINTFORMW 「でも……嬉しいな。ありがとう、%CNAME("二人称", "かな")%」	PRINTFORMW 「但是……心理止不住的开心。谢谢你、%CNAME("二人称", "かな")%」
PRINTFORMW 「%CNAME("二人称")%、そういうのは%CNAME("一人称")%に言うことじゃないと思うんだけど……」	PRINTFORMW 「%CNAME("二人称")%、我觉得这种话不应该是对%CNAME("一人称")%我说的……」
PRINTFORMW 「部活に来て結構長いけど、部活っていろんな人がいるよね。」	PRINTFORMW 「虽然社团活动占用了很多时间、但是依旧有很多人呢。」
PRINTFORMW 「%CNAME("一人称")%も負けてられないからいっぱい調べちゃった。」	PRINTFORMW 「%CNAME("一人称")%也不能服输呢、要做到更多才行。」
PRINTFORMW 「%CALLNAME:ACTOR%さん、悪魔でメイドってステキだよね。」	PRINTFORMW 「%CALLNAME:ACTOR%小姐、作为恶魔女仆实在是太棒了。」
PRINTFORMW 「何でもそつなくこなしちゃうお姉さんって感じ。」	PRINTFORMW 「感觉是无微不至的大姐姐一样呢。」
PRINTFORMW 「%CALLNAME:ACTOR%先輩は狐耳がいいよね。」	PRINTFORMW 「%CALLNAME:ACTOR%前辈的耳朵是狐耳吗。」
PRINTFORMW 「もふもふしたくならない？あ、ならない……？」	PRINTFORMW 「毕竟毛茸茸的？啊、不是吗……？」
PRINTFORMW 「%CALLNAME:ACTOR%お姉ちゃんほんとかわいいよね……妹の%CNAME("一人称")%ですら嫉妬しちゃう。」	PRINTFORMW 「%CALLNAME:ACTOR%姐姐真的好可爱啊……就连作为妹妹的%CNAME("一人称")%也会有些嫉妒呢。」
PRINTFORMW 「【深窓の令嬢】って%CALLNAME:ACTOR%お姉ちゃんのためにあるような言葉だよね」	PRINTFORMW 「【深闺大小姐】这个词、简直就像是因为%CALLNAME:ACTOR%姐姐才出现的呢」
//存疑
PRINTFORMW 「%CALLNAME:ACTOR%先輩はどや顔可愛いよね」	PRINTFORMW 「%CALLNAME:ACTOR%前辈是真的很可爱呢」
PRINTFORMW 「悪魔祓いなのにドジっ子とかすごく可愛いと思う……」	PRINTFORMW 「虽然是恶魔、但是我觉得真的很可爱……」
PRINTFORMW 「%CALLNAME:ACTOR%先輩に%CNAME("一人称")%も一度どや顔されてみたい！！」	PRINTFORMW 「%CALLNAME:ACTOR%前辈再多让に%CNAME("一人称")%看一看嘛！！」
PRINTFORMW 「お母さん美人だよねえ……」	PRINTFORMW 「妈妈长得真漂亮啊……」
PRINTFORMW 「クラスの男子からも『先生いいよな……』って言われるよ！」	PRINTFORMW 「班上的男生也会说『老师真棒啊……』这种话哦！」
PRINTFORMW 「双葉先輩は文武両道でかっこいいよね。」	PRINTFORMW 「双叶前辈文武双全、很帅呢。。」
PRINTFORMW 「次期生徒会選挙！みたいなイベントがあったら確実に入り込んできそうなタイプ。」	PRINTFORMW 「下次学生会选举！如果您参加的话、一定会当选的呢。」
PRINTFORMW 「%CALLNAME:ACTOR%先輩は猫娘なんだよね」	PRINTFORMW 「%CALLNAME:ACTOR%前辈是猫娘呢」
PRINTFORMW 「でもなんか私がマタタビあげたら警戒されそう……」	PRINTFORMW 「但是总感觉我给她木天蓼的话会被警戒的样子……」
PRINTFORMW 「猫好きなんだけどなぁ……」	PRINTFORMW 「我很喜欢猫的说……」
PRINTFORMW 「%CALLNAME:ACTOR%先輩は男の人なのに吸血鬼にさせられちゃったの？タイヘンだよねえ……」	PRINTFORMW 「%CALLNAME:ACTOR%前辈本来是男人却因为吸血鬼的原因性转了？真是奇怪的事情呢……」
PRINTFORMW 「朝の支度とか大変そうじゃないかなあ……」	PRINTFORMW 「一开始应该很辛苦吧……」
//不用存疑、我没看懂上下文连接
PRINTFORMW 「%CALLNAME:ACTOR%ちゃんは……」	PRINTFORMW 「%CALLNAME:ACTOR%酱的话……」
PRINTFORMW 「さくらお姉ちゃんみたいな妹的存在、かな」	PRINTFORMW 「就像是樱姐变成了我的妹妹一样的存在、大概」
PRINTFORMW 「見た目とか結構似てるし。お姉ちゃんがちっちゃい頃って写真でしか見たことないし」	PRINTFORMW 「看起来很像。但是姐姐小的时候、我只从照片里见到过」
PRINTFORMW 「鈴ちゃんと一緒にいると楽しそうかな。」	PRINTFORMW 「和铃在一起会很开心吗。」
PRINTFORMW 「%CNAME("一人称")%の下に妹がいないから……って言うのもあるんだけど」	PRINTFORMW 「%CNAME("一人称")%下面没有妹妹呢……大概是这样的吧」
PRINTFORMW 「うーーーん一言で言葉にするのが難しい！」	PRINTFORMW 「唔……一时之间想要讲清楚太难了啦！」
PRINTFORMW 「でもね、%CNAME("一人称")%もこういう妹がいたらいいなあって思ったりする」	PRINTFORMW 「但是、%CNAME("一人称")%也觉得有这样的妹妹真不错呢」
PRINTFORMW 「%CALLNAME:ACTOR%さん胸おっきいよね……」	PRINTFORMW 「%CALLNAME:ACTOR%小姐的胸部好大啊……」
PRINTFORMW 「たまに、ああいう感じのお姉さんとかに甘えたくならない？」	PRINTFORMW 「偶尔会想向那种感觉的姐姐撒娇吗？」
PRINTFORMW 「え？『まだまだ子供』……？ むー……」	PRINTFORMW 「嗯？『真像个小孩子呢』……？ 唔……」
PRINTFORMW 「%CALLNAME:ACTOR%先輩かっこかわいいよね。うちの学年でも人気すごく高いよ～！」	PRINTFORMW 「%CALLNAME:ACTOR%前辈真的很可爱呢。在我们年级也是很有人气的～！」
PRINTFORMW 「まさに聖女って感じだよね。」	PRINTFORMW 「简直就是圣女的感觉。」
PRINTFORMW 「フランスのジャンヌ・ダルクとか、あんな感じのイメージ。」	PRINTFORMW 「比如法国的圣女贞德、那种感觉。」
PRINTFORMW 「%CALLNAME:ACTOR%先輩知らない人って学校でいないんじゃない？」	PRINTFORMW 「不认识%CALLNAME:ACTOR%前辈的人大概在这个学校是不存在的？」
CALL PRINT_STR, @" 「そんな人がこんな部活にいるなんて知ったら……_HH_」_W"	CALL PRINT_STR, @" 「那样的人也会在这个社团里呢……_HH_」_W"
PRINTFORMW %CALLNAME:TARGET%は、どうやら学校中のヒロインである%CALLNAME:ACTOR%をこの部活で独占できていることが嬉しいようだ。	PRINTFORMW %CALLNAME:TARGET%总之、学校里的高人气角色%CALLNAME:ACTOR%能被这个社团招纳、是件很振奋人心的事。
PRINTFORMW 「片峰先輩ってすごくこう、男気あるよね」	PRINTFORMW 「单峰前辈很有男子气概呢」
PRINTFORMW 「普段は銃が似合いそうだけど……なんかこう、日本刀持ってても似合いそうじゃない？」	PRINTFORMW 「感觉就应该配上一把手枪……总觉得、好像日本刀也不错的样子？」
PRINTFORMW 「詩澄先輩？」	PRINTFORMW 「詩澄前辈？」
PRINTFORMW 「ダウナー女子！って感じ。でもほんとはすごくベタベタしたくて仕方ない……」	PRINTFORMW 「丧女！对！那种感觉。但实际非常粘人的样子……」
PRINTFORMW 「なんだっけ、えーと、【私は友達が多すぎる】に出てきそうな……あれそうじゃない？」	 PRINTFORMW 「什么来着、嗯、好像会在【我的朋友太多了】里出现一样……欸、不是那样吗？」
PRINTFORMW そのたとえは違う気がする……とは思ったが、意味は伝わったのでよしとしよう。	PRINTFORMW 我觉得那个比喻有些不太恰当……虽然这么想、但是意思传达了就好了。
PRINTFORMW 「千堂先輩？」	PRINTFORMW 「千堂前辈？」
PRINTFORMW 「なんていうのかなあ……独特の色気がある人だよね」	PRINTFORMW 「该怎么说呢……是个有着独特魅力的人吧」
PRINTFORMW 「%CALLNAME:ACTOR%ちゃんかわいいよね……」	PRINTFORMW 「%CALLNAME:ACTOR%好可爱啊……」
PRINTFORMW 「でも、私もちょっと負けてられない……って気持ちもあるんだ。」	PRINTFORMW 「但是、我也有不想认输的……这种心情。」
PRINTFORMW %CALLNAME:TARGET%は%CALLNAME:ACTOR%相手に闘志を燃やしているようだ……	PRINTFORMW %CALLNAME:TARGET%对%CALLNAME:ACTOR%好像燃起了不得了的奇怪斗志……
PRINTFORMW 「望木先輩は……なんて言ったら良いのかな、お姉ちゃんの好きそうな本に出てくる感じ」	PRINTFORMW 「望木前辈的话……怎么说呢、好像会在姐姐喜欢的书里出现的感觉」
CALL PRINT_STR, @" 「好きな人に素直になれなくて……みたいな。きゃー_HH__HH_」_W"	CALL PRINT_STR, @" 「应该不能对喜欢的人坦白吧……大概。_HH__HH_」_W"
PRINTFORMW 「望木先輩……ってお兄さんの方も来たんだっけ。」	PRINTFORMW 「望木前辈……的哥哥也来这里的啊。」
PRINTFORMW 「兄と妹、２人とも素直になれなくて、でもすれ違う……みたいな。」	PRINTFORMW 「这对兄妹、好像互相之间不太坦诚、却又相依为命……的那种感觉。」
PRINTFORMW 「えっ？それを言うなら%CNAME("一人称")%達も？……そうかも♪」	PRINTFORMW 「欸？这样说的话、%CNAME("一人称")%也是？……可能吧♪」
PRINTFORMW 「なんていうか……すごい意地悪な人。」	PRINTFORMW 「怎么说呢……有些坏心眼的样子。」
PRINTFORMW 「でもああいうの好きそうな人いるよね……」	PRINTFORMW 「但是也有喜欢这样的人……」
PRINTFORMW 「織笠先輩？んー……魔性の女！って感じ！」	PRINTFORMW 「織笠前辈？嗯……魔性の女！的感觉！」
PRINTFORMW 「男専門っぽいけどあれ絶対女の子も手に掛けてるって！！」	PRINTFORMW 「虽然看起来只对男性感兴趣、但是肯定也对女孩子下手过！！」
PRINTFORMW そう考えると、確かに%CALLNAME:ACTOR%相手は女の子も責めていそうだ……	PRINTFORMW 这么说来、的确%CALLNAME:ACTOR%有对女孩子下手的履历……
PRINTFORMW 「%CALLNAME:ACTOR%先輩？んー……不思議なヒトだよねえ。」	PRINTFORMW 「%CALLNAME:ACTOR%前辈？嗯……是个不可思议的人呢。」
PRINTFORMW 「カタコトだから言葉通じにくいのかと思いきや槞彁さんみたいに完全に通訳しないといけないわけでもないし」	PRINTFORMW 「因为是只言片语硬凑出来的、所以我觉得很难理解。像是槞彁那样完全翻译倒也不是不可以」
//完全败北
PRINTFORMW 「%CALLNAME:ACTOR%先輩ってナニモノ……？」	PRINTFORMW 「%CALLNAME:ACTOR%前辈是何许人也……？」
//再议
PRINTFORMW 「小早川先輩美人だよね……」	PRINTFORMW 「小早川前辈很漂亮啊……」
PRINTFORMW 「芯がしっかりしてるのにどことなくおっとりしてるっていう感じ」	PRINTFORMW 「内心坚强又落落大方的感觉」
PRINTFORMW 「【大和撫子】って小早川先輩のためにあるような言葉だよね」	PRINTFORMW 「【大和抚子】简直就是为小早川前辈量身定做的称号一样」
PRINTFORMW 「ふぅーっ、つかれたぁ……」	PRINTFORMW 「呼……、累死了……」
PRINTFORMW 「ちょうど%TEXTR("国語/数学/英語/理科/社会")%の%TEXTR("予習/復習")%が終わったんだ。」	PRINTFORMW 「正好%TEXTR("国语/数学/英语/理科/社会")%的%TEXTR("预习/复习")%结束了。」
PRINTFORMW 「やっぱり高校別々になるかもしれないから、予習復習は大事にしないとね」	PRINTFORMW 「果然为了不去不同的高中、预习复习是很重要的大事呢」
PRINTFORMW 「%CNAME("二人称")%は、食べることって好き？」	PRINTFORMW 「%CNAME("二人称")%、今天的食物喜欢吃吗？」
PRINTFORMW 「%CNAME("一人称")%は――大好きだよ！」	PRINTFORMW 「%CNAME("一人称")%哇――最喜欢了哦！」
PRINTFORMW 「うん？　どうしたの、%CNAME("二人称")%？　――え、呼んでみただけ？」	PRINTFORMW 「唔嗯？　怎么了嘛、%CNAME("二人称")%？　――欸、只是想叫一下？」
PRINTFORMW 「そうなんだ……えへへ、%CNAME("一人称")%は元気だよ！」	PRINTFORMW 「那样啊……欸嘿嘿、%CNAME("一人称")%很精神哦！」
PRINTFORMW 「ん、しょ。もう大丈夫だよ。」	PRINTFORMW 「ん、しょ。已经可以了哦。」
PRINTFORMW ……汗を拭き取られている最中の%CALLNAME:TARGET%がどことなく色っぽくて、つい視線を向けてしまった。	PRINTFORMW ……擦汗的过程中、总觉得%CALLNAME:TARGET%很性感、不由得移开了视线。
PRINTFORMW 「ふんふんふふーん♪」	PRINTFORMW 「哼哼哼哼哼~♪」
PRINTFORMW 「あっ、お酒？ありがと～！！」	PRINTFORMW 「啊、是酒呢？十分感谢～！！」
PRINTFORMW 「%CNAME("二人称")%、まだ私未成年だから……オトナになってから、ね？」	PRINTFORMW 「%CNAME("二人称")%、因为我还没有成年……等到成年后再、呐？」
PRINTFORMW %CALLNAME:TARGET%にやんわり断られてしまった……。	PRINTFORMW %CALLNAME:TARGET%委婉的拒绝了……。
PRINTFORMW 今はまだ%CALLNAME:TARGET%に酒を勧めるのは早いだろう。	PRINTFORMW 现在向%CALLNAME:TARGET%劝酒还太早了。
PRINTFORMW %CALLNAME:TARGET%が構って欲しそうに声を掛けてきた。	PRINTFORMW %CALLNAME:TARGET%期盼地叫了一声。
PRINTFORMW 「ねーぇ、%CNAME("二人称")%……構ってよ～」	PRINTFORMW 「呐……、%CNAME("二人称")%……多一点～」
//存疑
PRINTFORMW 「……すっきりした？」	PRINTFORMW 「……满足了吗？」
PRINTFORMW 「……ふー……え、なんにもしてないよ？」	PRINTFORMW 「……呼……欸、什么都没有做呀？」
PRINTFORMW 「ちょ、ちょっとお花摘みにいってくるね…！」	PRINTFORMW 「稍、稍微去摘了一下花…！」
PRINTFORMW 「え？何してたの…って？」	PRINTFORMW 「欸？在做什么呢…在这里？」
PRINTFORMW みなみはどうも気まずそうだ。	PRINTFORMW 总觉得气氛很尴尬。
PRINTFORMW 「やだっ、%CNAME("二人称")%！？」	PRINTFORMW 「讨厌、%CNAME("二人称")%！？」
PRINTFORMW 「……ねぇ……うずうず、しちゃったんだけど……」	PRINTFORMW 「……呐……、虽然我不知道……但我会试着做的……」
PRINTFORMW 「ここでスるから、見てて……♪」	PRINTFORMW 「是这里吧、请看……♪」
CALL PRINT_STR, @"「おっきくなってる……_HH_」_W"	CALL PRINT_STR, @"「变大了呢……_HH_」_W"
CALL PRINT_STR, @"「ここでしてこ……_HH_」_W"	CALL PRINT_STR, @"「这样会比较舒服吗……_HH_」_W"
CALL PRINT_STR, @"「むらむらがとまんなくなっちゃって……_HH_」_W"	CALL PRINT_STR, @"「在里面颤个不停呢……_HH_」_W"
CALL PRINT_STR, @"「ここでえっち、してこ……_HH_」_W"	CALL PRINT_STR, @"「就是那里、再多来一点……_HH_」_W"
CALL PRINT_STR, @"「ここでおしりえっち、してこ……_HH_」_W"	CALL PRINT_STR, @"「竟然要用那里做呢、想好了吗……_HH_」_W"
//我裂开来、焊这玩意、好难、乱焊的乱焊的、不要打我
PRINTFORMW 「んっ、そこはダメだってば……」	PRINTFORMW 「嗯姆、哪里是不行的……」
PRINTFORMW %CALLNAME:TARGET%はやや声を荒げて止めてきた…	PRINTFORMW %CALLNAME:TARGET%发出细微的声音想要制止…
PRINTFORMW 「……ちょっとだけだからね？」	PRINTFORMW 「……只可以看一点点哦？」
PRINTFORMW そういうと死角を見つけて、そこに連れ込んでじっくり見せてくれた……	PRINTFORMW 这样说着、把你带到到了视线的死角、仔细的给你看了一会……
PRINTFORMW 「えっ、何言ってるの……？」	PRINTFORMW 「欸、在说什么呢……？」
PRINTFORMW %CALLNAME:TARGET%はとぼけたような表情ですかしてきた。	PRINTFORMW %CALLNAME:TARGET%好像因为受到冲击呆住了。
PRINTFORMW 「……あんまりじろじろ見ないでね？」	PRINTFORMW 「……不要那样一直盯着看啊？」
PRINTFORMW (うぅぅ、%CNAME("二人称")%にがっつり見られてる……)	PRINTFORMW (唔啊啊、%CNAME("一人称")%正在被%CNAME("二人称")%盯着看……)
PRINTFORMW (ヘンな気分に、なっちゃう……)	PRINTFORMW (为什么会变成这样奇怪的气氛啊……)
PRINTFORMW 「……あんまりじろじろ見ないでね？」	PRINTFORMW 「……可以不要这样看着我吗？」
PRINTFORMW そういう%CALLNAME:TARGET%の頬はやや紅潮している……	PRINTFORMW %CALLNAME:TARGET%的脸上泛起了点点红潮……
PRINTFORMW 「ねーぇ、%CNAME("二人称")%……そんなにスカートの中が見たいの？」	PRINTFORMW 「呐……、%CNAME("二人称")%……就那么想要看我的裙子下面吗？」
PRINTFORMW (うう、%CNAME("二人称")%に見られちゃった……)	PRINTFORMW (唔、被%CNAME("二人称")%看见了……)
PRINTFORMW 「ふぁ……ん……%CNAME("二人称")%…… ……！？」	PRINTFORMW 「哈啊……嗯……%CNAME("二人称")%…… ……！？」
PRINTFORMW 「えっ、スカートの中が見たいの……？」	PRINTFORMW 「欸、想要看裙子下面……？」
PRINTFORMW 「ちょ、ちょっとだけだからね？」	PRINTFORMW 「只、只是一点点哦？」
PRINTFORMW 「……！？%CNAME("二人称")%、みないでーっ！！」	PRINTFORMW 「……！？%CNAME("二人称")%、别看过来啊！！」
//？不懂这里是怎么连接的
PRINTFORMW 「……！？ えっ！？ やだっ、%CNAME("二人称")%！ こっちこないで！！」	PRINTFORMW 「……！？ 欸！？ 讨厌、%CNAME("二人称")%！ 不要过来这边啊！！」
PRINTFORMW 「何が何でもだめーーー！」	PRINTFORMW 「无论如何都不行ーーー！」
PRINTFORMW ……ものすごい剣幕で%CALLNAME:TARGET%に怒られてしまった。	PRINTFORMW ……在那之后被%CALLNAME:TARGET%狠狠的斥责了一顿。
PRINTFORMW 「……！？ えっ！？ やだっ、こっちこないで！！」	PRINTFORMW 「……！？ 欸！？ 讨厌、不要过来啊！！」
PRINTFORMW 「ねーぇ、今週末……空いてない？」	PRINTFORMW 「呐……、这个周末……有时间吗？」
PRINTFORMW 「わぁ、いいの！？ いこういこう！」	PRINTFORMW 「哇、可以吗！？ 那么快出发吧快出发吧！」
PRINTFORMW 「んー、そっか。%CNAME("二人称")%にも予定があるもんね。」	PRINTFORMW 「嗯、这样啊。%CNAME("二人称")%也有自己的安排呢。」
PRINTFORMW 「今日は、楽しかったね。」	PRINTFORMW 「今天、很开心呢。」
PRINTFORMW 「……%CNAME("二人称", "かな")%。どっかで、シてく？」	PRINTFORMW 「……%CNAME("二人称", "かな")%。觉得今天、怎么样呢？」
PRINTFORMW 「……%CNAME("二人称", "かな")%、また誘って欲しいな。」	PRINTFORMW 「……%CNAME("二人称", "かな")%、希望能再邀请我呢。」
MAIL_BODY =  こんなえっちなのは%CALLNAME:MASTER%だけだからね	MAIL_BODY =  %CALLNAME:MASTER%是唯一可以这样做的人哦
MAIL_BODY =  恥ずかしいけど、見てね♪	MAIL_BODY =  虽然很害羞、但是请看♪
MAIL_BODY =  よかったら、その……夜のおかずに使ってね	MAIL_BODY =  如果可以的话、那个……可以用作夜里的配菜哦
MAIL_BODY =  他の人でヌいたら怒っちゃうかも♪	MAIL_BODY =  如果是其他人的话、会生气的哦♪
MAIL_BODY = こんなえっちなのは%CNAME("二人称", "かな")%だけだからね	MAIL_BODY = 能这样做的、只有%CNAME("二人称", "かな")%一个人哦
MAIL_BODY = 恥ずかしいけど、その、よく……とれた、から……♪	MAIL_BODY = 虽然很害羞、那个、也是……可以的、的说……♪
MAIL_BODY = こういうの、好きかな……って	MAIL_BODY = 这样的、喜欢吗……呐
MAIL_BODY = 水着、かわいく撮れてるといいな♪	MAIL_BODY = 泳装、如果能拍的很可爱就好了♪
MAIL_BODY = 今年の水着撮ってみたんだ～	MAIL_BODY = 是今年的新泳装哦～
MAIL_BODY = 今年はこれ着て楽しむよっ	MAIL_BODY = 今年穿着这个很开心
MAIL_BODY =  学校の水着も、たまには良いよね♪	MAIL_BODY =  是死库水哦、偶尔看看学校的泳衣也不错吧♪
MAIL_BODY = 学校の水着撮ってみたんだ～	MAIL_BODY = 拍了校园泳衣哦～
MAIL_BODY = こうやって撮ると、また違うね！	MAIL_BODY = 这样拍的话、又不一样了呢！
MAIL_BODY = 体操服、似合ってるかな？	MAIL_BODY = 体操服、合身吗？
MAIL_BODY = 学校の体操服撮ってみたんだ～	MAIL_BODY = 试着拍了一下学校的体操服～
MAIL_BODY =  下着、似合ってると良いな♪	MAIL_BODY =  内衣、穿着合适吗♪
MAIL_BODY = 恥ずかしいけど、下着姿…その、みてね♪	MAIL_BODY = 虽然很羞耻、穿着内衣的样子…那个、给你看♪
MAIL_BODY = かわいく撮れてるといいな♪	MAIL_BODY = 如果你喜欢的话就好了♪
MAIL_BODY = 自撮りしてみたんだ、あとで感想教えてね！	MAIL_BODY = 试着自拍了一下、之后要告诉我感想哦！
MAIL_BODY = どーお？これ、似合うかな！	MAIL_BODY = 怎么样？这个、看起来合适吗！


//EVENT_K42_SHOP.ERB


PRINTFORMW 「だめなコトは言うけど、%CNAME("一人称")%に出来ることなら何でも！」	PRINTFORMW 「虽然不是什么都能做、但只要是%CNAME("一人称")%能做到的事都可以哦！」
PRINTFORMW %CALLNAME:MASTER%が意を決して思いを伝えると、%CALLNAME:TARGET%は照れくさそうな笑みを浮かべつつどこか上の空でそっぽを向いた。	PRINTFORMW %CALLNAME:MASTER%表达自己的心意之时、%CALLNAME:TARGET%露出了羞涩的笑容、有些不好意思的拒绝了。
PRINTFORMW 「%CNAME("一人称")%も……ホントはね、%CNAME("二人称")%のコト、好きだったんだ。」	PRINTFORMW 「%CNAME("一人称")%也……真的吗、%CNAME("二人称")%的话、也喜欢着你哦。」
PRINTFORMW 「でも%CNAME("一人称")%たち%NAMES("兄弟")%だから、本当はいけないこと……ってわかってるんだけど……」	PRINTFORMW 「但是%CNAME("一人称")%们是%NAMES("兄弟")%所以、本来应该是不可以的……明明我知道的……」
PRINTFORMW 「ごめんね……%CNAME("一人称")%も、すごく嬉しい、でも…… 気持ちの整理が……簡単には、付かないよ」	PRINTFORMW 「对不起呢……%CNAME("一人称")%呢、真的很高兴、但是…… 我不知道如何对待自己的这份感情……」
PRINTFORMW 本当に好意を寄せられて、どうしたらいいか戸惑う%CALLNAME:TARGET%の頬に涙がこぼれている、と言うと……	PRINTFORMW 真的受到告白时、不知道该怎么办的%CALLNAME:TARGET%脸颊上撒满了泪水……
PRINTFORMW 「……%CNAME("二人称", "かな")%、愛してる……」	PRINTFORMW 「……%CNAME("二人称", "かな")%、我爱你……」
PRINTFORMW そういって、%CALLNAME:TARGET%自ら唇を塞いできたのでしばらく離してもらえなかった。	PRINTFORMW 这样说着、%CALLNAME:TARGET%用嘴堵住了你的双唇、久久没有分开。
PRINTFORMW 「えっ？ %CNAME("一人称")%たち、%NAMES("兄弟")%だよ？」	PRINTFORMW 「欸？ %CNAME("一人称")%们、是%NAMES("兄弟")%的呦？」
PRINTFORMW 「%CNAME("二人称")%のことは……嫌いじゃないし側にいて欲しいなって思ってるけど」	PRINTFORMW 「%CNAME("二人称")%的事……我不讨厌、我希望你能留在我身边」
PRINTFORML 「まだ今は早いんじゃないかな……」	PRINTFORML 「我们还有很长的时间不是吗……」
PRINTFORMW 「んっ、いいよ～」	PRINTFORMW 「嗯、可以哦～」
PRINTFORMW 「えー……」	PRINTFORMW 「欸……」
PRINTFORMW 「ね、もーちょっとちょーだい？」	PRINTFORMW 「欸、也稍微等一下吧？」
PRINTFORMW 「やったー♪」	PRINTFORMW 「太好了呢♪」
PRINTFORMW 「しょーがないなあ……」	PRINTFORMW 「真没办法呢……」
PRINTFORMW 「……服、脱ぐの……？」	PRINTFORMW 「……衣服、要脱掉吗……？」
PRINTFORMW 「……%CNAME("二人称")%はそういうのホント好きだよね」	PRINTFORMW 「……%CNAME("二人称")%真的很喜欢这种东西呢」
PRINTFORMW 「……やだ」	PRINTFORMW 「……不要」
PRINTFORMW 「もし脱いで欲しかったらお金欲しいな」	PRINTFORMW 「如果你想要的话、给我买一条新的」
PRINTFORMW 「%CNAME("二人称")%がそうしたいならするけど……」	PRINTFORMW 「如果%CNAME("二人称")%想要那样做的话……」
PRINTFORMW 躊躇いがちに%CALLNAME:TARGET%は服を脱いだ。	PRINTFORMW %CALLNAME:TARGET%踌躇不定的脱掉了衣服。
PRINTFORMW 「せめて人が居ないところで、ね？」	PRINTFORMW 「至少要在没有人的地方、呐？」
PRINTFORMW 「……ねえ、ひどいよ……」	PRINTFORMW 「……欸、太过分了……」
PRINTFORMW 「%CNAME("一人称")%達、実の%NAMES("兄弟")%なのに、なんで……？」	PRINTFORMW 「%CNAME("一人称")%们明明是%NAMES("兄弟")%的、为什么……？」
PRINTFORMW 「……ばか」	PRINTFORMW 「……BAKA」
PRINTFORMW 「……ばかぁ」	PRINTFORMW 「……笨蛋」
PRINTFORMW %CALLNAME:TARGET%はどれだけ寂しい思いをさせたの、と言わんばかりの瞳で訴えてきた。	PRINTFORMW %CALLNAME:TARGET%用十分寂寞的眼神诉说着内心的情感。
PRINTFORMW 「あのね」	PRINTFORMW 「啊喏浽」
PRINTFORMW 「%CNAME("二人称")%がよくても、%CNAME("一人称")%の家はあそこだけなんだけど……」	PRINTFORMW 「%CNAME("二人称")%也好、%CNAME("一人称")%的家只有那里……」
PRINTFORMW 「%CNAME("一人称")%より、フェリシエルさんのお弁当のが美味しいと思うけど……」	PRINTFORMW 「比起%CNAME("一人称")%、弗理希艾尔小姐做的便当应该更好吃吧……」
PRINTFORMW 「%CNAME("一人称")%ね、お弁当作りのためにいろいろ頑張ってるんだよ」	PRINTFORMW 「%CNAME("一人称")%呢、为了做好便当付出了很多努力呢」
PRINTFORMW 「だからまた作ってあげたいなって思ってたの」	PRINTFORMW 「所以说我还想要再努力一点」
//存疑
PRINTFORMW 「それでもよかったら、食べて欲しいな」	PRINTFORMW 「即使这样也想要吃的话、没办法呢」


//汎用口上K42(K5改変)

LOCALS:3 = %TEXTR(@"%CNAME("主人", "甘え")%…/%CNAME("主人")%、")%%TEXTR("好きです/大好きです/ずっと……")%%TEXTR(@"%CNAME("一人称")%とキスしてください……/%CALLNAME%を愛してください……/いつまでもお側においてください……")%%UNICODE(0x2665)%	LOCALS:3 = %TEXTR(@"%CNAME("主人", "甘え")%…/%CNAME("主人")%、")%%TEXTR("喜欢……/最喜欢了……/请一直……")%%TEXTR(@"%CNAME("一人称")%和我亲吻吧……/%CALLNAME%请宠爱我……/请永远都不要离开我……")%%UNICODE(0x2665)%
LOCALS = %LOCALS%%TEXTR("ちゅっ、/ちゅ…/ちゅっ…/ちゅぅ……/んちゅっ、")%%TEXTR("ちゅっ/ちゅっ…/ちゅ……っ/ちゅ……/ちゅっ…ちゅっ")%	LOCALS = %LOCALS%%TEXTR("啾嗯……、/啾…/啾唔…/啾…………/唔嗯……、")%%TEXTR("啾呜……/啾唔…/啾……嗯/哈啊…………/啾………啾呜……")%
LOCALS = %LOCALS%%TEXTR("＿/ん、/んっ、/ん……")%%TEXTR("んっ…/ちゅ、んん…/んん……/んん…っ、ん…/んんっ、ん…/ぁふっ、ん…/んっ、ちゅ…")%%TEXTR("…/…/…/っ/…んっ")%	LOCALS = %LOCALS%%TEXTR("＿/嗯、/嗯唔、/嗯……")%%TEXTR("嗯唔…/啾、嗯嗯…/嗯嗯……/嗯嗯…唔、嗯…/嗯……唔……、啾…/呼啊……、嗯…/嗯唔、啾…")%%TEXTR("…/…/…/……呜……/…呜嗯……")%
LOCALS:3 = %TEXTR(@"%CNAME("主人", "甘え")%…/%CNAME("主人")%、")%%TEXTR(@"気持ちいいんですね/びくびくして可愛い/こんなに脈打って/こんなに熱くなって/%CNAME("一人称")%のご奉仕どうでしょうか…/好きです/大好きです")%%UNICODE(0x2665)%%TEXTR("＿/……")%	LOCALS:3 = %TEXTR(@"%CNAME("主人", "甘え")%…/%CNAME("主人")%、")%%TEXTR(@"舒服吗……/一跳一跳的好可爱呢……/这样脉动……/的好热啊……/%CNAME("一人称")%侍奉的怎么样/喜欢吗/怎么样")%%UNICODE(0x2665)%%TEXTR("＿/……")%
LOCALS = %LOCALS%%TEXTR("んっ、/んっ…、/んぅ、/んぅ…/ちゅっ、/んんっ……/れろ、/れろっ、/れろ…/れろ…/れろ…")%%TEXTR("れろ…/れろ……/ぁむ…/れろっ…/はむ……")%%TEXTR("＿/んっ/んぅっ/ちゅっ/ちゅぷっ")%	LOCALS = %LOCALS%%TEXTR("嗯唔、/嗯呜…、/呣呜、/姆呜…/啾啾、/嗯嗯……/呸咯、/呸咯、/呸咯…/呸咯…/呸咯…")%%TEXTR("呸咯…/呸咯……/呣呜…/呸咯…/哈呣……")%%TEXTR("＿/嗯唔/呣唔/啾/啾噗")%
LOCALS = %LOCALS%%TEXTR("んっ、/んっ…、/んん…/ん…ぐっ……/んぐっ、/んむっ、")%%TEXTR("んぐっ…/んぅ……/んん……/んっ…/んむっ……/んん…")%%TEXTR("＿/っ/んっ")%	LOCALS = %LOCALS%%TEXTR("嗯、/嗯唔…、/嗯嗯…/嗯…咕呜……/咕呜、/咕呜嗯、")%%TEXTR("嗯呜…/呣……/嗯呣……/嗯唔…/呣……/嗯嗯…")%%TEXTR("＿/咕/哈啊……")%
LOCALS = %LOCALS%%TEXTR("ん、/んっ、/んん…っ、/んんっ、")%%TEXTR("んっ/んっ…っ/んん……っ/ん…っ/ぷはっ、ん…っ")%%TEXTR("＿/、ちゅ、んん…っ/、ちゅ…っ")%	LOCALS = %LOCALS%%TEXTR("嗯、/嗯姆、/嗯嗯…呜、/嗯呜、")%%TEXTR("嗯姆/嗯唔…呜/嗯姆……/嗯…呣/呸咯、嗯…呼")%%TEXTR("＿/、啾、嗯嗯…哈/、啾…唔")%
LOCALS:4 = %CALLNAME%は嬉しそうにしながら、嵌められたリングギャグから舌を突き出して懸命に奉仕している	LOCALS:4 = %CALLNAME%看起来很开心地含住了肉棒、并用灵巧的唇舌刺激着可能的敏感点
LOCALS:4 = 強制開口された%CALLNAME%は頬を赤らめて、頭を前後に動かし%CALLNAME:PLAYER%に奉仕している	LOCALS:4 = 被强制插入口中的%CALLNAME%脸颊微红、不断被迫前后摆动着头部侍奉着%CALLNAME:PLAYER%
LOCALS:4 = %CALLNAME%はリングギャグをつけられている事に興奮しながら、舌を絡め口内に擦りつける様にして献身的に奉仕している	LOCALS:4 = %CALLNAME%似乎对这种粗暴的对待产生了快感、口中的舌头积极地缠绕着、吮吸着、努力地侍奉着口中的肉棒
LOCALS:4 = %CALLNAME%は嵌められたリングギャグから舌を突き出して奉仕している	LOCALS:4 = %CALLNAME%用灵巧的舌头对粗暴地插入口中的肉棒进行着抚慰
LOCALS:4 = 強制開口された%CALLNAME%は頭を前後に動かし奉仕している	LOCALS:4 = 被强制插入口中的且有些粗暴地被晃动头部的%CALLNAME%…
LOCALS:4 = %CALLNAME%は不自由さを感じながらも、舌を絡め口内に擦りつける様にして奉仕している	LOCALS:4 = %CALLNAME%感到了些许的不自由、但并未放松对口内肉棒的刺激、用舌头尽力的侍奉着
LOCALS:1 = %TEXTR("むぐっ/むぐぅっ/ん゛ん゛っ/んぶぅっ")%%UNICODE(0x2665)%	LOCALS:1 = %TEXTR("呣咕/姆咕/嗯゛嗯゛っ/噗呜")%%UNICODE(0x2665)%
LOCALS:3 = %TEXTR("んんっ/んむ゛っ/んぐぅっ/ぐぶぅっ")%%UNICODE(0x2665)%	LOCALS:3 = %TEXTR("姆呜呜/姆咕/呜呜/呜呼")%%UNICODE(0x2665)%
LOCALS = %LOCALS%%TEXTR("んぐっ、/んぐ、んっ…/ん゛んっ、/んむぅっ、")%%TEXTR("むぐぅっ…/んむぅ…っ/んん゛っ…、ぶぐ、ぅ…/っ…ぐぶっ/んむ゛っ……っ/ん゛ん…っ")%	LOCALS = %LOCALS%%TEXTR("嗯姆、/呜、呣…/嗯゛呼啊、/嗯唔呣、")%%TEXTR("姆咕…/嗯唔…っ/嗯嗯゛呜…、呼啊、呣…/嗯…呸咯/呜咕゛嗯……嗯/嗯゛嗯…っ")%
LOCALS = %LOCALS%%TEXTR("んっ、/んぅっ、/んん…っ、")%%TEXTR("んっ…っ/んぐ…っ/ぐむ……っ/んぐ…っ/んんぅ゛っ/んぐむ…っ/んっ、ごぇぇ…っ")%	LOCALS = %LOCALS%%TEXTR("嗯、/嗯姆、/嗯嗯…っ、")%%TEXTR("嗯唔…っ/咕…っ/呜呣……っ/嗯咕…っ/姆呜゛っ/咕呣…っ/嗯、噗嘿嘿…っ")%
LOCALS:4 = %CALLNAME%は苦しそうにしながらも喉奥深くまで咥え込み、頭を前後に動かして奉仕している	LOCALS:4 = %CALLNAME%露出了有些痛苦的神色、将肉棒吞至喉咙深处并不断吞吐侍奉着
LOCALS:4 = 強制開口された%CALLNAME%は苦しげな表情を浮かべながらも、%CALLNAME:PLAYER%を根元まで咥え込み舌を使って喜ばせようとしている	LOCALS:4 = 被强制插入口中的%CALLNAME%露出了痛苦的表情、但还是用舌头努力侍奉着%CALLNAME:PLAYER%放入自己口中的肉棒
LOCALS:4 = %CALLNAME%は苦しそうに眉根を寄せながらもその瞳は快感に蕩け、開口リングからは切なげな吐息が漏れていた	LOCALS:4 = %CALLNAME%略微地皱起了眉头、但那双动人的眼眸中却荡漾起一丝情欲、努力张开的口中发出了一丝满足地叹息
LOCALS:4 = %CALLNAME%は嵌められたリングギャグにより抵抗出来ずに、喉奥深くまで咥え込まされている	LOCALS:4 = 被抓住头部的%CALLNAME%无法抵抗您的侵入、肉棒一直深入到喉咙深处
LOCALS:4 = 強制開口された%CALLNAME%は根元まで咥え込まされ、苦悶の表情を浮かべている	LOCALS:4 = 被强制插入喉咙深处的%CALLNAME%、脸上浮现了苦闷的表情
LOCALS:4 = %CALLNAME%は眉根を寄せながらも、抵抗する事が出来ずに口腔を犯されている	LOCALS:4 = %CALLNAME%一遍皱着眉头、一遍无法抵抗的被侵犯着口腔
LOCALS:3 = %TEXTR("んっ…/んぅっ…/はぁ…/っ…")%%TEXTR(@"お仕置きしてください/叩いてください/もっと強くしてください/%CNAME("主人")%の望むままに")%%UNICODE(0x2665)%……	LOCALS:3 = %TEXTR("嗯…/嗯唔…/哈啊…/啊…")%%TEXTR(@"请惩罚我/请蹂躏我/请更加激烈的对待我/如果这是%CNAME("主人")%的愿望的话")%%UNICODE(0x2665)%……
LOCALS = %LOCALS%%TEXTR("んぐっ/くっ/くぅっ/んっ/んぅ")%	LOCALS = %LOCALS%%TEXTR("呜呣/呼/呼呜/嗯/嗯唔")%
LOCALS = %LOCALS%%TEXTR("んっ/んぅっ/んんっ")%	LOCALS = %LOCALS%%TEXTR("呣呜/呜嗯/嗯嗯")%
LOCALS:4 = %CALLNAME%は苦しそうにしながらも、悩ましげな吐息を漏らしている……	LOCALS:4 = %CALLNAME%一边忍受着痛苦、一边发出有些难受的吐息声……
LOCALS:4 = %CALLNAME%は痛みを快感として受け入れ、苦しげに喘いでいる……	LOCALS:4 = %CALLNAME%似乎将痛苦转化为了快感、苦闷地喘息着……
LOCALS:4 = %CALLNAME%は痛めつけられる事に快感を覚え、甘い吐息を吐いている……	LOCALS:4 = %CALLNAME%感受着痛苦带来的快感、甜美的喘息声流淌在你的耳边……
LOCALS:1 = %TEXTR("んぅぅ/んぅっ/んんぅっ/ん゛ぅっ/ん゛ん゛っ/ん゛ぅーっ/ん゛ん゛ぅ/ん゛ぅっー")%%UNICODE(0x2665)%……	LOCALS:1 = %TEXTR("呜呜呜！/呜嗯！/姆呜呜！/嗯呜呜！/嗯゛嗯゛っ/嗯゛呼啊/嗯゛嗯゛ぅ/嗯゛咦ー！")%%UNICODE(0x2665)%……
LOCALS:3 = %TEXTR("んぅっ/んんっ/んぅう/んうぅ/んっ/んー/んぅっ/ん゛ぅう/ん゛うぅ/ん゛ん゛ぅ/ん゛ぅっ/ん゛ん゛っ/ん゛っ/ん゛ー/ん゛ぅっ/ん゛ん゛ぅ")%%UNICODE(0x2665)%……	LOCALS:3 = %TEXTR("嗯唔/啊呜/哼唔/啊哈/嗯嗯/嗯ー/呼啊/嗯゛嗯嗯/嗯゛呜呜/嗯゛嗯゛呜/嗯゛哈唔/嗯゛嗯゛っ/嗯゛っ/嗯゛ー/嗯゛呜哈/嗯゛嗯゛ぅ")%%UNICODE(0x2665)%……
LOCALS = %LOCALS%%TEXTR("んぐっ、/んぐ、んっ…/ん゛んっ、/んむぅっ、/んぅっ/ん゛ぐぅ/んー/ん゛っー/んぅっ/んんっ/んぅう/んうぅ/んっ/んー/んぅっ/ん゛ぅう/ん゛うぅ/ん゛ん゛ぅ/ん゛ぅっ/ん゛ん゛っ/ん゛っ/ん゛ー/ん゛ぅっ/ん゛ん゛ぅ")%%TEXTR("むぐぅっ/んむぅ…っ/ん゛むぅ…っ/んん゛っ…、ぶぐ、ぅ/っ…ぐぶっ/んむ゛っ……っ/ん゛ん…っ")%	LOCALS = %LOCALS%%TEXTR("咕/嗯唔、哈啊…/嗯゛嗯唔、/嗯姆呜呜、/努呜/嗯゛哈啊/嗯ー/嗯゛咕ー/嗯呜呜/啊啊……/嗯唔/不要/呜呣/哈ー/呣唔/嗯゛ぅう/哈゛嗯呜/呜゛唔゛ぅ/嗯゛唔/嗯゛嗯゛っ/嗯゛っ/嗯゛ー/嗯゛唔っ/嗯゛嗯゛ぅ")%%TEXTR("姆咕/姆呜…唔/嗯゛呣唔…っ/嗯嗯゛っ…、卟咕、ぅ/っ…呼呣/嗯呼゛っ……っ/嗯゛嗯…っ")%
LOCALS = %LOCALS%%TEXTR("んぐっ/んぐ、んっ/ん゛んっ/んむぅっ/んぅっ/ん゛ぐぅ/んー/ん゛っー/んぅっ/んんっ/んぅう/んうぅ/んっ/んー/んぅっ/ん゛ぅう/ん゛うぅ/ん゛ん゛ぅ/ん゛ぅっ/ん゛ん゛っ/ん゛っ/ん゛ー/ん゛ぅっ/ん゛ん゛ぅ")%	LOCALS = %LOCALS%%TEXTR("嗯呣/嗯唔、呼/嗯゛嗯唔/呣唔/嗯唔/嗯゛咕/嗯ー/嗯゛っー/嗯ぅっ/嗯嗯っ/嗯唔う/嗯嗯ぅ/嗯っ/嗯ー/嗯唔っ/嗯゛ぅ唔/嗯゛呜ぅ/嗯゛嗯゛ぅ/嗯゛ぅっ/嗯゛嗯゛っ/嗯゛っ/嗯゛ー/嗯゛ぅっ/嗯゛嗯゛ぅ")%
LOCALS = %LOCALS%%TEXTR("んっ、/んっんっ、/んぅっ、/ん゛ぅっ、/んん…っ、/ん゛ん゛…っ、")%%TEXTR("んっ…っ/ん゛っ…っ/んぐ…っ/んぐ…っ/ん゛ぐ…っ/ぐむ……っ/んんぅ゛っ/んぐむ…っ/んっ、…っ/ん゛っ…っ/んっ、んぅ")%	LOCALS = %LOCALS%%TEXTR("嗯っ、/嗯っ嗯っ、/嗯ぅっ、/嗯゛ぅっ、/嗯嗯…っ、/嗯゛嗯゛…っ、")%%TEXTR("嗯っ…っ/嗯゛っ…っ/嗯唔…っ/嗯呼…っ/嗯゛呼…っ/呜呣……っ/嗯嗯ぅ゛っ/咕呣…っ/呜っ、…っ/呜゛っ…っ/呜っ、呜ぅ")%
LOCALS = %LOCALS%%TEXTR("んっ/んっんっ/んぅっ/ん゛ぅっ/んん…っ/ん゛ん゛…っ")%	LOCALS = %LOCALS%%TEXTR("嗯っ/嗯っ嗯っ/呜嗯っ/嗯゛ぅっ/嗯嗯…っ/嗯゛嗯゛…っ")%
LOCALS:4 = %CALLNAME%に嵌められたギャグボールからとめどなく液体が溢れ堕ちていた……	LOCALS:4 = 佩戴着口球的%CALLNAME%嘴边不断滴落着晶莹的液体……
LOCALS:4 = %CALLNAME%は嵌められたリングギャグから舌を突き出して、とめどなく液体を溢れさせている	LOCALS:4 = %CALLNAME%的舌头从被强制张开的口中探出，嘴边不可控制地滴落着晶莹剔透的津液
LOCALS:4 = 口をボールギャグで塞がれながら%CALLNAME%はうっとりとした表情を浮かべている	LOCALS:4 = 被塞入口球的%CALLNAME%浮现出陶醉的表情
LOCALS:4 =  強制開口させられた%CALLNAME%は歓喜に頬を染めている	LOCALS:4 =  被强制张开嘴巴的%CALLNAME%露出了欣喜的表情
LOCALS:4 = 口をボールギャグで塞がれている%CALLNAME%は%CALLNAME:MASTER%を睨みつけている	LOCALS:4 = 被塞入口球堵住嘴巴的%CALLNAME%无言地盯着%CALLNAME:MASTER%
LOCALS:4 = 強制開口された%CALLNAME%は嫌悪に顔を歪めている	LOCALS:4 = 被强制张开嘴巴的%CALLNAME%露出了嫌恶的神情
LOCALS:4 = 口をボールギャグで塞がれている%CALLNAME%は嬉しそうに頬を染めて、声にならない声をあげる	LOCALS:4 = 被塞入口球的%CALLNAME%脸上泛起了迷醉的红晕、发出欣喜的呜呜声
LOCALS:4 =  強制開口させられた%CALLNAME%は甘い吐息を漏らしポタポタと唾液を零れさせ、声にならない声をあげる	LOCALS:4 =  被迫张开嘴巴的%CALLNAME%、晶莹的唾液不断滴落着，迷醉地呼出甜美的吐息
LOCALS:4 = 口をボールギャグで塞がれている%CALLNAME%は苦しげな吐息を漏らし、声にならない声をあげる	LOCALS:4 = 被强制塞入口球的%CALLNAME%呜呜地漏出了痛苦的吐息声
LOCALS:4 = 強制開口させられた%CALLNAME%は苦しげな吐息を漏らし、声にならない声を漏らしていた……	LOCALS:4 = 被强制张开嘴巴的%CALLNAME%痛苦地呼吸着、发出不成话语的声音……
