LOCALS = ボク_ぼく	LOCALS = 我_我
LOCALS = ご主人様_ごしゅじんさま	LOCALS = 主人_主人
LOCALS = %CALLNAME:ASSI%さん_%CALLNAME:ASSI%さん	LOCALS = %CALLNAME:ASSI%_%CALLNAME:ASSI%
誰か分からなくなる誰そ彼逢まが時、	在不为人知的黄昏之刻、
或いは何もかもが寝静まる時に人を殺す少女。	或者是万籁俱寂的时刻割断生命之弦的少女。
何かをする為に殺しているのではなく、	不为了夺走什么而杀、
殺すためだけに人を殺している。	仅仅只是为了杀而杀。
血を見ることに興奮はしていない。	不因飞洒之血而兴奋。
肉の感触を楽しんでもいない。	不因撕裂肉体而快乐。
ただ、彼女は人を殺す事しか知らない。	她仅仅只知道杀人一事。
もしかしたら、いつか彼女が自らの行いを考え直すかもしれない。	或许、什么时候她自己会重新思考自己的行为也说不定。
その時にあなたは何かを選ばなければいけないだろう。	不过到了那时、你也会面临着不得不抉择的时候吧。
或いは、思いもよらない言葉を言うかもしれない。	也许、会说出意想不到的话语也说不定。
花言葉はいったい何？	花语是什么呢？
「歓迎」「恋に酔う」「■■■■■■■」	「欢迎」「堕入爱河」「■■■■■■■」
【これまでに%NAME:TARGET%に{CFLAG:殺された数}回殺された】	【至今被%NAME:TARGET%杀了{CFLAG:殺された数}次】
PRINTFORMW 夜は深く、人が己が家への路を辿り自らの場所で寛いでいる。	PRINTFORMW 夜深、人们已经回到了自己的归处、准备迎接新的一天。
PRINTFORMW そのさなか%CALLNAME:MASTER%は何か買うものがあったのか家を出てコンビニに向かっていた。	PRINTFORMW 就在这样的时候、%CALLNAME:MASTER%为了买点东西而走出家门前往便利店。
PRINTFORMW 聞きなれた入店音を通り過ぎ商品を手にして会計を済まして店を出た。	PRINTFORMW 伴随着听惯了的欢迎音走进店内、果断的拿了想要的东西付完款之后离开了便利店。
PRINTFORMW 前を行く人が振り向けば誰か分からなくなる誰そ彼逢まが刻。	PRINTFORMW 在冥眗亡见的黄昏之刻。
PRINTFORMW 人々が家路を辿るさなか%CALLNAME:MASTER%は今日は偶々一人で家への路を辿っていた。	PRINTFORMW 在人们都在忙于归家的时候、%CALLNAME:MASTER%今天在偶然的情况下只能独自回家。
PRINTFORML ふと、何時もは通らない裏路地に目が行く。	PRINTFORML 突然、目光突然注意到不管什么时候都不会走的小路。
PRINTFORMW %CALLNAME:MASTER%は好奇心に駆られ歩を進めた。	PRINTFORMW %CALLNAME:MASTER%好奇的走了过去。
PRINTFORMW 暫く歩を進めていると、路地の奥から少女が此方に歩いてきた。	PRINTFORMW 走了一段路、突然看到小路深处迎面走过来一名少女。
PRINTFORMW そして、すれ違う瞬間―――――――	PRINTFORMW 然后、就在那个瞬间―――――――
PRINTFORMW 腹部から強烈な痛みがうねりを上げて襲い掛かってくる。	PRINTFORMW 剧烈的痛楚从腹部传来。
PRINTFORMW 視線を下にやると、お腹に一本のナイフが突き刺さっていた。	PRINTFORMW 朝下看去、一把小刀刺入了腹部。
PRINTFORMW 再び視線を少女にやると少女は満面の笑みを浮かべていた。	PRINTFORMW 视线再次回到少女的时候、少女浮现了开心的笑容。
PRINTFORMW ぞっとするほど美しくも可愛らしい笑顔。	PRINTFORMW 令人惊叹的容颜上绽放了可爱的笑容。
PRINTFORMW 意識が途切れようとする瞬間、%CALLNAME:MASTER%は慣れた、或いは慣れていない感覚を感じる。	PRINTFORMW 就在意识快消失的时候、%CALLNAME:MASTER%已经习惯、或者是还没有习惯的感觉传来。
PRINTFORMW 魂を生命に変える感覚を。	PRINTFORMW 那是魂转变为生命的感觉。
CALL PRINT_STR, "紅_＜リザレクション！＞_W_"	CALL PRINT_STR, "紅_＜复活！＞_W_"
PRINTFORMW %CALLNAME:MASTER%は最後の力を振り絞って復活した！	PRINTFORMW %CALLNAME:MASTER%用尽最后的力气复活了！
PRINTFORMW %CALLNAME:MASTER%が怪我を治し立ち上がった様を見て少女はびっくりした表情をする。	PRINTFORMW 看着%CALLNAME:MASTER%的伤口肉眼可见的愈合的样子、少女露出见了鬼的表情。
PRINTFORMW 「わぁ！%CNAME("一人称")%、はじめてみました！殺しても死なない人！」	PRINTFORMW 「哇！%CNAME("一人称")%、第一次见到这样的！杀了也没死的人！」
PRINTFORMW 嬉しそうに声を上げた後、少女は無邪気に飛び跳ねてはしゃぐ。	PRINTFORMW 伴随着雀跃的声音、少女天真无邪的在那一蹦一跳的。
PRINTFORMW それを%CALLNAME:MASTER%は自分が殺されたのにとても冷静に少女を見ていた。	PRINTFORMW 这边、%CALLNAME:MASTER%冷静的看着这个刚才杀了自己的少女。
PRINTFORMW 路地に差し込む僅かな光でもキラキラと光る綺麗な長い髪。	PRINTFORMW 即使是这样阴暗的小路也能闪闪发光的漂亮长发。
PRINTFORMW %CALLNAME:MASTER%が流した血よりも赫い瞳。	PRINTFORMW 比%CALLNAME:MASTER%身上流出的血液还要猩红的眼眸。
PRINTFORMW 凶器を扱うには柔らかく華奢すぎる少女らしい身体。	PRINTFORMW 与使用的凶器相比充满了违和感的柔软而又婀娜的少女身姿。
PRINTFORMW 飛び跳ねまわった後に少女は%CALLNAME:MASTER%に近づいて言う。	PRINTFORMW 跳了一会儿的少女向着%CALLNAME:MASTER%靠近过来说道。
PRINTFORMW 「ねぇねぇ、%CNAME("一人称")%、%CALLNAME:ARG%っていいます。あなたはなんていうのです？」	PRINTFORMW 「呐呐、%CNAME("一人称")%、叫我%CALLNAME:ARG%就好。你的名字是什么呢？」
PRINTFORMW %CALLNAME:MASTER%は少し困惑しながら自分の名を返す。	PRINTFORMW %CALLNAME:MASTER%有点困惑的报上了自己的名字。
PRINTFORMW 「へー、そんななまえなんですね。%CNAME("一人称")%、あなたのこときにいりました！」	PRINTFORMW 「嘿ー、是那样的名字呐。%CNAME("一人称")%、很中意你！」
PRINTFORMW 「だから、いっぱい殺させてくれるかわりになんでもしますよ！」	PRINTFORMW 「所以、能让我尽情的杀死的话、我什么都可以做！」
PRINTFORMW 何でもとは何でもか？と問うと%CALLNAME:ARG%は「もちろんです！」と頷いた。	PRINTFORMW 什么都可以是真的吗？这样问了之后%CALLNAME:ARG%点点头回答「当然的！」。
PRINTFORMW %CALLNAME:MASTER%は自分の事情を話して勧誘を始めた……	PRINTFORMW 随后、%CALLNAME:MASTER%说明了自己的事情之后开始劝诱她缔结契约……
PRINTFORMW 「これからよろしくです！」	PRINTFORMW 「那么今后请多多指教！」
CALL PRINT_STRW, @"_イエロー_【%CALLNAME:ARG%は%CALLNAME:MASTER%を殺す代わりに何でもしてくれます】_"	CALL PRINT_STRW, @"_イエロー_【%CALLNAME:ARG%作为可以杀%CALLNAME:MASTER%的代价什么都可以做】_"
PRINTFORMW %NAME:ARG%は居候として "同棲中" となります。	PRINTFORMW %NAME:ARG%以借助的方式、变成 "同居中"了。
PRINTFORMW しかし学園生ではないので部室には来ることが出来ません。	PRINTFORMW 但是因为不是学生所以不能来到部室。
PRINTFORMW また一人、路地裏で命が失われた。	PRINTFORMW 又有一个人在小路丧生。
PRINTFORMW 【あなたと出会ってから殺した数、{CFLAG:ARG:殺した数}人】	PRINTFORMW 【从与你相遇开始的杀人数、有{CFLAG:ARG:殺した数}人】
PRINTFORMW 「待ってました！」	PRINTFORMW 「久等啦！」
PRINTFORMW すると言うや否や%CALLNAME:TARGET%は%CALLNAME:MASTER%に抱きついてきた。	PRINTFORMW %CALLNAME:TARGET%一边这样说着然后同时抱住了%CALLNAME:MASTER%。
PRINTFORMW 「実は%CNAME("二人称")%さんにかくれてえっちなご本とか読んで勉強してました！」	PRINTFORMW 「实际上我已经用%CNAME("二人称")%给的色色的书好好的预习过了！」
PRINTFORMW 「%CNAME("一人称")%はずっとずっときたいしていたのですっ！」	PRINTFORMW 「%CNAME("一人称")%一直一直在期待着的！」
PRINTFORMW %CALLNAME:TARGET%の赫い瞳はキラキラと輝いている。	PRINTFORMW %CALLNAME:TARGET%的赤瞳发出神采奕奕的光芒。
CALL PRINT_STRW,@"「だから、%CNAME("一人称")%になんでもしてくださいっ_HH_」"	CALL PRINT_STRW,@"「所以、不管什么全都来和%CNAME("一人称")%做吧_HH_」"
PRINTFORMW そして%CALLNAME:TARGET%はとても良い顔で咲った。	PRINTFORMW 然后、%CALLNAME:TARGET%露出笑意、如同绽开的白兰花一般。
CALL PRINT_STRW,@"「つ、ついにですか_／／／_」"	CALL PRINT_STRW,@"「终、终于要来了吗_／／／_」"
PRINTFORMW %CALLNAME:MASTER%にすると言われた%CALLNAME:TARGET%は顔を赤らめている。	PRINTFORMW %CALLNAME:MASTER%说出夜伽之事后%CALLNAME:TARGET%显得有点害羞。
CALL PRINT_STRW,@"「すっごくむねがどきどきしてます……_／／／_」"	CALL PRINT_STRW,@"「心跳的有点厉害……_／／／_」"
PRINTFORMW %CALLNAME:TARGET%は胸に手を当て瞳を少し閉じて、	PRINTFORMW %CALLNAME:TARGET%将手放在胸前、双目微闭、
CALL PRINT_STRW,@"「恥ずかしい気持ちもいっぱいありますけど、」"	CALL PRINT_STRW,@"「虽然心中的羞耻都快多的爆炸了、」"
CALL PRINT_STRW,@"「%CNAME("二人称")%さんが%CNAME("一人称")%を求めてくれてうれしいです……_／／／_」"	CALL PRINT_STRW,@"「但是%CNAME("二人称")%会这样渴求%CNAME("一人称")%、非常的开心……_／／／_」"
PRINTFORMW そう言って%CALLNAME:TARGET%はつぅ……と涙を一滴零して咲う。	PRINTFORMW 这样说着%CALLNAME:TARGET%……一滴眼泪如同珍珠一般划过脸庞。
PRINTFORMW 「あっ、これは、いやってことじゃ」	PRINTFORMW 「啊、这个、不是说讨厌」
PRINTFORMW 言葉を遮る様に頭を撫でる。	PRINTFORMW 摸着头语无伦次的解释着。
PRINTFORMW 始めようか。	PRINTFORMW 开始吧。
CALL PRINT_STRW,@"「はいっ！_／／／_」"	CALL PRINT_STRW,@"「是！_／／／_」"
PRINTFORMW 「えっちをするのですか？」	PRINTFORMW 「要做色色的事情吗？」
PRINTFORMW きょとんとした後、少し咲う。	PRINTFORMW 她愣了一会、然后嘴角露出一丝微笑。
PRINTFORMW 「ふふっ…、待ってました……」	PRINTFORMW 「呼呼…、久等啦……」
PRINTFORMW 「%CNAME("一人称")%は%CNAME("二人称")%さんと出会ったときに言いましたね」	PRINTFORMW 「%CNAME("一人称")%和%CNAME("二人称")%相遇的时候说过的吧」
PRINTFORMW 「いっぱい殺させてくれるかわりになんでもしますよ！って」	PRINTFORMW 「让我杀死你、作为代价你可以对我做任何事！这样的话」
PRINTFORMW 「%CNAME("一人称")%は……、」	PRINTFORMW 「%CNAME("一人称")%……、」
PRINTFORMW %CALLNAME:TARGET%は何かを確かめる様に一呼吸して、	PRINTFORMW %CALLNAME:TARGET%像是做心理准备一样深吸了一口气、
CALL PRINT_STRW,@"「%CNAME("一人称")%の全部は、%CNAME("二人称")%さんのモノです_／／／_」"	CALL PRINT_STRW,@"「%CNAME("一人称")%的全部、都是%CNAME("二人称")%的东西_／／／_」"
PRINTFORMW 「だから、」	PRINTFORMW 「所以、」
PRINTFORMW そう言ってたっと少し駆け、ぽすっと%CALLNAME:MASTER%の身体に抱きつき。	PRINTFORMW 这样说着、往前紧紧的抱住了%CALLNAME:MASTER%的身体。
PRINTFORMW そして、すっと%CALLNAME:MASTER%の耳元で囁く。	PRINTFORMW 然后、贴在%CALLNAME:MASTER%耳边柔声说道。
CALL PRINT_STRW,@"暗灰色_「今度こそ%CNAME("一人称")%になんでもしてください……_HH_暗灰色_」"	CALL PRINT_STRW,@"暗灰色_「这次才是真的、无论做什么、%CNAME("一人称")%都会去做的……_HH_暗灰色_」"
PRINTFORMW 「これからえっち？をするのです？」	PRINTFORMW 「色色的事情？接下来做？」
PRINTFORMW そう言う%CALLNAME:TARGET%は自分がこれから何をされるか理解していないようだ。	PRINTFORMW 嘴上这样说着、但是%CALLNAME:TARGET%似乎自己完全没有对这件事有清楚的认知的样子。
PRINTFORMW 「どんなのか%CNAME("一人称")%しらないのでたのしみです！」	PRINTFORMW 「虽然%CNAME("一人称")%不知道是什么事情但是很期待！」
PRINTFORMW 無垢な少女を自分の手で汚す、その背徳感に%CALLNAME:MASTER%は愉しみを感じた…	PRINTFORMW 接下来要将这只纯洁的少女由自己的手玷污、这股背德感让%CALLNAME:MASTER%升起一股愉悦的感觉…
PRINTFORMW 「えへへ～♪」	PRINTFORMW 「欸嘿嘿～♪」
PRINTFORMW これからすると言う前に%CALLNAME:TARGET%は%CALLNAME:MASTER%に抱きついてきた。	PRINTFORMW 在说出邀请之前%CALLNAME:TARGET%就抱住了%CALLNAME:MASTER%。
PRINTFORMW 「%CNAME("一人称")%、人殺しのつぎに%CNAME("二人称")%さんとえっちするのが好きです！」	PRINTFORMW 「%CNAME("一人称")%、除了杀人以外就是最喜欢和%CNAME("二人称")%做色色的事情！」
CALL PRINT_STRW,@"「だから、%CNAME("一人称")%にいっぱいえっちなことをしてくださいっ_HH_」"	CALL PRINT_STRW,@"「所以、和%CNAME("一人称")%尽情的做H的事情吧_HH_」"
CALL PRINT_STRW,@"「今日はどんなことを、するのです……？_／／／_」"	CALL PRINT_STRW,@"「今天打算、做什么呢……？_／／／_」"
PRINTFORMW そう期待した熱っぽい瞳で%CALLNAME:TARGET%は%CALLNAME:MASTER%を見つめてくる。	PRINTFORMW %CALLNAME:TARGET%眼眸中闪动着期待的光芒紧紧的盯着%CALLNAME:MASTER%。
CALL PRINT_STRW,@"「あっ……やっぱり今の聞かなかったことにしてください……_／／／_」"	CALL PRINT_STRW,@"「啊……果然刚才就当没有听到吧……_／／／_」"
PRINTFORMW 慌てて両手を振ってさっきの言葉を取り消した。	PRINTFORMW 她羞赧又慌张的摆动着双手想收回刚才的发言。
CALL PRINT_STRW,@"「だって、なにも知らないほうがどきどきできますから……_／／／_」"	CALL PRINT_STRW,@"「因为、我这个什么都不知道的反而会害羞……_／／／_」"
PRINTFORMW 「最近想うのです」	PRINTFORMW 「最近我在想啊」
PRINTFORMW 何時もの様に不毛な、だけど欠かせない始める前の雑談をしていると%CALLNAME:TARGET%が真剣な顔をして言い出した。	PRINTFORMW 虽然和平时一样的平淡、但是开始前%CALLNAME:TARGET%认真的开口。
PRINTFORMW 「%CNAME("二人称")%さんを殺すのをやめたほうが良いのかなって？」	PRINTFORMW 「也许、放弃杀%CNAME("二人称")%会好点？」
PRINTFORMW 「いやならいやって言ってください」	PRINTFORMW 「如果讨厌的话就说出来」
PRINTFORMW 「%CNAME("一人称")%は%CNAME("二人称")%さんがいやがる事はしたくないです」	PRINTFORMW 「%CNAME("一人称")%不想做会让%CNAME("二人称")%讨厌的事情」
PRINTFORMW 確かに刺されて殺されるのは痛いし、辛い事だ。	PRINTFORMW 的确每次被刺杀非常痛苦、常人恐怕早已崩溃了。
PRINTFORMW だけども、それで良いと言ったのは%CALLNAME:MASTER%自身だ。	PRINTFORMW 可是、答应她的就是%CALLNAME:MASTER%自己。
PRINTFORMW だから、殺して良い。	PRINTFORMW 所以、你依然可以做平时做的事情。
PRINTFORMW 「まだ、ふらふら迷ってますね、%CNAME("一人称")%……」	PRINTFORMW 「果然、%CNAME("一人称")%还在摇摇摆摆的迷茫着呢……」
PRINTFORMW 人間なんてそんなモノだ。	PRINTFORMW 人类就是这样的生物。
PRINTFORMW 「ふふっ……そうなんですねっ」	PRINTFORMW 「呼呼……是这样呢」
PRINTFORMW そう言って%CALLNAME:TARGET%はとても、とても綺麗な顔で咲う。	PRINTFORMW 这样说着%CALLNAME:TARGET%脸上绽放了美丽的笑容。
PRINTFORMW 「ねぇ？今日はどんなことをするのです……？」	PRINTFORMW 「呐？今天要做什么呢……？」
PRINTFORMW 今度は蠱惑的に咲って%CALLNAME:MASTER%の事を見つめる。	PRINTFORMW 这次她魅惑的看着%CALLNAME:MASTER%开口问道。
PRINTFORMW 「お願いがあります……」	PRINTFORMW 「我有一个请求……」
PRINTFORMW 「%CNAME("一人称")%をなにもわからないくらいぐちゃぐちゃにしてください……」	PRINTFORMW 「把%CNAME("一人称")%弄得一塌糊涂什么都没办法思考吧……」
PRINTFORMW 「今はなにも考えたくないのです……お願いしますっ……！」	PRINTFORMW 「现在我什么都不想考虑……求你了……！」
PRINTFORMW 懇願するように%CALLNAME:MASTER%の服の裾を握って揺れた瞳で%CALLNAME:MASTER%の顔を見つめてる。	PRINTFORMW 恳求的抓住%CALLNAME:MASTER%的衣服下摆摇晃着、眼眸紧盯着%CALLNAME:MASTER%的脸。
PRINTFORMW 「う～えっちはたのしくないのです…」	PRINTFORMW 「唔～色色的事情一点都不好玩…」
PRINTFORMW 「ふわぁってすることもあるけどたのしくないのです！」	PRINTFORMW 「虽然会有那么点感觉但是完全不好玩！」
PRINTFORMW そうは言っているが%CALLNAME:TARGET%はベットの上でちょこんと座って待っている。	PRINTFORMW 不过虽然这样说、但是%CALLNAME:TARGET%还是乖巧的坐在了床上。
PRINTFORMW ちゃんと対価を払っているからだろうか…	PRINTFORMW 可能是为了付出定下的代价吧…
PRINTFORMW 「だから、おわったら殺させてください！」	PRINTFORMW 「所以、结束之后就让我杀了你吧！」
PRINTFORMW ずいぶん自分の命も安くなったな。	PRINTFORMW 感觉自己的命真够便宜的。
PRINTFORMW 「すこしだけえっちがたのしくなってきました！」	PRINTFORMW 「稍微有一点感觉到色色的事情的有趣之处了！」
PRINTFORMW 回数を重ねたからか%CALLNAME:TARGET%は悦びを感じ始めてるらしい。	PRINTFORMW 似乎是做的次数的多了、%CALLNAME:TARGET%似乎也有点开始感到快乐了。
PRINTFORMW その事に%CALLNAME:MASTER%は達成感を少し覚えるが、	PRINTFORMW 让%CALLNAME:MASTER%有点成就感、
PRINTFORMW 「でも、殺すほうがたのしいので」	PRINTFORMW 「但是、杀死你这件事更好玩」
PRINTFORMW すっと%CALLNAME:TARGET%は近づいて耳元で囁く。	PRINTFORMW %CALLNAME:TARGET%贴在耳边说道。
PRINTFORMW 「おわったら殺させてください」	PRINTFORMW 「结束之后就让我杀了你吧」
PRINTFORMW どうやら、まだまだのようだ。	PRINTFORMW 看来、距离攻略还早。
PRINTFORMW 「きょうはどんなことをするのです？」	PRINTFORMW 「今天要做什么事情呢？」
PRINTFORMW %CALLNAME:TARGET%は少し熱のこもった瞳で問いかけてきた。	PRINTFORMW %CALLNAME:TARGET%用略带热情的眼神问我。
PRINTFORMW どうやら、%CALLNAME:TARGET%が今日何をするのかに興味を持ち始めたようだ。	PRINTFORMW 看来、%CALLNAME:TARGET%已经开始对这种事情有兴趣了。
PRINTFORMW %CALLNAME:TARGET%は%CALLNAME:MASTER%に抱き付き耳元で囁く。	PRINTFORMW %CALLNAME:TARGET%抱住%CALLNAME:MASTER%然后在耳边喃喃的说道。
PRINTFORMW 「だから%CNAME("一人称")%をもっと、ふわふわさせてください」	PRINTFORMW 「所以、要让%CNAME("一人称")%更加、更加的舒服哦」
PRINTFORMW %CALLNAME:MASTER%は薄く笑みを浮かべてベットへ連れて行った。	PRINTFORMW %CALLNAME:MASTER%微微笑了笑然后抱着她走向床铺。
PRINTFORMW 「えっちですか！」	PRINTFORMW 「H吗！」
PRINTFORMW %CALLNAME:TARGET%は嬉しそうに言うやいなや%CALLNAME:TARGET%は服を脱ごうとする。	PRINTFORMW %CALLNAME:TARGET%一边高兴的说着一边把自己身上的衣服褪去。
PRINTFORMW それを%CALLNAME:MASTER%は止めた。	PRINTFORMW 然后被%CALLNAME:MASTER%阻止了。
PRINTFORMW 「う～、なんでとめるのです？」	PRINTFORMW 「唔～、为什么让我停下来啦？」
PRINTFORMW 自主的に脱いでくれるのは、まぁ嬉しいがそれはそれと%CALLNAME:MASTER%は言う。	PRINTFORMW %CALLNAME:MASTER%说、虽然有妳自己脱掉让我感到开心。
PRINTFORMW 「ん～？自分にまかせてほしい？わかりました！」	PRINTFORMW 「嗯～？想要亲自来脱？我知道了！」
PRINTFORMW そう言って%CALLNAME:TARGET%は%CALLNAME:MASTER%の手を引きベットへ連れて行く。	PRINTFORMW 这样说着%CALLNAME:TARGET%牵着%CALLNAME:MASTER%的手走向床铺。
PRINTFORMW よしよしと思っていたが、	PRINTFORMW 看着她这样心里感到一股成就感、
CALL PRINT_STRW,@"「えっちがおわったら殺させてください_HH_」"	CALL PRINT_STRW,@"「做完了之后就让我杀了你吧_HH_」"
PRINTFORMW ここまでくると慣れたもので%CALLNAME:MASTER%は頷いた。	PRINTFORMW %CALLNAME:MASTER%点了点头、事到如今已经差不多快习惯了。
PRINTFORMW 「%CNAME("一人称")%が殺す前に死んじゃだめですよ！」	PRINTFORMW 「不要在%CNAME("一人称")%杀你之前死掉啊！」
PRINTFORMW そう言いながら%CALLNAME:TARGET%は繋がったまま%CALLNAME:MASTER%をぽかぽかと殴る。	PRINTFORMW 然后%CALLNAME:TARGET%一边说着一边连续的殴打着%CALLNAME:MASTER%的身体。
PRINTFORMW そのつもりは無いだろうがそれはグラインドの様になって快感を与える。	PRINTFORMW 虽然她可能没有那个想法但是她揍人的动作反而给予了一股快感。
PRINTFORMW そして、快楽のまま解き放ち、%CALLNAME:MASTER%は二度死ぬ羽目になった。	PRINTFORMW 然后、随着快感的解放、%CALLNAME:MASTER%再一次的死亡。
PRINTFORMW 【%CALLNAME:TARGET%に殺された数　+2】	PRINTFORMW 【%CALLNAME:TARGET%杀你的次数　+2】
CALL PRINT_STRW,@"「ふわふわから…_HH_もどってこれないです…_HH_」"	CALL PRINT_STRW,@"「连根手指都动不了了…_HH_已经不想管其他的事情了…_HH_」"
PRINTFORMW はぁーはぁーと息を荒げて%CALLNAME:TARGET%は虚空を見つめている。	PRINTFORMW %CALLNAME:TARGET%大口的喘着粗气、眼睛呆滞的开着。
PRINTFORMW 悪戯をしようかと思ったが、やめて%CALLNAME:TARGET%の頭を撫でてやる。	PRINTFORMW 虽然有一瞬间想要对她做点恶作剧什么的、想了想还是轻轻的抚摸着%CALLNAME:TARGET%的头。
PRINTFORMW 「ん……、～♪」	PRINTFORMW 「嗯……、～♪」
PRINTFORMW 「えっちでふわふわするのも良いですが、」	PRINTFORMW 「做H的事情很舒服感觉很好、」
PRINTFORMW 「こうやって%CNAME("二人称")%さんになでられてふわってするのも好きです」	PRINTFORMW 「但是这样被%CNAME("二人称")%摸摸头也很喜欢」
CALL PRINT_STRW,@"「ひぐ…_HH_はぁ_HH_はぁ_HH_も、もうむりれす_HH_」"	CALL PRINT_STRW,@"「咕…_HH_哈_HH_哈_HH_已、已经不行了_HH_」"
PRINTFORMW そう言って顔を隠しながら%CALLNAME:TARGET%は身体を投げ出している。	PRINTFORMW %CALLNAME:TARGET%单手掩面然后浑身放松的躺着。
PRINTFORMW ふと、思い付き、まだ元気なソレを%CALLNAME:TARGET%に入れるふりをする。	PRINTFORMW 突然、想起把还在精神的肉棒装作要插进%CALLNAME:TARGET%的那里的样子。
CALL PRINT_STRW,@"「だめっ_HH_れす_HH_いまっ_HH_いれられたら_HH_%CNAME("一人称")%_HH_死んじゃいます_HH_」"	CALL PRINT_STRW,@"「不行_HH_啊_HH_现在_HH_进去的话_HH_%CNAME("一人称")%_HH_真的会死掉的_HH_」"
PRINTFORMW 冗談だと言うと	PRINTFORMW 然后告诉她只是开玩笑之后
CALL PRINT_STRW,@"「い、いじわるしないでください…」"	CALL PRINT_STRW,@"「请、请不要捉弄人啦…」"
PRINTFORMW 嗜虐心をくすぐる台詞を言われて鎮めるのに%CALLNAME:MASTER%は苦労した。	PRINTFORMW 为了说点抖s的话让她冷静下来、%CALLNAME:MASTER%也是煞费苦心。
絶頂しすぎて瞳は焦点を絞れなくて虚空を見つめ、身体は不規則に痙攣を繰り返し、	不断的高潮让她的意识涣散、毫无神采的眼眸呆望着虚空、身体则因为高潮的快感本能的抽搐着、
脱力しきった膣からは注ぎ込まれた精液がごぽりと逆流して地面を白濁に彩っていく。	大量的精液早已从温软的蜜穴流淌而出、在地上形成了一个白浊的淫乱水洼
「あぅ……あ……%CNAME("二人称")%さ、ん……」	「啊……啊……%CNAME("二人称")%……」
%CALLNAME:TARGET%の%CALLNAME:MASTER%を呼ぶ声に、%CALLNAME:MASTER%はやれやれと自分がした行為に目を瞑って膝枕をしてやる。	听到了%CALLNAME:TARGET%呼喊自己的声音、%CALLNAME:MASTER%装作没听到的样子让她枕在自己的膝盖上。
「う……ぁ……ぁぅ……」	「唔……啊……啊呜……」
さらさらと髪を撫でてやり、どうにか動けるようになるまで待ってやった……	抚摸着她蓬松的头发、等着她回过神来
何とか身体を起こせるようになったのか%CALLNAME:TARGET%は突然%CALLNAME:MASTER%の首筋に口づけをした。	似乎终于可以活动身体的%CALLNAME:TARGET%突然吻住了%CALLNAME:MASTER%脖颈。
「んんっ……！！」	「嗯嗯……！！」
首筋を吸われる少しの痛みの後に、	直到脖颈被她吸的感到了疼痛之后、
「えへ…へ……」	「欸嘿…嘿……」
微笑んで%CALLNAME:TARGET%は倒れて	脸上写满了幸福的%CALLNAME:TARGET%残留着微笑倒在自己的怀里
「すぅ……すぅ……」	「Zzz……Zzz……」
安心しきった顔で%CALLNAME:MASTER%に抱きつきながら眠った。	脸上露出安心的表情抱着%CALLNAME:MASTER%睡着了。
%CALLNAME:MASTER%の首筋には%CALLNAME:TARGET%が付けた赤く腫れた痕が残っていた。	%CALLNAME:MASTER%的脖颈上还残留着%CALLNAME:TARGET%留下的可爱草莓。
CALL PRINT_STRW,@"「はぁ……_HH_はぁ……_HH_もう動けません……_HH_」"	CALL PRINT_STRW,@"「哈……_HH_哈……_HH_已经动不了了……_HH_」"
PRINTFORMW そう言ってぐったりと%CALLNAME:TARGET%はうつ伏せに寝ているが、若干お尻をふっている。	PRINTFORMW 说完便精疲力竭的倒在%CALLNAME:TARGET%身上躺着睡着了、稚嫩的屁股微微的扭动着。
PRINTFORMW 「ちらっ」	PRINTFORMW 「"扭动"」
PRINTFORMW 誘っているようだが、駄目です。	PRINTFORMW 看上去似乎在请君入瓮、然而不行。
PRINTFORMW 「むぅ～」	PRINTFORMW 「姆～」
CALL PRINT_STRW,@"「はぁ……_HH_はぁ……_HH_うぁ……あぁ……_HH_」"	CALL PRINT_STRW,@"「哈……_HH_哈……_HH_呜……啊……_HH_」"
PRINTFORMW 精魂尽きた%CALLNAME:TARGET%は息も絶え絶えだ。	PRINTFORMW 精魂消耗殆尽的%CALLNAME:TARGET%奄奄一息。
PRINTFORMW だが、秘所はいやらしくもとめどなく愛液を垂れ流している。	PRINTFORMW 但是、私处的爱液却依然还在流下。
PRINTFORMW 少し前だったらこの後に%CALLNAME:MASTER%を殺そうとしてくるのだがその気配は全くない……	PRINTFORMW 前不久这种时候肯定要杀%CALLNAME:MASTER%一次、不过现在似乎已经完全没有那个迹象了……
PRINTFORMW 「うぅ…つかれました…」	PRINTFORMW 「呜…累了…」
PRINTFORMW %CALLNAME:TARGET%はぐったりとしている。	PRINTFORMW %CALLNAME:TARGET%精疲力尽的躺着。
PRINTFORMW これならば殺されないだろう…	PRINTFORMW 看样子应该不会被杀掉吧…
PRINTFORMW 「元気になったら殺すのでまっててください…」	PRINTFORMW 「等我休息一会就来杀你所以请等一会…」
PRINTFORMW どうやらそうでもないみたいだ。	PRINTFORMW 看来还是逃不掉。
PRINTFORMW 【%CALLNAME:TARGET%に殺された数　+1】	PRINTFORMW 【%CALLNAME:TARGET%杀你的次数　+1】
CALL PRINT_STRW,@"「たくさんふわふわしました…_HH_」"	CALL PRINT_STRW,@"「做了好多舒服的事情呐…_HH_」"
PRINTFORMW 少し満足気に%CALLNAME:TARGET%はベットに四肢を投げだしている。	PRINTFORMW %CALLNAME:TARGET%有点满足的软绵绵的躺在床上。
PRINTFORMW 流石にこれなら大丈夫だろう…	PRINTFORMW 再怎么说这样应该不会被杀吧…
CALL PRINT_STRW,@"「おちついたら、殺すからまってください_HH_」"	CALL PRINT_STRW,@"「等我恢复过来、就来杀你了所以请等一下_HH_」"
PRINTFORMW 駄目みたいですね。	PRINTFORMW 不行的样子。
PRINTFORMW 「%CNAME("一人称")%はたくさんふわふわできましたけど、%CNAME("二人称")%さんはどうでした？」	PRINTFORMW 「%CNAME("一人称")%倒是尽情的享受了、%CNAME("二人称")%呢？」
PRINTFORMW %CALLNAME:TARGET%がこれまでなら考えられないような事を言ってきたので%CALLNAME:MASTER%は驚く。	PRINTFORMW %CALLNAME:TARGET%说出了至今从未考虑过的问题让%CALLNAME:MASTER%感到惊讶。
PRINTFORMW 「むぅ、しんがいです。%CNAME("一人称")%だっていろいろかんがえているのですよ？」	PRINTFORMW 「姆、真是失礼。就算是%CNAME("一人称")%也会考虑各种事情的哦？」
PRINTFORMW ふくれる%CALLNAME:TARGET%に%CALLNAME:MASTER%は感想を言うと%CALLNAME:TARGET%は嬉しそうに笑った。	PRINTFORMW %CALLNAME:TARGET%脸颊鼓气对着%CALLNAME:MASTER%说着感想的时候、突然%CALLNAME:TARGET%很开心的笑了起来。
PRINTFORMW 「ならよかったです」	PRINTFORMW 「那就好」
PRINTFORMW %CALLNAME:MASTER%は%CALLNAME:TARGET%が復活するまで頭を撫で続けた。	PRINTFORMW %CALLNAME:MASTER%直到%CALLNAME:TARGET%恢复过来为止都在抚摸着她的头。
PRINTFORMW 暫くして落ち着いたのか%CALLNAME:TARGET%は身体を起こして%CALLNAME:MASTER%を見つめて。	PRINTFORMW 过了一会%CALLNAME:TARGET%做起身看着%CALLNAME:MASTER%。
PRINTFORMW 「いっぱいシてくれてありがとうですっ！」	PRINTFORMW 「能全心全意的和我做、我很高兴！」
PRINTFORMW そう綺麗に咲って感謝してきた。	PRINTFORMW 她脸上绽放出美丽的笑容发出感谢的话。
CALL PRINT_STRW,@"「ひぐ…_HH_はぁ……はぁ……_HH__HH_も、もうむりれす_HH_」"	CALL PRINT_STRW,@"「咕…_HH_哈_HH_哈_HH_已、已经不行了_HH_」"
PRINTFORMW びくんっびくんっと身体を痙攣させているのを見て、どうだったかを聞くのは無粋であろう。	PRINTFORMW 看着她偶尔抽搐一下的娇躯、如果问她感觉怎么样也太过不解风情了。
PRINTFORMW だから、頭を撫でる事にした。	PRINTFORMW 所以、抬起手抚摸着她的头。
CALL PRINT_STRW,@"「はぁ……はぁ……_HH__HH_……………」"	CALL PRINT_STRW,@"「哈……哈……_HH__HH_……………」"
「不思議ですね。こうやってなでてもらえるとすごく安心します……_／／／_」	「真是奇怪呢。被这样摸头感觉非常的安心……_／／／_」
「ありがとうです」	「谢谢」
CALL PRINT_STRW,@"「はぁ……はぁ……_HH_大満足です……_HH__HH_」"	CALL PRINT_STRW,@"「哈……哈……_HH_已经满足了……_HH__HH_」"
PRINTFORMW 蕩けきった情けない顔で%CALLNAME:TARGET%は四肢を投げ出している。	PRINTFORMW %CALLNAME:TARGET%露出融化一样的表情软绵绵的躺在那。
PRINTFORMW 暫くすると何とか顔を取り繕って%CALLNAME:TARGET%は身体を起こしてくる。	PRINTFORMW 过了一会、%CALLNAME:TARGET%擦了擦脸坐起身来。
PRINTFORMW 「んくっ………、%CNAME("二人称")%さんはどうでした……？」。	PRINTFORMW 「嗯………、%CNAME("二人称")%感觉怎么样……？」。
PRINTFORMW そう聞いてきたので、満足していると返すと	PRINTFORMW 很满足
PRINTFORMW 「なら良かったですっ」	PRINTFORMW 「那就好」
PRINTFORMW そう言って咲いながら%CALLNAME:MASTER%に抱きついてすりすりと顔を擦り付けてきた。	PRINTFORMW 然后一边笑着一边抱住%CALLNAME:MASTER%、脸庞不停的摩擦着胸膛。
PRINTFORMW そんな%CALLNAME:TARGET%の頭を%CALLNAME:MASTER%は撫でてやった………	PRINTFORMW %CALLNAME:MASTER%伸出手抚摸着怀里可人的秀发……
PRINTFORMW 「あれっ？もう終わりなのです？」	PRINTFORMW 「啊嘞？已经不行了吗？」
PRINTFORMW 「うむぅ……、もっとシてほしいですっ！」	PRINTFORMW 「唔姆……、我还想要做！」
PRINTFORMW 終わりなモノは終わりだとたしなめる。	PRINTFORMW 和她辩解说已经不行了就是不行了。
PRINTFORMW 「ふかんぜんねんしょうです……」	PRINTFORMW 「这是能力不行的说……」
PRINTFORMW 「ふかんぜんねんしょうをぶつけます！」	PRINTFORMW 「这样的表现我会动手的哦！」
PRINTFORMW そう言って%CALLNAME:TARGET%は%CALLNAME:MASTER%にナイフを突き立てた。	PRINTFORMW 然后%CALLNAME:TARGET%一边说着朝%CALLNAME:MASTER%刺出了匕首。
PRINTFORMW まぁ、そうなるな……	PRINTFORMW 嘛、果然是这样吗……
PRINTFORMW そんな事を考えながら%CALLNAME:MASTER%はいつものをした。	PRINTFORMW 一边这样想着%CALLNAME:MASTER%又一次的经历了日常。
PRINTFORMW 「ん……終わりですか？」	PRINTFORMW 「嗯……结束了吗？」
PRINTFORMW 「あのっできたらで良いのですが……」	PRINTFORMW 「要是能做那个就好了……」
PRINTFORMW 「眠るまでいっしょにいてくれませんか……？」	PRINTFORMW 「睡觉之前、能不能就这样待在一起……？」
CALL PRINT_STRW,@"「………ありがとうです_／／／_」"	CALL PRINT_STRW,@"「………谢谢_／／／_」"
「しばらく%CNAME("一人称")%のこと抱きしめてくれませんか……？」	「能不能暂时抱住%CNAME("一人称")%一会……？」
PRINTFORMW 「今日は、もう終わりなのですか……？」	PRINTFORMW 「今天、就这……？」
PRINTFORMW そうだと伝えると、	PRINTFORMW 点头回应了她、
PRINTFORMW 「むぅ～不満です……」	PRINTFORMW 「姆～不满的说……」
PRINTFORMW 「こうぎします！なので殺します！」	PRINTFORMW 「这样的表现、我要抗议！所以我要杀了你！」
PRINTFORMW 自分の命が安すぎる……	PRINTFORMW 自己的命还真是一点都不值钱呐……
PRINTFORMW そう思いながら%CALLNAME:MASTER%は%CALLNAME:TARGET%に刺された。	PRINTFORMW 这样想着的时候%CALLNAME:TARGET%已经朝%CALLNAME:MASTER%刺出了匕首。
PRINTFORMW 「なので！今日はいっしょに寝ることをようきゅうします！」	PRINTFORMW 「所以！今天申请一起睡觉！」
%CALLNAME:MASTER%は仕方がないと少し呆れた表情をして横になる。	%CALLNAME:MASTER%略微有点吃惊、不过还是回应她说拿你没办法。
PRINTFORMW 「わーい！えへへ～♪おやすみですっ」	PRINTFORMW 「哇ー！欸嘿嘿～♪晚安」
PRINTFORMW 「終わり、ですか……？」	PRINTFORMW 「结束了、吗……？」
PRINTFORMW 名残惜しそうに手を伸ばしてきたが、%CALLNAME:TARGET%は途中で止めて手を握って	PRINTFORMW %CALLNAME:TARGET%恋恋不舍的伸出手、但是伸到一半就停了下来
PRINTFORMW 「いえ……、なんでもないです……」	PRINTFORMW 「不……、没什么……」
PRINTFORMW そう苦しそうに笑って、それから何も言わずに着衣を整えた。	PRINTFORMW 有点勉强的笑了笑、然后什么也不说的整理起着装。
PRINTFORMW 「ん～？」	PRINTFORMW 「嗯～？」
PRINTFORMW まだ動けるのに終わったことに%CALLNAME:TARGET%は疑問に思っている様だ。	PRINTFORMW 明明还在做的时候突然就结束了%CALLNAME:TARGET%脸上充满了问号。
PRINTFORMW 「まっ、いっかです」	PRINTFORMW 「嘛、算了」
PRINTFORMW そう言って%CALLNAME:TARGET%はナイフをすらりと抜き%CALLNAME:MASTER%に振り下ろした。	PRINTFORMW 这样说着%CALLNAME:TARGET%抽出匕首朝%CALLNAME:MASTER%挥下。
PRINTFORMW 「もうおわりなのです？」	PRINTFORMW 「就这？」
PRINTFORMW %CALLNAME:TARGET%はどうやら困惑してるようだ。	PRINTFORMW %CALLNAME:TARGET%脸上充满了问号。
PRINTFORMW 「%CNAME("二人称")%さんがなっとくしてるなら、いいですけど……」	PRINTFORMW 「%CNAME("二人称")%觉得可以的话、我倒是没什么……」
PRINTFORMW 「じゃあ殺しますね」	PRINTFORMW 「那我就开杀了」
PRINTFORMW そう言うと%CALLNAME:TARGET%は%CALLNAME:MASTER%にナイフを振り下ろした。	PRINTFORMW 这样说着%CALLNAME:TARGET%朝%CALLNAME:MASTER%挥出匕首。
PRINTFORMW 「あれ？きょうはここまでですか？」	PRINTFORMW 「啊嘞？今天就到这了吗？」
PRINTFORMW まだ体力精力に余裕があるのに終わった事に%CALLNAME:TARGET%は困惑しているようだ。	PRINTFORMW 明明体力精力都还有大把余裕、但是还是结束了让%CALLNAME:TARGET%感到很迷惑。
PRINTFORMW 「いつもだったら%CNAME("一人称")%が立てないくらい、いっぱいシてくるのに……」	PRINTFORMW 「明明平时的话要做到%CNAME("一人称")%站都站不起来的程度的说……」
PRINTFORMW %CALLNAME:TARGET%はどうやら不完全燃焼の様だが今日はここまでだ。	PRINTFORMW %CALLNAME:TARGET%今天有点不在状态所以就到这了。
PRINTFORMW ふくれる%CALLNAME:TARGET%はナイフを取り出して%CALLNAME:MASTER%に突き立てた。	PRINTFORMW 脸上写满了不高兴的%CALLNAME:TARGET%抽出匕首刺向%CALLNAME:MASTER%。
PRINTFORMW 「えへへ♪いっぱいさわってくださいっ！」	PRINTFORMW 「欸嘿嘿♪请尽情的爱抚我吧！」
PRINTFORMW そう言って%CALLNAME:TARGET%は%CALLNAME:MASTER%さに身体を完全に預けてくる。	PRINTFORMW 这样说着%CALLNAME:TARGET%完全把自己的身体放松交给は%CALLNAME:MASTER%。
PRINTFORMW 「お勉強したご本には男の人が女の人をえっちにさわってるのがのってました！」	PRINTFORMW 「我看的书上说男生爱抚女生的时候会很兴奋！」
PRINTFORMW 「それを%CNAME("一人称")%と%CALLNAME:MASTER%ささんにして想像してましたけど、」	PRINTFORMW 「虽然当时把%CNAME("一人称")%和%CALLNAME:MASTER%脑补代入进去、」
PRINTFORMW 「そのときに感じたどきどきにくらべたら、今のどきどきのほうがすごいですっ」	PRINTFORMW 「但是比起那时候的心情、现在的心情更加的高涨」
CALL PRINT_STRW,@"「だから、いっぱいさわってください_HH_」"	CALL PRINT_STRW,@"「所以、尽情的爱抚我吧_HH_」"
CALL PRINT_STRW,@"「少し、きんちょうします……_／／／_」"	CALL PRINT_STRW,@"「稍微、有点紧张……_／／／_」"
PRINTFORMW %CALLNAME:MASTER%に身体を預けている%CALLNAME:TARGET%は顔を赤くして咲う。	PRINTFORMW 把自己的身体任凭%CALLNAME:MASTER%摆弄的%CALLNAME:TARGET%脸上泛起了一片片红云。
CALL PRINT_STRW,@"「それ以上に%CNAME("二人称")%さんにふれてもらえるのが嬉しいですっ_／／／_」"	CALL PRINT_STRW,@"「被%CNAME("二人称")%这样爱抚我好开心_／／／_」"
PRINTFORMW 「だ、だきゃらっ！」	PRINTFORMW 「所、苏窝以！」
PRINTFORMW よしよしと慰める様に頭を撫でてやる。焦らなくて良い。	PRINTFORMW 乖啦乖啦、这样一边安慰着她一边摸着她的头。不用这么着急。
CALL PRINT_STRW,@"「……はい。%CNAME("一人称")%にいっぱいふれてください_／／／_」"	CALL PRINT_STRW,@"「……是。尽情的爱抚%CNAME("一人称")%吧_／／／_」"
CALL PRINT_STRW,@"「%CNAME("一人称")%を愛してくださいっ_／／／_」"	CALL PRINT_STRW,@"「尽情的疼爱%CNAME("一人称")%吧_／／／_」"
PRINTFORMW すっぽりと%CALLNAME:MASTER%の腕に収まっている%CALLNAME:TARGET%は笑いかけてくる。	PRINTFORMW %CALLNAME:TARGET%把%CALLNAME:MASTER%的手握在手中、微微笑着。
PRINTFORMW そんな%CALLNAME:TARGET%の胸とアソコに手を伸ばそうとすると、	PRINTFORMW %CALLNAME:TARGET%往她的胸前和私处伸出手去、
PRINTFORMW 「あっ……」	PRINTFORMW 「啊……」
PRINTFORMW 察したのか少し身体を固くする。	PRINTFORMW 她的娇躯微微的颤抖了一下。
PRINTFORMW 大丈夫だ。と耳元で囁く。	PRINTFORMW 在少女的耳旁轻轻说道。没事的。
PRINTFORMW その言葉にぶんぶんと頭を横に振ってから	PRINTFORMW 她听到这话之后轻轻的摇了摇头
PRINTFORMW 「いえっ！いやじゃないです！」	PRINTFORMW 「不！不是讨厌！」
PRINTFORMW 「ただ、きんちょうしちゃって……」	PRINTFORMW 「只是、有点紧张……」
PRINTFORMW そこで言葉を切って、すぅはぁと深呼吸してから続ける。	PRINTFORMW 说完之后、她深呼气了一口气然后说道。
CALL PRINT_STRW,@"「%CNAME("一人称")%にいっぱいふれてください_HH_」"	CALL PRINT_STRW,@"「尽情的疼爱%CNAME("一人称")%吧_HH_」"
PRINTFORMW %CALLNAME:MASTER%が%CALLNAME:TARGET%の身体を愛撫しようとすると、%CALLNAME:TARGET%はとても困惑した表情をする。	PRINTFORMW %CALLNAME:MASTER%爱抚着%CALLNAME:TARGET%的身体的时候、%CALLNAME:TARGET%露出了疑惑的表情。
PRINTFORMW 自分が何をされるのか分かっていないのだろうか……？	PRINTFORMW 是不知道爱抚的意义的是什么吗……？
PRINTFORMW %CALLNAME:MASTER%は%CALLNAME:TARGET%に自分がこれから何をするのか説明すると	PRINTFORMW %CALLNAME:MASTER%对%CALLNAME:TARGET%解释了爱抚的含义
PRINTFORMW 「つまり%CNAME("一人称")%のからだをさわりたいのです？」	PRINTFORMW 「也就是说、要摸%CNAME("一人称")%的身体是吗？」
PRINTFORMW いいですよ！と言い華奢な身体を%CALLNAME:MASTER%にあずけた。	PRINTFORMW 好啊！说完之后完全放松了身体交给了%CALLNAME:MASTER%。
CALL PRINT_STRW,@"「あっ_HH_ん…っ_HH_あっ…_HH_ふぅっ…_HH_あははっ_HH_」"	CALL PRINT_STRW,@"「啊_HH_嗯…_HH_啊…_HH_呼…_HH_啊哈哈_HH_」"
PRINTFORMW %CALLNAME:TARGET%は感じるのを楽しんでいる様だ。	PRINTFORMW %CALLNAME:TARGET%的身体随着爱抚身体扭动着。
CALL PRINT_STRW,@"「ふわふわできて_HH_たのしいです_HH__HH_」"	CALL PRINT_STRW,@"「好舒服_HH_好开心_HH__HH_」"
PRINTFORMW もっともっと%CALLNAME:MASTER%に触れてほしいのか%CALLNAME:TARGET%は積極的に身体を絡めてくる。	PRINTFORMW %CALLNAME:TARGET%为了得到更多的快感而紧紧的抱着%CALLNAME:MASTER%。
PRINTFORMW %CALLNAME:MASTER%は言葉ではなく行動で返すことにした。	PRINTFORMW %CALLNAME:MASTER%没有说话用行动回答着她。
CALL PRINT_STRW,@"「ん、ふぅっ_HH_も、と…_HH__HH_すき、すきぃッ_HH__HH__HH_」"	CALL PRINT_STRW,@"「嗯、呼_HH_更、多…_HH__HH_喜欢、喜欢_HH__HH__HH_」"
CALL PRINT_STRW,@"「～～っ_HH_っぁ…_HH_あっ…_HH_」"	CALL PRINT_STRW,@"「～～_HH_啊…_HH_啊…_HH_」"
PRINTFORMW 恥ずかしさを知ったからか、どうやら%CALLNAME:TARGET%は喘ぐのを抑えている様だ。	PRINTFORMW 似乎是感觉有点害羞、%CALLNAME:TARGET%压抑着自己的声音。
PRINTFORMW 洩れる声があるから口を押えようとするのを%CALLNAME:MASTER%は愛撫している腕を器用につかって抑えつけた。	PRINTFORMW 看出了她的意图之后%CALLNAME:MASTER%伸出爱抚着她的手捂住她漏出来的声音。
CALL PRINT_STRW,@"「ああぁっ_HH_ゃあぁ_HH_なんっれ_HH_だっめですっ_HH_」"	CALL PRINT_STRW,@"「啊啊っ_HH_呀啊_HH_停_HH_停一下_HH_」"
PRINTFORMW 文句ありげな瞳を寄越してくるがそれを無視して愛撫を続ける。	PRINTFORMW 无视了她的眼神继续爱抚着。
CALL PRINT_STRW,@"「ゃっ_HH__HH_ひっぁあぁっ……_HH__HH_」"	CALL PRINT_STRW,@"「不_HH__HH_咿啊啊啊……_HH__HH_」"
CALL PRINT_STRW,@"「ひゃぁ…_HH_んっ_HH_あっ…_HH_ふふっ…_HH_」"	CALL PRINT_STRW,@"「咿呀…_HH_嗯_HH_啊…_HH_呼…_HH_」"
PRINTFORMW 愛撫されながら%CALLNAME:TARGET%は嬉しそうに咲う。	PRINTFORMW %CALLNAME:TARGET%享受着爱抚然后露出了笑容。
PRINTFORMW 少し疑問に思ったのを%CALLNAME:TARGET%は目ざとく気が付いたようで、	PRINTFORMW %CALLNAME:TARGET%似乎注意到我的疑惑开口说道、
CALL PRINT_STRW,@"「大好きな人に、んく…_HH_こんなにさわって、あっ_HH_もらえるのがうれしくて_HH_」"	CALL PRINT_STRW,@"「喜欢的人、嗯咕…_HH_被这样的抚摸的话、啊_HH_能被这样爱抚真的很高兴_HH_」"
PRINTFORMW そう言いながら%CALLNAME:TARGET%は腕を%CALLNAME:MASTER%の頭に絡め、自らキスをしてきた。	PRINTFORMW 这样说着%CALLNAME:TARGET%伸出手环住%CALLNAME:MASTER%的脑袋、自主的吻了过来。
CALL PRINT_STRW,@"「%CNAME("一人称")%を、ちゅ_HH_もっと、あっ…_HH_愛して、ん…_HH_ください_HH_ふあ…_HH_んく…_HH_」"	CALL PRINT_STRW,@"「吻%CNAME("一人称")%、_HH_再、更加的…_HH_疼爱、嗯…_HH_我_HH_呼啊…_HH_嗯咕…_HH_」"
PRINTFORMW 返すように%CALLNAME:MASTER%も負けじと舌を絡め、キスに意識が行っている瞬間に愛撫の手を強める。	PRINTFORMW 怀中的可人这么说、%CALLNAME:MASTER%自然也更加来兴、kiss的动作更加侵略的同时加强了爱抚的动作。
CALL PRINT_STRW,@"「あっ_HH_だめでっす_HH_っいま_HH_つよくされたらぁぁ_HH__HH__HH_」"	CALL PRINT_STRW,@"「啊_HH_不行_HH_这样_HH_弄的话啊啊啊_HH__HH__HH_」"
CALL PRINT_STRW,@"「ああぁっ_HH_ふぁ、あ゛あっ_HH__HH_ひっ_HH_あぁっ_HH_」"	CALL PRINT_STRW,@"「啊啊っ_HH_呼啊、啊゛啊_HH__HH_咿_HH_啊_HH_」"
PRINTFORMW %CALLNAME:MASTER%に与えられる快楽に%CALLNAME:TARGET%は乱れに乱れている。	PRINTFORMW %CALLNAME:MASTER%持续的动作带来的快感让%CALLNAME:TARGET%翻起白眼发出淫荡的声音。
CALL PRINT_STRW,@"「もっとっ！%CNAME("一人称")%をっ！もっとっ……_HH__HH_ぐちゃぐちゃにしてくださいっ_HH__HH_」"	CALL PRINT_STRW,@"「我还要！尽情的侵犯%CNAME("一人称")%吧！把我……_HH__HH_弄得乱七八糟吧_HH__HH_」"
PRINTFORMW …………望みどおりにぐちゃぐちゃにしてやる。	PRINTFORMW …………那就如你所愿。
CALL PRINT_STRW,@"「あ゛あ゛ぁ゛あ゛あ゛あ゛ぁ゛ぁ゛ぁ………_HH__HH__HH__HH_」"	CALL PRINT_STRW,@"「啊゛啊゛啊゛啊゛啊゛啊゛啊゛啊゛啊………_HH__HH__HH__HH_」"
CALL PRINT_STRW,@"暗灰色_「っ……、っぁ……ひぅ……」"	CALL PRINT_STRW,@"暗灰色_「嗯……、啊……呼……」"
PRINTFORMW %CALLNAME:TARGET%は確かに感じているみたいだが、何処か愛撫を拒否している様にしている。	PRINTFORMW %CALLNAME:TARGET%虽然的确对爱抚的动作有了感觉、但是似乎对有一点拒绝的模样。
PRINTFORMW %CALLNAME:MASTER%が少し伺う様にしていると	PRINTFORMW %CALLNAME:MASTER%稍微问了问她之后
CALL PRINT_STRW,@"「いやじゃ、ないのです……でもっ……」"	CALL PRINT_STRW,@"「不是、讨厌……只是……」"
PRINTFORMW 感情がぐちゃぐちゃになっているのか赫い瞳から涙が零れている。	PRINTFORMW 她的那泛着泪花的眼眸中充满了混乱和不知所措。
CALL PRINT_STRW,@"「っあ…_HH_ひゃっ…_HH_あっ…_HH_んく…_HH_はぁ…はぁ……_HH_」"	CALL PRINT_STRW,@"「啊…_HH_咿呀…_HH_啊…_HH_嗯…_HH_哈啊…哈啊……_HH_」"
PRINTFORMW 度重なる愛撫の結果、%CALLNAME:TARGET%はかなり感じるようになったようだ。	PRINTFORMW %CALLNAME:TARGET%在反复的爱抚之下也逐渐开始有了快感。
PRINTFORMW %CALLNAME:MASTER%の愛撫を受けながら、%CALLNAME:TARGET%は熱のこもった瞳で%CALLNAME:MASTER%を見つめる。	PRINTFORMW 享受着%CALLNAME:MASTER%的同时、%CALLNAME:TARGET%用充满热情的眼眸看着%CALLNAME:MASTER%。
CALL PRINT_STRW,@"―――もっとください_HH_"	CALL PRINT_STRW,@"―――尽情的疼爱我吧_HH_"
PRINTFORMW 言葉に出してはいないが%CALLNAME:MASTER%にはそう言っているように見えた。	PRINTFORMW 虽然并没有说出口、但是能看出%CALLNAME:MASTER%的眼眸中的意思。
PRINTFORMW 期待に応えるように%CALLNAME:MASTER%は愛撫の手を強くした。	PRINTFORMW %CALLNAME:MASTER%为了回应她的期待、手上的动作更加的卖力了。
CALL PRINT_STRW,@"「ふぁ……_HH_んっ…_HH_あっ……_HH_」"	CALL PRINT_STRW,@"「呼啊……_HH_嗯…_HH_啊……_HH_」"
PRINTFORMW 経験を積んだからか、%CALLNAME:TARGET%はそこそこ感じるようになったようだ。	PRINTFORMW 随着经验的积攒、%CALLNAME:TARGET%也逐渐对这种事情产生了一些感觉。
PRINTFORMW 胸に触れた手には少しの汗の感触が。	PRINTFORMW 触碰雪白酥胸时候少许的汗的触感。
PRINTFORMW クリトリス触れた手には愛液が。	PRINTFORMW 挑逗阴蒂的时候手上的爱液。
PRINTFORMW 少しずつ自分の色に染まっている事に%CALLNAME:MASTER%は笑みを浮かべる。	PRINTFORMW 感觉到她也逐渐在染上自己的颜色、%CALLNAME:MASTER%不由得笑了笑。
CALL PRINT_STRW,@"「ん…_HH_すこしふわってします…_HH_」"	CALL PRINT_STRW,@"「嗯…_HH_稍微感觉到一点点舒服了…_HH_」"
PRINTFORMW 無意識だろうが身を少しよじり%CALLNAME:MASTER%に触ってほしい所を手を持っていこうとしている。	PRINTFORMW 无意识的扭了扭身子、握着%CALLNAME:MASTER%拉到想要被抚摸的地方。
PRINTFORMW だが、%CALLNAME:MASTER%は悪戯心が働いたのか違うところを愛撫する。	PRINTFORMW 但是、%CALLNAME:MASTER%恶作剧的去爱抚其他地方。
PRINTFORMW 「むぅ…」	PRINTFORMW 「姆…」
PRINTFORMW その事に%CALLNAME:TARGET%は不満気のようだ。	PRINTFORMW %CALLNAME:TARGET%鼓起了包子脸以示不满。
PRINTFORMW 「あははっ！くすぐったいです！」	PRINTFORMW 「啊哈哈！好痒！」
PRINTFORMW %CALLNAME:TARGET%は身体を触られてくすぐったいのか笑っている。	PRINTFORMW %CALLNAME:TARGET%被触碰的时候感觉很痒的笑了出来。
CALL PRINT_STRW,@"「…っ_HH_んっ…_HH_」"	CALL PRINT_STRW,@"「…嗯_HH_嗯…_HH_」"
PRINTFORMW だが、少しは感じているみたいだ。	PRINTFORMW 不过、看上去还是能有点感觉的。
PRINTFORMW 「オナニーですか？」	PRINTFORMW 「自慰吗？」
PRINTFORMW %CALLNAME:TARGET%は少し考える様な動作をした後、ポンと手を叩く。	PRINTFORMW %CALLNAME:TARGET%做出托着腮稍微思考的动作过了一会、啪的拍了拍手。
「一回しました！%CNAME("一人称")%が迷っていたときに！」	「做过一次！在%CNAME("一人称")%感觉迷茫的时候！」
PRINTFORMW ほう	PRINTFORMW 嚯
PRINTFORMW 「あの時はオナニーって知りませんでしたけど、クラスのお友達に教えてもらいました！」	PRINTFORMW 「不过那时候还不知道这个行为叫什么、现在班里的朋友们教我了！」
PRINTFORMW ………まぁ、良いか。	PRINTFORMW ………嘛、也好。
PRINTFORMW 「%CNAME("二人称")%さんのことを想いながらやればいいのですねっ！」	PRINTFORMW 「想着%CNAME("二人称")%的事情同时自慰就好了对吧！」
CALL PRINT_STRW,@"「よいしょ……、ん……あっ……_HH_ぁ……_HH_」"	CALL PRINT_STRW,@"「嘿咻……、嗯……啊……_HH_啊……_HH_」"
CALL PRINT_STRW,@"「お、オナニーですか_／／／_」"	CALL PRINT_STRW,@"「自、自慰吗_／／／_」"
PRINTFORMW %CALLNAME:TARGET%は顔を真っ赤にしてあらぬ方向を見ている。	PRINTFORMW %CALLNAME:TARGET%满脸通红的看着这边。
CALL PRINT_STRW,@"「ぼ、%CNAME("一人称")%知らないです_／／／_」"	CALL PRINT_STRW,@"「窝、%CNAME("一人称")%不知道的说_／／／_」"
PRINTFORMW うそつけ、全く白々しい反応だ。	PRINTFORMW 你在逗我、一眼就看穿了好吗。
PRINTFORMW しっているのだろう？	PRINTFORMW 你会做的吧？
CALL PRINT_STRW,@"「し、シてません_／／／_」"	CALL PRINT_STRW,@"「不、不做_／／／_」"
PRINTFORMW ん？シてません？なるほど、なるほど。	PRINTFORMW 嗯？不做？原来如此、原来如此。
CALL PRINT_STRW,@"「う、うぅ～～～～～～～～～！_／／／_」"	CALL PRINT_STRW,@"「呜、呜～～～～～～～～～！_／／／_」"
PRINTFORMW より顔を赤らめて%CALLNAME:TARGET%はぷいっと%CALLNAME:MASTER%から顔をそらしたが、シやすいようにした後始めた。	PRINTFORMW %CALLNAME:TARGET%的脸仿佛快滴血一样的通红、转过头不敢看%CALLNAME:MASTER%的同时、换了一个方便的姿势然后开始了。
CALL PRINT_STRW,@"「あ、あんまり見ないでください_／／／_」"	CALL PRINT_STRW,@"「不、不要紧紧的盯着_／／／_」"
PRINTFORMW 「シたことありますけど……できれば%CNAME("二人称")%さんにさわってほしいです……」	PRINTFORMW 「做是做过……可以的话还是想要%CNAME("二人称")%来爱抚我呢……」
PRINTFORMW %CALLNAME:MASTER%は%CALLNAME:TARGET%がひとりでしているところが見たいのだ。	PRINTFORMW %CALLNAME:MASTER%告诉%CALLNAME:TARGET%想要看她自慰的模样之后。
CALL PRINT_STRW,@"「う、うぅ～。……わかりました。シます……_／／／_」"	CALL PRINT_STRW,@"「呜、呜～。……我知道了。我做……_／／／_」"
PRINTFORMW そう言って座って足を開けて%CALLNAME:MASTER%に見やすいようにして始めた。	PRINTFORMW 这样说着、坐下然后张开双腿给%CALLNAME:MASTER%看到然后开始了。
CALL PRINT_STRW,@"「あっ……_HH_んぅ……_HH_%CALLNAME:MASTER%っさん……_HH_」"	CALL PRINT_STRW,@"「啊……_HH_嗯……_HH_%CALLNAME:MASTER%……_HH_」"
PRINTFORMW よがる%CALLNAME:TARGET%は快感を受けようとも%CALLNAME:MASTER%から瞳をずらさない。	PRINTFORMW %CALLNAME:TARGET%感受着快感的同时视线也没有从%CALLNAME:MASTER%身上离开。
CALL PRINT_STRW,@"「あっあっ_HH_そこっ_HH_そこをっ_HH__HH_」"	CALL PRINT_STRW,@"「啊啊_HH_那里_HH_那里_HH__HH_」"
PRINTFORMW 自慰をしながら%CALLNAME:TARGET%は蕩けた瞳で必死に%CALLNAME:MASTER%を誘っている……	PRINTFORMW 自慰的同时%CALLNAME:TARGET%用融化一般的眼眸热情的诱惑着%CALLNAME:MASTER%……
PRINTFORMW 「じいってなんです？」	PRINTFORMW 「嗯……让你看我是什么意思？」
PRINTFORMW %CALLNAME:MASTER%が%CALLNAME:TARGET%に自慰をするように言ったが伝わっていないみたいだ。	PRINTFORMW %CALLNAME:MASTER%没有对%CALLNAME:TARGET%说让她自慰。
PRINTFORMW 知らない単語だと思ったから言い換えて伝えたが、	PRINTFORMW 因为想着她应该不知道这个词的意思所以换成了别的说法、
PRINTFORMW 「おなにーってなんです？」	PRINTFORMW 「紫薇是什么意思？」
PRINTFORMW …………はぁ	PRINTFORMW …………哈啊
PRINTFORMW 仕方が無いから%CALLNAME:MASTER%は%CALLNAME:TARGET%にやり方を教えた……。	PRINTFORMW 没办法的%CALLNAME:MASTER%只能教%CALLNAME:TARGET%怎么做了……。
PRINTFORMW 「オナニーですか？わかりました！」	PRINTFORMW 「自慰吗？我知道了！」
PRINTFORMW %CALLNAME:MASTER%は%CALLNAME:TARGET%に自慰するように言うと%CALLNAME:TARGET%は元気よく返事をした。	PRINTFORMW %CALLNAME:MASTER%让%CALLNAME:TARGET%自慰之后%CALLNAME:TARGET%元气满满的答应了。
CALL PRINT_STRW,@"「はぁ…_HH_んっ…_HH_あっ…_HH_」"	CALL PRINT_STRW,@"「哈啊…_HH_嗯…_HH_啊…_HH_」"
PRINTFORMW 昔は自慰のやり方すら分からなかった少女が今では積極的にするようになった。	PRINTFORMW 以前连自慰都不知道是什么的少女现在已经能很积极的做了。
CALL PRINT_STRW,@"「ひ、あっ……_HH_あぅ…_HH_ああぁあぁ…_HH_」"	CALL PRINT_STRW,@"「咿、啊……_HH_啊…_HH_啊啊啊…_HH_」"
PRINTFORMW 「う～、見ないでください…」	PRINTFORMW 「呜～、请不要盯着看啦…」
PRINTFORMW %CALLNAME:MASTER%に自慰をするように言われた%CALLNAME:TARGET%は顔を赤らめながら始めたが隠すようにしている。	PRINTFORMW %CALLNAME:MASTER%要求做自慰之后%CALLNAME:TARGET%满面通红的开始自慰、但是双腿略微合起想要藏住。
PRINTFORMW それを咎めるように%CALLNAME:TARGET%は%CALLNAME:MASTER%を見つめるが…	PRINTFORMW %CALLNAME:TARGET%略带不满的看着%CALLNAME:MASTER%…
CALL PRINT_STRW,@"「っあ…_HH_そんなっに_HH_み、ないでっ_HH_ひゃっ_HH_」"	CALL PRINT_STRW,@"「啊…_HH_不要那样_HH_看、我_HH_咿呀_HH_」"
PRINTFORMW これはこれで良いなと思う%CALLNAME:MASTER%だった。	PRINTFORMW %CALLNAME:MASTER%觉得这样也好。
CALL PRINT_STRW,@"「ふふっ_HH_%CNAME("一人称")%がオナニーするところ見ててください_HH_」"	CALL PRINT_STRW,@"「呼呼_HH_尽情的看%CNAME("一人称")%自慰吧_HH_」"
PRINTFORMW %CALLNAME:TARGET%はそう言うと%CALLNAME:MASTER%に見せつけるように自慰を始めた。	PRINTFORMW %CALLNAME:TARGET%这样说着同时打开双腿能让%CALLNAME:MASTER%看到的姿势开始自慰了。
CALL PRINT_STRW,@"「…んっ_HH_はぁ…_HH_あっ…_HH_」"	CALL PRINT_STRW,@"「…嗯_HH_哈啊…_HH_啊…_HH_」"
CALL PRINT_STRW,@"「あっ…_HH_奥に_HH_もっと奥にぃ…_HH_」"	CALL PRINT_STRW,@"「啊…_HH_深处_HH_更深处ぃ…_HH_」"
PRINTFORMW 乳首、クリトリスと弄っていた%CALLNAME:TARGET%はやがて膣に指を入れ始めた。	PRINTFORMW 玩弄着乳头、阴蒂的%CALLNAME:TARGET%终于不满足的开始用手指插入小穴自慰了。
CALL PRINT_STRW,@"「入口、あっ_HH_ばっかりはっ、ゃあ_HH_切ない、あぁっ_HH_ですっ_HH_」"	CALL PRINT_STRW,@"「只是、穴口_HH_的话、啊_HH_有点、不满足_HH_的说っ_HH_」"
PRINTFORMW どうやら、%CALLNAME:MASTER%とのセックスをおかずにしている様だ。	PRINTFORMW 看来、和%CALLNAME:MASTER%做爱被当成下饭菜了。
PRINTFORMW 熱心に自慰をしているが%CALLNAME:TARGET%の瞳は蕩けているが%CALLNAME:MASTER%から外れない。	PRINTFORMW 热情的自慰的%CALLNAME:TARGET%用融化般的瞳孔盯着%CALLNAME:MASTER%。
CALL PRINT_STRW,@"―――はやくシてほしいです_HH_"	CALL PRINT_STRW,@"―――快点来和我做啦_HH_"
PRINTFORMW 言葉に出してはいないが行動で要求してくる%CALLNAME:TARGET%に%CALLNAME:MASTER%は笑みを浮かべた。	PRINTFORMW 并没有说出话、%CALLNAME:TARGET%魅惑的笑着作着诱惑的动作邀请着%CALLNAME:MASTER%。
CALL PRINT_STRW,@"「くぅ……あっ……_HH_っひぅ……_HH_あ、あっ！！」"	CALL PRINT_STRW,@"「咕……啊……_HH_咿……_HH_啊、啊！！」"
CALL PRINT_STRW,@"「あっあっあっ_HH_ああっう゛_HH_あぁあっ_HH__HH_」"	CALL PRINT_STRW,@"「啊啊啊_HH_啊啊唔゛_HH_啊啊_HH__HH_」"
PRINTFORMW 何かを振り払う様に積極的に快楽を貪ろうと必死にクリトリスと乳首を弄っている。	PRINTFORMW 她积极的为了贪食快感而卖力的拨弄着自己的阴蒂和乳头。
PRINTFORMW 「%CNAME("二人称")%さんっ、%CNAME("二人称")%さんっ……」	PRINTFORMW 「%CNAME("二人称")%、%CNAME("二人称")%……」
CALL PRINT_STRW,@"「…っ！あぅ…っやぁ_HH_ふぁ、ああっ_HH_」"	CALL PRINT_STRW,@"「…呜！啊…呀_HH_呼、啊啊_HH_」"
PRINTFORMW %CALLNAME:TARGET%もかなり自慰に慣れてきたようだ。	PRINTFORMW %CALLNAME:TARGET%也已经非常的习惯自慰了呢。
PRINTFORMW 積極的にクリトリスと乳首を触り、どんどん気持ち良くなっているみたいだ。	PRINTFORMW 积极的拨弄着自己的阴蒂和乳首、看上去越来越舒服的模样。
CALL PRINT_STRW,@"「ふわふわっ_HH_ふわふわしますっ_HH_」"	CALL PRINT_STRW,@"「舒服_HH_好舒服_HH_」"
PRINTFORMW 最初の頃の消極的な態度とうって変わり積極的になった%CALLNAME:TARGET%の様を見て%CALLNAME:MASTER%はちょっかいをかける事にした。	PRINTFORMW 看着%CALLNAME:TARGET%从最开始的消极态度变成现在这样很放得开的样子、%CALLNAME:MASTER%决定调戏她一下。
CALL PRINT_STRW,@"「ひゃっ！だめっです_HH_いじわるしないでっ_HH_くだっ_HH_ああぁああぁあ_HH__HH_」"	CALL PRINT_STRW,@"「咿呀！不要_HH_别欺负人_HH_咕_HH_啊啊啊啊啊啊_HH__HH_」"
CALL PRINT_STRW,@"「んっ…_HH_なんかへんなかんじです…_HH_」"	CALL PRINT_STRW,@"「嗯…_HH_有点奇怪的感觉呢…_HH_」"
PRINTFORMW 経験を積んで感度が上がったからか%CALLNAME:TARGET%は大分気持ち良さにのれるようになったみたいだ。	PRINTFORMW 现在积攒了不少经验敏感度应该是上升不少了、%CALLNAME:TARGET%看上去很舒服的样子。
CALL PRINT_STRW,@"「ふわふわします_HH_……あっ_HH_」"	CALL PRINT_STRW,@"「好舒服_HH_……啊_HH_」"
PRINTFORMW すると、これまでとは違った反応をした。	PRINTFORMW 于是、出现了和以前不一样的反应。
CALL PRINT_STRW,@"「こ、ここ_HH_もっとふわふわです_HH_」"	CALL PRINT_STRW,@"「这、这里_HH_更舒服呢_HH_」"
PRINTFORMW どうやら、クリトリスを直に触ったようだ。	PRINTFORMW 看起来、是直接摸到阴蒂了呢。
PRINTFORMW 悪戯心が働いた%CALLNAME:MASTER%は悪い顔をして少しだけ手伝った。	PRINTFORMW 恶作剧的想法作祟、%CALLNAME:MASTER%脸上带着腹黑的笑容伸出手。
CALL PRINT_STRW,@"「ひゃっ、ああぁあぁ_HH__HH_」"	CALL PRINT_STRW,@"「咿呀、啊啊啊啊_HH__HH_」"
PRINTFORMW 「むぅ…じぶんでするのってむずかしいです」	PRINTFORMW 「姆…自己做好难啊」
PRINTFORMW %CALLNAME:TARGET%は%CALLNAME:MASTER%に言われて自慰をしているがまだ気持ち良さにのれないようだ。	PRINTFORMW %CALLNAME:TARGET%听%CALLNAME:MASTER%的话开始自慰、但是并没有得到快感的样子。
CALL PRINT_STRW,@"「ん…_HH_すこしふわふわします…_HH_」"	CALL PRINT_STRW,@"「嗯…_HH_稍微有点舒服了…_HH_」"
PRINTFORMW だが回数を重ねたからか前よりは感じやすくなっている様だ。	PRINTFORMW 不过比起最开始已经有了不少次经验、现在已经能很好的感受快感了。
PRINTFORMW 「う～、たのしくないです……」	PRINTFORMW 「唔～、一点都不好玩……」
PRINTFORMW %CALLNAME:TARGET%は自分がやっている事に意味を見いだせてないみたいだ。	PRINTFORMW %CALLNAME:TARGET%对自慰完全没有理解这个行为有什么意义。
PRINTFORMW 冷静に考えると自慰は誰かに言われてやるモノでは無いと%CALLNAME:MASTER%は思ってしまう。	PRINTFORMW %CALLNAME:MASTER%冷静思考了下、自慰这种事情似乎不是用来和人说的事情来着。
CALL PRINT_STRW,@"「んっ…_HH_」"	CALL PRINT_STRW,@"「嗯…_HH_」"
PRINTFORMW だが、少しは感じているの見て%CALLNAME:MASTER%は良い傾向だと薄く笑みを浮かべた…	PRINTFORMW 但是、看着她似乎有点感觉了、%CALLNAME:MASTER%露出一丝浅笑…
PRINTFORMW %CALLNAME:TARGET%に押し倒された%CALLNAME:MASTER%は過去の経験から本能的に恐怖を感じた。	PRINTFORMW 被%CALLNAME:TARGET%推倒的%CALLNAME:MASTER%因为过去发生的事情本能的感到一丝恐怖。
PRINTFORMW 赫い瞳は獣の如き捕食者の視線。	PRINTFORMW 赤红的眼眸散发着掠食者的狂气。
PRINTFORMW 普通なら魅力的に見える唇は餌を前にした獣の如く歪んでいる。	PRINTFORMW 平常感觉很有魅力的薄唇现在也如同要把对方吃掉一般的兽意。
PRINTFORMW 「はぁん……」	PRINTFORMW 「哈嗯……」
PRINTFORMW 瞬間%CALLNAME:TARGET%は%CALLNAME:MASTER%にキスを始めた。	PRINTFORMW 一瞬、%CALLNAME:TARGET%吻住了%CALLNAME:MASTER%。
PRINTFORMW 荒々しく、歯がぶつかり、それはキスとは言えるものではなかったがそれ以外に形容する言葉がなかった。	PRINTFORMW 狂乱的动作、牙齿互相碰撞在一起、已经不能说是亲吻但也不能用其他词来形容。
PRINTFORMW 衝動の赴くままに%CALLNAME:TARGET%は%CALLNAME:MASTER%の唇を貪る。	PRINTFORMW %CALLNAME:TARGET%顺着体内的冲动贪食着%CALLNAME:MASTER%。
CALL PRINT_STRW,@"「ぷはぁっ_HH_はぁ…_HH_はぁ…_HH_」"	CALL PRINT_STRW,@"「噗哈っ_HH_哈啊…_HH_哈啊…_HH_」"
PRINTFORMW 暴虐の嵐の果てに%CALLNAME:TARGET%は%CALLNAME:MASTER%の唇から離れ肩で息をしている。	PRINTFORMW 肆虐的暴风过去、%CALLNAME:TARGET%离开了%CALLNAME:MASTER%的嘴唇喘着粗气。
PRINTFORMW 「よくわからないですけど、なんかこうするべきとおもいました！」	PRINTFORMW 「虽然不知道是什么回事、但是总觉得就应该这么做！」
PRINTFORMW どうやら、本能で動いていたようだ……	PRINTFORMW 看来、是依着本能动起来啊……
PRINTFORMW 「キスですか？」	PRINTFORMW 「kiss吗？」
PRINTFORMW %CALLNAME:TARGET%はキョトンとした表情で%CALLNAME:MASTER%を見つめる。	PRINTFORMW %CALLNAME:TARGET%有点迷茫的看着%CALLNAME:MASTER%。
PRINTFORMW そして、その後満面の笑みをする。	PRINTFORMW 然后、喜笑颜开的说道。
CALL PRINT_STRW,@"「ふふっ_HH_実は今か今かと待ってたのです_HH_」"	CALL PRINT_STRW,@"「呼呼_HH_实际上我一直在期待的哦_HH_」"
PRINTFORMW 「他の人から、いっぱい色々な話を聞いた中にキスの話があったのです」	PRINTFORMW 「从其他人那里、学的东西里就有kiss的事情」
PRINTFORMW 「だから、%CNAME("一人称")%とキスしてください」	PRINTFORMW 「所以、和%CNAME("一人称")%kiss吧」
PRINTFORMW %CALLNAME:MASTER%は%CALLNAME:TARGET%を抱き寄せ舌を絡め合う口づけを交わした。	PRINTFORMW %CALLNAME:MASTER%抱住了%CALLNAME:TARGET%吻住了她的唇瓣。
CALL PRINT_STRW,@"「ふふっ_HH_んっ…_HH_んぁ…_HH_」"	CALL PRINT_STRW,@"「呼呼_HH_嗯…_HH_嗯啊…_HH_」"
PRINTFORMW %CALLNAME:MASTER%がキスをしようと思った瞬間には%CALLNAME:TARGET%がキスをしてきた。	PRINTFORMW %CALLNAME:MASTER%说出来亲吻的一瞬间%CALLNAME:TARGET%就已经吻了过来。
PRINTFORMW %CALLNAME:TARGET%は%CALLNAME:MASTER%を貪るようにキスをしてくる。	PRINTFORMW %CALLNAME:TARGET%如同要融为一体般的贪食着与%CALLNAME:MASTER%的亲吻。
CALL PRINT_STRW,@"「ん…_HH_れろ_HH_んく_HH_はぁ…_HH_はぁ…_HH_」"	CALL PRINT_STRW,@"「嗯…_HH_吸溜_HH_嗯咕_HH_哈啊…_HH_哈啊…_HH_」"
PRINTFORMW 「普通の女の子がど言うのかは%CNAME("一人称")%はまだわかりません」	PRINTFORMW 「普通的女孩子是怎么样的%CNAME("一人称")%还不是很清楚」
PRINTFORMW 「でも、%CNAME("一人称")%があなたが大好きなのは確かです」	PRINTFORMW 「但是、%CNAME("一人称")%最喜欢你了是真心实意的」
CALL PRINT_STRW,@"「だから、行動でしめしてみました_HH__／／／_」"	CALL PRINT_STRW,@"「所以、就用行动来表现了_HH__／／／_」"
CALL PRINT_STRW,@"「んっ…_HH_あっ…_HH_んく…_HH_ふあ…_HH_」"	CALL PRINT_STRW,@"「嗯…_HH_啊…_HH_嗯咕…_HH_呼啊…_HH_」"
PRINTFORMW %CALLNAME:TARGET%と%CALLNAME:MASTER%はこれが二度目のキスなのに	PRINTFORMW 明明%CALLNAME:TARGET%和%CALLNAME:MASTER%这才第二次的接吻
PRINTFORMW お互いがどうすれば良いのか分かっているように口づけを交わす。	PRINTFORMW 但是两人却似乎已经知道该怎么做一般。
PRINTFORMW 愛を確かめるように、愛を貪るように。	PRINTFORMW 十里柔情、思之如狂。
CALL PRINT_STRW,@"「ぷはぁっ_HH_はぁ…_HH_はぁ…_HH_……%CNAME("一人称")%、あなたの事が大好きです」"	CALL PRINT_STRW,@"「噗哈_HH_哈啊…_HH_哈啊…_HH_……%CNAME("一人称")%、最喜欢你了」"
PRINTFORMW 「人を殺す事しか出来ない%CNAME("一人称")%の事を独り占めにしてくれて」	PRINTFORMW 「能喜欢上%CNAME("一人称")%这种除了杀人以外什么都不会的人、真的」
PRINTFORMW 「ありがとう」	PRINTFORMW 「谢谢」
PRINTFORMW 「まだ、ほんとの意味を分かってないけど……、%CNAME("一人称")%はあなたの事を愛してます」	PRINTFORMW 「虽然、还在有点不明白自己的心意……、但是%CNAME("一人称")%真的爱着你」
PRINTFORMW %CALLNAME:MASTER%と%CALLNAME:TARGET%は再び確かめるようにキスをした。	PRINTFORMW 话止、花影约重来。
PRINTFORMW 「きすってなんです？」	PRINTFORMW 「kiss、是什么？」
PRINTFORMW %CALLNAME:MASTER%は言葉で教えるよりも行動で教えたほうが良いと思い、%CALLNAME:TARGET%を抱き寄せキスをした。	PRINTFORMW %CALLNAME:MASTER%想着与其纸上谈兵、不如真枪实战、然后抱住了%CALLNAME:TARGET%吻住她的唇瓣。
PRINTFORMW 「ふぁ？」	PRINTFORMW 「呼啊？」
PRINTFORMW 唇で唇を、こじ開けて探しあてた舌を舌で絡める。	PRINTFORMW 双唇相交、撬开她的朱唇、双舌缠绵。
PRINTFORMW その時にコツコツと歯が当たるが%CALLNAME:MASTER%はそれを無視して続ける。	PRINTFORMW 虽然因为经验问题两人亲吻的时候总是会碰到牙齿但是%CALLNAME:MASTER%无视这些继续着亲吻。
PRINTFORMW 「んー！ん～！」	PRINTFORMW 「嗯ー！嗯～！」
PRINTFORMW %CALLNAME:TARGET%がぽかぽかと%CALLNAME:MASTER%を叩いてくるが所詮少女の腕それも無視して続ける。	PRINTFORMW %CALLNAME:TARGET%用手砰砰的打着%CALLNAME:MASTER%、但是%CALLNAME:MASTER%无视了她持续的吻着她。
PRINTFORMW %CALLNAME:MASTER%は何も言わずに%CALLNAME:TARGET%に近づきあごを上げさせた。	PRINTFORMW %CALLNAME:MASTER%什么也没说托起%CALLNAME:TARGET%的下巴吻了下去。
PRINTFORMW %CALLNAME:TARGET%はびっくりし目をパチパチさせながらもそれを受け入れ…	PRINTFORMW %CALLNAME:TARGET%虽然被吓了一跳、不过还是眨巴眨巴眼睛迎合着亲吻…
CALL PRINT_STRW,@"「んっ……_HH_あっ…_HH_んく……_HH_ふあ…_HH_」"	CALL PRINT_STRW,@"「嗯……_HH_啊…_HH_嗯……_HH_呼啊…_HH_」"
PRINTFORMW ……ただの唇を重ねる行為、だけどこの時は%CALLNAME:MASTER%と%CALLNAME:TARGET%の心はたしかに重なっていた。	PRINTFORMW ……只是单纯的嘴唇重叠的行为、但是这个瞬间让两人的心意相通。
CALL PRINT_STRW,@"「んくっ_HH_はぁ…_HH_はぁ…_HH_……」"	CALL PRINT_STRW,@"「嗯_HH_哈啊…_HH_哈啊…_HH_……」"
PRINTFORMW 暫くして唇は離れたが繋いだ心は離れていない。	PRINTFORMW 过了一会、唇分、心未分。
CALL PRINT_STRW,@"「んちゅっ……_HH_れろ…_HH_ぁん……_HH_」"	CALL PRINT_STRW,@"「嗯啾……_HH_吸溜…_HH_嗯……_HH_」"
PRINTFORMW %CALLNAME:TARGET%は%CALLNAME:MASTER%の全てを貪るように舌を絡めてくる。	PRINTFORMW %CALLNAME:TARGET%抱紧了%CALLNAME:MASTER%积极的回应着。
PRINTFORMW 何かに飢えてるように。	PRINTFORMW 宛如想要把自己融进来一样。
CALL PRINT_STRW,@"「んむ…？んン…っ！_HH_あっ…_HH_ふあ…_HH_」"	CALL PRINT_STRW,@"「嗯姆…？嗯…！_HH_啊…_HH_呼啊…_HH_」"
PRINTFORMW ならばと%CALLNAME:MASTER%も貪り返す。	PRINTFORMW %CALLNAME:MASTER%也同样的回应着积极的她。
CALL PRINT_STRW,@"「ん…_HH_」"	CALL PRINT_STRW,@"「嗯…_HH_」"
PRINTFORMW キスをすると言うと%CALLNAME:TARGET%は頬を赤らめながら%CALLNAME:MASTER%に身体を預ける。	PRINTFORMW 听到要kiss之后、虽然%CALLNAME:TARGET%脸上烧起红云但是还是把自己的身体放松让%CALLNAME:MASTER%为所欲为。
PRINTFORMW 優しく、確かめるように、そして溶かすように舌を絡め合う。	PRINTFORMW 轻轻的接触在一起、然后沉醉的交换着唾液。
CALL PRINT_STRW,@"「%CNAME("一人称")%、キス好きです…_HH_」"	CALL PRINT_STRW,@"「%CNAME("一人称")%、喜欢kiss…_HH_」"
PRINTFORMW キスをやめて少しだけ離れた%CALLNAME:TARGET%は微笑んで言う。	PRINTFORMW 停下kiss的%CALLNAME:TARGET%稍微退后了点微笑的说。
CALL PRINT_STRW,@"「なんとなくですけど、あなたを感じる事ができるから…_HH_」"	CALL PRINT_STRW,@"「虽然总觉得有点不好、但是我是能感受到你的心意的…_HH_」"
CALL PRINT_STRW,@"「ちゅっ……_HH_」"	CALL PRINT_STRW,@"「啾……_HH_」"
PRINTFORMW 唇と唇を重ねるだけの軽い口づけ。	PRINTFORMW 双唇重叠、浅尝即止。
CALL PRINT_STRW,@"「えへへ……_HH_」"	CALL PRINT_STRW,@"「欸嘿嘿……_HH_」"
PRINTFORMW %CALLNAME:TARGET%は微笑んでもう一度顔を近づける。	PRINTFORMW %CALLNAME:TARGET%微笑的再一次的凑过来。
CALL PRINT_STRW,@"「ちゅっ_HH_ん……_HH_れろ…_HH_んく……_HH_」"	CALL PRINT_STRW,@"「啾_HH_嗯……_HH_吸溜…_HH_嗯……_HH_」"
PRINTFORMW 今度は、唇が触れた瞬間に%CALLNAME:TARGET%の舌が%CALLNAME:MASTER%の舌をからめとった。	PRINTFORMW 这次、解除的一瞬%CALLNAME:TARGET%就将舌头伸了进来缠绕着%CALLNAME:MASTER%的舌头。
CALL PRINT_STRW,@"「あっ……_HH_ふあ_HH_んン……っ_HH_」"	CALL PRINT_STRW,@"「啊……_HH_呼啊_HH_嗯……嗯_HH_」"
PRINTFORMW 負けじと%CALLNAME:MASTER%も舌を絡めて%CALLNAME:TARGET%を蕩けさせる。	PRINTFORMW 不服输的%CALLNAME:MASTER%也积极的回应着%CALLNAME:TARGET%。
PRINTFORMW 二人はそっと唇を離した。	PRINTFORMW 良久、两人轻轻的分开。
PRINTFORMW 「やっぱり」	PRINTFORMW 「果然」
CALL PRINT_STRW,@"「やっぱり、%CNAME("一人称")%はあなたの事を愛してるみたいです_HH__／／／_」"	CALL PRINT_STRW,@"「果然、%CNAME("一人称")%还是爱着你的样子_HH__／／／_」"
PRINTFORMW %CALLNAME:TARGET%は頬を赤らめて笑顔をつくって%CALLNAME:MASTER%に思いを紡いだ。	PRINTFORMW %CALLNAME:TARGET%脸庞通红的露出美丽的笑颜对%CALLNAME:MASTER%说出自己的思念。
PRINTFORMW 何も言わずに%CALLNAME:TARGET%は%CALLNAME:MASTER%の唇を貪る。	PRINTFORMW %CALLNAME:TARGET%什么也没说的迎合着%CALLNAME:MASTER%的唇。
PRINTFORMW 何も考えたくないように本能的に、野性的に、舌が絡まってくる。	PRINTFORMW 似乎完全抛弃了思考遵循本能、狂野的、缠绕着舌头。
PRINTFORMW 息が続かなくて苦しそうだがまだ続けてくる。	PRINTFORMW 就算开始呼吸困难也依然在继续。
CALL PRINT_STRW,@"「ぷはぁっ……、はぁ……_HH_はぁ……_HH_」"	CALL PRINT_STRW,@"「噗哈……、哈啊……_HH_哈啊……_HH_」"
PRINTFORMW キスが終わり、離れた%CALLNAME:TARGET%の顔は朦朧としていて瞳は蕩けていた。	PRINTFORMW kiss结束的时候、%CALLNAME:TARGET%脸上带有意思昏沉但是眼瞳却散发着一股魅力。
PRINTFORMW そう言う%CALLNAME:TARGET%は何故か乗り気のようだ。	PRINTFORMW %CALLNAME:TARGET%莫名的有一鼓兴奋劲。
PRINTFORMW ファーストキスは手荒いモノだったのにだ。	PRINTFORMW 初吻应该是更加慌张的样子来着。
PRINTFORMW 「ん～、なんでかわからないですけどあったかくなるので、キスはすきです！」	PRINTFORMW 「嗯～、虽然不知道为什么但是会感觉很温暖、所以喜欢kiss！」
PRINTFORMW 「だから、キスしたいです」	PRINTFORMW 「所以、想要kiss」
PRINTFORMW そう言うと%CALLNAME:TARGET%は唇を%CALLNAME:MASTER%に近づけてきた…	PRINTFORMW 这样说着%CALLNAME:TARGET%将唇递到%CALLNAME:MASTER%的面前…
PRINTFORMW 「む？セックス？」	PRINTFORMW 「姆？Sex？」
PRINTFORMW %CALLNAME:TARGET%は少し考える様子見せてから、%CALLNAME:MASTER%を見つめた後あらぬ方向を見始める。	PRINTFORMW %CALLNAME:TARGET%看上去似乎在思考的样子、%CALLNAME:MASTER%静静的看着她。
PRINTFORMW 「ぼ、%CNAME("一人称")%、セックスなんて知りませんよ？？」	PRINTFORMW 「我、%CNAME("一人称")%、不知道什么是Sex啊？？」
PRINTFORMW 露骨、余りにも露骨。	PRINTFORMW 明显、太明显了。
PRINTFORMW どうやら%CALLNAME:TARGET%は他の人物からの会話で聞いていたようだ。	PRINTFORMW 看来是%CALLNAME:TARGET%已经从其他人那里的谈话中听过这种事情了。
PRINTFORMW %CALLNAME:MASTER%は無言で%CALLNAME:TARGET%に近づき、それを構える。	PRINTFORMW %CALLNAME:MASTER%无言的靠近了%CALLNAME:TARGET%然后抱住了她。
CALL PRINT_STRW,@"「う、う～…。や、優しくしてください…_HH_」"	CALL PRINT_STRW,@"「唔、呜～…。温、温柔点…_HH_」"
CALL PRINT_STRW,@"「ひゃ、ひゃい！_／／／_」"	CALL PRINT_STRW,@"「咿呀、咿咿！_／／／_」"
PRINTFORMW %CALLNAME:MASTER%が%CALLNAME:TARGET%にセックスをすると言うと%CALLNAME:TARGET%は緊張した様に声を上ずらせた。	PRINTFORMW 听到%CALLNAME:MASTER%说要Sex之后、%CALLNAME:TARGET%惊愕的叫出了声。
PRINTFORMW %CALLNAME:TARGET%の顔はびっくりするくらい赤く、熱を出しているのではなかろうかと思う。	PRINTFORMW %CALLNAME:TARGET%的脸颊因为惊吓而泛起一片片红云、就好像快冒出蒸汽一样。
CALL PRINT_STRW,@"「ぼ、%CNAME("一人称")%のひゃじめてを受けとってくだしゃい！_／／／_」"	CALL PRINT_STRW,@"「我、%CNAME("一人称")%的第一瓷、请、收下吧！_／／／_」"
PRINTFORMW 噛んだ。思いっきり噛んだ。	PRINTFORMW 因为太过紧张而咬到了舌头。
CALL PRINT_STRW,@"「う、うぅ～～～～～～～～～～～～～！_／／／_」"	CALL PRINT_STRW,@"「呜、呜～～～～～～～～～～～～～！_／／／_」"
PRINTFORMW より顔を赤らめる%CALLNAME:TARGET%に%CALLNAME:MASTER%は軽く頭を撫でてやり、肩にそっと手をかける。	PRINTFORMW %CALLNAME:MASTER%轻轻的抚摸了下%CALLNAME:TARGET%红透的脸庞、然后把手放在了她的肩上。
PRINTFORMW 「…！……仕切りなおしです！」	PRINTFORMW 「…！……请让我重新说一次！」
PRINTFORMW すぅ…はぁ…と深呼吸をして%CALLNAME:TARGET%は%CALLNAME:MASTER%を見つめ直す。	PRINTFORMW 嘶…哈…%CALLNAME:TARGET%深呼吸了一口气然后认真的看着%CALLNAME:MASTER%。
CALL PRINT_STRW,@"「%CNAME("一人称")%のはじめてを受けとってください_HH_」"	CALL PRINT_STRW,@"「请收下%CNAME("一人称")%的第一次吧_HH_」"
PRINTFORMW 「セックスですか？」	PRINTFORMW 「Sex吗？」
PRINTFORMW %CALLNAME:MASTER%がセックスをすると言うと%CALLNAME:TARGET%は数度瞳を瞬かせ俯き身体を震わす。	PRINTFORMW %CALLNAME:MASTER%说出要做爱的时候、%CALLNAME:TARGET%瞳孔缩了缩然后身体颤抖了一下。
PRINTFORMW 「やっと、やっとですか…」	PRINTFORMW 「终于、终于来了吗…」
PRINTFORMW %CALLNAME:TARGET%の赫い瞳から涙がこぼれる。だが、顔は笑顔だった。	PRINTFORMW %CALLNAME:TARGET%那红宝石一般的眼眸流下了晶莹的泪水。但是、脸上却挂着开心的笑容。
PRINTFORMW 「%CNAME("一人称")%、じつは待ってたのです」	PRINTFORMW 「%CNAME("一人称")%、实际上一直在等着的说」
PRINTFORMW 「あなたが%CNAME("一人称")%のはじめてをうばってくれるのを」	PRINTFORMW 「等着%CALLNAME:MASTER%来收下%CNAME("一人称")%的第一次」
PRINTFORMW そう言って%CALLNAME:TARGET%は%CALLNAME:MASTER%に身体を預ける。	PRINTFORMW 这样说着、%CALLNAME:TARGET%放松了自己的身体、完全的把自己交给了%CALLNAME:MASTER%。
PRINTFORMW 「どんな体制でも%CNAME("一人称")%はいいです」	PRINTFORMW 「不管什么样的姿势%CNAME("一人称")%都可以承受」
PRINTFORMW 「だから」	PRINTFORMW 「所以」
CALL PRINT_STRW,@"―――%CNAME("一人称")%をあなたの女にしてください_HH_"	CALL PRINT_STRW,@"―――让%CNAME("一人称")%成为%CALLNAME:MASTER%的女人吧_HH_"
PRINTFORMW 「せっくす？」	PRINTFORMW 「Sex？」
PRINTFORMW %CALLNAME:TARGET%の反応に%CALLNAME:MASTER%はやっぱりな、となる。	PRINTFORMW %CALLNAME:TARGET%的反应如预想的一般。
PRINTFORMW だから、%CALLNAME:MASTER%は自身のモノを見せつけ、指差し、%CALLNAME:TARGET%の秘所に挿入れると伝えた。	PRINTFORMW 所以、%CALLNAME:MASTER%露出了自己的下体、指了指、然后说明要插进%CALLNAME:TARGET%蜜穴之内。
PRINTFORMW 「おちんちんさん？を%CNAME("一人称")%のおまんこにいれるのですね？」	PRINTFORMW 「欧金金？要插到%CNAME("一人称")%的小穴里吗？」
PRINTFORMW 疑問符が浮いているのが見て取れるが%CALLNAME:TARGET%は思ったよりも積極的だ。	PRINTFORMW %CALLNAME:TARGET%虽然脑门上冒出了许多的问号、但是态度却比想象的积极的多。
PRINTFORMW 知識がないからだろうか……？	PRINTFORMW 这就是、无知者无畏……？
PRINTFORMW 「今日はせいじょういからなのですね！」	PRINTFORMW 「今天是从正常位开始啊！」
PRINTFORMW そう言って%CALLNAME:TARGET%はトスンとベットに腰かけて足を開く。	PRINTFORMW 这样说着%CALLNAME:TARGET%扑通的坐在床上、双腿抬高然后打开呈M字。
PRINTFORMW 「%CNAME("一人称")%はいつでもだいじょうぶです！」	PRINTFORMW 「%CNAME("一人称")%随时都没问题的！」
PRINTFORMW そう構える%CALLNAME:TARGET%は何だかとても頼りのある感じがする。	PRINTFORMW 现在的%CALLNAME:TARGET%总感觉有一股很靠得住的感觉。
PRINTFORMW ならばと、%CALLNAME:MASTER%はソレを構えて%CALLNAME:TARGET%の膣に挿入れた。	PRINTFORMW 随后、%CALLNAME:MASTER%对好小穴然后插入了进去。
CALL PRINT_STRW,@"「んっ……_HH_んぅっ_HH_んはっ_HH_はぁ_HH_はぁ……_HH_んっ_HH_おちんちんさんがうごいてます……_HH_」"	CALL PRINT_STRW,@"「嗯……_HH_嗯_HH_嗯哈_HH_哈啊_HH_哈啊……_HH_嗯_HH_大鸡巴好舒服……_HH_」"
PRINTFORMW 「あっ、%CNAME("一人称")%このかっこう好きです！」	PRINTFORMW 「啊、%CNAME("一人称")%喜欢这个姿势！」
PRINTFORMW 「%CNAME("一人称")%のいやらしいお顔を見られますけど、」	PRINTFORMW 「虽然会被看到%CNAME("一人称")%放浪形骸的脸就是了、」
PRINTFORMW 「それ以上に%CNAME("二人称")%さんを見ることができるので！」	PRINTFORMW 「但是也能看到%CNAME("二人称")%的脸庞！」
PRINTFORMW %CALLNAME:TARGET%は満面の笑みをつくりながらそう言った。	PRINTFORMW %CALLNAME:TARGET%笑容满面的说道。
PRINTFORMW %CALLNAME:MASTER%は何かを言おうとしたが、やめて%CALLNAME:TARGET%の手を握る。	PRINTFORMW %CALLNAME:MASTER%张了张嘴想要说什么、最后还是一言不发的握住了%CALLNAME:TARGET%的手。
CALL PRINT_STRW,@"「あっ_／／／_おねがいが一つあります」"	CALL PRINT_STRW,@"「啊_／／／_我有一个请求」"
CALL PRINT_STRW,@"「このかっこうでシているあいだは、手を、はなさないでください……_／／／_」"	CALL PRINT_STRW,@"「用这个姿势做的时候、请、握住我的手……_／／／_」"
PRINTFORMW 頷き、そして膣に挿入れた。	PRINTFORMW 点了点头、然后挺腰直入。
CALL PRINT_STRW,@"「んはっ……_HH_はぁ_HH_はぁ_HH_はぁ_HH_はいって_HH_きましたぁ……_HH_」"	CALL PRINT_STRW,@"「嗯哈……_HH_哈啊_HH_哈啊_HH_哈啊_HH_进到_HH_深处了……_HH_」"
CALL PRINT_STRW,@"「すこしだけ、はずかしいです…_／／／_」"	CALL PRINT_STRW,@"「稍微有点、害羞呢…_／／／_」"
PRINTFORMW %CALLNAME:TARGET%はそう言いながら二つあるうちの枕を一つ抱えてお顔を隠している。	PRINTFORMW %CALLNAME:TARGET%抱着一个枕头遮住脸庞害羞的说。
PRINTFORMW 足も閉じて秘所を隠している。	PRINTFORMW 双腿紧闭隐藏着那桃源之地。
CALL PRINT_STRW,@"「だって%CNAME("一人称")%のいやらしいお顔ぜんぶみられちゃいますから……_／／／_」"	CALL PRINT_STRW,@"「因为会被看到%CNAME("一人称")%色情的样子……_／／／_」"
PRINTFORMW %CALLNAME:MASTER%は%CALLNAME:TARGET%が抱えている枕を強引に取り上げてソレを見せつける。	PRINTFORMW %CALLNAME:MASTER%强硬的拿掉了%CALLNAME:TARGET%用来遮挡的枕头之后拉开紧闭的双腿看着那粉嫩的蜜穴。
CALL PRINT_STRW,@"「うっ、うぅう～_／／／_やさしくしてください……_／／／_」"	CALL PRINT_STRW,@"「呜、呜呜～_／／／_温柔点……_／／／_」"
PRINTFORMW 保障は出来ないと返して%CALLNAME:TARGET%の足を開かせて膣にゆっくりと挿入れた。	PRINTFORMW 点了点头、%CALLNAME:TARGET%扶住她的双腿然后肉棒插入到了她那粉嫩的小穴之中。
CALL PRINT_STRW,@"「んっ、んんっ_HH_ひゃぅっ_HH_あっ……_HH__はぁ……_HH_はぁ……_HH_」"	CALL PRINT_STRW,@"「嗯、嗯嗯_HH_咿呀_HH_啊……_HH__哈啊……_HH_哈啊……_HH_」"
PRINTFORMW 「このかっこうが一応普通なのでしたっけ？」	PRINTFORMW 「这个姿势真的很正常吗？」
PRINTFORMW ベットに寝て足を開いている%CALLNAME:TARGET%は%CALLNAME:MASTER%にそう尋ねる。	PRINTFORMW 在床上躺着打开双腿的%CALLNAME:TARGET%向%CALLNAME:MASTER%问道。
PRINTFORMW 無防備すぎると思うがそれだけ信頼されているのだろう。	PRINTFORMW 丝毫没有防备的姿态也是证明她对自己的信赖吧。
PRINTFORMW 「%CNAME("一人称")%、このかっこうきらいじゃないです」	PRINTFORMW 「%CNAME("一人称")%倒不讨厌这个姿势」
CALL PRINT_STRW,@"「だって、%CNAME("一人称")%によゆうがある時は、%CNAME("二人称")%さんの感じるお顔をみれるのですから_／／／_」"	CALL PRINT_STRW,@"「因为、%CNAME("一人称")%只要还清醒的时候、就能看到%CNAME("二人称")%感觉很舒服的表情_／／／_」"
PRINTFORMW そう言って%CALLNAME:TARGET%は咲う。	PRINTFORMW %CALLNAME:TARGET%笑了笑说道。
PRINTFORMW 「たぶん、%CNAME("一人称")%、手をにぎってほしいって言うとおもいます」	PRINTFORMW 「大概、%CNAME("一人称")%、应该想要你握着我的手」
CALL PRINT_STRW,@"「その時はにぎってほしいです_／／／_」"	CALL PRINT_STRW,@"「那时候希望你能握着我的手_／／／_」"
PRINTFORMW その言葉に%CALLNAME:MASTER%は頷き右手を握ってお互いがそこに居るのだと確かめ合ってから、	PRINTFORMW 听闻此话、%CALLNAME:MASTER%点了点头右手与她的左手合在一起然后两人的身躯互相重叠、
CALL PRINT_STRW,@"「んっ……はぁッんんっ_HH_あっ_HH_あぅぅ……_HH_んんっ……_HH_んっ…_HH_んんっ……_HH_」"	CALL PRINT_STRW,@"「嗯……哈啊嗯嗯_HH_啊_HH_啊……_HH_嗯嗯……_HH_嗯…_HH_嗯嗯……_HH_」"
PRINTFORMW %CALLNAME:TARGET%の膣に挿入れた。	PRINTFORMW 进入了%CALLNAME:TARGET%的蜜穴之中。
PRINTFORMW 「う？今日は犬さんのかっこうからするのです？」	PRINTFORMW 「唔？今天要用狗狗一样的姿势吗？」
PRINTFORMW わかりました！と%CALLNAME:TARGET%は元気よく言うとその通りに四つん這いになった。	PRINTFORMW 我知道了！%CALLNAME:TARGET%元气的回答之后做出四肢着地的姿势。
PRINTFORMW 「んー……、！　うー、わんわん！」	PRINTFORMW 「嗯ー……、！　呜ー、汪汪！」
PRINTFORMW どうやら犬にもなったようだ。	PRINTFORMW 看来是变成狗狗了。
CALL PRINT_STRW,@"「くぅん_HH_きゅぅん_HH_」"	CALL PRINT_STRW,@"「吭_HH_汪_HH_」"
PRINTFORMW 犬の鳴きまねをしながら%CALLNAME:TARGET%はお尻を振って%CALLNAME:MASTER%を誘っている。	PRINTFORMW %CALLNAME:TARGET%一边模仿着狗的叫声一边扭着腰、摇摆的臀部不断地诱惑着%CALLNAME:MASTER%。
PRINTFORMW %CALLNAME:MASTER%は%CALLNAME:TARGET%の腰に手をそえ、そして膣に突き立てた	PRINTFORMW %CALLNAME:MASTER%扶住%CALLNAME:TARGET%的腰、然后直捣黄龙
CALL PRINT_STRW,@"「わっ、んはぁああぁぁあぁ……_HH_」"	CALL PRINT_STRW,@"「汪、嗯嗯嗯啊啊……_HH_」"
CALL PRINT_STRW,@"「うぅ、このかっこうは犬さんみたいでちょっと恥ずかしいです…_／／／_」"	CALL PRINT_STRW,@"「呜、这个姿势像狗一样的好害羞…_／／／_」"
PRINTFORMW 恥ずかしそうに%CALLNAME:TARGET%は枕に顔をうずめている。	PRINTFORMW %CALLNAME:TARGET%很害羞的用枕头遮住自己的脸。
PRINTFORMW しかし、頭隠して尻隠さず。	PRINTFORMW 只不过、没有遮住下身。
PRINTFORMW %CALLNAME:TARGET%の秘所からは愛液が少しずつ垂れてきている。	PRINTFORMW %CALLNAME:TARGET%粉嫩的蜜穴内已经开始流出不少的爱液。
PRINTFORMW %CALLNAME:MASTER%がソレを%CALLNAME:TARGET%の秘所にくっつけると	PRINTFORMW %CALLNAME:MASTER%把鸡巴对准%CALLNAME:TARGET%的蜜穴然后插了进去
CALL PRINT_STRW,@"「ひゃっ_HH_や、やさしくしてください…_／／／_」"	CALL PRINT_STRW,@"「咿呀_HH_温、温柔点啦…_／／／_」"
PRINTFORMW %CALLNAME:MASTER%はそれは無理だと返して乱暴に突き挿入れた。	PRINTFORMW %CALLNAME:MASTER%无视了她的声音持续用力的戳弄着她的小穴。
CALL PRINT_STRW,@"「えっ、ちょっ_HH_あっ_HH_あああぁああぁあぁ_HH__HH__HH_」"	CALL PRINT_STRW,@"「欸、等_HH_啊_HH_啊啊啊啊啊啊啊啊_HH__HH__HH_」"
CALL PRINT_STRW,@"「ふふっ_HH_はーやーく、いーれーてーくーだーさーいっ_HH_」"	CALL PRINT_STRW,@"「呼呼_HH_快ー点ー来、插ー到ー我ー的ー小ー穴ー里_HH_」"
PRINTFORMW 四つん這いになった%CALLNAME:TARGET%はそう言いながら%CALLNAME:MASTER%を挑発するようにお尻をふりふりと振る。	PRINTFORMW 四肢着地的%CALLNAME:TARGET%扭动着腰诱惑的挑衅着%CALLNAME:MASTER%。
PRINTFORMW 待ち遠しいのか、%CALLNAME:TARGET%の秘所からは愛液が垂れてきている。	PRINTFORMW 可能是太着急了、%CALLNAME:TARGET%淫乱的骚穴内早已流出汩汩的爱液。
PRINTFORMW %CALLNAME:MASTER%が%CALLNAME:TARGET%の腰に手をあてると腰振りを止め完全に受け挿入れる体制になった。	PRINTFORMW %CALLNAME:MASTER%握住%CALLNAME:TARGET%的腰固定好之后大鸡巴用力的插到她的最深处去。
CALL PRINT_STRW,@"「っっっ_HH__HH__HH_きっ_HH_きましたぁ_HH__HH__HH_」"	CALL PRINT_STRW,@"「唔_HH__HH__HH_来_HH_来了啊啊啊_HH__HH__HH_」"
CALL PRINT_STRW,@"「このかっこう、やっぱりすっごくえっちです…_／／／_」"	CALL PRINT_STRW,@"「这个姿势、果然好色啊…_／／／_」"
PRINTFORMW そう言っている%CALLNAME:TARGET%の顔は珍しく良く分かるほど赤らめている。	PRINTFORMW 这样说着%CALLNAME:TARGET%脸上露出了难得一见的酡红。
PRINTFORMW 恥が薄いと思っていたが一応は恥ずかしい事もあるようだ。	PRINTFORMW 本来以为已经不怎么害羞了、看起来还是有一点羞耻心的。
CALL PRINT_STRW,@"「はぁ_HH_はぁ_HH_んくっ、はぁ_HH_はぁ_HH_」"	CALL PRINT_STRW,@"「哈啊_HH_哈啊_HH_嗯咕、哈啊_HH_哈啊_HH_」"
PRINTFORMW 何も言わずに%CALLNAME:MASTER%のモノをじっと見つめる%CALLNAME:TARGET%。	PRINTFORMW %CALLNAME:TARGET%看着一言不发的%CALLNAME:MASTER%的肉棒发出了淫荡的喘息声。
PRINTFORMW それは期待しているようで…	PRINTFORMW 看起来很期待的样子…
PRINTFORMW 出口は上を向いているのに愛液が少しずつ溢れてくる。	PRINTFORMW 粉嫩的蜜穴已经开始分泌爱液。
PRINTFORMW 何時もとは逆になって%CALLNAME:MASTER%は振り下ろした。	PRINTFORMW %CALLNAME:MASTER%毫不犹豫的插了进去。
CALL PRINT_STRW,@"「きゃっ_HH_んんっ_HH_んんんっ_HH__HH_」"	CALL PRINT_STRW,@"「咿呀_HH_嗯嗯_HH_嗯嗯嗯_HH__HH_」"
CALL PRINT_STRW,@"「やっ、やっぱり、このかっこう恥ずかしいです…_／／／_」"	CALL PRINT_STRW,@"「果、果然、这个姿势好羞耻…_／／／_」"
PRINTFORMW %CALLNAME:TARGET%はそう言いながら顔を隠してる。	PRINTFORMW %CALLNAME:TARGET%一边遮住自己的脸庞一边说道。
CALL PRINT_STRW,@"「%CNAME("一人称")%の恥ずかしいところ、全部みられてっ……_／／／_」"	CALL PRINT_STRW,@"「%CNAME("一人称")%淫荡的样子全被、看光了啦……_／／／_」"
PRINTFORMW しかし、そうは言っているが%CALLNAME:TARGET%の秘所からは愛液が溢れ出している。	PRINTFORMW 但是、虽然这么说、%CALLNAME:TARGET%蜜穴已经流出了汩汩爱液。
PRINTFORMW %CALLNAME:MASTER%は%CALLNAME:TARGET%の腕を抑えつけ、%CALLNAME:TARGET%に見せつけるように膣に挿入れた。	PRINTFORMW %CALLNAME:MASTER%压着%CALLNAME:TARGET%的手、能让%CALLNAME:TARGET%看到的姿势插入了她的蜜穴。
CALL PRINT_STRW,@"「やっ_HH_あっ_HH_ひっああぁあぁぁあぁ_HH__WH__HH_」"	CALL PRINT_STRW,@"「呀_HH_啊_HH_咿啊啊啊啊啊啊_HH__WH__HH_」"
CALL PRINT_STRW,@"「うぅ…%CNAME("一人称")%の恥ずかしいところ全部みられてます…_／／／_」"	CALL PRINT_STRW,@"「唔…%CNAME("一人称")%淫荡的样子全被看光了啦…_／／／_」"
PRINTFORMW 顔を赤らめて、恥ずかしがってる風の台詞を言っている%CALLNAME:TARGET%だが	PRINTFORMW 虽然满面通红的说着好像很害羞的台词、但是
PRINTFORMW その瞳は%CALLNAME:MASTER%のモノに釘付けで、期待に満ち溢れている。	PRINTFORMW 她的眼眸紧紧的盯着%CALLNAME:MASTER%的肉棒、期待之情溢于言表。
PRINTFORMW その証拠に%CALLNAME:TARGET%の秘所から愛液がつぅっと溢れ出してくる。	PRINTFORMW %CALLNAME:TARGET%蜜穴滴落的爱液已经验证了她的心情。
PRINTFORMW そして、%CALLNAME:MASTER%は突き立てるように%CALLNAME:TARGET%の膣に挿入れた。	PRINTFORMW 然后、%CALLNAME:MASTER%猛地插入了%CALLNAME:TARGET%腔穴内。
CALL PRINT_STRW,@"「ひゃっ_HH_あああぁああぁあぁ_HH__HH__HH_」"	CALL PRINT_STRW,@"「咿呀_HH_啊啊啊啊啊啊啊_HH__HH__HH_」"
CALL PRINT_STRW,@"「んっ……_／／／_」"	CALL PRINT_STRW,@"「嗯……_／／／_」"
PRINTFORMW %CALLNAME:MASTER%に対面座位ですると言われた%CALLNAME:TARGET%は何もいわずに%CALLNAME:MASTER%に抱き付いた。	PRINTFORMW 决定做对面坐位之后、%CALLNAME:TARGET%什么也没说的抱住了%CALLNAME:MASTER%。
CALL PRINT_STRW,@"「あったかいです……_／／／_」"	CALL PRINT_STRW,@"「好温暖……_／／／_」"
PRINTFORMW 落ち着いた感じで%CALLNAME:MASTER%に身体を預けている。	PRINTFORMW 似乎平静下来的她把自己交给%CALLNAME:MASTER%任凭摆弄。
PRINTFORMW そっと、腰に手をそえると	PRINTFORMW 轻轻的吧手环住她的腰
CALL PRINT_STRW,@"「あっ_／／／_」"	CALL PRINT_STRW,@"「啊_／／／_」"
PRINTFORMW ぴくんっと反応する。	PRINTFORMW 她的身体颤抖了一下。
CALL PRINT_STRW,@"「%CNAME("一人称")%はいつでもいいですよ…？_HH__／／／_」"	CALL PRINT_STRW,@"「%CNAME("一人称")%随时都没问题的哦…？_HH__／／／_」"
CALL PRINT_STRW,@"「きゃっ_HH_あっはゃあ_HH__HH_」"	CALL PRINT_STRW,@"「咿呀_HH_啊哈啊啊_HH__HH_」"
CALL PRINT_STRW,@"「ち、近いです、ね……_／／／_」"	CALL PRINT_STRW,@"「好、好近、呢……_／／／_」"
PRINTFORMW %CALLNAME:TARGET%は顔を真っ赤にしながらも%CALLNAME:MASTER%の首に腕をまわし抱き付いてくる。	PRINTFORMW %CALLNAME:TARGET%满面通红的用手环抱着%CALLNAME:MASTER%脖颈。
PRINTFORMW そして、%CALLNAME:MASTER%のモノと%CALLNAME:TARGET%の秘所が軽くキスする。	PRINTFORMW 然后、%CALLNAME:MASTER%的肉棒和%CALLNAME:TARGET%的蜜穴轻轻的触碰在一起。
PRINTFORMW 触れた事に意識してしまったのか、亀頭から%CALLNAME:TARGET%の溢れ垂れた愛液が%CALLNAME:MASTER%のモノを濡らしていく。	PRINTFORMW 虽然似乎意识到了碰在一起的事情、但是从龟头上感觉到了%CALLNAME:TARGET%蜜穴上流出来的爱液。
PRINTFORMW 伝った愛液に我慢が出来なくなった%CALLNAME:MASTER%は%CALLNAME:TARGET%の膣に挿入れた。	PRINTFORMW 感受着她的爱液%CALLNAME:MASTER%也忍受不住的直接插入了进去。
CALL PRINT_STRW,@"「んっ…_HH_んんっ……_HH_うっ…_HH_ふぅ…_HH_」"	CALL PRINT_STRW,@"「嗯…_HH_嗯嗯……_HH_唔…_HH_呼…_HH_」"
CALL PRINT_STRW,@"「あっ…_HH__／／／_」"	CALL PRINT_STRW,@"「啊…_HH__／／／_」"
CALL PRINT_STRW,@"「%CNAME("一人称")%、このたいせい好きです…_HH__／／／_」"	CALL PRINT_STRW,@"「%CNAME("一人称")%、很喜欢这个姿势…_HH__／／／_」"
PRINTFORMW 「だって」	PRINTFORMW 「因为」
CALL PRINT_STRW,@"「%CNAME("二人称")%さんに抱きしめてもらえるからですっ_HH_」"	CALL PRINT_STRW,@"「能被%CNAME("二人称")%抱着_HH_」"
PRINTFORMW %CALLNAME:TARGET%は%CALLNAME:MASTER%に満面の笑みを浮かべる。	PRINTFORMW %CALLNAME:TARGET%笑容满面的看着%CALLNAME:MASTER%。
PRINTFORMW 期待しているのか%CALLNAME:TARGET%の秘所からは愛液が溢れ出し%CALLNAME:MASTER%のモノを濡らす。	PRINTFORMW 似乎是在期待着一样、%CALLNAME:TARGET%的小穴内流出的爱液早已把%CALLNAME:MASTER%肉棒浸湿。
PRINTFORMW そして、%CALLNAME:MASTER%は言葉に応えるように%CALLNAME:TARGET%をしっかりと抱きしめて膣に挿入れた。	PRINTFORMW 然后、%CALLNAME:MASTER%为了回应她一般的抱起%CALLNAME:TARGET%、下身的肉棒也插入她的小穴之中。
CALL PRINT_STRW,@"「んっ…んぅっ_HH_んっ_HH_んんんっ_HH__HH_」"	CALL PRINT_STRW,@"「嗯…嗯唔_HH_嗯_HH_嗯嗯嗯_HH__HH_」"
CALL PRINT_STRW,@"「ふーふーふーふ……♪_／／／_」"	CALL PRINT_STRW,@"「呼ー呼ー呼ー呼……♪_／／／_」"
PRINTFORMW ニコニコと笑いながら%CALLNAME:TARGET%は%CALLNAME:MASTER%に抱き付いてくる。	PRINTFORMW %CALLNAME:TARGET%笑眯眯的抱住了%CALLNAME:MASTER%。
PRINTFORMW そして、%CALLNAME:MASTER%のモノをお腹ですりすりと撫でてくる。	PRINTFORMW 然后、轻轻抚摸着%CALLNAME:MASTER%的肉棒。
PRINTFORMW そして、服の裾を上げて%CALLNAME:MASTER%のモノを服の下に潜り込ませてお腹ですりすりと撫でてくる。	PRINTFORMW 然后、撩起衣服的下摆让%CALLNAME:MASTER%的肉棒伸进衣服下面用小腹摩擦抚摸着。
PRINTFORMW まるで、ここに自分の子宮があるのだと教えるように。	PRINTFORMW 就好像、在说自己的子宫在这里一样。
PRINTFORMW %CALLNAME:TARGET%が座っている%CALLNAME:MASTER%の足に水の感触がする。	PRINTFORMW %CALLNAME:TARGET%坐在%CALLNAME:MASTER%的腿上一会之后、%CALLNAME:MASTER%的腿上沾满了爱液。
PRINTFORMW どうやら、%CALLNAME:TARGET%は今の行為でだけで濡れてしまったようだ。	PRINTFORMW 看来、%CALLNAME:TARGET%也早就兴奋了。
CALL PRINT_STRW,@"「%CNAME("一人称")%のなかにいれてください_HH__HH__／／／_」"	CALL PRINT_STRW,@"「插进%CNAME("一人称")%的里面吧_HH__HH__／／／_」"
PRINTFORMW 言われるまでもない、%CALLNAME:MASTER%は%CALLNAME:TARGET%の膣に挿入れた。	PRINTFORMW 无需多言、%CALLNAME:MASTER%一挺腰、狠狠的插到了%CALLNAME:TARGET%的小穴最深处。
CALL PRINT_STRW,@"「んっ…_HH_ああっ_HH__HH_はいって_HH__HH_きましたぁ_HH__HH__HH_」"	CALL PRINT_STRW,@"「嗯…_HH_啊啊_HH__HH_哈啊进_HH__HH_来了_HH__HH__HH_」"
PRINTFORMW %CALLNAME:TARGET%は%CALLNAME:MASTER%に身体を預けてリラックスしている。	PRINTFORMW %CALLNAME:TARGET%放松的把身体交给了%CALLNAME:MASTER%。
PRINTFORMW 「このかっこう、なんだか安心します…」	PRINTFORMW 「这个姿势、总感觉很安心呢…」
PRINTFORMW %CALLNAME:TARGET%はそう言うとえへへと咲う。	PRINTFORMW %CALLNAME:TARGET%欸嘿嘿的笑着说道。
CALL PRINT_STRW,@"「んっ_／／／_」"	CALL PRINT_STRW,@"「嗯_／／／_」"
PRINTFORMW %CALLNAME:TARGET%は瞳を閉じてこちらを向いている。	PRINTFORMW %CALLNAME:TARGET%闭上眼睛然后把头转向这边。
PRINTFORMW ……どうやらキスをして欲しいようだ。	PRINTFORMW ……看起来是想要亲吻。
PRINTFORMW やれやれと思いながら%CALLNAME:MASTER%は%CALLNAME:TARGET%とキスをする。	PRINTFORMW 鸭累鸭累daze的想着的%CALLNAME:MASTER%吻住了%CALLNAME:TARGET%的红唇。
CALL PRINT_STRW,@"「ん…_HH_れろ_HH_んく_HH_はぁ_HH_はぁ…_HH_」"	CALL PRINT_STRW,@"「嗯…_HH_吸溜_HH_嗯咕_HH_哈啊_HH_哈啊…_HH_」"
CALL PRINT_STRW,@"「んふふ_／／／_」"	CALL PRINT_STRW,@"「嗯呼呼_／／／_」"
PRINTFORMW キスに応えたからか%CALLNAME:TARGET%は嬉しそうだ。	PRINTFORMW 如愿以偿的%CALLNAME:TARGET%感觉很高兴的样子。
PRINTFORMW しかし、今のキスで%CALLNAME:MASTER%はもう我慢が限界になった。	PRINTFORMW 但是、刚才的kiss已经让%CALLNAME:MASTER%到达了极限。
PRINTFORMW はち切れんばかりに大きくなったソレを不意打ち気味に%CALLNAME:TARGET%の膣に挿入れた。	PRINTFORMW 巨大的肉棒唐突的插入到了%CALLNAME:TARGET%小穴内。
CALL PRINT_STRW,@"「ひぅっ_HH_ひぐぅぅぅ_HH__WH__HH_」"	CALL PRINT_STRW,@"「咿_HH_咿咕唔_HH__WH__HH_」"
PRINTFORMW 瞳を閉じ身体を預けてる%CALLNAME:TARGET%に悪戯心が動いた%CALLNAME:MASTER%は	PRINTFORMW 看着完全任君采摘的%CALLNAME:TARGET%、%CALLNAME:MASTER%升起了恶作剧的想法
PRINTFORMW バレないように腰を動かして狙いを定める。	PRINTFORMW 小心翼翼不被她察觉的抱住她的腰把位置对好。
PRINTFORMW なんとかバレる前に狙いを付けれた%CALLNAME:MASTER%は一気に%CALLNAME:TARGET%の膣にいれた。	PRINTFORMW 总算在暴露前对准了的%CALLNAME:MASTER%一口气插进了%CALLNAME:TARGET%的小穴深处。
CALL PRINT_STRW,@"「ひぐぅ_HH__WH__HH__WH__HH__WH__HH_」"	CALL PRINT_STRW,@"「咿咕_HH__WH__HH__WH__HH__WH__HH_」"
PRINTFORMW 「このかっこう、%CNAME("二人称")%さんのお顔があんまりみえないですけど、」	PRINTFORMW 「这个姿势、看不到%CNAME("二人称")%的脸有点不好呢、」
CALL PRINT_STRW,@"「そのぶん、%CNAME("一人称")%のいやらしいお顔もみえないのできらいじゃないです_／／／_」"	CALL PRINT_STRW,@"「不过转过来想、%CNAME("一人称")%的表情也不会被看到了_／／／_」"
PRINTFORMW %CALLNAME:TARGET%は%CALLNAME:MASTER%に身体を預けて、上に赫い瞳をやりこちらを見つめてくる。	PRINTFORMW %CALLNAME:TARGET%将身体任凭%CALLNAME:MASTER%摆弄、赤红的眼眸看着这边。
CALL PRINT_STRW,@"「その…_／／／_、よかったらでいいのですが、%CNAME("一人称")%のことを抱きしめてもらえませんか？_／／／_」"	CALL PRINT_STRW,@"「那个…_／／／_、可以的话、能不能抱紧%CNAME("一人称")%呢？_／／／_」"
PRINTFORMW %CALLNAME:MASTER%は言葉を返さず、行動で返した。	PRINTFORMW %CALLNAME:MASTER%没有说话、静静的抱住了她。
CALL PRINT_STRW,@"「あっ…_／／／_ありがとうです_／／／_」"	CALL PRINT_STRW,@"「啊…_／／／_谢谢_／／／_」"
PRINTFORMW しばらく%CALLNAME:MASTER%は%CALLNAME:TARGET%を抱きしめていると、	PRINTFORMW 天长地久有时尽、此恨绵绵无绝期、
CALL PRINT_STRW,@"「ちょっと恥ずかしいですけど、%CNAME("一人称")%からいれますね_／／／_」"	CALL PRINT_STRW,@"「虽然有点害羞、但是让%CNAME("一人称")%来开始吧_／／／_」"
PRINTFORMW そう言うと%CALLNAME:TARGET%は腰を浮かせて……	PRINTFORMW 这么说着%CALLNAME:TARGET%把腰微微抬起、然后坐下……
CALL PRINT_STRW,@"「んっ…_HH_ああぁあ_HH_はぁ_HH_はぁ_HH_はいり_HH_ました_HH__HH_」"	CALL PRINT_STRW,@"「嗯…_HH_啊啊啊_HH_哈啊_HH_哈啊_HH_进来_HH_了_HH__HH_」"
PRINTFORMW 「このかっこうは%CNAME("二人称")%さんのお顔がみえないことが不満ですが」	PRINTFORMW 「这个姿势看不到%CNAME("二人称")%的脸有点不愉快的说」
PRINTFORMW そう言うと%CALLNAME:TARGET%は%CALLNAME:MASTER%の腕を取って包み込むように身体を抱かせる。	PRINTFORMW 这样说着%CALLNAME:TARGET%拉着%CALLNAME:MASTER%的双手环在自己腰上。
CALL PRINT_STRW,@"「こうやって、抱きしめてもらえるのは好きです_／／／_」"	CALL PRINT_STRW,@"「要这样、我喜欢被这样抱着_／／／_」"
PRINTFORMW 顔は見えないが%CALLNAME:TARGET%は今笑みを浮かべているだろう。	PRINTFORMW 虽然看不到脸、但也能听出%CALLNAME:TARGET%现在很开心。
CALL PRINT_STRW,@"「よいしょっと、じゃあいれますね_HH__HH_」"	CALL PRINT_STRW,@"「嘿咻、那么插进来了哦_HH__HH_」"
PRINTFORMW 腰を浮かせて、秘所の入り口に%CALLNAME:MASTER%のモノを当て……	PRINTFORMW 她抬起腰部、小穴对准了%CALLNAME:MASTER%的肉棒、然后一口气坐下……
CALL PRINT_STRW,@"「あっ…_HH_あああぁあぁああぁ_HH__HH_」"	CALL PRINT_STRW,@"「啊…_HH_啊啊啊啊啊啊_HH__HH_」"
PRINTFORMW 「むむっ、今日はこのかっこうからなんですね！」	PRINTFORMW 「姆姆、今天是从这个姿势开始啊！」
PRINTFORMW そう言う%CALLNAME:TARGET%はむふーっと嬉しそうだ。	PRINTFORMW %CALLNAME:TARGET%笑眯眯的说着。
PRINTFORMW 「%CNAME("一人称")%、このかっこう好きです！」	PRINTFORMW 「%CNAME("一人称")%、很喜欢这个姿势！」
PRINTFORMW 「だって、%CNAME("二人称")%さんを上から見れるから」	PRINTFORMW 「因为、能从上面看着%CNAME("二人称")%」
PRINTFORMW そう言う%CALLNAME:TARGET%の瞳は完全に捕食者の瞳だ。	PRINTFORMW %CALLNAME:TARGET%红宝石般的眼瞳里充满了捕食者的狂气。
PRINTFORMW %CALLNAME:MASTER%の命をしっかりと狙っている。	PRINTFORMW 宛如盯上了%CALLNAME:MASTER%的性命。
PRINTFORMW 「でも、%CNAME("二人称")%さんを殺しても死なないのはうれしいですけど」	PRINTFORMW 「但是、%CNAME("二人称")%就算被杀也不会死的说」
PRINTFORMW 「%CNAME("一人称")%がつけた傷が消えるのは、なんかなっとくいかないです！」	PRINTFORMW 「%CNAME("一人称")%刺的伤口都消失了、总感觉不爽！」
PRINTFORMW そう言って%CALLNAME:TARGET%は%CALLNAME:MASTER%の身体を触れる。	PRINTFORMW 这样说着%CALLNAME:TARGET%抚摸着%CALLNAME:MASTER%的身体。
PRINTFORMW 前回刺した場所、前々回刺した場所、前々々回刺した場所………、	PRINTFORMW 前次刺中的地方、前前次刺的地方、前前前次刺的地方………、
PRINTFORMW そして、最初に出会った時に刺した場所。	PRINTFORMW 然后是、最初相遇时被刺的地方、哪怕伤口不见了、依然能一一指出伤在何处。
PRINTFORMW ぞっとするくらいの記憶力。	PRINTFORMW 让人惊叹的记忆力。
PRINTFORMW 「じつは一回一回かえてるのですよ？」	PRINTFORMW 「实际上每次我都有记录的哦？」
PRINTFORMW 赫い瞳は%CALLNAME:MASTER%を捉えて離さない。	PRINTFORMW 赤红的眼瞳死死的盯着%CALLNAME:MASTER%。
CALL PRINT_STRW,@"「それはともかく、はじめましょう？_HH_」"	CALL PRINT_STRW,@"「不说了、让我们开始吧？_HH_」"
PRINTFORMW そう言って%CALLNAME:TARGET%は腰を浮かし%CALLNAME:MASTER%のモノを一気に挿入れた。	PRINTFORMW 这样说着%CALLNAME:TARGET%抬起腰然后一口气把%CALLNAME:MASTER%的肉棒吞入。
CALL PRINT_STRW,@"「ん゛んんっ_HH__HH_%CNAME("二人称")%さんの……_HH_おちんちんさん_HH_たべちゃいました_HH__HH_」"	CALL PRINT_STRW,@"「嗯゛嗯嗯っ_HH__HH_%CNAME("二人称")%的……_HH_大鸡巴_HH_被我吃掉了_HH__HH_」"
PRINTFORMW 「今日は%CNAME("一人称")%が上からではじめるのですね」	PRINTFORMW 「今天让%CNAME("一人称")%在上开始吗」
PRINTFORMW そう言って%CALLNAME:TARGET%は%CALLNAME:MASTER%の上に跨った。	PRINTFORMW %CALLNAME:TARGET%跨站在%CALLNAME:MASTER%身上。
PRINTFORMW 「む？むむっ？」	PRINTFORMW 「姆？姆姆？」
PRINTFORMW %CALLNAME:TARGET%は%CALLNAME:MASTER%の身体を見て何かを探している様だ。	PRINTFORMW %CALLNAME:TARGET%似乎在找%CALLNAME:MASTER%身上的什么东西的样子。
PRINTFORMW 「昨日、%CNAME("一人称")%がつけた傷がないです！」	PRINTFORMW 「昨天、%CNAME("一人称")%杀你留下的伤口不见了！」
PRINTFORMW なんてものをさがしてるのだ。	PRINTFORMW 你到底在找什么啊口牙。
PRINTFORMW 「だって%CNAME("一人称")%が%CNAME("二人称")%さんにできることって殺すことかえっちくらいしかないですからっ」	PRINTFORMW 「因为%CNAME("一人称")%能为%CNAME("二人称")%做的事情就只有杀你还有和你做爱了啊」
PRINTFORMW 他にもっとあるよ。	PRINTFORMW 其他还有的啊魂淡。
PRINTFORMW 「うー、でもぉ……」	PRINTFORMW 「唔ー、但是……」
PRINTFORMW 良く分からないことに駄々こねる%CALLNAME:TARGET%を置いておき%CALLNAME:MASTER%は%CALLNAME:TARGET%の腰を持ち上げ、	PRINTFORMW 没有理会还在纠结着伤口的%CALLNAME:TARGET%、%CALLNAME:MASTER%托起%CALLNAME:TARGET%的腰、
PRINTFORMW そのまま、押し込んで%CALLNAME:TARGET%の膣に突き立てた。	PRINTFORMW 然后就这样、直接放开%CALLNAME:TARGET%把肉棒直接吞入。
CALL PRINT_STRW,@"「ひぎぃっ_HH__WH__HH__WH__HH__WH__HH_ふいっ_HH_うちっ_HH_はっ_HH_やめてっ_HH_くださいっ_HH__HH_」"	CALL PRINT_STRW,@"「咿呀っ_HH__WH__HH__WH__HH__WH__HH_呼咿_HH_偷袭_HH_太_HH_耍赖_HH_啦_HH__HH_」"
PRINTFORMW 「今日はさいしょは%CNAME("一人称")%が上なんですね」	PRINTFORMW 「今天最开始是%CNAME("一人称")%在上啊」
PRINTFORMW 騎乗位からすると言われた%CALLNAME:TARGET%は%CALLNAME:MASTER%に跨る。	PRINTFORMW %CALLNAME:TARGET%跨站在%CALLNAME:MASTER%身上。
PRINTFORMW 「あっ…」	PRINTFORMW 「啊…」
PRINTFORMW %CALLNAME:TARGET%は何かに気が付いたのか%CALLNAME:MASTER%の腹部から瞳を外さない。	PRINTFORMW %CALLNAME:TARGET%似乎注意到什么紧紧的盯着%CALLNAME:MASTER%的腹部。
PRINTFORMW どうかしたのかと問うと	PRINTFORMW 问她发生什么了
PRINTFORMW 「い、いいえ、ちょっとだけ%CNAME("一人称")%がつけた傷がないなーっておもっただけですっ」	PRINTFORMW 「没、没什么、稍微有点在意之前%CNAME("一人称")%刺出的伤口怎么不见啦这件事情」
PRINTFORMW どうやら%CALLNAME:TARGET%は%CALLNAME:MASTER%の腹部に傷が無いのが残念なようだ。	PRINTFORMW 看起来%CALLNAME:TARGET%似乎对%CALLNAME:MASTER%腹部的伤口消失了感觉很可惜。
PRINTFORMW 普通の女の子になると言っていたが、変なこじれ方したなぁと思ってしまう。	PRINTFORMW 虽然嘴上说要做普通的女孩子、但是还是有点奇怪的地方啊。
PRINTFORMW だが、それはそれ、これはこれ。	PRINTFORMW 但是、一码归一码。
PRINTFORMW %CALLNAME:TARGET%が%CALLNAME:MASTER%に刻むことは無理だが%CALLNAME:MASTER%が%CALLNAME:TARGET%に刻む事は出来る。	PRINTFORMW %CALLNAME:TARGET%没办法在%CALLNAME:MASTER%身上留下印记、但是%CALLNAME:MASTER%却能在%CALLNAME:TARGET%身上留下。
PRINTFORMW 腰をゆすって挿入れると合図を送る。	PRINTFORMW 抚了抚腰、提醒了她要插入了。
CALL PRINT_STRW,@"「あっ……はいっ_／／／_」"	CALL PRINT_STRW,@"「啊……好_／／／_」"
PRINTFORMW %CALLNAME:TARGET%が腰を上げ秘所の入り口を%CALLNAME:MASTER%のモノにくっ付ける。	PRINTFORMW %CALLNAME:TARGET%抬起腰部、对准%CALLNAME:MASTER%的肉棒。
PRINTFORMW そして、%CALLNAME:MASTER%が腰に手をそえ、腰を下ろさせた。	PRINTFORMW 然后、%CALLNAME:MASTER%拉着她的腰、用力往下。
CALL PRINT_STRW,@"「んっ、ん゛ぃっ…_HH__HH_はぁ_HH_はぁ_HH_」"	CALL PRINT_STRW,@"「嗯、嗯゛好…_HH__HH_哈啊_HH_哈啊_HH_」"
CALL PRINT_STRW,@"「%CNAME("二人称")%さんのおちんちんさん、%CNAME("一人称")%のここまで入るのですね…_／／／_」"	CALL PRINT_STRW,@"「%CNAME("二人称")%的大鸡巴、就这样插进%CNAME("一人称")%的里面…_／／／_」"
PRINTFORMW %CALLNAME:MASTER%の上に跨った%CALLNAME:TARGET%は%CALLNAME:MASTER%のモノをお腹ですりすりと撫で顔を赤らめている。	PRINTFORMW %CALLNAME:MASTER%跨在%CALLNAME:TARGET%身上、%CALLNAME:MASTER%的大鸡巴摩擦着她的小腹让她面红耳赤。
PRINTFORMW %CALLNAME:MASTER%の上に跨った%CALLNAME:TARGET%は服の中に潜り込ませた%CALLNAME:MASTER%のモノをお腹ですりすりと撫で顔を赤らめている。	PRINTFORMW %CALLNAME:MASTER%的大鸡巴伸入了%CALLNAME:TARGET%的衣服下摆之中、大鸡巴摩擦着她的小腹让%CALLNAME:TARGET%满面通红。
PRINTFORMW ふと、%CALLNAME:MASTER%のモノに水気を感じる。	PRINTFORMW 突然、%CALLNAME:MASTER%的大鸡巴上沾上了湿润的淫液。
PRINTFORMW ぽたっ……つつぅ……	PRINTFORMW 滴滴答答…………
PRINTFORMW 勘違いではない、どうやら%CALLNAME:TARGET%は想像だけで濡れてしまったようだ。	PRINTFORMW 没有猜错、%CALLNAME:TARGET%的肉穴早已万事俱备、只欠东风。
CALL PRINT_STRW,@"「………？……あっ！_／／／_じゃ、じゃあいれますね！_／／／_」"	CALL PRINT_STRW,@"「………？……啊！_／／／_那、就插进去了！_／／／_」"
PRINTFORMW %CALLNAME:MASTER%が気が付いたのに気付いたのか%CALLNAME:TARGET%は捲し立てる様に言って挿入れようとしたが	PRINTFORMW 没有理会%CALLNAME:MASTER%有没有听到、只是说了一句要插进来之后%CALLNAME:TARGET%缓缓坐下
PRINTFORMW 膝を滑らせて重力にそのまま膣の深い所まで入った。	PRINTFORMW 因为重力的原因肉棒一口气插到了淫穴的最深处。
CALL PRINT_STRW,@"「ひぐぅっ_HH__H__HH__H__HH__H__HH_」"	CALL PRINT_STRW,@"「咿咕_HH__H__HH__H__HH__H__HH_」"
PRINTFORMW ゲーム中にここが出たらエラー報告してください。	PRINTFORMW 游戏中看到这句话就代表出bug了、请报告相关bug。
PRINTFORMW 「ぐちゃぐちゃにしてください……」	PRINTFORMW 「让我变得乱七八糟的吧……」
PRINTFORMW 「お願いですっ………！」	PRINTFORMW 「求求你了………！」
PRINTFORMW 「セックスですね！わかりました！」	PRINTFORMW 「Sex吗！我知道了！」
PRINTFORMW 度重なるセックスのお陰で大分%CALLNAME:TARGET%は感じるようになったからか	PRINTFORMW 一次次的做爱也让%CALLNAME:TARGET%能充分的感受到性爱的快乐
PRINTFORMW %CALLNAME:MASTER%に言われた体位をしている。セックスに対して積極的になったようだ。	PRINTFORMW %CALLNAME:MASTER%说的任何姿势也能做到。对于做爱也是积极的态度了。
PRINTFORMW 「セックスさいしょはぐぐってかんじで、あんまりふわふわしませんでしたけど」	PRINTFORMW 「虽然最开始做爱总觉得胀的难受、没什么舒服的」
PRINTFORMW 「さいきんはいっぱいふわふわできるようになりました！」	PRINTFORMW 「但是最近已经开始能感觉很舒服了！」
PRINTFORMW 「うぅ…まだおまんこがじくじくします…」	PRINTFORMW 「唔…小穴又要变得丝丝拉拉的刺痛了…」
CALL PRINT_STRW,@"「あっあっあっ_HH__HH_はぁ～～～～っ_HH__HH_ひゃぁあっ_HH__HH__HH_」"	CALL PRINT_STRW,@"「啊啊啊啊_HH__HH_哈啊～～～～_HH__HH_咿呀啊嗯_HH__HH__HH_」"
CALL PRINT_STRW,@"「%CNAME("一人称")%、このたいせい_HH_すきです_HH__HH_」"	CALL PRINT_STRW,@"「%CNAME("一人称")%、喜欢这个_HH_姿势_HH__HH_」"
CALL PRINT_STRW,@"「あぎっ_HH_ひぃ_HH__HH_ぃ゛いい_HH_ぁ゛あ……ッ_HH_あ゛っ_HH_あ゛っ_HH__HH_っあ゛あ゛あ゛ぁ゛っっっ_HH__HH__HH_」"	CALL PRINT_STRW,@"「啊咿_HH_咿_HH__HH_咿゛咿咿_HH_啊゛啊……_HH_啊゛啊_HH_啊゛_HH__HH_啊゛啊゛啊゛啊゛_HH__HH__HH_」"
CALL PRINT_STRW,@"「もっと_HH_んンっ_HH_おくにっ_HH__HH_ください_HH__HH_」"	CALL PRINT_STRW,@"「用力_HH_插进_HH_最深处_HH__HH_嗯嗯_HH__HH_」"
CALL PRINT_STRW,@"「あっ_HH_あっ_HH_あっ_HH_んんんっ_HH__HH_あぅっ_HH_んっ_HH__HH_」"	CALL PRINT_STRW,@"「啊_HH_啊_HH_啊_HH_嗯嗯嗯_HH__HH_啊_HH_嗯_HH__HH_」"
CALL PRINT_STRW,@"「すごいっ_HH_ですっ_HH_ふわふわっ_HH_でっ_HH__HH_」"	CALL PRINT_STRW,@"「好舒服_HH_嗯_HH_好爽_HH_啊_HH__HH_」"
CALL PRINT_STRW,@"「おまんこがっ_HH_おまんこがっ_HH__HH_」"	CALL PRINT_STRW,@"「小穴里_HH_好舒服_HH__HH_」"
CALL PRINT_STRW,@"「ふわって_HH_ふわって_HH_します_HH__HH_」"	CALL PRINT_STRW,@"「好爽_HH_好舒服_HH_用力_HH__HH_」"
CALL PRINT_STRW,@"「ぁあっ_HH_はっ_HH_ああ……っ_HH_んぐっ_HH_やぁっっ_HH__HH_あ゛っあ゛っあ゛っ_HH__HH__HH_」"	CALL PRINT_STRW,@"「啊啊_HH_哈_HH_啊……_HH_嗯咕_HH_咿呀_HH__HH_啊゛啊゛啊゛_HH__HH__HH_」"
CALL PRINT_STRW,@"灰色_「だめっ_HH__灰色_です_HH_%CNAME("一人称")%、そんなにされたらっ_HH__HH_」"	CALL PRINT_STRW,@"灰色_「不行_HH__灰色_的说_HH_那样弄的话_HH__HH_」"
CALL PRINT_STRW,@"灰色_「あんっ_HH__灰色_んんっ_HH_なかで_HH_おちんちんさんが_HH_おおきくなってっ_HH__HH_」"	CALL PRINT_STRW,@"灰色_「啊嗯_HH__灰色_嗯嗯_HH_里面_HH_大鸡巴搅的好舒服_HH_好棒_HH__HH_」"
CALL PRINT_STRW,@"「しゅきぃ_HH_すきぃ_HH_だいしゅきですっ_HH__HH_」"	CALL PRINT_STRW,@"「稀饭_HH_喜欢_HH_最喜欢了_HH__HH_」"
CALL PRINT_STRW,@"暗灰色_「%CNAME("一人称")%をっ_HH__灰色_%CNAME("一人称")%をっ_HH_はなさないでっ_HH__HH_」"	CALL PRINT_STRW,@"暗灰色_「%CNAME("一人称")%_HH__灰色_不要放开%CNAME("一人称")%_HH_嗯嗯_HH__HH_」"
CALL PRINT_STRW,@"灰色_「おちんちんさんがっ_HH__HH_そこっ_HH_そこですっ_HH__HH_」"	CALL PRINT_STRW,@"灰色_「大鸡巴_HH__HH_就是那_HH_用力_HH__HH_」"
CALL PRINT_STRW,@"「あっ_HH_あっ_HH_あっ_HH_お゛っ_HH__HH_ふく゛っ_HH_あ゛っ_HH__HH__HH_」"	CALL PRINT_STRW,@"「啊_HH_啊_HH_啊_HH_啊゛_HH__HH_呼゛_HH_啊゛_HH__HH__HH_」"
CALL PRINT_STRW,@"「そんなにっ……_HH_ひぅっ_HH_おまんこのなかっ_HH_か、かきまわしちゃ_HH_だめっです_HH__HH_」"	CALL PRINT_STRW,@"「那样插……_HH_咿_HH_小穴的深处_HH_、会爽的什么都不知道的_HH_啊嗯_HH__HH_」"
CALL PRINT_STRW,@"「あっ……_HH_おねがいっ_HH_あぅっ_HH_です_HH__HH_%CNAME("一人称")%を……_HH__HH_あぁっ！_HH_だきしめてっ_HH_んぁぅっ_HH_くださいっ……_HH__HH_」"	CALL PRINT_STRW,@"「啊……_HH_求求你_HH_啊_HH_嗯_HH__HH_抱紧%CNAME("一人称")%……_HH__HH_啊！_HH_嗯嗯_HH_啊_HH_嗯嗯嗯……_HH__HH_」"
CALL PRINT_STRW,@"「てを、てをっ_HH__HH_にぎって、にぎってっ_HH_くださいっ……_HH__HH_」"	CALL PRINT_STRW,@"「握紧、握紧_HH__HH_我的手、请握紧_HH_嗯啊……_HH__HH_」"
CALL PRINT_STRW,@"「んんんっ_HH__HH_おまんこのおく_HH_までっ……_HH_ひびいてますっ_HH__HH_」"	CALL PRINT_STRW,@"「嗯嗯嗯_HH__HH_插到小穴的_HH_深处了……_HH_好舒服_HH__HH_」"
CALL PRINT_STRW,@"「なかに……_HH_なかに_HH_らしてくださいっ_HH__HH_」"	CALL PRINT_STRW,@"「在里面……_HH_在里面_HH_射出来吧_HH__HH_」"
CALL PRINT_STRW,@"「はぁ～～～～っ_HH__HH__HH_はぁ～～～～っ_HH__HH__HH_」"	CALL PRINT_STRW,@"「哈啊～～～～_HH__HH__HH_哈啊～～～～っ_HH__HH__HH_」"
CALL PRINT_STRW,@"「はぁ……はぁ……_HH_んっ…_HH_んぅっ……_HH_あっ_HH_ああぁ_HH_んっ……_HH_んぁっ_HH_」"	CALL PRINT_STRW,@"「哈啊……哈啊……_HH_嗯…_HH_嗯……_HH_啊_HH_啊啊啊_HH_嗯……_HH_嗯啊_HH_」"
CALL PRINT_STRW,@"「んっ、んんっ_HH__HH_あっ_HH_んんんっ_HH_」"	CALL PRINT_STRW,@"「嗯、嗯嗯_HH__HH_啊_HH_嗯嗯嗯_HH_」"
CALL PRINT_STRW,@"「んっ、んっ……、んぁっ……_HH_んっ、んんっ_HH_」"	CALL PRINT_STRW,@"「嗯、嗯……、嗯啊……_HH_嗯、嗯嗯_HH_」"
CALL PRINT_STRW,@"「あっ_HH_あっ_HH_あっ_HH_」"	CALL PRINT_STRW,@"「啊_HH_啊_HH_啊_HH_」"
CALL PRINT_STRW,@"「んぐぅ、はぁ…はぁ…はぁ…」"	CALL PRINT_STRW,@"「嗯咕、哈啊…哈啊…哈啊…」"
PRINTFORMW 「このかっこう、%CNAME("一人称")%知ってます！」 	PRINTFORMW 「这个姿势、%CNAME("一人称")%知道！」
PRINTFORMW どうやら珍しく%CALLNAME:TARGET%の知識の中にあるらしい。	PRINTFORMW %CALLNAME:TARGET%居然知道这个姿势。
PRINTFORMW 「%CNAME("二人称")%さんと会う前に犬さんがこのかっこうでじゃれあってるのを見たことがあります！」	PRINTFORMW 「遇到%CNAME("二人称")%之前见过狗狗们用这个姿势！」
PRINTFORMW じゃあこれからそれを再現しようか。	PRINTFORMW 那就让我们 历 史 重 现。
PRINTFORMW そう言って%CALLNAME:MASTER%は%CALLNAME:TARGET%の秘所に乱暴に突き立てた。	PRINTFORMW 然后%CALLNAME:MASTER%用力的抽插着%CALLNAME:TARGET%小穴。
CALL PRINT_STRW,@"「くっ、きゅぅんんっ_HH__HH__HH_」" 	CALL PRINT_STRW,@"「咕、咿嗯嗯_HH__HH__HH_」"
CALL PRINT_STRW, @"「おひっ_HH_あっ_HH_あっ_HH_お゛っ_HH_お゛っ_HH_お゛っ_HH_」"	CALL PRINT_STRW, @"「哦咿_HH_啊_HH_啊_HH_哦゛_HH_哦゛_HH_啊゛_HH_」"
PRINTFORMW 獣のような喘ぎ声を上げながらも%CALLNAME:TARGET%は%CALLNAME:MASTER%を抱きしめて離さない。	PRINTFORMW %CALLNAME:TARGET%紧紧的抱着%CALLNAME:MASTER%发出野兽一样的浪叫声。
CALL PRINT_STRW, @"「あはっ_HH_ああぁっ_HH_あははっ_HH_お゛っ_HH__HH_お゛っお゛っお゛っ_HH_」"	CALL PRINT_STRW, @"「啊哈_HH_啊啊_HH_啊哈哈_HH_哦゛_HH__HH_哦゛哦゛哦゛嗯_HH_」"
CALL PRINT_STRW, @"「お゛っお゛っお゛っ_HH_あ゛ぁぁっ_HH_あひっ_HH_あっ_HH_ああ゛っ_HH_あ゛っ_HH_あ゛っ_HH_あ゛っ_HH_」"	CALL PRINT_STRW, @"「哦゛哦゛哦゛_HH_啊゛啊啊_HH_啊咿_HH_啊_HH_啊啊゛_HH_啊゛_HH_啊゛_HH_啊゛_HH_」"
CALL PRINT_STRW, @"「なかっ_HH_なかがっ_HH_あひっ_HH_いいれすっ_HH_あっ_HH_あっ_HH_あ゛っ_HH_らしてくださいっ_HH__HH_」"	CALL PRINT_STRW, @"「用力_HH_用力_HH_插到_HH_最深处_HH_啊_HH_啊_HH_啊゛_HH_嗯啊啊_HH__HH_」"
PRINTFORMW 「えへへ～♪%CNAME("二人称")%さんのお顔がよく見えますっ！」	PRINTFORMW 「欸嘿嘿～♪可以看到%CNAME("二人称")%的脸！」
PRINTFORMW 「ん～♪%CNAME("二人称")%さんのくっ付いてるとあったかいです……」	PRINTFORMW 「嗯～♪和%CNAME("二人称")%贴在一起好温暖……」
PRINTFORMW 「%CNAME("二人称")%さんと抱きあってると安心します……」	PRINTFORMW 「被%CNAME("二人称")%抱着很安心呢……」
%CALLNAME:MASTER%と%CALLNAME:TARGET%は一度抱き合った後に少しだけ離れて軽く言葉を交わした。	两人相拥、良久、稍微离开了一点然后轻轻的说着情话。
CALL PRINT_STRW, @"「んっ……_HH_きゅうくつかもしれませんが、」"	CALL PRINT_STRW, @"「嗯……_HH_虽然感觉有点挤、」"
CALL PRINT_STRW, @"「うごく前にキスしたいですっ！ダメ、ですか……？」"	CALL PRINT_STRW, @"「但是想在做之前先kiss一下！不行吗……？」"
PRINTFORMW やれやれと、軽く口づけを交わす。	PRINTFORMW 真拿你没办法、然后吻住了她的朱唇。
PRINTFORMW 「んっ……、えへへ～♪」	PRINTFORMW 「嗯……、欸嘿嘿～♪」
PRINTFORMW 交わした唇が離れると、%CALLNAME:TARGET%は無邪気に咲う。	PRINTFORMW 两人小啄了一口便分开看着对方、%CALLNAME:TARGET%天真无邪的笑了笑。
PRINTFORMW そして、ゆっくりと%CALLNAME:TARGET%の膣を確かめる様に動き始めた。	PRINTFORMW 随后、缓慢的在%CALLNAME:TARGET%的肉穴内开始抽插。
CALL PRINT_STRW, @"「ひゃっ、あはっ_HH_ぁんっ_HH_あっ_HH_」"	CALL PRINT_STRW, @"「咿呀、啊哈_HH_嗯_HH_啊_HH_」"
CALL PRINT_STRW, @"「んっ、ぐっ……はぁ……はぁ……あっ_HH_」"	CALL PRINT_STRW, @"「嗯、咕……哈啊……哈啊……啊_HH_」"
PRINTFORMW ガチガチに勃起した%CALLNAME:MASTER%のモノが%CALLNAME:TARGET%の柔らかなお腹に当たっているのをちらりと見て	PRINTFORMW %CALLNAME:MASTER%勃起怒张的肉棒碰在%CALLNAME:TARGET%的腹部上
PRINTFORMW 服越しだがガチガチ勃起した%CALLNAME:MASTER%のモノが%CALLNAME:TARGET%のお腹に当たっているのをちらりと見て81	PRINTFORMW %CALLNAME:MASTER%勃起怒张的肉棒隔着衣服碰在%CALLNAME:TARGET%的腹部上
CALL PRINT_STRW, @"「んっ……_HH_もうおっきくなってますね……_HH_」"	CALL PRINT_STRW, @"「嗯……_HH_已经变得这么大了呢……_HH_」"
CALL PRINT_STRW, @"「いれる前にキスしたいですっ！ダメ、ですか……？」"	CALL PRINT_STRW, @"「插进来之前我想要亲亲！不行吗……？」"
PRINTFORMW そして、ゆっくりと%CALLNAME:TARGET%の膣を確かめる様に挿入れた。	PRINTFORMW 随后、缓慢的在%CALLNAME:TARGET%的肉穴内开始抽插。。
CALL PRINT_STRW,@"「んっ、んんっ_HH_あはっ_HH_はいってきましたっ_HH_」"	CALL PRINT_STRW,@"「嗯、嗯嗯_HH_啊哈_HH_进来了_HH_」"
%CALLNAME:TARGET%は%CALLNAME:MASTER%の首に腕をまわしているが顔は離れていて蕩けた顔がよく見える。	PRINTFORMW %CALLNAME:TARGET%伸出手环抱着%CALLNAME:MASTER%的脖子、可以看到她那洋溢着荡漾之情的面孔。
CALL PRINT_STRW,@"「あはっ_HH_あんっ_HH_あっ_HH_んぁっ_HH_あぁっ_HH__HH_」"	CALL PRINT_STRW,@"「啊哈_HH_啊嗯_HH_啊_HH_嗯啊_HH_啊啊啊_HH__HH_」"
CALL PRINT_STRW,@"「あっあっあっ_HH_%CNAME("二人称")%さんの_HH_おちんちんさんが_HH_」"	CALL PRINT_STRW,@"「啊啊啊_HH_%CNAME("二人称")%的_HH_大肉棒_HH_」"
CALL PRINT_STRW,@"「%CNAME("一人称")%のっ_HH_なかをっ_HH_かき_HH_まわしてっ_HH__HH_」"	CALL PRINT_STRW,@"「在%CNAME("一人称")%_HH_的里面_HH_搅动_HH_着嗯嗯_HH__HH_」"
CALL PRINT_STRW, @"「あはっ_HH_あっあっあっ_HH_あぁぁっ_HH_あっ_HH__HH_」"	CALL PRINT_STRW, @"「啊哈_HH_啊啊啊_HH_啊啊啊_HH_啊_HH__HH_」"
快楽に流されて%CALLNAME:TARGET%は顔を蕩けさせながら盛大に喘いでいる。	PRINTFORMW 享受着快乐的%CALLNAME:TARGET%脸上挂着淫荡的表情大声淫叫着。
CALL PRINT_STRW, @"「おちんちんさんが_HH_おっきくなってますっ_HH_なかにっ_HH_だしてっ_HH_だしてくださいっ_HH__HH_」"	CALL PRINT_STRW, @"「大鸡巴_HH_变大了_HH_在我的_HH_里面_HH_射出来_HH__HH_」"
CALL PRINT_STRW, @"灰色_「は～～～～っ_HH__灰色_あ゛っ_HH__灰色_は～～～～っ_HH_HH__灰色_ん゛ぁっ_HH__灰色_ん゛んっ_HH__灰色_」"	CALL PRINT_STRW, @"灰色_「哈～～～～っ_HH__灰色_啊゛_HH__灰色_哈～～～～_HH_HH__灰色_嗯゛啊_HH__灰色_嗯゛嗯_HH__灰色_」"
PRINTFORMW 絶頂を繰り返して息も絶え絶えで顔もぐちゃぐちゃな%CALLNAME:TARGET%だが、%CALLNAME:MASTER%を抱きしめた腕は離れない。	PRINTFORMW 不断的绝顶让%CALLNAME:TARGET%的表情早已淫乱不堪、淫叫也越来越小、但是抱住%CALLNAME:MASTER%的手却依旧抱得紧紧的。
CALL PRINT_STRW, @"灰色_「は～～～～っ_HH_灰色_あ゛_HH_灰色_は～～～～っ_HH_灰色_ん゛あっ_HH_灰色_あ゛っ_HH_」"	CALL PRINT_STRW, @"灰色_「哈～～～～っ_HH_灰色_啊゛_HH_灰色_哈～～～～っ_HH_灰色_嗯゛啊_HH_灰色_啊゛っ_HH_」"
CALL PRINT_STRW,@"灰色_「あ゛っ_HH__灰色_ん゛っ_HH__灰色_あ゛ぁぁっ_HH__灰色_あひっ_HH__灰色_あっ_HH__灰色_あっ_HH__灰色_あっ_HH__灰色_」"	CALL PRINT_STRW,@"灰色_「啊゛_HH__灰色_嗯゛_HH__灰色_啊゛啊啊_HH__灰色_啊咿_HH__灰色_啊_HH__灰色_啊_HH__灰色_啊_HH__灰色_」"
CALL PRINT_STRW,@"暗灰色_「あっ_HH__灰色_あっ_HH_なかにっ_HH_くらさいっ_HH_おねっ、あ゛っ_HH_おねがいですっ_HH_」"	CALL PRINT_STRW,@"暗灰色_「啊_HH__灰色_啊_HH_大力_HH_插深点_HH_用力、啊゛_HH_插进来_HH_」"
CALL PRINT_STRW,@"「%CNAME("二人称")%さんのお顔が近いです……_／／／_」"	CALL PRINT_STRW,@"「%CNAME("二人称")%的脸离得好近……_／／／_」"
CALL PRINT_STRW,@"「あ、あんまり%CNAME("一人称")%のお顔見ないでほしいです……_／／／_」"	CALL PRINT_STRW,@"「那、能不能不要太盯着%CNAME("一人称")%的脸看……_／／／_」"
CALL PRINT_STRW,@"「少しだけ恥ずかしいです……_／／／_」"	CALL PRINT_STRW,@"「稍微有点害羞……_／／／_」"
%CALLNAME:TARGET%は顔を真っ赤にして%CALLNAME:MASTER%から逸らしてはいるが確りと抱きついている。	PRINTFORMW %CALLNAME:TARGET%脸颊通红的避开了看着她的视线然后抱住了%CALLNAME:MASTER%。
CALL PRINT_STRW,@"「……えっと、そのっ、うごく前にキス、したいです……_／／／_」"	CALL PRINT_STRW,@"「……哪个、嗯、做之前、想要亲亲……_／／／_」"
PRINTFORMW 顔をさらに赤くして視線を斜め下にしながら%CALLNAME:MASTER%の方へ顔を向けて、	PRINTFORMW 她满面通红的移开视线然后把脸凑了过来、
CALL PRINT_STRW,@"「ダメです、か……？_／／／_」"	CALL PRINT_STRW,@"「不行、吗……？_／／／_」"
PRINTFORMW ちゃんと%CALLNAME:MASTER%を見据えて聞いてきた。	PRINTFORMW 然后目不转睛的看着%CALLNAME:MASTER%。
PRINTFORMW 頷いて、軽くキスを交わす。	PRINTFORMW 点了点头、嘴唇相接。
CALL PRINT_STRW,@"「あっ……_／／／_ん……、あ、ありが_灰色_とう_暗灰色_です……」"	CALL PRINT_STRW,@"「啊……_／／／_嗯……、啊、谢_灰色_谢_暗灰色_嗯……」"
PRINTFORMW 恥ずかしくなったのかドンドン声が小さくなっていく。	PRINTFORMW 似乎是开始放松下来了、喘息声也逐渐平缓了下来。
PRINTFORMW そして、%CALLNAME:MASTER%はゆっくりと腰を動かし始めた。	PRINTFORMW 然后、%CALLNAME:MASTER%慢慢的动起了腰。
CALL PRINT_STRW,@"灰色_「あっ、ひゃっ_HH_あぅっ_HH_あっ_HH_」"	CALL PRINT_STRW,@"灰色_「啊、咿呀_HH_啊_HH_啊_HH_」"
CALL PRINT_STRW,@"「んぐっ……、あっ……、あっ……_HH_」"	CALL PRINT_STRW,@"「嗯咕……、啊……、啊……_HH_」"
PRINTFORMW ガチガチに勃起した%CALLNAME:MASTER%のモノが%CALLNAME:TARGET%の柔らかなお腹に当たる。	PRINTFORMW %CALLNAME:MASTER%勃起怒张的肉棒碰在%CALLNAME:TARGET%的腹部上。
PRINTFORMW 服越しだがガチガチ勃起した%CALLNAME:MASTER%のモノが%CALLNAME:TARGET%のお腹に当たる。	PRINTFORMW %CALLNAME:MASTER%勃起怒张的肉棒隔着衣服碰在%CALLNAME:TARGET%的腹部上。
CALL PRINT_STRW,@"「あっ……_／／／_、あぅ……_／／／__暗灰色_こんなにおおきく……」"	CALL PRINT_STRW,@"「啊……_／／／_、啊……_／／／__暗灰色_插的好深……」"
CALL PRINT_STRW,@"「……えっと、そのっ、いれる前にキス、したいです……_／／／_」"	CALL PRINT_STRW,@"「……哪个、嗯、做之前、想要亲亲……_／／／_」"
CALL PRINT_STRW,@"「あっ……_／／／_ん……、あ、ありが_灰色_とう_暗灰色_です……_／／／__暗灰色_」"	CALL PRINT_STRW,@"「啊……_／／／_嗯……、啊、谢_灰色_谢_暗灰色_嗯……_／／／__暗灰色_」"
PRINTFORMW そして、%CALLNAME:MASTER%はゆっくりと%CALLNAME:TARGET%の膣に深く挿入した。	PRINTFORMW 然后、%CALLNAME:MASTER%慢慢的动起了腰。
CALL PRINT_STRW,@"「んっ……_HH_んんっ_HH__HH_んっ_HH_」"	CALL PRINT_STRW,@"「嗯……_HH_嗯嗯_HH__HH_嗯_HH_」"
PRINTFORMW %CALLNAME:TARGET%は%CALLNAME:MASTER%の肩に顔をうずめて漏れ出る声を必死に押し殺している。	PRINTFORMW %CALLNAME:TARGET%把脸放在%CALLNAME:MASTER%的肩膀处然后拼命的压住自己的声音。
CALL PRINT_STRW,@"灰色_「んっ……ふっ_HH_あっ_HH__灰色_んんっ_HH__灰色_」"	CALL PRINT_STRW,@"灰色_「嗯……呼_HH_啊_HH__灰色_嗯嗯_HH__灰色_」"
CALL PRINT_STRW,@"灰色_「んぅっ_HH_ひゃっ_HH_お、おちんちんさんが……%CNAME("一人称")%のなかで_／／／_」"	CALL PRINT_STRW,@"灰色_「嗯_HH_咿呀_HH_肉、肉棒插到……%CNAME("一人称")%的里面了_／／／_」"
CALL PRINT_STRW,@"灰色_「あっ_HH_あぁっ_HH_あっあっあっ_HH__灰色_んぐっ_HH__灰色_んんっ_HH__灰色_んんんんっ_HH__HH__灰色_」"	CALL PRINT_STRW,@"灰色_「啊_HH_啊_HH_啊啊啊_HH__灰色_嗯咕_HH__灰色_嗯嗯_HH__灰色_嗯嗯嗯_HH__HH__灰色_」"
CALL PRINT_STRW,@"灰色_「んんっ……_HH__灰色_んんんっ……_HH_ひぐぅっ_HH_あっあっあっ_HH__HH_」"	CALL PRINT_STRW,@"灰色_「嗯嗯……_HH__灰色_嗯嗯嗯……_HH_咿咕_HH_啊啊啊_HH__HH_」"
PRINTFORMW 必死に喘ぎ声を我慢していた%CALLNAME:TARGET%だが、絶頂が近いのか声が漏れ始めている。	PRINTFORMW 虽然%CALLNAME:TARGET%全力的压住自己的声音、但是快要绝顶的时候、声音还是逐渐的漏了出来。
CALL PRINT_STRW,@"「んぐっ_HH_あぁっ_HH_あっ_HH_なかっ_HH_あっ_HH_あっ_HH_なかにぃッ_HH__HH_」"	CALL PRINT_STRW,@"「嗯咕_HH_啊_HH_啊_HH_里面_HH_啊_HH_啊_HH_在里面_HH__HH_」"
CALL PRINT_STRW,@"「ひぐっ_HH_お゛ぉ_HH_あ゛_HH_んぁっ_HH_」"	CALL PRINT_STRW,@"「咿咕_HH_哦゛哦_HH_啊゛_HH_嗯啊_HH_」"
PRINTFORMW 何度も何度も絶頂した所為で%CALLNAME:TARGET%の意識はもう朦朧としていて言葉は不確かになっている。	PRINTFORMW 连续不断的绝顶已经让%CALLNAME:TARGET%的意识飞到九霄云外、连嘴里的淫叫都已经只剩下本能的咿呀声。
PRINTFORMW だけど、絶頂に痙攣していても、ぎゅうっと%CALLNAME:MASTER%を抱きしめる腕は離さない。	PRINTFORMW 但是、就算因为绝顶二痉挛、她也没有放开抱着%CALLNAME:MASTER%的手。
CALL PRINT_STRW,@"「あ゛っ_HH_んん゛っ…_HH_ん゛ぅ～～～っ_HH_」"	CALL PRINT_STRW,@"「啊゛_HH_嗯嗯゛…_HH_嗯゛～～～_HH_」"
CALL PRINT_STRW,@"「んっ_HH__HH_んぁっ、あっ_HH__HH_んんっ_HH_あっ_HH_あっ_HH_あ゛ぁぁっ_HH__HH_」"	CALL PRINT_STRW,@"「嗯_HH__HH_嗯、啊_HH__HH_嗯嗯_HH_啊_HH_啊_HH_啊゛啊啊_HH__HH_」"
CALL PRINT_STRW,@"「なか゛っ_HH_なか゛にっ_HH__HH_ら゛してっ_HH_ら゛してっくら゛さいっ_HH__HH__HH_」"	CALL PRINT_STRW,@"「里面゛_HH_在゛里面_HH__HH_社゛出来_HH_社゛出来゛巴_HH__HH__HH_」"
CALL PRINT_STRW,@"「%CNAME("二人称")%さんのお顔がよく見えます_／／／_」"	CALL PRINT_STRW,@"「能看到%CNAME("二人称")%的脸_／／／_」"
CALL PRINT_STRW,@"「%CNAME("二人称")%さんのお顔が近いです、ね_／／／_」"	CALL PRINT_STRW,@"「%CNAME("二人称")%的脸离得好近、呐_／／／_」"
CALL PRINT_STRW,@"「えへへ～♪%CNAME("二人称")%さんっ_／／／_」"	CALL PRINT_STRW,@"「欸嘿嘿～♪%CNAME("二人称")%_／／／_」"
PRINTFORMW てれてれと顔を赤らめて%CALLNAME:TARGET%は%CALLNAME:MASTER%の首に腕を回す。	PRINTFORMW 脸上浮现出因为害羞出现的红云%CALLNAME:TARGET%环抱着%CALLNAME:MASTER%的脖颈。
CALL PRINT_STRW,@"「……その、うごく前にキス、してほしいです……_／／／_」"	CALL PRINT_STRW,@"「……哪个、嗯、做之前、想要亲亲……_／／／_」"
PRINTFORMW 「ダメ、ですか……？」	PRINTFORMW 「不行、吗……？」
PRINTFORMW 頷いて、軽く口づけを交わす。	PRINTFORMW 点了点头、嘴唇相接。
CALL PRINT_STRW,@"「ん……、ありがとうです……_／／／_」"	CALL PRINT_STRW,@"「嗯……、谢谢……_／／／_」"
PRINTFORMW %CALLNAME:TARGET%はくしゃりと咲った。	PRINTFORMW %CALLNAME:TARGET%脸上绽放了开心的笑容。
PRINTFORMW そして、%CALLNAME:MASTER%は%CALLNAME:TARGET%の膣中を楽しむように腰を動かし始めた。	PRINTFORMW 然后、%CALLNAME:MASTER%兴奋的挺动着在%CALLNAME:TARGET%肉穴内的肉棒。
CALL PRINT_STRW,@"「あっ_HH_あっあっ_HH_あぁっ_HH__HH_」"	CALL PRINT_STRW,@"「啊_HH_啊啊_HH_啊啊_HH__HH_」"
CALL PRINT_STRW,@"「んぐっ……、あっ……、ひぅ……_HH_」"	CALL PRINT_STRW,@"「嗯咕……、啊……、咿……_HH_」"
PRINTFORMW その時にガチガチに勃起した%CALLNAME:MASTER%のモノが%CALLNAME:TARGET%の柔らかなお腹に当たる。	PRINTFORMW %CALLNAME:MASTER%勃起怒张的肉棒碰在%CALLNAME:TARGET%的腹部上。
PRINTFORMW その時に服越しだがガチガチ勃起した%CALLNAME:MASTER%のモノが%CALLNAME:TARGET%のお腹に当たる。	PRINTFORMW %CALLNAME:MASTER%勃起怒张的肉棒隔着衣服碰在%CALLNAME:TARGET%的腹部上。
CALL PRINT_STRW,@"「あっ、%CNAME("二人称")%さんのこ、こんなに……_／／／_」"	CALL PRINT_STRW,@"「啊、%CNAME("二人称")%的肉棒、已经变得这么大……_／／／_」"
CALL PRINT_STRW,@"「……その、いれる前にキス、してほしいです……_／／／_」"	CALL PRINT_STRW,@"「……那个、我想在做之前、kiss一下……_／／／_」"
PRINTFORMW %CALLNAME:TARGET%はにへらと咲った。	PRINTFORMW %CALLNAME:TARGET%脸上绽放了开心的笑容。
PRINTFORMW そして、%CALLNAME:TARGET%の軽い身体を持ち上げて深く挿入れた。	PRINTFORMW 然后、%CALLNAME:TARGET%抬起自己的身体然后猛地坐下。
CALL PRINT_STRW,@"「んっ……_HH_んんっ_HH__HH_んっ_HH_はいってきました……_HH_」"	CALL PRINT_STRW,@"「嗯……_HH_嗯嗯_HH__HH_嗯_HH_进来了……_HH_」"
PRINTFORMW %CALLNAME:TARGET%の小さくて軽い身体を確りと抱きしめながら%CALLNAME:MASTER%は腰を動かす。	PRINTFORMW %CALLNAME:MASTER%抱着%CALLNAME:TARGET%娇小的身体挺动着腰身。
CALL PRINT_STRW,@"「んっ……んはぅっ_HH_はぁ、んっ……んぅっ」"	CALL PRINT_STRW,@"「嗯……嗯哈_HH_哈啊、嗯……嗯」"
CALL PRINT_STRW,@"「ひゃぁっ_HH_なかでっ_HH_%CNAME("二人称")%さん、のがっ_HH_」"	CALL PRINT_STRW,@"「咿呀_HH_里面_HH_%CNAME("二人称")%的、大肉棒_HH_」"
CALL PRINT_STRW,@"「あっあっあっ_HH_おまんこのなかっ_HH_かきまわしちゃっ_HH__HH_」"	CALL PRINT_STRW,@"「啊啊啊_HH_小穴里_HH_大肉棒搅动的好舒服_HH__HH_」"
CALL PRINT_STRW,@"「んっ_HH__HH_んぁっ、あっ_HH__HH_んんっ_HH_あっ_HH_あっ_HH_あぁぁっ_HH__HH_」"	CALL PRINT_STRW,@"「嗯_HH__HH_嗯啊、啊_HH__HH_嗯嗯_HH_啊_HH_啊_HH_啊啊啊_HH__HH_」"
PRINTFORMW 絶頂が近いのか%CALLNAME:TARGET%の声は艶のある嬌声しか出てこない。	PRINTFORMW 接近绝顶的时候、%CALLNAME:TARGET%的声音越发的淫媚。
CALL PRINT_STRW,@"「おちんちんさんがっ_HH_びくびくって_HH_なかにっ_HH_だしてっ_HH_らしてくださいっ_HH_」"	CALL PRINT_STRW,@"「大鸡巴在颤抖_HH_嗯嗯_HH_在里面_HH_射出来_HH_射给我_HH_」"
CALL PRINT_STRW, @"「ぴゃぁっ_HH_」"	CALL PRINT_STRW, @"「咿呀_HH_」"
PRINTFORMW Ｇスポットを突いてやると%CALLNAME:TARGET%は素っ頓狂な声をあげた。 	PRINTFORMW 刺激到%CALLNAME:TARGET%的G点之后她发出了狂乱的淫叫声。
CALL PRINT_STRW, @"「そ、そこっ_HH__HH_とてもふわってします_HH_」"	CALL PRINT_STRW, @"「那、那里_HH__HH_好舒服_HH_」"
PRINTFORMW %CALLNAME:MASTER%はおねだりと判断してそのまま同じところを突いてやる。	PRINTFORMW %CALLNAME:MASTER%不断的抽插着肉棒刺激着她的G点。
CALL PRINT_STRW, @"「ひゃっ_HH_あっあっあっ_HH_」"	CALL PRINT_STRW, @"「咿呀_HH_啊啊啊_HH_」"
PRINTFORMW %CALLNAME:TARGET%はびくんっと身体を痙攣させ瞳がどんどん蕩けていく。	PRINTFORMW %CALLNAME:TARGET%突然抽搐了一下眼瞳上翻露出了阿嘿颜。
CALL PRINT_STRW, @"「あひっ_HH_あっあっ_HH_あははっ_HH_ひぅっ_HH_ふわって_HH_ふわふわっ_HH_ですっ_HH_」"	CALL PRINT_STRW, @"「阿嘿_HH_啊啊_HH_啊哈哈_HH_咿_HH_好爽_HH_好爽_HH_啊_HH_」"
CALL PRINT_STRW, @"「あ、あんまり、あっ_HH_いじわるし、ひゃっ_HH_っないで、ああっ_HH_くださ、んんっ_HH_い……_／／／_」"	CALL PRINT_STRW, @"「啊、不要、这样_HH_连续、的_HH_啦_HH_嗯嗯、嗯嗯_HH_……_／／／_」"
「あっあっあっ_HH_すきぃ_HH_そこっ_HH_とってもふわってしますっ_HH_」	「啊啊啊_HH_喜欢_HH_那里_HH_好舒服_HH_」
「お゛っ_HH_あ゛_HH_あ_HH_あ゛っ_HH_っい゛いぃ～～～～～～っ_HH__HH_」	「哦゛_HH_啊゛_HH_啊_HH_啊゛_HH_好゛好舒服～～～～～～_HH__HH_」
%CALLNAME:TARGET%はイきすぎたのか、笑う余裕がなくなって嬌声しか上げられなくなっている。	%CALLNAME:TARGET%因为高潮太多次的原因、已经没有欢呼的余裕只能不断发出与少女般不符的淫媚娇声。
瞳は絶えず動き、焦点は定まっていないだろう。口はだらしなく開いて唾液がだらだらと出ている。	眼眸失去了焦点。薄唇微微张开、口中的香津不受控制的从嘴边流下。
そんな意識が不確か%CALLNAME:TARGET%と違って膣は確かにあなたから搾ろうとうねうねと動く。	然而%CALLNAME:TARGET%的蜜穴就算没有本人的控制也依旧本能的为了榨取精液而蠕动绞弄着肉棒。
「お゛…おっ_HH_あ゛う゛ぅっ_HH_あ゛っ_HH_あく゛っ_HH_あぁあ゛っあああ゛っ_HH__HH__HH_」	「哦゛…哦_HH_啊゛唔゛呜_HH_啊゛_HH_啊゛_HH_啊啊゛啊啊啊゛_HH__HH__HH_」
「んあ゛あぁ_HH_あ゛_HH_あ゛っあぁ_HH_あ゛っ_HH_～～～～～～～っ_HH__HH__HH_」	「嗯啊゛啊_HH_啊゛_HH_啊゛啊_HH_啊゛_HH_～～～～～～～_HH__HH__HH_」
「あぁっ_HH_はっ_HH_え_HH_あ゛っは_HH_い゛っぅ_HH_うああ゛あっ_HH__HH__HH_」	「啊啊_HH_哈啊_HH_唉_HH_啊゛哈啊_HH_号゛书_HH_富゛啊啊_HH__HH__HH_」
「あ゛ぁ～～～～っ_HH_あ_HH_あ゛っあ_HH_あ゛あ゛あっ～～～～っ_HH_」	「啊゛啊～～～～_HH_啊_HH_啊゛啊_HH_啊゛啊゛啊～～～～_HH_」
絶頂が近いからか%CALLNAME:TARGET%の声は一層に獣のような声色になってきた。	快要到达绝顶的%CALLNAME:TARGET%如同娇小的雌兽一般一声高过一声的发出淫叫。
「な、か゛っ_HH__HH_な゛か゛にぃっ_HH__HH_あ゛～～～っ_HH_あっ_HH_あ゛っ_HH_くら゛しゃいぃっっ_HH__HH__HH_」	「栽、在゛李_HH__HH_里゛面゛啊啊_HH__HH_啊゛～～～っ_HH_啊_HH_啊゛_HH_射゛粗来噫啊啊_HH__HH__HH_」
本能的になのか、%CALLNAME:MASTER%が射精しそうになったのを察した%CALLNAME:TARGET%は反射的に膣に出すことを求めてきてる。	似乎是本能的察觉到了%CALLNAME:MASTER%到了射精的边缘、%CALLNAME:TARGET%条件反射的要求在里面射出来。
「あはっ_HH_そこっ_HH_いいですっ_HH_も、っと_HH_あっ_HH_あっ_HH_あっ_HH_もっとぉっっ_HH__HH_」	「啊哈_HH_那里_HH_好棒_HH_用、力_HH_啊_HH_啊_HH_啊_HH_再用力啊啊_HH__HH_」
Ｇスポットを刺激してやると%CALLNAME:TARGET%嬉しそうにして嬌声を上げる。	刺激到了她的G点之后%CALLNAME:TARGET%发出欢愉的淫叫声。
言葉以上に%CALLNAME:TARGET%の身体は、膣をうねうねと動かし貪欲なまでに%CALLNAME:MASTER%を求めてくる。	比起语言、%CALLNAME:TARGET%的身体反应更甚、柔软湿滑的穴肉蜿蜒起伏的绞弄着%CALLNAME:MASTER%的肉棒渴求着精液的浇灌。
「ぁひっ_HH_あ、ふ、ぅ_HH_ふぁっあ_HH_くひゅっ_HH_すきぃ…_HH_ふぁ、ああぁあ_HH__HH__HH_」	「啊咿_HH_啊、好、爽_HH_啊啊啊_HH_稀饭_HH_喜欢…_HH_呼啊、啊啊啊啊_HH__HH__HH_」
「はっあ_HH_ひ_HH_あ_HH_%CNAME("二人称", "どもり")%さん_HH_う_HH_あ゛っ_HH__HH_あ_HH__HH__HH_」	「哈啊_HH_咿_HH_啊_HH_%CNAME("二人称", "どもり")%_HH_唔_HH_啊゛_HH__HH_啊_HH__HH__HH_」
「んっ_HH_あっ_HH_ふっ_HH_ふぅっ_HH_んあっ_HH_あっ_HH_んああぁっ_HH__HH__HH_」	「嗯_HH_啊_HH_呼_HH_呼_HH_嗯啊_HH_啊_HH_嗯啊啊啊_HH__HH__HH_」
「あっ_HH_うっ_HH_ぁうっ_HH_%CNAME("二人称", "どもり")%さん_HH_%CNAME("一人称", "どもり")%_HH_も、う_HH_ひあぁんっ_HH__HH_」	「啊_HH_唔_HH_啊呜_HH_%CNAME("二人称", "どもり")%_HH_%CNAME("一人称", "どもり")%_HH_已、经_HH_要啊啊啊啊_HH__HH_」
絶頂が近いのか%CALLNAME:TARGET%は蕩けた瞳で%CALLNAME:MASTER%を見つめてくる。	似乎是快高潮了、%CALLNAME:TARGET%用荡漾的眼神看着%CALLNAME:MASTER%。
「あっ_HH_ひゃっ_HH_なかにっ_HH__HH_%CNAME("二人称", "どもり")%さんの、がっ_HH_ほしぃで、す_HH_なかっ_HH__HH_なかにっっ_HH__HH__HH_」	「啊_HH_咿呀_HH_里面_HH__HH_%CNAME("二人称", "どもり")%的、想_HH_想要、啊_HH_在_HH__HH_里面咿咿_HH__HH__HH_」
%CALLNAME:TARGET%は%CALLNAME:MASTER%に膣に出してほしいと必死に懇願してくる。	%CALLNAME:TARGET%渴求着%CALLNAME:MASTER%在里面射出来。
「あっあっあっ_HH_おっ_HH_お゛っ_HH_お゛っ_HH_あ゛っ_HH__HH_は～～～～っ_HH_は～～～～っ_HH_」	「啊啊啊啊_HH_啊_HH_哦゛_HH_哦゛_HH_啊゛_HH__HH_哈～～～～_HH_哈～～～～_HH_」
%CALLNAME:TARGET%はイきすぎたからか抑圧されいてたモノが解放されたかのように盛大に喘いでいる。	%CALLNAME:TARGET%因为快感的浪潮再也抑制不住自己的声音、发出了大声的浪叫声。
瞳の焦点は定まらず、閉ざそうとしていた口はだらしなく開いている。	眼睛失去神采、本来紧闭的薄唇也放荡的张开着。
身体は不規則に痙攣して、膨らんだＧスポットを一突きしてやる度に潮を吹いている。	身体不规则的抽搐着、每次碰到G点之后都会潮吹一次。
「あ゛っ…_HH_あ゛ぁっ_HH_ん゛っ_HH__HH_あ゛あっっ_HH_HH_」	「啊゛っ…_HH_啊゛啊_HH_嗯゛_HH__HH_啊゛啊_HH_HH_」
「あ゛っ_HH_ん゛んっ_HH_やぁっ_HH_や゛っ_HH__HH_あああ゛ぁっ_HH__HH_」	「啊゛_HH_嗯゛嗯_HH_呀_HH_呀゛_HH__HH_啊啊啊゛_HH__HH_」
「ん゛んっ_HH_あ゛っ_HH_ひゃあぁあっ_HH__HH_お゛っお゛っお゛っ_HH__HH_」	「嗯゛嗯_HH_啊゛_HH_咿呀啊啊_HH__HH_哦゛哦゛哦゛_HH__HH_」
「あ゛あっ_HH_あっ_HH_あっ_HH_あ゛ぁっ_HH__HH_ひぐぅっ_HH_あああぁああぁあ_HH__HH__HH_」	「啊゛啊_HH_啊_HH_啊_HH_啊゛啊_HH__HH_咿_HH_啊啊啊啊啊啊_HH__HH__HH_」
絶頂が近いのか%CALLNAME:TARGET%の声の色が変わってきた。	临近绝顶的时候%CALLNAME:TARGET%的声音也越发高昂。
「な、かっ_HH__HH_あっ_HH_あ゛っ_HH_あ゛あぁっ_HH_なかにぃっっ_HH__HH__HH_」	「里、面_HH__HH_啊_HH_啊゛_HH_啊゛啊啊啊_HH_在里面_HH__HH__HH_」
意識も不確かなのに%CALLNAME:MASTER%のソレがびくびくと大きくなったの察した%CALLNAME:TARGET%%CALLNAME:TARGET%は膣に出してと懇願してきた。	明明已经意识涣散了还是本能的察觉到%CALLNAME:MASTER%的肉棒即将射精的%CALLNAME:TARGET%恳求着在自己里面射出来。
「ひゃあぁあっ_HH__HH_そこっ_灰色_ふわって_暗灰色_しますけ_、あっあっ_HH_声出ちゃって、は、_灰色_はずか_暗灰色_しぃで_、ああっ_HH__HH__／／／_」	「咿呀啊啊_HH__HH_那里_灰色_好舒_暗灰色_服_、啊啊啊啊_HH_声音、控制、_灰色_不住_暗灰色_了_、啊啊_HH__HH__／／／_」
声が漏れ出るからいやいやと首を振る%CALLNAME:TARGET%だが%CALLNAME:MASTER%はお構いなしにＧスポットを刺激してやる。	虽然%CALLNAME:TARGET%控制不住声音大声的浪叫着然而%CALLNAME:MASTER%没有理会继续不断的刺激着G点。
言葉や仕草とは逆に身体は、膣は、うねうねと動いて貪欲に%CALLNAME:MASTER%を求めている。	与意识反逆的身体、蜜穴、不断的贪食着快感。
「やぁっ_HH_ひゃっ_HH__灰色_んんっ_HH_んはぅっ_HH_ああぁっ_HH__HH_」	「呀啊_HH_咿呀_HH__灰色_嗯嗯_HH_嗯哈_HH_啊啊啊_HH__HH_」
「ひぅっ_HH_あぁっ_HH_あっ_／／／__暗灰色_んぅっ_HH__灰色_んんっ_HH_んぁっ_HH_ひゃあぁあっ_HH__HH_」	「咿_HH_啊_HH_啊_／／／__暗灰色_嗯_HH__灰色_嗯嗯_HH_嗯啊_HH_咿呀啊_HH__HH_」
「んんっ_HH__灰色_んんんっ_HH_ああぁっ_HH_あい_灰色_して_暗灰色_く_だっ_HH_あひぃぃいっ_HH_」	「嗯嗯_HH__灰色_嗯嗯嗯_HH_啊啊啊_HH_尽情_灰色_疼爱_暗灰色_我_吧_HH_啊咿咿咿_HH_」
「ひぅっ_HH_あっあっあっ_HH_やぁっ_HH_あぁッ_HH__HH_ああぁあぁああぁっ_HH__HH__HH_」	「咿_HH_啊啊啊_HH_呀_HH_啊啊_HH__HH_啊啊啊啊啊啊_HH__HH__HH_」
絶頂が近いのか%CALLNAME:TARGET%は声を抑えられずに盛大に嬌声を上げている。	临近绝顶的时候%CALLNAME:TARGET%的浪叫也越来越大声。
「で、できればっ_HH_あっあっ_HH__HH__暗灰色_な_灰色_か_がっっ_HH_ひゃあぁっ_HH_なかにっ_HH__HH_だしてっ_HH__HH__HH_だしてぇっっ_HH__HH__HH_」	「可、可以的话_HH_啊啊啊_HH__HH__暗灰色_在_灰色_里_里面_HH_咿呀啊_HH_在里面_HH__HH_射出来_HH__HH__HH_全部射给我咿咿咿_HH__HH__HH_」
恥ずかし気に、だが%CALLNAME:MASTER%に中に出してほしいのか%CALLNAME:TARGET%は必死に求めている。	虽然觉得羞耻、但是%CALLNAME:TARGET%还是拼命的要求着%CALLNAME:MASTER%在里面射出来。
「ぉこ゛っ_HH_お゛ぉっ_HH_ふく゛っ_HH_ぁく゛_HH_ぅ゛うっ_HH_～～～～～～～っ_HH__HH__HH_」	「哦゛_HH_哦゛哦_HH_呼゛_HH_啊゛_HH_唔゛唔_HH_～～～～～～～_HH__HH__HH_」
イきすぎて意識が不確かな%CALLNAME:TARGET%のＧスポットを刺激してやると、獣のような声をあげた。	不断刺激着早已意识涣散的%CALLNAME:TARGET%的G点、随后娇小的雌兽发出了更加淫荡的浪叫声。
瞳は虚空を見つめていて口からはだらしなく涎がだらだらと出ている。	眼眸呆望着虚空、薄唇微微张开、口中的香津不受控制的从嘴边流下。
身体はびくんびくんと痙攣して膨らんで主張してくる場所を一突きする度に塩を吹いている。	身体不断的抽搐着、每次抽插蜜穴都会喷出一道道淫汁。
「お゛ぉっ_HH_あき゛ぃっ_HH_あ゛っ_HH_あ゛っっ_HH__HH_」	「哦゛哦_HH_好大゛_HH_啊゛_HH_啊゛_HH__HH_」
「ふぅっ_HH_ぅう゛_HH_んっ_HH_あ゛っ_HH__HH_お゛っ_HH_お゛ぉっ_HH__HH_」	「呼_HH_唔゛_HH_嗯_HH_啊゛_HH__HH_哦゛_HH_哦゛_HH__HH_」
「ん゛ぅう゛っ_HH_あ゛っ_HH_お゛っ_HH_ひっ_HH_あ゛あっ_HH__HH_」	「嗯゛唔゛_HH_啊゛_HH_哦゛_HH_咿_HH_啊゛啊_HH__HH_」
「お゛っ_HH_お゛っ_HH_おぅ゛っ_HH__HH_はひっ_HH_はひぃいぃぃ_HH__HH__HH_」	「哦゛_HH_哦゛_HH_哦゛_HH__HH_哈咿_HH_哈咿咿咿_HH__HH__HH_」
絶頂が近いのか%CALLNAME:TARGET%の嬌声はリズミカルになってきている。	随着绝顶的到来%CALLNAME:TARGET%的娇喘声也变得越来越频繁。
「おっ_HH_お゛ぉっ_HH__HH_あ゛ぇっ_HH_お゛く゛っ_HH_あ゛っ_HH_お゛く゛っ_HH_」	「哦_HH_哦゛哦_HH__HH_啊゛_HH_哦゛゛_HH_啊゛_HH_哦゛゛_HH_」
ほとんど意識が無いのに、%CALLNAME:TARGET%は%CALLNAME:MASTER%に必死に奥に射精して欲しいと要求してくる。	明明已经几乎没有什么意识了、%CALLNAME:TARGET%还是本能的渴求着%CALLNAME:MASTER%在里面射精。
「あひっ_HH_そこ、すきっ_HH_すきですっ_HH__HH_」	「啊咿_HH_那里、喜欢_HH_好舒服_HH__HH_」
Ｇスポットを刺激してやると%CALLNAME:TARGET%は嬉しそうな声をあげてもっともっと、と要求してくる。	品尝到G点带来的快乐的%CALLNAME:TARGET%欢愉的渴求着更多快感。
突いてやる度にぷしゃっと潮を吹いて言葉だけじゃなくて身体も要求してくる。	不仅仅是嘴上的话语、每次抽插都会喷出一道道晶莹的淫液的身体也在不断的贪求着。
「すきっ_HH_あぅっ_HH_すっ_HH_きぃ……っ_HH__HH_ふぁ_HH_ああぁあぁ_HH__HH_」	「喜欢_HH_啊_HH_喜_HH_欢……_HH__HH_呼啊_HH_啊啊啊_HH__HH_」
「あっ_HH_んっ_HH_ひっ_HH__HH_あぅ……_HH_んぁ_HH_あっ_HH_あひぃっ_HH__HH_」	「啊_HH_嗯_HH_咿_HH__HH_啊……_HH_嗯_HH_啊_HH_啊咿_HH__HH_」
「もっとっ_HH_あっあっあっ_HH_%CNAME("一人称", "どもり")%をっ_HH_あひぃっ_HH_あいしてっ_HH_くださぃっ_HH__HH_」	「我还要_HH_啊啊啊啊_HH_%CNAME("一人称", "どもり")%_HH_啊咿っ_HH_尽情的_HH_疼爱_HH__HH_」
「あっ_HH_ひっ_HH_あぁああぁ_HH__HH_あぁ_HH_っあ_HH_あっぁああ_HH__HH__HH_」	「啊_HH_咿_HH_啊啊啊啊_HH__HH_啊_HH_啊_HH_啊啊啊啊_HH__HH__HH_」
絶頂が近いのか%CALLNAME:TARGET%は言葉を言えずに盛大に喘いでいる。	随着绝顶的临近、%CALLNAME:TARGET%也失去了言语的能力只能不断的发出淫媚的叫声。
「なかっ_HH_ひゃあ_HH_なかがっいいですっ_HH_あっあっあっ_HH_なかにだしてくださいっ_HH__HH__HH_」	「在里面_HH_咿呀啊_HH_在里面可以的哦_HH_啊啊啊啊_HH_在里面射出来_HH__HH__HH_」
「～～～～っ_HH_～～～～っ_HH_かひゅっ_HH__HH_ひゅーっ_HH_ひゅーっ_HH_」	「～～～～嗯_HH_～～～～嗯_HH_嗯咿_HH__HH_咿呜ー_HH_咿ー_HH_」
子宮口を責めすぎたからか、%CALLNAME:TARGET%は声に成らない嬌声を上げて、息も絶え絶えになっている。	似乎是喜欢上了插入子宫口带来的快感、%CALLNAME:TARGET%发出了一浪又一浪的娇喘声。
身体は痙攣しており、玉のような汗が出て、焦点の定まらない瞳。	娇嫩的身躯因为高潮不时的抖动着、晶莹如玉的汗珠在娇躯上划出美丽又魅惑的轨迹、眼眸失去了神采、意识早已飞到九霄云外。
だが、そんな事は%CALLNAME:MASTER%には関係の無い事だ。	但是、%CALLNAME:MASTER%没有关心那些。
まだ初潮も来ていない%CALLNAME:TARGET%の未成熟な子宮口を乱暴に、貪欲に	对着甚至连初潮都没有来过的%CALLNAME:TARGET%那未成熟的育婴房、粗暴而又贪婪的冲刺着
初潮が来て妊娠するかもしれない%CALLNAME:TARGET%の子宮口を乱暴に、貪欲に	已经来过初潮的可能会怀孕的%CALLNAME:TARGET%的育婴房、粗暴而又贪婪的冲刺着
「～～～～っ_HH__HH_かひゅっ_HH_う゛く゛っ_HH_くひゅっ_HH_ひゅっ_HH_ひゅっ_HH_ひゅーっ_HH__HH_」	「～～～～嗯_HH__HH_咔咿_HH_呜゛゛_HH_咿呜_HH_咿_HH_咿呜_HH_咿ー_HH__HH_」
「あ゛ぁあっあ_HH__HH_あ゛～～～っ_HH_あ゛～～～っ_HH_かひゅっひゅっけほっ…すきぃ…_HH_すきっ_HH_～～～～っ_HH__HH_」	「啊゛啊啊啊_HH__HH_啊゛～～～_HH_啊゛～～～_HH_好舒服…喜欢…_HH_好喜欢_HH_～～～～_HH__HH_」
「あ゛ぁっあ゛っ_HH_ぁっがっごほっお゛っぇ゛っ ひんっく゛っぅ゛う゛う゛う゛う゛_HH__HH__HH_」	「啊゛啊啊゛_HH_啊嗯嗯嗯゛呜゛嗯 ゛呜゛唔゛唔゛唔゛唔゛_HH__HH__HH_」
「あひ、い、ぎぃぃ_HH_ひっ_HH_ぁう゛ぅ_HH_は、ひ、ひ_HH__HH_あ゛ぅっ_HH_お゛_HH_ごぉッ_HH_ぎ、あ゛ぁぁッ_HH__HH__HH_」	「啊咿、咿、咿_HH_啊_HH_啊゛_HH_哈、咿、咿_HH__HH_啊゛唔_HH_哦゛_HH_啊啊_HH_咿、啊゛啊啊啊_HH__HH__HH_」
「ひっ_HH_ひぎっ_HH_な、～～～～ぁっ_HH__HH_あ゛っ_HH__HH__HH_あ゛ぁぇえぃっ_HH__HH_にぃ_HH__HH_くだ、あ゛ぁぁっ_HH__HH_」	「咿_HH_咿_HH_好棒、～～～～啊啊啊_HH__HH_啊゛_HH__HH__HH_啊啊゛啊啊_HH__HH_在_HH__HH_里、啊啊啊゛啊啊_HH__HH_」
「あ、はぁ_HH_う、うぅ゛う_HH_ふぁ、あ゛あっ_HH_くひゅっ_HH_くひゅ～～っ_HH__HH_」	「啊、哈啊_HH_唔、呜゛唔_HH_呼啊、啊゛啊_HH_咿_HH_咿咿～～_HH__HH_」
子宮口を突く度に%CALLNAME:TARGET%は嬉しそうに獣の様に喉を唸らせる。	每次戳弄子宮口都会让%CALLNAME:TARGET%发出欢愉的淫叫声。
ともすれば、女の子が上げて良い類の声ではないのだろう。	那是与平常的声音不一样的呻吟。
「もっとっ_HH_もっともっともっと_HH__HH_くださいっっ_HH__HH__HH_」	「更多_HH_我还要更多更多_HH__HH_给我更多的_HH__HH__HH_」
だが、%CALLNAME:TARGET%は「もっと」を望んでいる。	但是、%CALLNAME:TARGET%的愿望只有「想要更多」而已。
「あはっ_HH_くぅ_HH_ひぁっ_HH_ん゛ぁっっ_HH__HH__HH_」	「啊哈_HH_咕_HH_咿啊_HH_嗯゛啊_HH__HH__HH_」
子宮口を抉るように突いてやると潮を吹き、%CALLNAME:TARGET%は嬉しそうな声を上げる。	每次猛烈的冲撞她的子宫口都会伴随着%CALLNAME:TARGET%欢愉的淫叫喷出一道道的淫汁。
「ひゅぅ…はぁ_HH_%CNAME("二人称")%さんに、%CNAME("一人称")%のおくをコンコンされるの好きですっ_HH_」	「咿…哈_HH_%CNAME("二人称")%的、狠狠的插到%CNAME("一人称")%深处、好喜欢_HH_」
―――だからもっとください_HH_	―――所以更用力的干我吧_HH_
言われるまでも無い、%CALLNAME:MASTER%は再び腰を打ち付け始めた。	不用多说、%CALLNAME:MASTER%再次开始猛烈的抽插。
「ん、う゛ぅ_HH_ふ、あぁっ_HH_ぁあ゛あっ_HH__HH_すきっだいすきぃ_HH__HH_っひ、ぁあ゛っ_HH_～～～～っ_HH__HH__HH_」	「嗯、唔゛_HH_呼、啊_HH_啊゛啊_HH__HH_喜欢%CNAME("二人称")%最喜欢%CNAME("二人称")%了_HH__HH_咿、啊゛_HH_～～～～_HH__HH__HH_」
「うう゛っう_HH_も、とっ_HH_おっ、おくっ_HH_こんこんし、てくだひゃ_HH_あ_HH_あ_HH_あ_HH_あぁあ゛_HH_ああ゛ぁああ゛_HH__HH__HH_」	「呜呜゛唔_HH_最、深处_HH_再、用力_HH_的、操我_HH_啊_HH_啊_HH_啊_HH_啊啊啊゛_HH_啊゛啊啊゛_HH__HH__HH_」
「ぃぎっ_HH_ひぃい_HH_んほっぉ゛_HH__HH_もっとっ_HH_くらひゃぃ_HH_おね、おねがいですっ_HH_んぁあっ_HH_あ゛っぁああ゛ぁ_HH__HH__HH_」	「咿_HH_咿咿_HH_嗯゛_HH__HH_再用力的_HH_干我_HH_求、求你了_HH_嗯啊_HH_啊゛啊啊啊゛啊_HH__HH__HH_」
「ん゛んん゛ぁあ゛あっっ_HH__HH_ぁ、たま、ふわふわ_HH_しへ、ぇ゛_HH__HH_っあ゛ぁああぁあ_HH__HH__HH_」	「嗯゛嗯嗯゛啊゛啊_HH__HH_啊、脑袋、飘飘的_HH_啊、嗯゛_HH__HH_啊゛啊啊啊啊_HH__HH__HH_」
「お゛、っひ_HH_ぃ゛いい_HH_あ_HH_%CNAME("一人称")%のなかに_HH_ぃ゛ひっ_HH_ほ、しいです…_HH_ぅ゛っはぁ_HH_おね、がいですっっっ_HH__HH__HH_」	「哦゛、咿_HH_咿゛咿咿_HH_啊_HH_%CNAME("一人称")%的小穴_HH_゛咿_HH_想、要…_HH_唔゛哈_HH_求、求你了唔呜呜_HH__HH__HH_」
「か、ひ_HH_ひ、んぐっ_HH_ぅ、ぎぃ_HH_や、や゛らぁ_HH_やぇれてっ_HH__HH_ひぎっっ_HH__HH_」	「嗯、咿_HH_咿、嗯咕_HH_呜、咿_HH_呀、呀゛啊啊_HH_插进来_HH__HH_咿咿_HH__HH_」
「んっ_HH__灰色_くぅっ_HH_ん゛ぎぃっっ_HH__HH_あっ_HH_あっ_HH__ハートピンク_あ゛っ_HH_やっだめでっお゛っ_HH__HH_」	「嗯_HH__灰色_咕_HH_嗯゛咿_HH__HH_啊_HH_啊_HH__ハートピンク_啊゛_HH_不行了゛啊啊_HH__HH_」
子宮口を抉るように突いてやるとぷしゃっと潮を吹き、%CALLNAME:TARGET%の必死に抑えていた声は獣のような声に。	每次猛烈的冲撞她的子宫口都会喷出一道道的淫汁、但是%CALLNAME:TARGET%拼命忍住潮水般的快感让自己不叫出声来。
「お゛っ_HH_お゛っ_HH_お゛ぉっ_HH_こえがっ_HH_あ゛っあ゛っあ゛っ_HH_おさえられっひぎぃっっ_HH__HH_」	「哦゛_HH_哦゛_HH_哦゛哦_HH_声音_HH_啊゛啊゛啊゛啊_HH_忍不住了咿呀啊啊_HH__HH_」
「ふぐぅぁっ_HH_あ゛っ_HH_あ゛っ_HH_あ゛っ_HH_んおぉおおっ_HH__HH_だめっ_HH_でっ…_HH_お゛ほおぉっ_HH__HH__HH_」	「呼咕_HH_啊゛_HH_啊゛_HH_啊゛_HH_嗯哦哦哦_HH__HH_不行_HH_啊…_HH_哦哦哦゛咿咿_HH__HH__HH_」
「ひ、ひぃ゛ぃっっ_HH_おく゛っ_HH__HH_ひゅっ…_HH_ばかり゛_HH_しにゃい゛れっ_HH_あっはぁあ゛ぁぁ_HH__HH__HH_」	「咿、咿゛咿_HH_里面゛_HH__HH_咿啊…_HH_全是゛_HH_填满了゛_HH_啊哈啊啊啊゛啊_HH__HH__HH_」
「ん゛おっ_HH_あ゛っあ゛っ_HH_も…、おく゛ぅう゛っ_HH_やぁえっ_HH_やぇれくらっ_HH_ひっ_HH_ひゃあぁあっっ_HH__HH__HH_」	「嗯゛哦_HH_啊゛啊゛_HH_插到…、最゛呜呜゛_HH_深处_HH_去啊啊啊_HH_咿_HH_咿呀啊啊啊啊_HH__HH__HH_」
「んひっ_HH__HH_ひぅっ_HH_は、ぁあ゛_HH__HH_あっあ゛ぁ_HH__HH_ぁあ゛っあ゛ぁう_HH__HH__HH_」	「嗯咿_HH__HH_咿_HH_哈、啊啊啊゛_HH__HH_啊啊゛啊_HH__HH_啊啊゛啊゛啊_HH__HH__HH_」
「あ_HH_ぁ_HH_あっ_HH_ぁ゛ひっ_HH_あ゛_HH_ふっぅ_HH_くださぃ……_HH_んあぅっ_HH_ぜんぶっ_HH_ふっ_HH_くらひゃぃっっ_HH__HH__HH_」	「啊_HH_啊_HH_啊_HH_啊゛咿_HH_啊゛_HH_呼_HH_给我……_HH_嗯啊_HH_全部_HH_射_HH_给我咿啊啊啊_HH__HH__HH_」
「あ゛ぁっ_HH_ひう゛ぅう゛うぅ_HH_あ゛、っぁあ゛ああ_HH__HH_んぃ゛いっ_HH_お゛っ_HH_」	「啊゛啊_HH_咿呜゛呜゛呜_HH_啊゛、啊゛啊_HH__HH_嗯゛咿_HH_哦゛_HH_」
%CALLNAME:TARGET%の子宮口を抉るように突き続けてやる。	不停的用龟头摩擦着%CALLNAME:TARGET%的子宫口。
「あっあっあっ_HH_ひぅっ_HH_あ_HH_っはぅっ_HH_ん゛ぃひっ_HH__HH_そ、そこっ_HH__HH_お゛っ_HH_」	「啊啊啊_HH_咿呜_HH_啊_HH_哈呜_HH_嗯゛咿_HH__HH_那、那里_HH__HH_哦゛_HH_」
子宮口を抉るように突いてやるとぷしゃっと潮を吹き、獣のような声を出した。	每次猛烈的冲撞她的子宫口都会伴随着%CALLNAME:TARGET%雌兽一样的淫叫喷出一道道的淫汁。
「お゛っ_HH_お゛っ_HH_お゛っ_HH_あっ、あんまり゛っ_HH_いじわる゛っ_HH__HH_」	「哦゛_HH_哦゛_HH_哦゛_HH_啊、不要゛_HH_欺负人゛啦_HH__HH_」
%CALLNAME:MASTER%はうるさい黙れと言わんばかりに乱暴に突いてやる。	%CALLNAME:MASTER%一边说着吵死人了一边粗暴的抽插着她的蜜穴。
「しなっ_HH_あ゛っ_HH_あ゛っ_HH_あ゛っ_HH_はひっ_HH__HH_あ゛ぁっ_HH__HH_」	「不要_HH_啊゛_HH_啊゛_HH_啊゛_HH_哈咿_HH__HH_啊゛啊_HH__HH_」
「あひぃぉっ_HH_お゛っ_HH_お゛っ_HH_お゛っ_HH_おひっ_HH__HH_ほおぉっ_HH__HH__HH_」	「啊咿_HH_哦゛_HH_哦゛_HH_哦゛_HH_哦咿_HH__HH_哈哦哦哦_HH__HH__HH_」
「あ゛っ_HH_あ゛_HH_ひゅっ_HH_きぃっ…_HH_すきぃっ_HH__HH_ぉ_HH__HH_ぉお゛おっ_HH__HH__HH_」	「啊゛_HH_啊゛_HH_咿_HH_咿…_HH_喜欢_HH__HH_哦_HH__HH_哦゛哦_HH__HH__HH_」
「お゛っ_HH_ひっ_HH_んあぁあ゛あぁ_HH__HH_おぉ゛_HH_っあ_HH_お゛っぉおお_HH__HH__HH_」	「哦゛_HH_咿_HH_嗯啊啊啊゛啊_HH__HH_哦哦゛_HH_啊_HH_哦゛噢噢噢噢_HH__HH__HH_」
「あ゛_HH_あ゛_HH_う゛ぅっ_HH_くひゅっ…_HH_そのままっ_HH_だし、てぇ_HH_くらさぃ…_HH__HH_だしてぇっ_HH__HH__HH_」	「啊゛_HH_啊゛_HH_呜゛呜_HH_咕咿…_HH_就那样_HH_射、出来_HH_吧…_HH__HH_射给我_HH__HH__HH_」
PRINTFORMW 「ふぇらちお？」	PRINTFORMW 「口胶？」
PRINTFORMW %CALLNAME:MASTER%のモノを口で奉仕する事だと教える。	PRINTFORMW %CALLNAME:MASTER%和她说了用口做的事情。
PRINTFORMW 「ん～？おちんちんさんをくわえればいいのです？」	PRINTFORMW 「嗯～？把肉棒吃掉就可以了是吧？」
PRINTFORMW そう言うと%CALLNAME:TARGET%は%CALLNAME:MASTER%のモノを咥え…	PRINTFORMW 这样说着%CALLNAME:TARGET%张口对着%CALLNAME:MASTER%肉棒咬下…
CALL PRINT_STR, "紅_＜ガリッ！＞_W_"	CALL PRINT_STR, "紅_＜咔吱！＞_W_"
PRINTFORMW 「フェラチオですか？」	PRINTFORMW 「口交吗？」
PRINTFORMW %CALLNAME:MASTER%がフェラをするように言うと%CALLNAME:TARGET%は少しだけ視線を泳がせた。	PRINTFORMW %CALLNAME:MASTER%说要口交之后%CALLNAME:TARGET%露出死鱼眼看着别的地方。
PRINTFORMW %CALLNAME:MASTER%がどうかしたのかと問うと	PRINTFORMW %CALLNAME:MASTER%问她怎么了之后
PRINTFORMW 「う～、噛んじゃった事を思い出したのです…」	PRINTFORMW 「唔～、想起之前咬下去的事情了…」
PRINTFORMW 「でも！今の%CNAME("一人称")%はちがうのです！」	PRINTFORMW 「但是！现在%CNAME("一人称")%不会了、放心稳的一批！」
PRINTFORMW %CALLNAME:TARGET%はそう言うと%CALLNAME:MASTER%の前に座りフェラをはじめた。	PRINTFORMW %CALLNAME:TARGET%说着坐在%CALLNAME:MASTER%面前开始口交。
CALL PRINT_STRW,@"「あむっ_HH_ちゅ_HH_ちゅるっ_HH_んっ_HH_んんっ_HH_はむっ_HH_くちゅっ__HH」"	CALL PRINT_STRW,@"「啊姆_HH_啾_HH_啾噜_HH_嗯_HH_嗯嗯_HH_哈姆_HH_吸溜__HH」"
CALL PRINT_STRW,@"「ろうれすか_HH_	CALL PRINT_STRW,@"「怎么样_HH_
PRINTFORMW 「ん、分かりました」	PRINTFORMW 「嗯、我知道了」
PRINTFORMW そう言うと%CALLNAME:TARGET%は%CALLNAME:MASTER%のモノにしゃぶり始めた。	PRINTFORMW 然后%CALLNAME:TARGET%将%CALLNAME:MASTER%的肉棒含入口中开始舔舐。
CALL PRINT_STRW,@"「ちゅっ_HH_ちゅぷ_HH_はむっ_HH_んっ_HH_」"	CALL PRINT_STRW,@"「啾_HH_啾噗_HH_哈姆_HH_嗯_HH_」"
CALL PRINT_STRW,@"「むかひ_HH_ちゅるっ_HH_はんやっへ_HH_れろ_HH_ごへん_HH_んちゅっ_HH_なはい_HH_」"	CALL PRINT_STRW,@"「姆_HH_啾噜_HH_哈嗯_HH_吸溜_HH_对_HH_不_HH_起_HH_」"
PRINTFORMW %CALLNAME:TARGET%はしゃぶりながら昔%CALLNAME:MASTER%のを噛んだことを謝っているようだ。	PRINTFORMW %CALLNAME:TARGET%似乎在一边舔弄着肉棒一边对以前咬到%CALLNAME:MASTER%的事情道歉。
PRINTFORMW %CALLNAME:MASTER%は%CALLNAME:TARGET%の頭を撫でてやる事にした。	PRINTFORMW %CALLNAME:MASTER%轻轻的摸了摸%CALLNAME:TARGET%的头表示没事。
CALL PRINT_STRW,@"「！……_HH__HH__HH_えへへ_HH_」"	CALL PRINT_STRW,@"「！……_HH__HH__HH_欸嘿嘿_HH_」"
CALL PRINT_STRW,@"「あーむっ_HH_んっ_HH_ちゅぅ…_HH_はむっ_HH_ぴちゅっ…_HH_ちゅ、くちゅっ…_HH_ちゅるっ、ちゅぷっ…_HH_」"	CALL PRINT_STRW,@"「啊ー姆_HH_嗯_HH_啾…_HH_哈姆_HH_吸溜…_HH_啾、咕…_HH_啾噜、啾噗…_HH_」"
PRINTFORMW %CALLNAME:MASTER%にフェラをするように言われた%CALLNAME:TARGET%は何も言わずに跪いてフェラを始めた。	PRINTFORMW 听到%CALLNAME:MASTER%说要口交之后%CALLNAME:TARGET%什么也没说跪在%CALLNAME:MASTER%面前开始舔弄。
CALL PRINT_STRW,@"「ちゅ_HH_ちゅぅ…_HH_ちゅぱっ…_HH_ちゅっ…_HH_ちゅるっ_HH_ちゅっ_HH_くちゃっ…_HH_」"	CALL PRINT_STRW,@"「啾_HH_啾…_HH_啾噗…_HH_啾…_HH_啾噜_HH_啾_HH_咕啾…_HH_」"
PRINTFORMW 舌と唇で%CALLNAME:MASTER%の気持ちいいところを刺激して射精感を促してくる。	PRINTFORMW %CALLNAME:MASTER%的舌头舔弄着肉棒敏感的地方催促着射精。
CALL PRINT_STRW,@"「……おひんひんはん_HH_おっひふなっへひまひた_HH_」"	CALL PRINT_STRW,@"「……大吉吧_HH_好棒_HH_」"
CALL PRINT_STRW,@"「んっ…_HH_ちゅるっ_HH_いふれも_HH_んっ_HH_ちゅっ…_HH_らひへ_HH_ちゅぱっ_HH_いいれすよ_HH_」"	CALL PRINT_STRW,@"「嗯…_HH_啾噜_HH_在里面_HH_嗯_HH_射出…_HH_来_HH_也可以的_HH_哦_HH_」"
PRINTFORMW %CALLNAME:TARGET%は上目遣いで%CALLNAME:MASTER%にいつ射精しても良いと伝えてくる。	PRINTFORMW %CALLNAME:TARGET%眼睛仰视着%CALLNAME:MASTER%口齿不清的说。
CALL PRINT_STRW,@"「じゅっ_HH_じゅるっ_HH_ちゅぱっ_HH_ちゅぱっ_HH__HH_んぅ、ちゅぱっ_HH_ちゅぱぱっ_HH__HH_ちゅむっ_HH__HH_」"	CALL PRINT_STRW,@"「啾_HH_啾噜_HH_啾_HH_啾_HH__HH_嗯、啾噗_HH_啾噗噗_HH__HH_啾姆_HH__HH_」"
PRINTFORMW %CALLNAME:MASTER%は恐れ知らずなのか%CALLNAME:TARGET%に再びフェラチオをさせる事にした。	PRINTFORMW %CALLNAME:MASTER%似乎脑子坏了一般又一次要求%CALLNAME:TARGET%进行口交。
PRINTFORMW 「ふっふっふ！%CNAME("一人称")%だっていろいろわかったのです！」	PRINTFORMW 「呼呼呼！%CNAME("一人称")%也努力学了很多了！」
PRINTFORMW 自信ありげに%CALLNAME:TARGET%は胸を張りながら言う。	PRINTFORMW 充满自信的%CALLNAME:TARGET%抱着胸自信的说道。
PRINTFORMW 「かんじゃだめだって！」	PRINTFORMW 「不能咬金金！」
PRINTFORMW うん、そうだね。	PRINTFORMW 嗯、没错。
PRINTFORMW 「う～、べとべとします……」	PRINTFORMW 「唔～、黏糊糊的……」
PRINTFORMW 「おまたがぬるぬるして、きもちわるいです…」	PRINTFORMW 「小穴黏糊糊的、好恶心…」
PRINTFORMW 「う～？なんだかふわぁってします」	PRINTFORMW 「唔～？突然感觉整个人飘乎乎的」
CALL PRINT_STRW, @"「%CNAME("一人称")%_HH_はぁ……はぁ……_HH_んくっ_HH_なんだかおかしいです…_HH_」"	CALL PRINT_STRW, @"「%CNAME("一人称")%_HH_哈……哈……_HH_嗯_HH_有点奇怪…_HH_」"
CALL PRINT_STRW, @"「からだがあつくて…_HH_んンっ_HH_はぁ_HH_はぁ…_HH_ふわぁってします…_HH_」"	CALL PRINT_STRW, @"「身体好热…_HH_嗯_HH_哈啊_HH_哈啊…_HH_飘飘然的感觉…_HH_」"
CALL PRINT_STRW, @"「んンっ_HH__HH__HH_くぁっ_HH_はぁ_HH_はぁ…_HH_」"	CALL PRINT_STRW, @"「嗯_HH__HH__HH_咕_HH_哈啊_HH_哈啊…_HH_」"
CALL PRINT_STRW, @"「ふわふわしました…_HH_」"	CALL PRINT_STRW, @"「好舒服…_HH_」"
CALL PRINT_STRW, @"「いっ_HH_ああぁあ_HH__HH_」"	CALL PRINT_STRW, @"「好_HH_啊啊啊啊_HH__HH_」"
CALL PRINT_STRW, @"「おなかが…_HH_ふわふわ…_HH_です…_HH_」"	CALL PRINT_STRW, @"「肚子里…_HH_好舒服…_HH_嗯…_HH_」"
CALL PRINT_STRW, @"[んんんっ_HH__HH_あぅぅっ_HH_んんんんんっっ_HH__HH_あぁぁぁぁ……_HH_」"	CALL PRINT_STRW, @"[嗯嗯嗯_HH__HH_啊_HH_嗯嗯嗯嗯_HH__HH_啊啊啊啊……_HH_」"
CALL PRINT_STRW, @"灰色_「んんっ_HH_灰色_んぁぅっ_HH_灰色_んんんんっ_HH_灰色_んんんんんぅぅぅぅぅぅぅぅぅっっ_HH__HH_灰色_」"	CALL PRINT_STRW, @"灰色_「嗯嗯_HH_灰色_嗯啊_HH_灰色_嗯嗯嗯_HH_灰色_嗯嗯_HH__HH_灰色_」"
CALL PRINT_STRW, @"「あっあっあっ_HH_あぁぁぁぁぁっ_HH_あっ、あぁぁっ_HH__HH_んんぁぁぁぁぁぁぁぁぁっ_HH__HH_」"	CALL PRINT_STRW, @"「啊啊啊_HH_啊_HH_啊、啊_HH__HH_嗯嗯_HH__HH_」"
PRINTFORMW %CALLNAME:TARGET%は弓形に身体を逸らして絶頂する。	PRINTFORMW %CALLNAME:TARGET%的身体因为绝顶的快感形成了一个弓形。
PRINTFORMW 絶頂の余韻で四肢と腰がびくんっびくんっと不規則に痙攣している。	PRINTFORMW 绝顶的余韵让四肢都不规则的抽搐着。
CALL PRINT_STRW, @"「んっ……_HH_はぁ……はぁ……_HH_」"	CALL PRINT_STRW, @"「嗯……_HH_哈啊……哈啊……_HH_」"
CALL PRINT_STRW,@"「んっ…_HH_んんっ_HH_んぅっ_HH_んんっ_HH__HH_」"	CALL PRINT_STRW,@"「嗯…_HH_嗯嗯_HH_嗯唔_HH_嗯嗯_HH__HH_」"
CALL PRINT_STRW,@"「おもった、はぁ_HH_はぁ…_HH_より、んぅっ_HH_痛い、んはぅっ_HH_です…」"	CALL PRINT_STRW,@"「比想、象的_HH_哈啊…_HH_要、嗯_HH_疼、嗯哈_HH_嗯…」"
CALL PRINT_STRW,@"「けど、あったかいです_HH_」"	CALL PRINT_STRW,@"「但是、很温暖_HH_」"
CALL PRINT_STRW,@"「あっ…！ああぁっ…！！_HH__HH_」"	CALL PRINT_STRW,@"「啊…！啊啊…！！_HH__HH_」"
CALL PRINT_STRW,@"「はぁ…_HH_はぁ……_HH_………えへへ_HH_」"	CALL PRINT_STRW,@"「哈啊…_HH_哈啊……_HH_………欸嘿嘿_HH_」"
CALL PRINT_STRW,@"「あなたに%CNAME("一人称")%のはじめてをあげれて良かったです_HH_」"	CALL PRINT_STRW,@"「%CNAME("一人称")%的第一次是你真的太好了_HH_」"
CALL PRINT_STRW,@"「っ……！！はぁ_HH_はぁ……_HH_」"	CALL PRINT_STRW,@"「唔……！！哈啊_HH_哈啊……_HH_」"
PRINTFORMW 「……痛くないって、言ったらうそになります」	PRINTFORMW 「……说不痛、那是谎话」
PRINTFORMW 「でも…」	PRINTFORMW 「但是…」
CALL PRINT_STRW,@"「それ以上に、心があったかいです……_HH_」"	CALL PRINT_STRW,@"「心里、很温暖……_HH_」"
CALL PRINT_STRW,@"「ひゃっ！？んんんんっっっ！！_HH_」"	CALL PRINT_STRW,@"「咿呀！？嗯嗯嗯嗯！！_HH_」"
CALL PRINT_STRW,@"「はぁ_HH_はぁ……_HH_………う～、いたいです」"	CALL PRINT_STRW,@"「哈啊_HH_哈啊……_HH_………唔～、好痛」"
PRINTFORMW 「%CNAME("二人称")%さんも%CNAME("一人称")%にさされたときはこんなかんじです？」	PRINTFORMW 「%CNAME("二人称")%插进来也是这样的感觉吗？」
CALL PRINT_STRW,@"「あぅ、っ_HH_やめ、あ゛ぁっ_HH_おかし゛く゛な゛ち゛ゃ゛い゛ま゛す゛ッッ_HH__HH_んん゛ンんんっ_HH__HH__HH_やっ、な、んんん゛っ、なにか_HH__HH_きま…ッ_HH__HH__HH_くる、きちゃ…ッッ_HH__HH__HH_」"	CALL PRINT_STRW,@"「啊、_HH_不、啊゛啊_HH_停゛停゛一下゛等゛啊゛啊゛啊゛啊゛啊_HH__HH_嗯嗯゛嗯嗯嗯_HH__HH__HH_呀、什、嗯嗯嗯゛、什么_HH__HH_要来…_HH__HH__HH_了、啊…啊啊_HH__HH__HH_」"
CALL PRINT_STRW,@"「あっあっあっ_HH_ああぁっ_HH_やぁ、らめぇ_HH_れすっ_HH_っやらぁ…っ！ひっ_HH_やら、あぁッ_HH_おくッら゛めてぇ！あ゛あっ_HH__HH_や゛らあぁッ_HH__HH_らめっれす_HH__HH_きっ_HH_あっ_HH_き_HH_ち゛ゃい゛ます゛うぅ゛っ_HH__H__HH__H__HH_」"	CALL PRINT_STRW,@"「啊啊啊_HH_啊啊っ_HH_呀、要去_HH_了っ_HH_嗯嗯…！咿_HH_呀、里_HH_深处゛好舒服！啊゛啊_HH__HH_要゛去了_HH__HH_要去了_HH__HH_咿_HH_啊_HH_咿_HH_咿゛啊゛啊゛呜呜゛啊_HH__H__HH__H__HH_」"
エンディングを迎える	终末之始
はなはおもう	花思叶、叶思花
がっこうへいこう	鸾翔凤集
花は考える	镜花水月
花は想う	花意
花の意味、言葉を選ぶなら	花语抉择
花の意味、言葉を選ぶ	花语抉择
むかしばなし	朝花夕拾
そして、蕾は開き、花は咲く	然后、含苞待放、娇艳欲滴
PRINTFORMW 「がっこう？」	PRINTFORMW 「学校？」
PRINTFORMW 今の反応で分かったが、%CALLNAME:TARGET%は学校に行った事がないようだ。	PRINTFORMW 从刚才的反应可以知道、%CALLNAME:TARGET%从来没有去过学校。
PRINTFORMW そんな気はしていたが。	PRINTFORMW 虽然之前有过以为她是学生的想法。
PRINTFORMW とにかく、今のまま殺され続けるのはちょっと耐えられないので、	PRINTFORMW 总之、已经开始承受不住每天被杀来杀去的日常了、
PRINTFORMW 色々と学ばせるために学校に通わせることにした。	PRINTFORMW 想让她能学到更多东西打算让她去上学。
PRINTFORMW もちろん、出会った頃のまま送り出したら学友を、	PRINTFORMW 当然、相见的时候就是校友了、
PRINTFORMW 出合い頭に殺すような事になるのは予想できていたので。	PRINTFORMW 虽然已经做好遇到的时候被杀的准备就是了。
PRINTFORMW ある程度、メイドの%CALLNAME:FINDCHARA(NO, 1)%に頼み込んで色々と教えさせた後だが…	PRINTFORMW 某种程度上来说、先让%CALLNAME:FINDCHARA(NO, 1)%教教她各种事情之后再说吧…
PRINTFORMW 「とりあえず、そのうちがっこうにいけばいいのですね！」	PRINTFORMW 「总之、去那个叫学校的地方去就行了吧！」
PRINTFORMW 何一つ理解できていないのに肯定的な返事をするのは%CALLNAME:MASTER%を信頼しているからだろうか？	PRINTFORMW 虽然完全没有理解但是依然毫不犹豫的答应了、这不也是她对你的信赖的表现吗？
PRINTFORMW 【%CALLNAME:FINDCHARA(NO, 1)%の努力のお陰か%CALLNAME:TARGET%は何とか学校に通えるようになりました】	PRINTFORMW 【在%CALLNAME:FINDCHARA(NO, 1)%的努力下、不管怎么说已经能让%CALLNAME:TARGET%来到学校上课了】
PRINTFORMW 【昼の部室に顔を出してくれます】	PRINTFORMW 【中午能来部室了】
PRINTFORMW ある日、%CALLNAME:MASTER%は%CALLNAME:TARGET%に呼び出された。	PRINTFORMW 有一天、%CALLNAME:MASTER%把%CALLNAME:TARGET%叫出来了。
PRINTFORMW 何時もは自分が呼び出すのにと自嘲する。	PRINTFORMW 虽然平时就天天这样叫她出来就是了。
PRINTFORMW 呼び出された場所は%CALLNAME:TARGET%と初めて出会ったあの路地裏。	PRINTFORMW 约好的地点、是与%CALLNAME:TARGET%第一次相遇时的小路。
PRINTFORMW 出会った時刻とはズレてるかもしれないけれど、確かにここで%CALLNAME:TARGET%と出会った。	PRINTFORMW 虽然相遇的时间与现在不同、但是确实是两人相遇的地方。
PRINTFORMW あれから%CALLNAME:TARGET%に何回殺されたのだろうか。	PRINTFORMW 那之后、被%CALLNAME:TARGET%杀了多少次呢。
PRINTFORMW 少なくとも10回以上は殺されている。	PRINTFORMW 最少也有10次以上了。
PRINTFORMW 慣れたモノだと思う。	PRINTFORMW 已经开始习惯了。
PRINTFORMW 「待ちました？」	PRINTFORMW 「久等了？」
PRINTFORMW 暫く待ちぼうけていると遅れて%CALLNAME:TARGET%がやって来た。	PRINTFORMW 稍微等了一会、来迟的%CALLNAME:TARGET%走过来问道。
PRINTFORMW 手にはあの時と同じナイフ。	PRINTFORMW 手中握着与那时相同的匕首。
PRINTFORMW 「……%CNAME("一人称")%、最近おかしいのです」	PRINTFORMW 「……%CNAME("一人称")%、最近有点奇怪」
PRINTFORMW %CALLNAME:TARGET%は俯き表情が分からない。	PRINTFORMW %CALLNAME:TARGET%低着头看不到她的表情。
PRINTFORMW 「%CNAME("二人称")%さんと出会う前は、ただ人を殺したくて殺していたのに」	PRINTFORMW 「遇到%CNAME("二人称")%之前、我的人生就只在杀人中度过」
PRINTFORMW 「男の人も、女の人も、若い人も、老いた人も」	PRINTFORMW 「不管是男人、女人、小孩、老人」
PRINTFORMW 「何にも考えずにただ殺していたのにっ」	PRINTFORMW 「什么也不想的、杀」
PRINTFORMW %CALLNAME:TARGET%が握っている手から血が伝う。	PRINTFORMW %CALLNAME:TARGET%握紧的手流下了猩红的血液。
PRINTFORMW 「%CNAME("二人称")%さんと出会ってからっ！%CNAME("一人称")%がやっている事が変なのかとっ！」	PRINTFORMW 「因为遇到了%CNAME("二人称")%！%CNAME("一人称")%的人生、才因此改变了！」
PRINTFORMW 「いっぱい、教えてもらいました」	PRINTFORMW 「我、学到了需多」
PRINTFORMW 「いっぱい、知りました」	PRINTFORMW 「我、知道了需多」
PRINTFORMW 「いっぱい、覚えました」	PRINTFORMW 「我、记住了需多」
PRINTFORMW 「いっぱい、よごしてました」	PRINTFORMW 「我、被给予了需多」
PRINTFORMW 「それでもっ！それ以上に%CNAME("一人称")%は%CNAME("二人称")%さんが好きなんですっ！」	PRINTFORMW 「尽管如此！%CNAME("一人称")%对%CNAME("二人称")%的爱在那些之上！」
PRINTFORMW 「%CNAME("一人称")%は%CNAME("二人称")%さんの横に普通に立って良いのかっ！」	PRINTFORMW 「%CNAME("一人称")%只想普通的站在%CNAME("二人称")%的身旁、那样就好！」
PRINTFORMW 「いっぱい…、いっぱいいっぱい考えても%CNAME("一人称")%は答えをだせないのですっ……！」	PRINTFORMW 「很多…、思考了很多、但是无论怎么思考、%CNAME("一人称")%自己得出的答案只有这一个……！」
PRINTFORMW 「普通の女の子になって、%CNAME("二人称")%さんを好きでいていいのかっ！」	PRINTFORMW 「想成为一个普通的女孩子、普通的喜欢上%CNAME("二人称")%、那样就好！」
PRINTFORMW 「だからっ！」	PRINTFORMW 「所以！」
PRINTFORMW %CALLNAME:TARGET%は顔を上げて酷い表情で	PRINTFORMW %CALLNAME:TARGET%抬起头、露出了狰狞的表情
PRINTFORMW 「%CNAME("一人称")%はどうすれば良いんですか……？」	PRINTFORMW 「%CNAME("一人称")%应该怎么做才好……？」
PRINTFORMW %CALLNAME:MASTER%に問いかけた。	PRINTFORMW 她、给出了问题。
PRINTFORMW それに%CALLNAME:MASTER%は…	PRINTFORMW 你的回答…？
CALL PRINT_SELECT, "　歓迎する/　恋に酔え/　決して離れない"	CALL PRINT_SELECT, "　不负相思意/　鸾凤和鸣/　长相厮守"
PRINTFORML 歓迎する。	PRINTFORML 欢迎。
PRINTFORMW %CALLNAME:MASTER%はそう%CALLNAME:TARGET%に言った。	PRINTFORMW %CALLNAME:MASTER%对着%CALLNAME:TARGET%说。
PRINTFORMW %CALLNAME:TARGET%のその在り方に惹かれたのだと。	PRINTFORMW 以为%CALLNAME:TARGET%会对这个简单的答案感到高兴。
PRINTFORMW だから、そのままで良い。そのままが良い。	PRINTFORMW 所以、这样就好。这样就好。
PRINTFORMW 「…ふふっ！ふふふふふふふふふふふっ！」	PRINTFORMW 「…呼呼！呼呼呼哈哈哈！」
PRINTFORMW 「アハハハハハハハハハハハハハハハハハハハハハハハハハハハハッ！」	PRINTFORMW 「啊哈哈哈哈哈哈哈哈哈哈哈哈哈哈哈！」
PRINTFORMW 「そうですか！%CNAME("一人称")%は%CNAME("一人称")%のままで良いのですね！」	PRINTFORMW 「这样啊！%CNAME("一人称")%保持现在这样就好是吗！」
PRINTFORMW 「迷う必要なんてなかったのですね！」	PRINTFORMW 「根本没有迷惘的必要啊！」
PRINTFORMW 「簡単な、簡単な話でした！」	PRINTFORMW 「简单、简单的话语啊！」
PRINTFORMW 「ふふっ！あはっ！アハハハハハハハハハハハハハッ！」	PRINTFORMW 「呼呼！啊哈！啊哈哈哈哈哈哈哈哈哈哈！」
PRINTFORMW %CALLNAME:TARGET%は狂笑を続ける。	PRINTFORMW %CALLNAME:TARGET%不断地发出狂气的笑声。
PRINTFORMW 笑って嗤って哂って咲う。	PRINTFORMW 大声的、狂气的、讥讽的绽放着。
PRINTFORMW 「……でしたら、何時もの様に%CNAME("一人称")%にあなたを何時もの様に殺させてください」	PRINTFORMW 「……那么、一如平常的%CNAME("一人称")%、一如平常的%CALLNAME:MASTER%、一如平常的让我杀了你！」
PRINTFORMW そう言って%CALLNAME:TARGET%はあの時と同じようにナイフを%CALLNAME:MASTER%に突き立てた。	PRINTFORMW 这样说着%CALLNAME:TARGET%在那一瞬间挥出了手中的匕首。
PRINTFORMW %CALLNAME:TARGET%はこれからも変わらず%CALLNAME:MASTER%と%CALLNAME:MASTER%以外を殺すだろう。	PRINTFORMW %CALLNAME:TARGET%从今以后、将永远的杀着%CALLNAME:MASTER%、永远的、持续下去。
PRINTFORMW 花は飾らなくても美しいのだと言ったからだ。	PRINTFORMW 因为、那是不用装饰就能拥有致命的美的花朵。
PRINTFORMW それは%CALLNAME:MASTER%が選んだ言葉で彼女をそうしたのだ。	PRINTFORMW 这、就是%CALLNAME:MASTER%选择的她。
PRINTFORMW ＥＮＤ　「花の意味、言葉を選ぶ：歓迎する」	PRINTFORMW ＥＮＤ　「花语抉择：不负相思意」
PRINTFORML 恋に酔え。	PRINTFORML 陶醉在恋爱之中。
PRINTFORMW %CALLNAME:TARGET%には普通の女の子の様になってほしいと。	PRINTFORMW %CALLNAME:TARGET%希望她能变成一名普通的女孩子。
PRINTFORMW だから、もう人を殺すのをやめて欲しい。	PRINTFORMW 所以、不希望她再杀人了。
PRINTFORMW 「そう…ですか、…ふふっ」	PRINTFORMW 「这…样吗、…呼呼」
PRINTFORMW 「%CNAME("一人称")%はずっと人を殺すが普通だっておもっていました」	PRINTFORMW 「%CNAME("一人称")%一直在杀人、也有考虑过过上普通的生活」
PRINTFORMW 「でも、%CNAME("一人称")%はあなたと出会いました」	PRINTFORMW 「但是、%CNAME("一人称")%和你相遇了」
PRINTFORMW 「普通が何なのかをいっぱい教えてもらいました」	PRINTFORMW 「已经学到了需多何为普通的事情了」
PRINTFORMW 「%CNAME("一人称")%はあなたの事が好きです」	PRINTFORMW 「%CNAME("一人称")%喜欢你」
PRINTFORMW 「あなたが言うから、%CNAME("一人称")%がそうしたいから」	PRINTFORMW 「你希望我成为普通的样子、%CNAME("一人称")%就会去这样做」
PRINTFORMW 「もう%CNAME("一人称")%は人を殺しません」	PRINTFORMW 「%CNAME("一人称")%不会再杀人了」
PRINTFORMW そう言って%CALLNAME:TARGET%は手に持っていたナイフを捨てた	PRINTFORMW %CALLNAME:TARGET%把手中的匕首扔到一旁
PRINTFORMW からんからんと転がり彼女の殺人は置いていかれる。	PRINTFORMW 似乎已经抛弃了杀人这一想法。
CALL PRINT_STRW,@"「だから、%CNAME("一人称")%を愛してください_HH_」"	CALL PRINT_STRW,@"「所以、请爱上%CNAME("一人称")%吧_HH_」"
CALL PRINT_STRW,@"「殺すように、溶けるくらいに、%CNAME("一人称")%のすべてを_HH_」"	CALL PRINT_STRW,@"「就像把我杀掉一般、让我彻底染上你的颜色、夺走%CNAME("一人称")%的一切_HH_」"
PRINTFORMW そう言うと%CALLNAME:TARGET%は%CALLNAME:MASTER%の顔を引き寄せ貪るようにキスをする。	PRINTFORMW 语毕、迫不及待的%CALLNAME:TARGET%抱住了%CALLNAME:MASTER%脖子贪恋的夺走了%CALLNAME:MASTER%的唇。
PRINTFORMW %CALLNAME:TARGET%はこれからは普通の女の子として%CALLNAME:MASTER%のそばに居るだろう。	PRINTFORMW 从现在开始、%CALLNAME:TARGET%将作为普通的女孩子陪伴在%CALLNAME:MASTER%的身旁。
PRINTFORMW ただ、野に咲く花のように。	PRINTFORMW 只不过、如同路边的野花一般。
PRINTFORMW ＥＮＤ　「花の意味、言葉を選ぶ：恋に酔え」	PRINTFORMW ＥＮＤ　「花语抉择：鸾凤和鸣」
PRINTFORML 決して離れない。	PRINTFORML 绝不分离。
PRINTFORMW %CALLNAME:TARGET%は%CALLNAME:MASTER%のモノで、だから%CALLNAME:MASTER%以外に%CALLNAME:TARGET%が何かをする事を赦さない。	PRINTFORMW %CALLNAME:TARGET%是%CALLNAME:MASTER%的东西、所以%CALLNAME:MASTER%会允许%CALLNAME:TARGET%做的任何事情。
PRINTFORMW そう言って%CALLNAME:MASTER%は%CALLNAME:TARGET%を強引に抱き寄せ唇を奪う。	PRINTFORMW 这样说着%CALLNAME:MASTER%强硬的抱住%CALLNAME:TARGET%夺走了她的唇。
PRINTFORMW その時にナイフがお腹に刺さるがそれを無視して続ける。	PRINTFORMW 就算被匕首刺入内脏也无视的继续着亲吻。
PRINTFORMW 痛みなんて%CALLNAME:TARGET%と関わってからもう慣れた。	PRINTFORMW 疼痛什么的、早已在无数次被%CALLNAME:TARGET%杀害的经验中习惯了。
PRINTFORMW 自分を創りなおす感覚なんてもう慣れた。	PRINTFORMW 伤口痊愈的感觉也早已习惯。
PRINTFORMW 時の針が止まったような口づけを交わす。	PRINTFORMW 如同时间停滞了一般、两人不断地接吻着。
CALL PRINT_STRW,@"「っぷは！はぁ……_HH_はぁ……_HH_んくっ……_HH_」"	CALL PRINT_STRW,@"「噗哈！哈啊……_HH_哈啊……_HH_嗯……_HH_」"
PRINTFORMW だから、%CALLNAME:MASTER%以外には目をくれるな	PRINTFORMW 所以、视线不要离开我
PRINTFORMW 「%CNAME("一人称")%は%CALLNAME:MASTER%をこのまま普通に好きになって良いのですか…？」	PRINTFORMW 「%CNAME("一人称")%这样被%CALLNAME:MASTER%普通的喜欢着真的好吗…？」
PRINTFORMW そうだ、%CALLNAME:TARGET%はもう%CALLNAME:MASTER%の女だ。	PRINTFORMW %CALLNAME:TARGET%已经是我的女人了。
PRINTFORMW だから、人を殺したくなったら%CALLNAME:MASTER%に言え。	PRINTFORMW 所以、想杀人的时候就和我说。
PRINTFORMW 喜んで、殺されてやる。	PRINTFORMW 喜欢的时候、杀。
PRINTFORMW 何度だって、殺されてやる。	PRINTFORMW 不管多少次、杀。
PRINTFORMW 他の奴に目をくれるな。%CALLNAME:MASTER%だけ見てろ。	PRINTFORMW 视线不要从我身上离开。%CALLNAME:TARGET%的眼中只能有我。
CALL PRINT_STRW,@"「ふふっ_HH_しっと深いですね。でも、うれしいです_HH_」"	CALL PRINT_STRW,@"「呼呼_HH_嫉妒心好强呢。但是、我很高兴哦_HH_」"
PRINTFORMW 「はい、%CNAME("一人称")%はもう%CALLNAME:MASTER%しか殺しません。あなた以外は殺しません。」	PRINTFORMW 「好、%CNAME("一人称")%已经不会再去杀%CALLNAME:MASTER%以外的人了。我会杀的、只有你一个人。」
PRINTFORMW 「殺します、あなたを」	PRINTFORMW 「我会、杀了你」
PRINTFORMW そう言って%CALLNAME:TARGET%は%CALLNAME:MASTER%のお腹に刺さったナイフを抜き、誓うように胸に刺した。	PRINTFORMW 说完之后、%CALLNAME:TARGET%拔出了插在%CALLNAME:MASTER%腹部的匕首、如同誓约一样的朝胸口刺下。
PRINTFORMW %CALLNAME:TARGET%はこれからも%CALLNAME:MASTER%を殺すだろう。しかし、同時に%CALLNAME:MASTER%を愛すだろう。	PRINTFORMW 以后、%CALLNAME:TARGET%也会一直杀%CALLNAME:MASTER%的吧。但是、同时永远的爱着%CALLNAME:MASTER%吧。
PRINTFORMW 殺す事しか出来なかった少女に全てを受け入れて愛を教え独占した。	PRINTFORMW 接受无知的杀人姬的所有、然后独占她所有的爱。
PRINTFORMW ＥＮＤ　「花の意味、言葉を選ぶ：決して離れない」	PRINTFORMW ＥＮＤ　「花语抉择：长相厮守」
PRINTFORMW 【%CALLNAME:TARGET%はもうあなた以外は殺しません】	PRINTFORMW 【%CALLNAME:TARGET%将不会再杀除你之外的人】
PRINTFORMW チチチチ、と小鳥が囀る声で%CALLNAME:MASTER%は目を覚ました。	PRINTFORMW 叽叽喳喳、的鸟鸣让%CALLNAME:MASTER%醒了过来。
PRINTFORMW 布団の誘惑から何とか抜け出して身支度を始める。	PRINTFORMW 总算从被窝的封印中逃出来、然后开始穿衣。
PRINTFORMW 「わ、わぁああああああああああああ！」	PRINTFORMW 「哇、哇啊啊啊啊啊啊！」
PRINTFORMW 小鳥の囀りが聞こえるほど静かな朝は悲鳴で一気に賑やかなモノになってしまう。	PRINTFORMW 本来周围还只有小鸟的鸣叫声、随着尖叫声一下子就变得嘈杂了起来。
PRINTFORMW ドタドタドタドタ！	PRINTFORMW 咚咚咚咚咚咚！
PRINTFORMW 廊下を誰かが走る音がする。	PRINTFORMW 走廊上有谁在奔跑的样子。
PRINTFORMW ドンドンドン！	PRINTFORMW 咚咚咚！
PRINTFORMW その誰かは%CALLNAME:MASTER%の部屋の前まで来たようだ。	PRINTFORMW 有谁来到%CALLNAME:MASTER%房间门前的样子。
PRINTFORMW 「%CNAME("二人称")%さん！ドアを開けてください！%CNAME("一人称")%死んじゃいます！」	PRINTFORMW 「%CNAME("二人称")%！开门！%CNAME("一人称")%要死了！」
PRINTFORMW 何事だと思ってドアを開けると声の主%CALLNAME:TARGET%がそこに居た。	PRINTFORMW 还想着发生什么了的%CALLNAME:TARGET%打开房门。
PRINTFORMW 暖色系のパジャマに身を包んだ%CALLNAME:TARGET%のズボンの、	PRINTFORMW 然后看到、穿着一身暖色系的睡衣的%CALLNAME:TARGET%的裤子上、
PRINTFORMW と言うよりも股間の部分は赤く血で染まっていた。	PRINTFORMW 不、应该说股间的部分被赤红的血液染红。
PRINTFORML 「ぼ、%CNAME("一人称")%のおまんこから血が出てきてます！」	PRINTFORML 「我、%CNAME("一人称")%的小穴流血了！」
PRINTFORML 「こんなの%CNAME("二人称")%さんとえっちしてから初めてです！」	PRINTFORML 「就像和%CNAME("二人称")%第一次做爱时候一样！」
PRINTFORMW 「血ってけがしてからしか出ないのに！」	PRINTFORMW 「明明血这种东西只有受伤之后才会出现的！」
CALL PRINT_STRL,@"「ぼ、%CNAME("一人称")%のおま、お股_／／／_から血が出てきてます！_／／／_」"	CALL PRINT_STRL,@"「我、%CNAME("一人称")%的小xue、屁股_／／／_那里流血了！_／／／_」"
CALL PRINT_STRL,@"「こ、こんなの%CNAME("二人称")%さんとえ、えっちしてから初めてです_／／／_」"	CALL PRINT_STRL,@"「这、这样的从最初和%CNAME("二人称")%做之后、第一次见到_／／／_」"
CALL PRINT_STRL,@"「ぼ、%CNAME("一人称")%のおまっ……、おまんこ_／／／_から血が出てきてます！_／／／_」"	CALL PRINT_STRL,@"「我、%CNAME("一人称")%的小……、小穴_／／／_流血了！_／／／_」"
CALL PRINT_STRL,@"「こ、こんなの%CNAME("二人称")%さんにはじめてをあげてから初めてです_／／／_」"	CALL PRINT_STRL,@"「这、这样的从最初和%CNAME("二人称")%做之后、第一次见到_／／／_」"
PRINTFORMW 取り合えず%CALLNAME:MASTER%は%CALLNAME:TARGET%に落ち着くように言って考える。	PRINTFORMW 总之%CALLNAME:MASTER%让%CALLNAME:TARGET%冷静下来。
PRINTFORMW 今日の晩御飯は赤飯だな、と。	PRINTFORMW 今晚的晚饭就做红豆饭吧、这样想着。
PRINTFORMW 「んー？%CNAME("一人称")%のはじめての話ですか？」	PRINTFORMW 「嗯ー？要说%CNAME("一人称")%以前的话吗？」
PRINTFORMW %CALLNAME:MASTER%が%CALLNAME:TARGET%に初めての事を尋ねた。	PRINTFORMW %CALLNAME:MASTER%向%CALLNAME:TARGET%询问着以前的事情。
CALL PRINT_STRW,@"「もぅ……%CNAME("二人称")%さんが%CNAME("一人称")%のはじめてを………_／／／_ひゃっ！ひたひれす！ひたひれす！」"	CALL PRINT_STRW,@"「真是的……%CNAME("二人称")%怎么能问%CNAME("一人称")%以前的事情………_／／／_咿呀！太近了！太近了！」"
PRINTFORMW どうやら%CALLNAME:MASTER%と接しすぎたせいで、頭が大分ピンクになってしまったようだ。	PRINTFORMW 看来和%CALLNAME:MASTER%待在一起待久了、她的思维都变得少女了起来。
PRINTFORMW ぐにーっと引っ張っていた頬を離し、殺しの事だと伝え直す。	PRINTFORMW 她鼓起脸颊退朝一边、然后开始说以前的事情。
PRINTFORMW 「んー……、あんまりたのしくないお話ですよ？」	PRINTFORMW 「嗯ー……、并不是什么特别有趣的话哦？」
PRINTFORMW それでも%CALLNAME:MASTER%には、その話を聞く義務がある。	PRINTFORMW 即使这样、%CALLNAME:MASTER%也觉得自己有听的必要。
PRINTFORMW だから、話してくれと言った。	PRINTFORMW 所以、开始你的表演。
PRINTFORMW 「そうですか……、じゃあ」	PRINTFORMW 「这样啊……、那」
PRINTFORMW %CNAME("一人称")%がはじめて人を殺した話を。	PRINTFORMW %CNAME("一人称")%第一次杀人的故事。
PRINTFORMW あるところに女の子がいました。	PRINTFORMW 某个地方有一名女孩子。
PRINTFORMW 女の子は生まれた時は祝福されましたが、	PRINTFORMW 女孩子出生的时候就受到了祝福、
PRINTFORMW 大きくなるにつれて殴ったり蹴ったりされるようになりました。	PRINTFORMW 但是随着长大、经常被人暴力殴打。
PRINTFORMW 理由はわかりません。	PRINTFORMW 不知道为什么。
PRINTFORMW でも、女の子は暴力を受け続けました。	PRINTFORMW 但是、女孩一直在别人的殴打中度过。
PRINTFORMW はなしかけるように虐待を、あたまをなでるように暴力を。	PRINTFORMW 如同日常谈话一样平常的虐待、如同摸头一样普通的暴力。
PRINTFORMW いつしか女の子はそれが普通だと思うようになりました。	PRINTFORMW 不知不觉间、女孩认为这是普通的。
PRINTFORMW 普通に接するとは暴力をふるう事だと。	PRINTFORMW 自己接受的暴力、是普通的。
PRINTFORMW ある日の夜、物音に目を覚ました女の子は	PRINTFORMW 某天的夜晚、因为什么东西响动而醒过来的女孩
PRINTFORMW おとうさんが服を脱いで近づいてくるのを見ました。	PRINTFORMW 看到爸爸脱了衣服走了过来。
PRINTFORMW いつもとは違う目をしたおとうさんに女の子は、	PRINTFORMW 感觉爸爸和平时不一样的女孩、
PRINTFORMW 床に落ちてた、なにかを拾ってなげました。	PRINTFORMW 从床上下来、拾起了什么。
PRINTFORMW いつもあいさつのようにモノを投げつけられたりされてるから、	PRINTFORMW 因为平常都会如同打招呼一般的被扔东西砸来自己身上、
PRINTFORMW それがふつうの事だと思って。	PRINTFORMW 所以觉得那也是普通的。
PRINTFORMW 落ちてたのはハサミでした。	PRINTFORMW 落在地上的、是一把剪刀。
PRINTFORMW ハサミはおとうさんの目に刺さりました。	PRINTFORMW 剪刀刺入了爸爸的眼中。
PRINTFORMW おとうさんは叫びます。	PRINTFORMW 爸爸发出了凄厉的叫声。
PRINTFORMW おかあさんがやって来ます。	PRINTFORMW 妈妈听到声音之后过来了。
PRINTFORMW やって来た、おかあさんに女の子はおとうさんの目に刺さったハサミを、	PRINTFORMW 来到现场的妈妈、女孩拔出刺入父亲眼中的剪刀、
PRINTFORMW お腹に刺しました。	PRINTFORMW 刺入了妈妈的腹部。
PRINTFORMW もちろんお母さんも叫びます。	PRINTFORMW 当然、妈妈也发出了凄厉的叫声。
PRINTFORMW だから、女の子はいつもいたいいたいと言うのをやめるまで殴られる様に、	PRINTFORMW 所以、女孩如同平时那样、就算发出求救的声音、也不会停止的殴打一样、
PRINTFORMW ハサミを突き立てました。	PRINTFORMW 刺出了剪刀。
PRINTFORMW なんどもなんども。	PRINTFORMW 一次又一次。
PRINTFORMW おかあさんはいつのまにか静かになったので、	PRINTFORMW 妈妈不知道什么时候已经变得安静了、
PRINTFORMW おとうさんを見ます。	PRINTFORMW 爸爸在一旁看着。
PRINTFORMW おとうさんは女の子を見てなにかを言っていますが、	PRINTFORMW 爸爸看着女孩嘴里说着什么、但是、
PRINTFORMW 女の子はハサミを突き立てました。	PRINTFORMW 女孩再次刺出了手中的剪刀。
PRINTFORMW しばらくすると、遠くからウー！ウー！ウー！と言う音が聞こえてきます。	PRINTFORMW 过了一会、远方传来呜ー！呜ー！呜ー！的声音。
PRINTFORMW ピーンポーンと言う音がしばらく続けて鳴った後、	PRINTFORMW 叮ー咚ー的声音响了一段时间后、
PRINTFORMW お家のドアをドンドンドン！と叩く音がひびき、	PRINTFORMW 家的大门被人敲打发出咚咚咚的声音、
PRINTFORMW ガチャリとドアが開く音がしました。	PRINTFORMW 然后门发出了咔嚓的被人打开的声音。
PRINTFORMW ドタドタと青い服を着た大人の人たちが入ってきます。	PRINTFORMW 随着哐哐哐的脚步声、房间里进来了需多穿着蓝色衣服的大人。
PRINTFORMW 女の子は手に持っていたハサミをふりますが、	PRINTFORMW 女孩虽然挥动着手中的剪刀、
PRINTFORMW もう大丈夫だ！と言われて腕をつかまれて白と黒の車に乗せられました。	PRINTFORMW 已经没事了！这样说着被抓住手腕坐上了黑白相间的车。
PRINTFORMW その後は………	PRINTFORMW 那之后………
PRINTFORMW 「%CNAME("一人称")%が殺した事を信じられなかったみたいなので孤児院に預けられました」	PRINTFORMW 「无法相信%CNAME("一人称")%能够杀人的样子然后被寄养到孤儿院」
PRINTFORMW 「%CNAME("一人称")%が殺した証拠はいっぱいあるのになんででしょうか？」	PRINTFORMW 「明明能证明%CNAME("一人称")%杀人的证据多如牛毛的说？」
PRINTFORMW %CALLNAME:TARGET%は過去を語った後に、疑問を言っている。	PRINTFORMW %CALLNAME:TARGET%说完之后、她似乎有些疑问。
PRINTFORMW これは想像だが、%CALLNAME:TARGET%の家には鍵がかかっていなかったのだろう。	PRINTFORMW 虽然知道她肯定做得出来、但是%CALLNAME:TARGET%的家里上着锁的吧。
PRINTFORMW で、押し入り強盗がやってきて逃げたと警察は勘違いしたのだろう。	PRINTFORMW 然后、闯进来的强盗逃跑了、被警察认错了吧。
PRINTFORMW 子供が自分がやりましたと言っても極度の混乱状態だと思われたのだろう。	PRINTFORMW 就算孩子说自己做的、也会被当成孩子在极度的混乱状态吧。
PRINTFORMW %CALLNAME:MASTER%はそれを口に出さずに%CALLNAME:TARGET%を引き寄せ頭を撫でてやる。	PRINTFORMW 不过%CALLNAME:MASTER%并没有说出口、只是无言的抱住%CALLNAME:TARGET%抚摸着她的头。
CALL PRINT_STRW,@"「ん～♪えへへ♪」"	CALL PRINT_STRW,@"「嗯～♪欸嘿嘿♪」"
PRINTFORMW ひとつだけ今の話を聞いて聞きたいことがある。	PRINTFORMW 有一个疑问现在想问问你。
PRINTFORMW %CALLNAME:TARGET%は親を、人を殺した事に後悔はないのか？	PRINTFORMW %CALLNAME:TARGET%、后悔杀了自己的父母吗？
PRINTFORMW 「ん～、あると言えばあります」	PRINTFORMW 「嗯～、要说有的话有的哦」
PRINTFORMW 「でも、今の%CNAME("一人称")%はそれを言ったらダメだとおもうのです」	PRINTFORMW 「但是、现在的%CNAME("一人称")%来说悔意的话总觉得不太好」
PRINTFORMW 「言ったら楽になっちゃいますから」	PRINTFORMW 「说出来的话可能会变得兴奋起来」
PRINTFORMW そうか。	PRINTFORMW 这样啊。
PRINTFORMW そのまま%CALLNAME:MASTER%と%CALLNAME:TARGET%は何も話さずゆったりと時間を過ごした。	PRINTFORMW 那之后、%CALLNAME:MASTER%和%CALLNAME:TARGET%一起说着话度过了一段悠闲地时光。
PRINTFORMW %CNAME("一人称")%はいま、たぶんいままでいちばん、しあわせなせいかつをできてます！	PRINTFORMW %CNAME("一人称")%现在的生活、大概是至今为止、最幸福的生活！
PRINTFORMW あったかいおうちに、おいしいごはん！	PRINTFORMW 温暖的家、好吃的饭！
PRINTFORMW おふろにもはいれますし、おはなしできる人、そして！なんども殺せる人！	PRINTFORMW 也能泡澡、也有人能说话、然后！还能无数次的杀人！
PRINTFORMW %CNAME("二人称")%さんとであってから%CNAME("一人称")%はとってもしあわせです！	PRINTFORMW 因为遇到了%CNAME("二人称")%%CNAME("一人称")%才能如此幸福！
PRINTFORMW %CNAME("二人称")%さんにであってから、ぶかつどう？の人とはなすようになってから	PRINTFORMW 因为遇到了%CNAME("二人称")%、我才能认识和结交部室？的人
PRINTFORMW %CNAME("一人称")%はおもうのです。	PRINTFORMW %CNAME("一人称")%想啊。
PRINTFORMW %CNAME("一人称")%ってふつうじゃないのかって？	PRINTFORMW %CNAME("一人称")%应该并不普通吧？
PRINTFORMW %CNAME("二人称")%さんのことをおもうと、むねがちくちくするのです。	PRINTFORMW 但是一想到%CNAME("二人称")%、就会感觉很兴奋。
PRINTFORMW おとうさんとおかあさんのことを、おもうときとおなじちくちく。	PRINTFORMW 如果想到妈妈和爸爸的话、应该也是一样的会兴奋吧。
PRINTFORMW %CNAME("二人称")%さんは%CNAME("一人称")%になんでもするって、いいましたが%CNAME("一人称")%になにもしてきません。	PRINTFORMW %CNAME("二人称")%会为了%CNAME("一人称")%做任何事、换过来说%CNAME("一人称")%也会为了%CNAME("二人称")%做任何事。
PRINTFORMW おはなしして、ごはんをたべて、あたまをなでてくれる。	PRINTFORMW 一起说话、一起吃饭、被摸摸头。
PRINTFORMW でも、%CNAME("二人称")%さんがするっていっていたことはしてきません。	PRINTFORMW 但是、我没有为%CNAME("二人称")%做过什么事情。
PRINTFORMW %CNAME("一人称")%はもらってばっかりです…。	PRINTFORMW %CNAME("一人称")%只是一味的享受着%CNAME("二人称")%的爱…。
PRINTFORMW %CNAME("一人称")%は、%CNAME("一人称")%はどうすればいいのでしょうか…？	PRINTFORMW %CNAME("一人称")%、%CNAME("一人称")%该怎么做才好…？
PRINTFORMW %CNAME("一人称")%は学校にかようことになりました！	PRINTFORMW %CNAME("一人称")%去学校上学了！
PRINTFORMW べんきょうはむずかしいですけど、色々なことを知れて楽しいです！	PRINTFORMW 虽然学习好难懂、但是能知道各种事情很开心！
PRINTFORMW お友達もいっぱいできました！	PRINTFORMW 也交到好多朋友！
PRINTFORMW すこしふまんなことがありますが、それ以上に楽しいことだらけです！	PRINTFORMW 虽然有些许不满、但是除此之外全都很开心！
PRINTFORMW クラスのお友達と帰りみちに、ふと前まで%CNAME("一人称")%がいた場所のまえを通りました。	PRINTFORMW 和班上的朋友回家的时候、不小心路过了以前%CNAME("一人称")%待的地方。
PRINTFORMW %CNAME("一人称")%と、%CNAME("二人称")%さんが出会った場所。	PRINTFORMW 那是、%CNAME("一人称")%和%CNAME("二人称")%相遇的地方。
PRINTFORMW %CNAME("一人称")%は……、	PRINTFORMW %CNAME("一人称")%……、
PRINTFORMW いまの%CNAME("一人称")%は、人を殺しちゃダメだってことを知りました。	PRINTFORMW 现在的%CNAME("一人称")%、知道了杀人是不对的。
PRINTFORMW ぼう力をふるっちゃダメだって。	PRINTFORMW 暴力是不对的。
PRINTFORMW でも、%CNAME("二人称")%さんは%CNAME("一人称")%に殺されるのをうけ入れてくれています。	PRINTFORMW 但是、%CNAME("二人称")%接受了%CNAME("一人称")%杀人的事情。
PRINTFORMW %CNAME("二人称")%さんのことを考えるとむねがぎゅーってなって何かしてあげたくなります。	PRINTFORMW 一想到%CNAME("二人称")%、心中就感觉有什么东西升上来。
PRINTFORMW でも、%CNAME("一人称")%は殺すことしかできません。	PRINTFORMW 但是、%CNAME("一人称")%除了杀人、什么都做不到。
PRINTFORMW もらってばかりです。	PRINTFORMW 只是不断的接受着。
PRINTFORMW %CNAME("一人称")%はなにかしてあげたいです。	PRINTFORMW %CNAME("一人称")%也想为%CNAME("二人称")%做点什么。
PRINTFORMW いっそ、%CNAME("二人称")%さんから%CNAME("一人称")%になにかを求めてほしいです。	PRINTFORMW 干脆、由%CNAME("二人称")%对%CNAME("一人称")%提个要求。
PRINTFORMW でも、%CNAME("二人称")%さんは%CNAME("一人称")%になんにも求めてこないです。	PRINTFORMW 但是、%CNAME("二人称")%从来不对%CNAME("一人称")%要求什么。
PRINTFORMW 夜になると%CNAME("一人称")%は%CNAME("二人称")%さんと出会った場所にいきます。	PRINTFORMW 是夜、%CNAME("一人称")%来到了和%CNAME("二人称")%相遇的地方。
PRINTFORMW ぐるぐるしたなにかをどこかへいかせるために。	PRINTFORMW 周围漆黑的环境下、总感觉有什么东西在蠢蠢欲动。
PRINTFORMW 歩きかたがふらふらした人が入ってきて	PRINTFORMW 有一个步履的人走了过来
PRINTFORMW いつものように手にもったナイフをふります。	PRINTFORMW 手中一如既往的握着那把匕首。
PRINTFORMW ぐるぐるしたなにかはすこしどこかへいきました。	PRINTFORMW 黑暗中有什么东西在蠢蠢欲动。
PRINTFORMW 『おやおや、派手にやっちゃいましたね』	PRINTFORMW 『哦呀哦呀、还真是夸张的阵势呢』
PRINTFORMW 声がして振り向くと%CALLNAME:FINDCHARA(NO, 1)%さんがいました。	PRINTFORMW 看向声音传来的地方、看到%CALLNAME:FINDCHARA(NO, 1)%在那里站着。
PRINTFORMW 『%CALLNAME:TARGET%さんがどうしようと私は関係ありませんが、』	PRINTFORMW 『虽然%CALLNAME:TARGET%小姐要做什么与我无关、然而、』
PRINTFORMW 『ご主人様が困るのは少しいただけないのでご主人様のメイドとして処理しておきます』	PRINTFORMW 『但是如果会造成主人的困扰的话作为女仆来说不能接受所以就由我来处理了』
PRINTFORMW 『これは親切心で忠告しますが、%CALLNAME:TARGET%さん』	PRINTFORMW 『这是衷心的忠告、%CALLNAME:TARGET%小姐』
PRINTFORMW 『あなたは何時か自身が何をしていたか後悔する日が来ます。それまでに答えを見つけなさい』	PRINTFORMW 『妳迟早会遇到因为自己做了什么而后悔的一天。在那之前自己去寻找答案吧』
PRINTFORMW %CALLNAME:FINDCHARA(NO, 1)%さんはそういうとなにかしました。	PRINTFORMW %CALLNAME:FINDCHARA(NO, 1)%一边说着一边做了什么的样子。
PRINTFORMW そして、殺しているところを見つかっておこられることなく家に帰りました。	PRINTFORMW 然后、虽然被撞破杀人现场但是没有生气、回到了家。
PRINTFORMW 人を殺すことはダメなのにおこられない。	PRINTFORMW 虽然被阻止了但是没有生气。
PRINTFORMW どっかいったぐるぐるがもどってきました。	PRINTFORMW 就好像绕了一圈最后回归原点一样。
PRINTFORMW わからないです。	PRINTFORMW 我不知道。
PRINTFORMW %CNAME("一人称")%はなにもわからないです。	PRINTFORMW %CNAME("一人称")%什么都不知道了。
PRINTFORMW でも、%CNAME("二人称")%さんのことを考えるとむねがぎゅーってなってどきどきします。	PRINTFORMW 但是、一想到%CNAME("二人称")%的时候都会感觉很暖和。
PRINTFORMW おまたがじゅんってなって手がかってにそこをさわっちゃいます。	PRINTFORMW 然后手就不由自主的伸到了下面。
CALL PRINT_STRW,@"「んっ…_HH_あっ…_HH_んンっ……_HH_」"	CALL PRINT_STRW,@"「嗯…_HH_啊…_HH_嗯嗯……_HH_」"
PRINTFORMW おまたからとうめいなおしっこがどんどん出てきて、あたまがふわふわしてきます。	PRINTFORMW 思维都变得混乱不堪。
PRINTFORMW どんどんふわふわがやってきて。	PRINTFORMW 然后逐渐舒服起来。
CALL PRINT_STRW,@"「あっあっあっ_HH_っ～～～～～～～～～_HH__HH_」"	CALL PRINT_STRW,@"「啊啊啊_HH_嗯～～～～～～～～～_HH__HH_」"
PRINTFORMW はじけました。	PRINTFORMW 然后到达了潮涌的高点。
CALL PRINT_STRW,@"「はぁ……_HH_はぁ……_HH_」"	CALL PRINT_STRW,@"「哈啊……_HH_哈啊……_HH_」"
PRINTFORMW ぼーっとした頭で%CNAME("一人称")%は想います。	PRINTFORMW 在余韵中的%CNAME("一人称")%思考着。
PRINTFORMW %CNAME("一人称")%は%CNAME("二人称")%さんが………	PRINTFORMW %CNAME("一人称")%对%CNAME("二人称")%………
PRINTFORMW 太陽が落ちていきます。	PRINTFORMW 渐渐的、夕阳收敛起他最后的光芒、还来不及说一声再见、便垂下头去、合上了双眼、静静地睡去了
PRINTFORMW もうすぐ夜です。	PRINTFORMW 马上夜幕就要降临了。
PRINTFORMW %CNAME("一人称")%の……%CNAME("一人称")%の時間です。	PRINTFORMW %CNAME("一人称")%的……到%CNAME("一人称")%的时间了。
PRINTFORMW 夕焼けに建物は染められていきます。	PRINTFORMW 建筑被晚霞染红。
PRINTFORMW %CNAME("二人称")%さんと出会っていっぱいの人と関わって	PRINTFORMW 和%CNAME("二人称")%相遇、认识了许多人
PRINTFORMW いっぱい知って、いっぱい学んで。	PRINTFORMW 知道了需多、学到了需多。
PRINTFORMW いっぱい手をよごしてました。	PRINTFORMW 很多人把手伸了过来。
PRINTFORMW 今だからわかります。	PRINTFORMW 现在我才明白。
PRINTFORMW %CNAME("一人称")%はよごれていると。	PRINTFORMW %CNAME("一人称")%沾满了血污的话。
PRINTFORMW あらってもあらっても、ぜったいにとれない、よごれ。	PRINTFORMW 不管怎么洗、也绝对洗不干净、那带着罪恶的猩红。
PRINTFORMW それでも、	PRINTFORMW 但是、
PRINTFORMW それでもっ！	PRINTFORMW 即便如此！
PRINTFORML %CNAME("一人称")%は%CNAME("二人称")%さんの事が好きになってしまいましたっ	PRINTFORML %CNAME("一人称")%也真心真意的喜欢上了%CNAME("二人称")%
PRINTFORML きたない%CNAME("一人称")%は%CNAME("二人称")%さんが好きなのですっ	PRINTFORML 满身疮痍的%CNAME("一人称")%喜欢上了%CNAME("二人称")%
PRINTFORML お友達と話している時も%CNAME("二人称")%さんの事を想います。	PRINTFORML 和朋友说话的时候脑海中只想着%CNAME("二人称")%。
PRINTFORML おいしいごはんを食べている時も%CNAME("二人称")%さんの事を想います。	PRINTFORML 吃着好吃的饭菜的时候也在想着%CNAME("二人称")%。
PRINTFORMW なにをしていても%CNAME("二人称")%さんの事を想います。	PRINTFORMW 不管做什么、脑海中始终都在想着%CNAME("二人称")%。
PRINTFORMW だから、よけいに%CNAME("一人称")%は%CNAME("二人称")%さんの横に立って良いか想ってしまいます。	PRINTFORMW 所以、更加的想要站在%CNAME("二人称")%的身旁、觉得这样就好。
PRINTFORMW 人を殺してしまった%CNAME("一人称")%が。	PRINTFORMW 杀人的%CNAME("一人称")%。
PRINTFORMW なんどなんども、%CNAME("二人称")%さんを殺してしまった%CNAME("一人称")%が。	PRINTFORMW 无数次的、杀了%CNAME("二人称")%的%CNAME("一人称")%。
PRINTFORMW %CNAME("一人称")%はこのまま手をよごしても良いのでしょうか？	PRINTFORMW %CNAME("一人称")%这样把手递过去真的好吗？
PRINTFORMW %CNAME("一人称")%は普通の女の子になって良いのでしょうか？	PRINTFORMW %CNAME("一人称")%变成普通的女孩真的好吗？
PRINTFORMW さみしいです。	PRINTFORMW 好孤独。
PRINTFORMW すぐ近くにいるのに。	PRINTFORMW 明明就在身边。
PRINTFORMW %CNAME("一人称")%ははなれたくないです。	PRINTFORMW %CNAME("一人称")%不想放手。
PRINTFORMW %CNAME("一人称")%は%CNAME("二人称")%さんが好きなのです。	PRINTFORMW %CNAME("一人称")%喜欢%CNAME("二人称")%。
%CALLNAME:TARGET%との学校の帰り道、近くで花火大会があると言うチラシを見かけた。	放学之后和%CALLNAME:TARGET%一起回家的路上、看到了附近有花火大会的传单。
何の気なしに花火を見たことがあるかと聞いた。	问了问她有没有兴趣。
「うー？花火ですか？うーん、あれは見たことになるでしょうか……？」	「唔ー？烟火晚会？唔ー嗯、似乎见过吧……？」
何かを思案するように上を眺めている。	她望着天空似乎在思考
……多分、ちゃんと見たこともないのだろう。	……大概、没有完整的看过吧。
じゃあ、見に行こうかと誘った。	然后、邀请她一起去吧。
「あっ！はいっ！楽しみですっ！」	「啊！好的！好期待！」
花火大会当日、運よく雨は降らず傘は必要なさそうだ。	烟火晚会的当天、运气好天气没有雨的样子所以也没有必要带伞了。
%CALLNAME:TARGET%がこの日までにどれだけのてるてる坊主を量産した事か。	多亏了%CALLNAME:TARGET%为了这一天量产了贼多的扫晴娘。
それが報われたのは良かったと少し思う。	能有效果真的太好了、心里默默的为她高兴。
その%CALLNAME:TARGET%は%CALLNAME:MASTER%のメイドに着付けを教えてもらいながら浴衣を着ているそうで、	%CALLNAME:TARGET%穿上了%CALLNAME:MASTER%的女仆手把手一边教一边帮忙穿上的浴衣、
先に会場に行っていて欲しいと言われた。	她说让我先去会场那边。
「お待たせしました～」	「久等了～」
そう言って巾着袋を片手にぶら下げて赤色の藤の花柄に染め抜きした浴衣を着た%CALLNAME:TARGET%がやって来た。	伴随着她的声音、一只手提着荷包、身着染上了红色藤花图案的浴衣的%CALLNAME:TARGET%走了过来。
長い髪の毛は簪で纏めてもらったのか浴衣に似合う髪型になっている。	长长的头发用簪子缠好做出了一个非常适合浴衣的发型。
これだけ、気合を入れているのだから、褒めないと誘った人として色々とアレだと思うから、ちゃんと褒める。	看着为了这场大会下足干劲的她、完全没有不夸她的理由、所以好好的夸了她一阵。
「えへへ～♪ありがとうですっ！」	「欸嘿嘿～♪谢谢！」
場所取りは先に来ていたモノとしての責務としてちゃんとしてある。	占好位置是先来的人的责任与义务。
出店を軽く回ってつまむモノを用意してみる準備は万端。	在店内基本上常见的想要买的小饰品什么的早已准备万全。
ひゅっと最初の一発目が空に上がる。	突然、最初的第一发烟花升上天空。
空で花が咲くのに遅れてぱぁんっと軽快な音が聞こえる。	伴随着天空中绽放的花朵、迟来的轻快的声音在耳边响起。
「わぁ～！」	「哇～！」
横を見るとこちらの花も咲いていた。	看了看身边、自家的花朵也宛如绽放了一般的绮丽。
この顔を見れて誘ったかいがあった。	看着她的表情、心中再次确定这次邀请是真的香。
PRINTFORMW 手をふれる。それだけでよかった。	PRINTFORMW 只要触碰到手。就觉得这样很好。
PRINTFORMW 頭をなでてくれる。それだけでよかった。	PRINTFORMW 被摸摸头。觉得这样就好。
PRINTFORMW でも、あなたはいっぱいの人とふれあう。	PRINTFORMW 但是、你会去触碰很多人。
PRINTFORMW それを見るだけで、苦しくなります。	PRINTFORMW 看到那个的时候、心中就很难过。
%CNAME("一人称")%だけを見ていてほしい。	只想让你看着%CNAME("一人称")%。
PRINTFORMW なんて言葉は言えません。	PRINTFORMW 但是这样的话我说不出口。
本当だったら%CNAME("一人称")%は誰かとふれあうこともなく、	实际上%CNAME("一人称")%不想去触碰任何人、
PRINTFORMW 死んじゃってたかもしれないのだから。	PRINTFORMW 因为死人没有接触的必要。
手がよごれてる%CNAME("一人称")%は本当はあなたといっしょにいれない。	手上充满血污的%CNAME("一人称")%没有资格递出自己的手。
これからよごす%CNAME("一人称")%は本当にあなたといっしょにいけない。	这样充满罪恶的%CNAME("一人称")%真的没有资格在你身旁。
PRINTFORMW それでも許されるなら───────	PRINTFORMW 如果即使这样也能原谅我的话───────
%CALLNAME:TARGET%が複数の男に連れて行かれたと聞かされた%CALLNAME:MASTER%は探して探しまわった。	听到%CALLNAME:TARGET%被几名男子带走的%CALLNAME:MASTER%疯狂的寻找着她。
PRINTFORMW 幾ら人を殺している殺人者でも、小さな女の子であるのは確かだ。	PRINTFORMW 就算杀了许多人的杀人姬、也只不过是一名幼小的女孩。
それを%CALLNAME:MASTER%は良く知っているはずだ。	%CALLNAME:MASTER%比谁都清楚。
PRINTFORMW 何も知らなくて人と接するやり方を、	PRINTFORMW 在什么都不知道的情况下、
PRINTFORMW 押し付けられた方法しか出来なかった普通の女の子。	PRINTFORMW 她只是一个普通的少女。
PRINTFORMW 良く喜び、良く泣き、良く怒り、良く咲う。	PRINTFORMW 笑着、哭着、生气、高兴。
そんな%CALLNAME:TARGET%を%CALLNAME:MASTER%は悪くは思っていないだろう。	从来没有觉得那样的%CALLNAME:TARGET%有什么不好的。
PRINTFORMW 走った足は疲れ、息は途切れ途切れ。	PRINTFORMW 跑到精疲力竭、疲惫不堪。
PRINTFORMW 休憩している間も無いのに休んでしまう。	PRINTFORMW 但是也不会让自己休息一下。
視界にメイド服を着た%CALLNAME:MASTER%をご主人様と呼ぶ悪魔メイドが。	视线里出现了叫着主人的恶魔女仆。
PRINTFORMW 『おやおや、頑張っていらっしゃいますね。ご主人様？』	PRINTFORMW 『哦呀哦呀、真是努力啊。主人？』
PRINTFORMW 『ご主人様が探していらっしゃる方の居場所ならお教えする事が出来ますが……』	PRINTFORMW 『主人要找的地方我倒是可以告诉你……』
『……ええ、そうですか。では、私はそれまでお暇しましょう。メイドですから』	『……嗯、这样啊。那么、到时间之前、我就在此等候主人佳音了。因为我是女仆』
そして、%CALLNAME:MASTER%は再び駆ける。	然后、再次迈开脚步。
PRINTFORMW 場所は分かった。後は間に合うだけだ。	PRINTFORMW 明白了地方之后。之后只剩下赶过去了。
PRINTFORMW もう手遅れかもしれないけれど。	PRINTFORMW 可能已经迟了。
PRINTFORMW それでも、行くべきなんだ。	PRINTFORMW 但是、即使这样也要。
PRINTFORMW 辿り着いたのは廃墟だった。	PRINTFORMW 到达的是一处废墟。
PRINTFORMW 前時代的な落書きに空き缶やら、微かに生活感のある。	PRINTFORMW 像是旧时代一样的涂鸦和空罐子、略微有点生活感。
PRINTFORMW よろしくない人が屯する場所だった。	PRINTFORMW 那是一些渣滓聚集在一起的地方。
PRINTFORMW 階段をひとつひとつ上がっていく。	PRINTFORMW 一步一步的走上楼。
PRINTFORMW ───────嗅ぎ慣れた血の匂いがする。	PRINTFORMW ───────习惯的血腥味传来。
PRINTFORMW 瓦礫を避けて歩いていく。	PRINTFORMW 避开瓦砾走了过去。
PRINTFORMW ───────泣き声が聞こえる。	PRINTFORMW ───────听到了哭泣的声音。
PRINTFORMW 声の元へ歩いていく。	PRINTFORMW 走向声音传来的地方。
PRINTFORMW ───────血の海だった。	PRINTFORMW ───────那是血液形成的海洋。
PRINTFORMW 惚れ惚れするほど綺麗に急所だけを一撃で斬られた死体が。	PRINTFORMW 如同艺术一般精准击杀要害的尸体堆成小山。
海に揺蕩うように、%CALLNAME:TARGET%は寝転がり泣いていた。	血海摇晃着、%CALLNAME:TARGET%随意的坐在上面哭泣着。
PRINTFORMW 名前を呼びかける。	PRINTFORMW 呼唤了她的名字。
PRINTFORMW 「ごめん、なさいっ」	PRINTFORMW 「对、不起」
PRINTFORMW 身体をおこしてやって頭を撫でてやる。	PRINTFORMW 扶起她的身姿摸了摸她的头。
「%CNAME("一人称")%は、%CNAME("一人称")%はっ……！」	「%CNAME("一人称")%、%CNAME("一人称")%……！」
PRINTFORMW 何も言わなくて良い。	PRINTFORMW 什么都不用说就好。
PRINTFORMW 「約束やぶっちゃいました………っ」	PRINTFORMW 「打破了约定………」
PRINTFORMW 知ってる。	PRINTFORMW 我知道。
PRINTFORMW 「あなた以外の人をっ……」	PRINTFORMW 「杀了除你之外的人……」
%CALLNAME:TARGET%の背中に腕をまわして抱きしめる。	PRINTFORMW 伸出手、环住她的纤腰、抱紧了她。
もう一度、あの時と同じ言葉を%CALLNAME:MASTER%は言う。	然后再一次、说出了和那时候同样的话。
@"───────決して<button value='100' title='離れない'>赦れない</button>。"	@"───────绝对<button value='100' title='不会离开'>不会原谅</button>。"
罪には罰。ああそうだろう。	这份罪恶就是惩罚、仅此而已
人の命を奪うのは赦されざることだろう。	夺走人的性命应该是不能原谅的事情吧。
それでも、少なくとも%CALLNAME:TARGET%が居なくなるのは嫌だと感じる所がある。	即便如此、至少、如果%CALLNAME:TARGET%不在身边的话、不要。
それに、まだ自分は%CALLNAME:TARGET%に殺され足りない。	而且、自己还没被%CALLNAME:TARGET%杀够。
泣きはらして、涙の痕がある%CALLNAME:TARGET%の顔に口づけを交わす。	捧起那哭肿的脸庞、看着%CALLNAME:TARGET%满脸泪痕的小脸、吻住了她的薄唇。
舌は交わさず、ただ触れるだけのキス。	没有舌头的交缠、仅仅只是碰触的轻吻。
心を重ねるだけの口づけ。	仅仅是表明心意的双唇相接。
抱擁を離して転がっていたナイフを手に取る。	放开拥抱的时候、捡起落在地上的小刀。
幾人の命を奪い、自分の命を数多く奪った凶器。	夺走了多少人的性命、夺走了多少次自己的性命的凶器。
とても軽いはずなのに。とても重たい。	本应该非常轻的它。现在却如此的沉重。
今からする事で、失われたモノは戻りはしないだろう。	现在开始要做的事情、失去的应该再也找不回了吧。
何かが解決する訳じゃない。	不是为了解决什么。
PRINTFORMW それでも	PRINTFORMW 即便如此
ナイフをしっかりと握り、振り下ろす。	握紧小刀、然后挥下。
「あっ――――――」	「啊――――――」
自分の胸に	自己的胸口
痛みが雷の様に落ちてきた。	痛楚如同闪电一般落下
歯を食いしばり、抜ける力を振り絞り刺さったナイフを抜く。	咬紧牙关、然后拔出了深深插进胸口的小刀。
身体が、思考が、精神が、痛みが、魂が、	无论是身体、思考、精神、痛楚、灵魂、
今すぐやめろと言ってくるが無視してもう一度振り下ろす。	无视了来自自我的悲鸣、再一次挥下
「や、やめてください！%CNAME("二人称")%さんっ」	「住、住手！%CNAME("二人称")%」
いいや、やめない。	不、不能停下。
罪には罰なんだ。	罪、即罚
たった一つの罰なんだ。	而罚、仅仅只有一个
%CALLNAME:TARGET%に償えない、償ってほしくない罪に対する自分が行える罰なんだ。	%CALLNAME:TARGET%无法偿还、不想让她来偿还、所以由我来承受。
%CALLNAME:TARGET%に人の怖さを教えずに	教导了%CALLNAME:TARGET%人的恐怖に
%CALLNAME:TARGET%にもう二度としないって誓われた人殺しをさせた	让%CALLNAME:TARGET%发誓再也不杀人
自分対する罰。	此乃吾之罪业、此乃吾之罪罚
何度目になるか、よろよろと上げた腕を%CALLNAME:TARGET%が止める。	不知道第几次了、摇摇晃晃抬起的手被%CALLNAME:TARGET%阻止了。
「ご、ごめ、ごめんなさいっ……」	「对、对不、对不起……」
「%CNAME("一人称")%は痛くないのにっ、%CNAME("一人称")%のこころが痛いですっ……」	「明明%CNAME("一人称")%不应该会痛的、但是%CNAME("一人称")%的心好痛……」
%CALLNAME:TARGET%に止められて、糸が切れたように自分の血の海の上に寝っ転がる。	被%CALLNAME:TARGET%阻止之后、宛如断线一般倒在了自己的血液形成的海洋之上。
今更ながらに自分の体質だか性能だかには感謝するしかない。	虽然现在才说、但是还是只能在心里感谢自己的体质
泣いている%CALLNAME:TARGET%の涙を拭う、けれども流した血でまた汚れる。	将哭泣的%CALLNAME:TARGET%脸上的泪水擦拭掉、但是被自己身上的血液弄得更脏了。
これで、もう自分も殺さないとかは無しだからなと%CALLNAME:MASTER%は%CALLNAME:TARGET%に言う。	这样、不杀自己的话也不算数了、%CALLNAME:MASTER%对%CALLNAME:TARGET%说道。
「なんで、です、か……？」	「为什、么、……？」
他の男に着いて行ったからな。	因为居然跟着其他男人走了。
自分以外見ないって誓ったくせに。	明明发誓只看我的。
ふいと、%CALLNAME:MASTER%はわざとらしく%CALLNAME:TARGET%から顔を逸らす。	突然、%CALLNAME:MASTER%的视线从%CALLNAME:TARGET%脸上离开看向别处。
「ふふっ……、しっと深いですね」	「呼呼……、嫉妒心好重啊」
何時かの様に%CALLNAME:TARGET%は微笑み言う。	不知什么时候、%CALLNAME:TARGET%微微笑着说道。
少し身体が動く様になったから、少しため息を吐きながらスマホを弄る。	身体似乎可以勉强动了、呼了口气然后拿出手机。
親愛なる悪魔メイドに事後処理を頼まないとだ。	只能叫亲爱的恶魔女仆来做事后处理了。
人間として感性が可笑しくなっているのだろうけれど、	虽然作为人类的感性已经变得越发邪道、
幼気な女の子を連れて、何かしらしようとしたとは言え	虽然牵着幼小的女孩子说想做点什么
人だったをモノをゴミの様に扱うのは……	但是把人当作物品、当作垃圾来处理这种心态……
はっ、自嘲する。	哈、令人发笑
罪だ罰だと言っていた人間がする事じゃないな。	压根不像是口口声声说罪业啊惩罚啊这样的人干的事
今度はどんなお小言を言われるだろうかと考えていると	这次又会被唠叨什么呢、心想着
「かえったら%CNAME("一人称")%もあやまりますっ」	「回去之后、%CNAME("一人称")%会好好道歉的」
「だから、はやく%CNAME("一人称")%たちのおうちにかえりましょうっ！」	「所以、快点回去%CNAME("一人称")%们的家吧！」
手を引く%CALLNAME:TARGET%にやれやれと自分と%CALLNAME:TARGET%に認識阻害をかけてから家路を辿る。	牵着%CALLNAME:TARGET%的手、嘴上念叨着鸭累鸭累daze然后对自己和%CALLNAME:TARGET%加上了认知阻碍之后走上回家的路。
罪は背負うものだ。	罪业是需要背负的东西。
重いから二人で背負っていこう。	因为很重、所以两个人一起来背吧。
%CNAME("二人称")%さんの手を引いて%CNAME("一人称")%は%CNAME("一人称")%たちのおうちにかえります。	被%CNAME("二人称")%牵着手的%CNAME("一人称")%现在要回去%CNAME("一人称")%们的家。
かえる前にちらりと%CNAME("一人称")%が殺した人を見ます。	回去之前看了一眼%CNAME("一人称")%杀掉的人。
人は死んだら「てんごく」と「じごく」というところにいくらしいです。	人死后似乎会去到叫做「天国」和「地狱」的地方的样子。
「てんごく」にはいい人がいって。	「天国」里面有着好人的灵魂。
「じごく」にはわるい人がいくそうです。	「地狱」里有着坏人的灵魂。
でしたら%CNAME("一人称")%は「じごく」にいくのでしょう。	这么说的话%CNAME("一人称")%应该会去到「地狱」的吧。
いっぱいいっぱいわるいことをしたのですから。	因为做了很多很多坏事。
%CNAME("二人称")%さんはすこしわるい人ですけど「てんごく」にいくのでしょう。	%CNAME("二人称")%虽然有点小坏但是应该会到「天国」的吧。
こんな%CNAME("一人称")%を大切にしてくれるから。	因为这么的%CNAME("一人称")%珍惜我。
ほんとは死んだあともいっしょにいたいです。	其实死后也想在一起。
%CNAME("一人称")%のわがままだって分かっています	%CNAME("一人称")%知道是自己的任性
でも、すくなくとも%CNAME("一人称")%にとっての「てんごく」はここです。	但是、至少、对%CNAME("一人称")%来说的「天国」就是这里。
%CNAME("一人称")%のことを想ってくれて、%CNAME("一人称")%のことを愛してくれて、	思考着%CNAME("一人称")%的一切、爱着%CNAME("一人称")%的一切、
%CNAME("一人称")%のことを見つけてくれた、あなたが%CNAME("一人称")%のしあわせです。	观测着%CNAME("一人称")%的一切、你（玩家）就是%CNAME("一人称")%的幸福。
ここが、あなたのとなりが、%CNAME("一人称")%のたましいのいばしょです。	这里、你的身边、就是%CNAME("一人称")%的灵魂港湾。
数多くの罪とたった一つの罰『第七天』　fin	数千的罪业与仅仅一份的惩罚『第七天』　fin
【握られた刃はもう本当に愛したモノしか貫かない】	【被握住的刀只会贯穿真正爱着的事物】
【理性でもって彼女はあなたを殺す】	【拥有理性的她会杀了你】
多くの罪とたった一つの罰	数千的罪业与仅仅一份的惩罚
数多くの罪とたった一つの罰	数千的罪业与仅仅一份的惩罚
瑕疵を罪上げる	充满了伤痕的罪业
いつからか、	不知什么时候开始
クラスの人とお話をしているとき、お昼ごはんを食べているとき、	和班上的人说话的时候、午休吃饭的时候
何でもない、ふとしたときに、	什么都没有、突然之间
%CNAME("一人称")%の手が血で真っ赤になってるまぼろしを見るようになりました。	会看到%CNAME("一人称")%的手上沾满了血污的幻象。
びっくりして、もう一度見なおすと血はなくなっています。	吓了我一大跳、但是再次看的时候血就消失了。
もう、人を殺すのをやめたのに何度も何度も。	明明已经没有杀人了、但是还是无数次的出现。
やっぱり、%CNAME("一人称")%は普通の女の子になれないのでしょうか？	果然、%CNAME("一人称")%没有办法成为普通的女孩子的吧？
%CNAME("一人称")%は人を殺すかいぶつにしかなれないのでしょうか？	%CNAME("一人称")%只能成为杀人的怪物吧？
すてたはずの人殺しは%CNAME("一人称")%を追いかけてきます。	早已应该舍去的杀人姬不断的追赶着%CNAME("一人称")%。
夢を見ました。	做了一个梦。
クラスの人と楽しそうにお話をしている夢を。	和班上的人高兴的说着话的梦
夢をみました。	做了一个梦。
ぶ活どうで部いんのみなさんとあそんだりしているゆめを。	在部室和大家玩耍的梦。
ゆめを見ました。	看到了一个梦。
%CNAME("二人称")%といっしょにすごすゆめを。	与%CNAME("二人称")%一同生活下去的梦。
ゆめをみました。	看到了一个梦。
おとうさんとおかあさんのゆめを。	爸爸和妈妈的梦。
さいごはぜんぶ、まっかないろでした。	最后发现、全都是假的。
とび起きて、台所に行ってのんだ水は血の味でした。	起床、去到厨房喝的水是血的味道。
おなかがぎゅうっとして、おもわずはいてしまいました。	肚子有种绞痛、不由自主的走了出去。
その日は偶々寝付けない夜だった。	那天是偶然有点睡不着的夜晚。
だからと言って予習や課題をする気になれなくて、	虽然这么说、但是我不想做预习和课题。
%CALLNAME:MASTER%は布団に横になって、ただただ眠気が来るまで天井を見つめてた。	%CALLNAME:MASTER%躺在被子里、看着天花板直到睡意袭来。
ふと、くぅと腹の虫が鳴く。	突然、肚子发出了咕噜咕噜的叫声。
どうやら、腹は食気を要求しているようだ。	看起来、是想要吃东西了。
仕方ないと、%CALLNAME:MASTER%は身体を起こして自室を出て台所に向かう。	没办法、%CALLNAME:MASTER%起身走出房间像厨房走去。
静かな夜だ。	静谧的夜。
いや、草木も眠ると言う言葉もある通りに静かなのは当たり前か。	不、草木也有休眠这种说法安静是当然的吧。
台所に通じるリビングの扉を開けて気が付く。	发觉通往厨房的客厅的门是打开的。
明かりが点いている事に。	看到了灯光。
誰かが消し忘れたのだろうかと%CALLNAME:MASTER%は思ったが、	是不是谁忘了关了、这样想着、
呻き声が聞こえて、そんな事はないと分かった。	听到了呻吟声、根本不该有那种声音的。
%CALLNAME:MASTER%は、慌てて台所に向かうと%CALLNAME:TARGET%が顔を真っ青にしてへたりこんでいた。	%CALLNAME:MASTER%慌忙的走进厨房然后看到%CALLNAME:TARGET%脸色铁青的坐在地板上。
息は荒く、ツンとした胃酸の匂いがする。	呼吸急促、空气中传来了胃酸的味道。
駆け寄り、背中をさすって、何があったと%CALLNAME:MASTER%は%CALLNAME:TARGET%に問う。	跑到她身旁、顺着她的背部、然后问她发生什么了。
「はぁ………はぁ………う、っく。な、なんでもないです……」	「哈啊………哈啊………唔、咕。没、没什么的……」
どう見たって強がりを言っているのが見て取れる。	用脚想都知道她在逞强。
そんな風には見えない。	但是看不出来。
本当の事を言うんだ。	似乎是在说真的。
真っ直ぐ%CALLNAME:TARGET%の赫い瞳を見てもう一度問う。	认真的看着她赤红的眼眸再次询问了一遍。
「う……はい……」	「唔……是……」
瞳を伏せて%CALLNAME:TARGET%は口を開く。	%CALLNAME:TARGET%闭上眼镜开口说道。
「さいきん、%CNAME("一人称")%の手が血で真っ赤になるのを見るのです」	「最近、%CNAME("一人称")%会看到手上沾满了血」
「血のぬめりとしたかんしょくに、温かさ」	「血淋淋的感觉、很温暖」
「そこにないのに、そこにあるように……」	「明明什么都没有、却好像真的有一样……」
「それに、夢でみなさんを殺す夢を見るんです」	「而且、梦见了把大家杀掉的梦」
「クラスの人と楽しそうにお話をしているのに、ナイフで殺して」	「和班上的人高兴的说着话的时候、用刀杀了」
「部員の人と楽しくトランプで遊んでいるのに、ナイフで殺して」	「和部员快乐的玩着扑克牌的时候、用刀杀了」
「あなたといっしょに普通にすごしているのに、ナイフでころして」	「和你一生度过的时候、用刀杀掉了」
「おとうさんとおかあさんをなんどもなんども、ハサミでころして」	「爸爸和妈妈、无数次、无数次的、用剪刀杀了」
「も、もうひとをころしたくないのに、ぼ、ボクはゆめのなかでひ、ひとをっ……」	「明、明明已经不想杀人了、我、我在梦境中、把人……」
「%CNAME("二人称")%さん」	「%CNAME("二人称")%」
「%CNAME("一人称")%はひとをころすかいぶつで、ふつうのおんなのこになれないのですか………？」	「%CNAME("一人称")%是杀人的怪物、所以是无法成为普通的女孩子的对吗………？」
弱々しく%CALLNAME:TARGET%はそう、%CALLNAME:MASTER%に問いかける。	弱气的%CALLNAME:TARGET%低声向%CALLNAME:MASTER%问道。
人を殺すと言うのは人が犯し得る罪の中では大きいモノだ。	杀人是人能犯的罪中最重的。
疑問や取っ掛かりは、%CALLNAME:TARGET%に普通の女の子になってほしいと言った時には既にあった。	对于自己是否能成为普通的女孩子、%CALLNAME:TARGET%心中充满了猜疑。
それに、犯した罪の大きさに%CALLNAME:TARGET%は漸く向き合えたのか。	而且、犯下如此多罪行的%CALLNAME:TARGET%要正视那些罪名了吗。
だからこそ、%CALLNAME:MASTER%は言う。	正因如此、%CALLNAME:MASTER%说道。
そんな事はないと。	没有那种事。
%CALLNAME:TARGET%は普通の女の子に成れると。	%CALLNAME:TARGET%一定能成为普通的女孩子的。
「で、でも……」	「但、但是……」
罪に気がつけて、罪と向き合って、もう人を殺したくないと言っただろう？	你已经察觉到了罪、然后直面了它、最后已经发誓不在杀人了不是吗？
その時点でもう%CALLNAME:TARGET%は人を殺す怪物じゃなくて、人なんだ。	从那时候开始%CALLNAME:TARGET%就已经不再是杀人的怪物了、而是一名人类。
女の子なんだ。	一个普通的女孩子。
でも、罪には罰なんだ。	但是、罪是需要惩罚的。
「そう、ですね……」	「说的、是呢……」
全てを受け入れるような表情で%CALLNAME:TARGET%は%CALLNAME:MASTER%を見つめる。	%CALLNAME:TARGET%脸上充满了决意、然后看着%CALLNAME:MASTER%。
そんな%CALLNAME:TARGET%の手を取り%CALLNAME:MASTER%は外に出た。	拉着%CALLNAME:TARGET%的手%CALLNAME:MASTER%向外面走去。
「ここは……？」	「这里是……？」
%CALLNAME:TARGET%を連れて、来たのは街を一望出来る丘上の公園だ。	带着%CALLNAME:TARGET%、来到了可以把街景一览无遗的公园里。
見える夜の街は未だ眠らず、明かりは灯り、光は行き交う。	夜晚的街道还未沉睡、明亮的路灯交织出光芒的大道。
この公園は春になると藤が咲く。	公园里开满了春天会盛开的紫藤。
%CALLNAME:TARGET%にかけた言葉を考えるならここが一番だろう。	想和%CALLNAME:TARGET%说想说的话、这里是最好的地点吧。
%CALLNAME:MASTER%は%CALLNAME:TARGET%に公園に落ちている石を集めるように言う。	%CALLNAME:MASTER%和%CALLNAME:TARGET%说把公园里散落的石头收集起来。
「え、あ、はい」	「欸、啊、是」
言われるがままに何度も何度も%CALLNAME:MASTER%の所を、	然后按照所说的无数次的把石头收集到%CALLNAME:MASTER%的地方、
行ったり来たりして手を汚しながら%CALLNAME:TARGET%は少しずつ石を集めていく。	 来来回回的收集让手上沾满了泥污、但是%CALLNAME:TARGET%还是不断的收集着石头。
%CALLNAME:MASTER%は手を出さない。	%CALLNAME:MASTER%没有出手帮忙。
結構集まった辺りで、%CALLNAME:MASTER%はそれを積み上げて山の様にする様に言う。	收集了挺多呢、%CALLNAME:MASTER%看着堆积如山的石头说道。
今度は%CALLNAME:MASTER%も手伝う、石の山がなるべく崩れにくい様に積み上げていく。	这次%CALLNAME:MASTER%伸手帮忙、让石山变得不容易崩坏。
「あの……、これはいったい何をしているのです？」	「那个……、这个到底是做什么呢？」
墓を作っている。	坟墓。
%CALLNAME:TARGET%がこれまでに殺した人の墓を。	%CALLNAME:TARGET%至今为止杀掉的人的墓。
こんな捨て石の墓で罪を償えたとは全く思えないけれど、	虽然觉得这种用路边石头当坟墓就能赎罪完全是笑话、
%CALLNAME:TARGET%を法の下で裁いて、離れ離れになるのは%CALLNAME:MASTER%も嫌だから、	但是让%CALLNAME:TARGET%被法律制裁、永远的离开自己、%CALLNAME:MASTER%绝对不要、所以、
自分の罪の証拠として墓を作って置くべきだと考えたのだ。	作为赎罪的证明在此立下墓碑。
「%CNAME("一人称")%、いっしょうけんめいやります」	「%CNAME("一人称")%会拼命去做的」
上手く積み上がらなくて、何度も何度も崩れては積み直す。	堆不好、一次又一次的倒下、一次又一次的重新堆。
その度に手の汚れは酷くなっていく。	手上的脏污已经到了某种程度
それでも、%CALLNAME:MASTER%と%CALLNAME:TARGET%は積み上げていく。	即使如此、%CALLNAME:MASTER%和%CALLNAME:TARGET%还是不断的堆积着。
こんなモノ何の解決にならない。	这种东西无法解决任何事情。
%CALLNAME:TARGET%が奪った命は戻って来ない。	%CALLNAME:TARGET%夺走的生命不能复生。
でも、自分が悪いと気が付いた普通の女の子が救われたって良いじゃないか。	但是、如果能救下这个天真的笨蛋不也挺好的。
「できました……」	「堆好了……」
積み上がった石の墓は少しの事では崩れないだろう。	堆积而成的石墓应该不会轻易的崩溃吧。
その墓に%CALLNAME:MASTER%は認識阻害をかけて他の人には見えない様に、近づけない様にする。	这个墓%CALLNAME:MASTER%加上了认知阻碍、所以其他人不会看到也不会接近这个墓。
東を見れば日が昇ってきた。	东方的太阳慢慢升起。
早く帰らないと。	不快点回去的话。
「%CNAME("二人称")%さん！」	「%CNAME("二人称")%！」
ふと、%CALLNAME:TARGET%が%CALLNAME:MASTER%に声をかける。	突然、%CALLNAME:TARGET%叫住了%CALLNAME:MASTER%。
「%CNAME("一人称")%、このおはか絶対に%CNAME("一人称")%が死ぬまで大事にします」	「%CNAME("一人称")%、直到%CNAME("一人称")%死为止一定会珍重这个墓的」
「%CNAME("一人称")%がしたことを忘れないために」	「为了不让%CNAME("一人称")%遗忘掉我做过的事情」
「だから、もう一度ちかいます」	「所以、再一次起誓」
「%CNAME("一人称")%はもう二度と人を殺さないと」	「%CNAME("一人称")%绝对不会再杀人了」
そうだな。	是啊。
じゃあ、あの悪魔メイドに怒られない様に早く帰るか	那么、在恶魔女仆生气之前快点回家吧。
「はい！」	「是！」
駆け足で%CALLNAME:MASTER%と%CALLNAME:TARGET%は家路を辿る。	两人迈开步子向家的方向跑去。
昇る曙光に道は照らされている。	升起的太阳照耀了两人的道路。
それはきっと───────	那一定是───────
しあわせな夢を。	幸福的梦。
もう二度とかなわない。	再也不会去看了。
しあわせで、かなしい夢を。	又幸福、又痛苦的梦。
おとうさんがいて、	爸爸在、
おかあさんがいて、	妈妈在、
なにひとつ不自由のない毎日。	自由的每天。
でも、%CNAME("一人称")%が好きで、大好きで、	但是、%CNAME("一人称")%喜欢的、最喜欢的、
愛している人はいません。	深爱着的人不在。
だから、%CNAME("一人称")%は選びます。	所以、%CNAME("一人称")%在此选择。
%CNAME("一人称")%のお家を出ようとした時に%CNAME("一人称")%が話しかけてきました。	在%CNAME("一人称")%出门的时候和我说道。
「おとうさんとおかあさんがくれたものをすてるのです？」	「是妈妈和爸爸的东西吗？」
すっと%CNAME("一人称")%が%CNAME("一人称")%にナイフをさし出しました。	然后%CNAME("一人称")%向%CNAME("一人称")%挥下了刀。
それをしばらく見た後に%CNAME("一人称")%の顔を見て言います。	过了一会之后、看着%CNAME("一人称")%的脸说道。
「―――うん、%CNAME("一人称")%はもう人を殺さないって決めましたから」	「―――嗯、%CNAME("一人称")%已经决定不杀人了」
「じゃあ、さようならですね」	「那么、再见了哦」
「はい、さようならです」	「嗯、再见」
%CNAME("一人称")%が手を振って来ます。	%CNAME("一人称")%挥着手。
%CNAME("一人称")%はふりむかず歩きます。	%CNAME("一人称")%一直往前走、没有回头。
歩いてきた道はボロボロとくずれてどこかへいきます。	脚下的道路破破烂烂的、不知道去往何方。
PRINTFORMW そして	PRINTFORMW 然后
「ん、むぅ……」	「嗯、姆……」
夢からさめました。	从梦中醒过来了。
ちくりとむねが痛みます。	突然心好痛。
でも、これは%CNAME("一人称")%の罪の痛みです。	但是、这是%CNAME("一人称")%的罪名带来的痛苦。
見なかったことにしてはいけません。	不能当作没看到。
だから、%CNAME("一人称")%は。	所以、%CNAME("一人称")%。
%CNAME("一人称")%が死んでしまうまで、かかえて生きます。	直到%CNAME("一人称")%死为止、将背负着罪名活下去。
<button value='100' title='きず'>罪</button>がどんなに大きくても、	<button value='100' title='伤痕'>罪</button>再大也好、
<button value='100' title='むかしばなし'>おとぎばなし</button>にしないために。	<button value='100' title='过去的故事'>没有童话故事</button>为了不成为。
瑕疵を罪上げる『御伽噺』　fin	充满了伤痕的罪业『御伽噺』　fin
【%CALLNAME:TARGET%は自分の罪に向き合いました】	【%CALLNAME:TARGET%直面了自己罪业】
痛みの正体、夜を越えて	痛苦之源、跨越黑夜
手にもったナイフをふります。	挥动着手里的刀
きらきらと光って真っ赤になりました。	闪闪发光的刀身充满了赤红色。
いつものことです。	什么时候的事了。
ちかごろ、%CNAME("二人称")%にかまってもらえなくて%CNAME("一人称")%はふまんです！	最近、%CNAME("二人称")%一直没有理%CNAME("一人称")%、很不高兴！
%CNAME("一人称")%がやっていることは悪いことだとはもう知っています。	%CNAME("一人称")%做过的事情是坏事已经知道了。
だから、%CALLNAME:FINDCHARA(NO, 1)%さんに殺してもいい人をきいて殺しています。	所以、听到%CALLNAME:FINDCHARA(NO, 1)%那些都是可以杀的人、所以全部杀掉了。
%CNAME("一人称")%のような悪い人でも殺してもいい人を。	%CNAME("一人称")%这样的恶人也可以杀的人。
PRINTFORMW ですが	PRINTFORMW 但是
なんででしょう？	为什么？
ちくりとむねが痛いです。	心脏好痛。
きぃと音をすこし立ててドアをひらきます。	伴随着开门的声音。
かぎなれた%CNAME("二人称")%さんのにおいが%CNAME("一人称")%をむかえてくれます。	房间内是熟悉的%CNAME("二人称")%的味道、%CNAME("一人称")%来来迎接了。
それにすこしだけ顔がゆるんでしまいます。	熟悉的脸庞带着松懈的神情。
ベットの上では%CNAME("二人称")%さんがすやすや、ねています。	在床上的%CNAME("二人称")%发出轻轻的喘息声、正在睡梦中。
このことが%CNAME("一人称")%だけのひとりじめだったらいいのにと想うこともありますけど。	如果这个场景能让%CNAME("一人称")%独占就好了。
%CNAME("一人称")%は%CNAME("二人称")%さんが好きってことでいいと思うのです。	只有%CNAME("一人称")%喜欢%CNAME("二人称")%就好。
PRINTFORMW でも	PRINTFORMW 但是
どうしてでしょう？	为什么呢？
むねがちくりと痛いです。	心好痛。
すやすやとねている%CNAME("二人称")%さんにまたがって服をまくり上げます。	悄悄的跨坐在%CNAME("二人称")%身上、卷起衣服。
傷ひとつない%CNAME("二人称")%さんのおなか。	%CNAME("二人称")%的肚子一点伤口都没有呢。
それをゆびで触ります。	伸出手指轻轻的触碰。
このあいだの、すこし前の、もっと前の…………最初の。	这个地方、是之前、更前面…………最初的。
最初に刺した場所を撫でる。	抚摸着最初刺到的地方。
%CNAME("一人称")%が初めてつけた傷。	%CNAME("一人称")%最开始造成的伤口。
今ではすっかりと消えてなくなっていますけど、	虽然现在已经完全消失无踪了、
%CNAME("一人称")%の%CNAME("一人称")%だけの傷。	%CNAME("一人称")%的、仅仅属于%CNAME("一人称")%的伤口。
すこしだけ安心してしまいます。	稍微有点安心了。
へんたいさんになってしまいました。	似乎变成变态了。
ねいきが変わりました。	睡姿改变了。
%CNAME("二人称")%さんが起きそうです。	%CNAME("二人称")%似乎快要醒来了。
ふだんでしたらこそこそと逃げますけど	平常的话会悄悄摸摸的逃走。
今日はそんな気分じゃないからこのままいます。	但是今天没有那种心情所以这样就好。
お腹が重くて、寝苦しくて目を覚ます。	肚子上有什么东西压着、越来越难受的我张开眼镜。
ぼやけた視界には、月光に反射した茶色の髪と赫い瞳。	出现在视界的、是反射着月光的靓丽茶色长发、以及那赤红的双眸。
なんてことはない、%CALLNAME:MASTER%が殺しを肯定した殺人姫、%CALLNAME:TARGET%だ。	没什么、只是被%CALLNAME:MASTER%允许杀人的杀人姬、%CALLNAME:TARGET%。
「こんばんはですっ♪」	「早上好♪」
楽しそうに嬉しそうに、でも少し寂しそうに%CALLNAME:TARGET%は挨拶してきた。	心情很好的她、带着一丝寂寞打了个招呼。
それにぼやけた思考のまま%CALLNAME:MASTER%は答える。	本能的回应着她。
「ちかごろ、%CNAME("二人称")%さんが%CNAME("一人称")%のことをかまってくれなくて、さみしいですっ」	「最近、%CNAME("二人称")%都不太理%CNAME("一人称")%了、很寂寞」
そう言えば、前に%CALLNAME:TARGET%としたのは何時だったか……	说起来、上一次和%CALLNAME:TARGET%做是什么时候的事情来着……
はっきりしない頭だと思い出せない。	一下子还想不起来。
「なので、襲いに来ましたっ」	「所以、来夜袭了」
そう言うと%CALLNAME:TARGET%は%CALLNAME:MASTER%のお腹をペロペロと舐め始めた。	然后说着、%CALLNAME:TARGET%伸出舌头舔着%CALLNAME:MASTER%腹部。
舌を這わす様に、味わう様に、確かめる様に。	像是品尝一般、确认着味道。
「ぺろっ……んむ……ちゅるっ……知ってます？%CNAME("一人称")%が今なめている場所」	「吸溜……嗯姆……啾噜……知道吗？%CNAME("一人称")%现在被舔的地方」
分からないが、徐々に股間に熱が籠り始めてきた。	不知道、倒是股间的那什么越来越大了。
「%CNAME("一人称")%が今まであなたを刺して殺した場所です」	「一直以来被%CNAME("一人称")%刺的地方哦」
ちろちろと、くすぐる様に舐めてくる。	她不断的舔弄着。
亡くなった傷跡を。	逝去的伤痕。
ぞっとする気持ちはあるけれど、それ以上に今の%CALLNAME:TARGET%はとても扇情的に見えた。	虽然听上去有点毛骨悚然、先不管那些、现在的%CALLNAME:TARGET%看上去非常的煽情。
「よいしょっ」	「嘿咻」
%CALLNAME:TARGET%はそう呟くと何時ものパーカーを脱ぎ、	在%CALLNAME:TARGET%嘟囔的时候不知合适脱下了穿着的风衣、
ブラジャーを外し、	取下胸罩、
ショーツの紐を解き、	解开内裤的带子。
生まれた姿になった。	成为了出生时的模样。
「ん…ふっ…んん……」	「嗯…呼…嗯嗯……」
%CALLNAME:MASTER%の下着越しに%CALLNAME:TARGET%は股を擦り付ける。	%CALLNAME:TARGET%隔着%CALLNAME:MASTER%的内裤用股间摩擦着。
股間がはち切れるほどの熱に少しずつ湿り気が。	摩擦的地方逐渐感觉到一股湿润的感觉。
「ふ、ふふっ_HH_」	「呼、呼呼_HH_」
蠱惑的に笑い、%CALLNAME:MASTER%の下着からソレを解放する。	妖媚的笑了笑、把%CALLNAME:MASTER%的内裤脱掉、露出了鼓胀的肉棒。
PRINTFORMW そして、	PRINTFORMW 然后、
「ん、んんぅっ_HH_」	「嗯、嗯嗯_HH_」
一気に膣に挿入れた。	一口气插到最深处。
「はぁ…_HH_はぁ…_HH_んふぅ…_HH_%CNAME("二人称")%さんを食べちゃいました_HH_」	「哈啊…_HH_哈啊…_HH_嗯呼…_HH_把%CNAME("二人称")%吃掉了_HH_」
赫い瞳で恍惚に笑う%CALLNAME:TARGET%。	荡漾的赤瞳露出了妖媚的笑容。
まだ動いていないのに膣はうねうねと%CALLNAME:MASTER%から搾り取る様に動く。	明明身子还没有动作、但是蜜穴内的软肉早已蠕动绞紧%CALLNAME:MASTER%的肉棒榨取着精液。
「ん、ふっ_HH_く、あっ_HH_」	「嗯、呼_HH_咕、啊_HH_」
ゆっくりと味わう様に腰を上下に動かして愉しんでいる%CALLNAME:TARGET%。	%CALLNAME:TARGET%慢慢的品味着快感然后慢慢的上下挺动着腰肢。
徐々に射精感を促されて解放しそうになるが、	渐渐的在射精感的催促下快要射出了。
「くひゅっ！？！？_HH__HH__HH_」	「咕咿咿！？！？_HH__HH__HH_」
されるがままでいる%CALLNAME:MASTER%では無かった。	%CALLNAME:MASTER%再也忍不住了。
浮いた腰を掴んで一気に奥を、子宮口を抉る。	双手握住她的纤腰、一口气插到最深处、顶到了子宫口。
突然の快感に瞳を白黒に瞬かせる%CALLNAME:TARGET%。	快感在%CALLNAME:TARGET%的眼眸中闪过。
「ふーっ_HH_ふーっ_HH_」	「呼ー_HH_呼ー_HH_」
確かに%CALLNAME:MASTER%は数えるのが億劫になる位、%CALLNAME:TARGET%に殺されているが、	的确%CALLNAME:MASTER%无数次、甚至厌烦的、被%CALLNAME:TARGET%杀了、
これで%CALLNAME:TARGET%に負けた事は殆ど無い筈だ。	所以在这种事情上几乎没有输过%CALLNAME:TARGET%。
「あっあっあっ_HH_あっ_HH__HH_」	「啊啊啊_HH_啊_HH__HH_」
寝起きを叩き起こされて、好き勝手にされたからには相応の事で返してやろう。	睡着了被叫醒、还擅自做这种事情、那么就用这种事情还回去。
%CALLNAME:TARGET%の事等お構いなしに腰を掴んで上下に抽出を行う。	紧紧的握住%CALLNAME:TARGET%的纤腰狠狠的从下往上抽动。
「ん゛ひっ_HH_あはっ_HH_あははっ_HH_」	「嗯゛咿_HH_啊哈_HH_啊哈哈_HH_」
%CALLNAME:TARGET%の腰を動かすだけではなく%CALLNAME:MASTER%も腰を動かして奥を、奥を突く。	%CALLNAME:TARGET%的腰没有动作、只有%CALLNAME:MASTER%在往上突刺、插到最深处。
おそらく普通だった痛いくらいの感覚を感じるだろうが%CALLNAME:TARGET%はむしろ笑って愉しんでいる。	如果是普通的情况的话可能会觉得很痛苦、但是%CALLNAME:TARGET%却高兴的笑着。
「あはっ_HH_んお゛っぉおお_HH_ふぁ、あ゛あっ_HH_あ、はぁ、う、う゛ぅう_HH__HH__HH_」	「啊哈_HH_嗯哦゛哦哦_HH_呼、啊゛啊_HH_啊、哈啊、唔、唔゛呜呜_HH__HH__HH_」
そして、止めを刺すように腰を打ち付けて%CALLNAME:TARGET%が絶頂を迎えると同時に射精す。	然后、插到最深处之后与%CALLNAME:TARGET%迎来高潮的同时射出了精液。
射精音が聞こえるかと思うくらいの勢いで%CALLNAME:TARGET%の膣を白く染め上げる。	似乎能听到射精的声音的程度将%CALLNAME:TARGET%蜜穴染满了白色。
%CALLNAME:TARGET%の子宮口はまるで飲むようにちゅうちゅうと出された精子を貪欲なまでに一滴残らず飲み込んだ。	%CALLNAME:TARGET%的子宫口宛如喝着精液一般将射进的精液一滴不剩的吸入。
「ん゛はっ……、はーっ……_HH_ふ、うぅ゛う……っ_HH__HH_」	「嗯゛哈啊……、哈ー……_HH_呼、唔゛唔……_HH__HH_」
ぐったりと%CALLNAME:MASTER%の上に息を荒くして%CALLNAME:TARGET%は倒れ込んだ。	%CALLNAME:TARGET%大声喘息着倒在%CALLNAME:MASTER%怀里。
倒れ込んだ%CALLNAME:TARGET%の背中を優しく撫でてやる。	抱着怀里的%CALLNAME:TARGET%抚摸着她白玉般无暇的背。
「さいきん、%CNAME("二人称")%さんがかまってくれないからさみしかったのです！」	「最近、%CNAME("二人称")%一直不来找我、很寂寞！」
つまり、夜這いをかけてきたのはそう言う事だったらしい。	也就是说、夜袭是因为这个。
確かに、最近は色々と忙しくて%CALLNAME:TARGET%の相手をする事が少なかった。	的确、最近忙各种事情完全没有顾及到%CALLNAME:TARGET%。
「いつもだったら%CNAME("二人称")%さんを殺した傷の場所を見て誤魔化していましたけど」	「平常的话会说来看%CNAME("二人称")%的伤口来做借口」
「今日はがまんができませんでした！」	「但是今天忍不住了！」
むじゃきにおそろしいことをいうなぁ。	别那样天真无邪的说着恐怖的话啊。
まぁ、でも今の%CALLNAME:TARGET%の在り方を選んだのは%CALLNAME:MASTER%自身だ。	嘛、但是现在%CALLNAME:TARGET%的模样是%CALLNAME:MASTER%自己选择的。
悪くは想っていない。	并没有觉得什么不好的。
さて、朝まで時間はあるから寝直そう。	接下来、离清晨还有时间睡个回笼觉吧。
「え、そのままシないのです？」	「欸、不接着做吗？」
%CALLNAME:MASTER%を何だと思っているのだこのメスガキは。	把我当成什么了啊你个死丫头。
異論は聞かないと%CALLNAME:TARGET%を抱き寄せてそのまま眠りにつく。	没有听她的抗议抱住%CALLNAME:TARGET%然后就这样睡着了。
「むぅ、でもこれはこれでいいですっ」	「姆、不过这样也挺好的」
そんな%CALLNAME:TARGET%の言葉を聞きながらまどろみにおちていく……	一边听着%CALLNAME:TARGET%的话然后堕入了梦乡……
さっきまでの力つよく%CNAME("一人称")%をらんぼうに使っていた%CNAME("二人称")%さんのうでは、	刚才还粗暴的抱着%CNAME("一人称")%的腰的双手、
今では%CNAME("一人称")%を優しくつつんでだきしめてくれています。	现在温柔的抱着%CNAME("一人称")%。
さっきまで感じていたむねのちくりとした痛みはいつの間にかなくなっています。	刚才还感觉到的胸口的疼痛、不知不觉间已经消失。
あぁ、やっぱりわかりました。	啊、果然是这样。
%CNAME("一人称")%は人を殺すのが好きなのではなくて、%CNAME("二人称")%さんを殺すが好きなんだと。	%CNAME("一人称")%不是喜欢杀人、而是喜欢杀%CNAME("二人称")%。
%CNAME("二人称")%さんが%CNAME("一人称")%にくれた優しい傷。	%CNAME("二人称")%给%CNAME("一人称")%的、温柔的伤口。
それが、あの痛みのしょうたいだったのですね。	这就是、那份痛楚的真相吧。
そっと%CNAME("一人称")%のむねをさわります。	手放在%CNAME("一人称")%的胸口上。
見えないけれど、たしかにある傷あと。	虽然看不到、但是的确有一份伤口。
%CNAME("一人称")%がここにいるあかし。	%CNAME("一人称")%存在于此的证据。
%CNAME("一人称")%は%CNAME("二人称")%さんにかんげいされてむかえられたのですから。	因为%CNAME("一人称")%被%CNAME("二人称")%接受了啊。
痛みの正体、夜を越えて『傷跡』　fin	痛苦之源、跨越黑夜『傷跡』　fin
PRINTFORML 「こんにちはです！今日は%CNAME("一人称")%が一番乗りですね！」	PRINTFORML 「你好呀！今日は%CNAME("一人称")%最先到吗！」
CALL PRINT_STRW, @"「他の人が来るまでナニかします……？_／／／_」"	CALL PRINT_STRW, @"「在其他人来之前要做什么吗……？_／／／_」"
PRINTFORML 「こんにちはです！あっ、今日は%CNAME("一人称")%が一番乗りですか……」	PRINTFORML 「你好呀！啊、今天是%CNAME("一人称")%最先到吗……」
CALL PRINT_STRW, @"「他の人が来るまで、な、なんでもシていいです、よ……？_／／／_」"	CALL PRINT_STRW, @"「在其他人来之前、做、做什么都可以、哦……？_／／／_」"
PRINTFORML 「こんにちはです！ん、今日は%CNAME("一人称")%が一番乗りですね……」	PRINTFORML 「你好呀！嗯、今天是%CNAME("一人称")%第一个到呢……」
CALL PRINT_STRL, @"「……ふふっ_／／／_」"	CALL PRINT_STRL, @"「……呼呼_／／／_」"
CALL PRINT_STRW, @"「今なら%CNAME("一人称")%たちがナニかしていても、他の人に見られないです、ね……？_／／／_」"	CALL PRINT_STRW, @"「现在的话、%CNAME("一人称")%们做什么、也不会有其他人知道、对吧……？_／／／_」"
PRINTFORMW 「……今日は%CNAME("一人称")%一番乗りですか」	PRINTFORMW 「……今天是%CNAME("一人称")%先到啊」
PRINTFORMW 「こんにちはです！きょうは%CNAME("一人称")%がいちばんのりですね！」	PRINTFORMW 「你好呀！今天是%CNAME("一人称")%第一个到呐！」
PRINTFORML 「ただいまです！」	PRINTFORML 「我回来了！」
PRINTFORMW 「うん、なんだか安心します♪」	PRINTFORMW 「嗯、总感觉很温馨呢♪」
PRINTFORMW 「……やっぱり、%CNAME("一人称")%が帰る場所はここが良いです」	PRINTFORMW 「……果然、%CNAME("一人称")%的归处是这里真的太好了」
PRINTFORML 「……ん、帰った時に、挨拶できるって」	PRINTFORML 「……嗯、回来的时候、能有人回应着自己」
PRINTFORMW 「とってもうれしいですね！」	PRINTFORMW 「真的感觉非常高兴呐！」
PRINTFORMW 「……ただいまです」	PRINTFORMW 「……我回来了」
PRINTFORMW 「ただいまです！」	PRINTFORMW 「我回来了！」
PRINTFORML 「おかえりなさいです！」	PRINTFORML 「欢迎回来！」
PRINTFORMW 「%CNAME("二人称")%さんが帰ってくるのを、いまかいまかと待ってました！」	PRINTFORMW 「我一直一直在等着%CNAME("二人称")%回来！」
PRINTFORML 「おかえりなさいです」	PRINTFORML 「欢迎回来」
%CALLNAME:MASTER%は%ARGS%事にした。	%CALLNAME:MASTER%做了%ARGS%的事情。
「%CNAME("二人称")%さんを殺すのが%CNAME("一人称")%の罰……」	「杀%CNAME("二人称")%就是%CNAME("一人称")%的惩罚……」
いやいやならやめて良いんだぞ。	讨厌的话停下来就好哦。
「いいえ、いやいやでやっていませんよ」	「不、倒不是讨厌」
ふるふると千紗は頭を横に振る。	千纱如同拨浪鼓一样摇晃着脑袋。
「%CNAME("一人称")%は%CNAME("一人称")%なりに%CNAME("二人称")%さんを殺す意味をかんがえています」	「%CNAME("一人称")%在想作为%CNAME("一人称")%杀%CNAME("二人称")%的意义」
「%CNAME("一人称")%はどれだけよごれても、さいしょに%CNAME("二人称")%さんと約束したことを守ります」	「不管%CNAME("一人称")%怎么污秽、也会遵守最开始和%CNAME("二人称")%的约定」
「『いっぱい殺させてくれるかわりになんでもします』」	「『作为杀你的代价对我做什么都可以』」
「%CNAME("二人称")%さんがいなければ、%CNAME("一人称")%じゃないです」	「没有%CNAME("二人称")%的话、%CNAME("一人称")%就不是我自己了」
「僕はあなたといきたいからさいしょの約束を守りたいです」	「因为想和你在一起所以遵守着最开始的约定」
顔がよく見える様に少し離れてからぱっと千紗は咲う。	她退后了几步然后露出了笑容。
「あなたのとなりが%CNAME("一人称")%のたましいのいばしょですからっ」	「你的身旁就是%CNAME("一人称")%的灵魂港湾」
【%CALLNAME:TARGET%の%CALLNAME:MASTER%に対する信頼が{ABL:信頼}LVに上がった】	【%CALLNAME:TARGET%对%CALLNAME:MASTER%的信赖{ABL:信頼}LV上升了】
PRINTFORML 「%CNAME("一人称")%、待っているあいだ少しだけさみしかったです」	PRINTFORML 「%CNAME("一人称")%、等%CNAME("二人称")%的时候有点寂寞」
PRINTFORMW 「でも、おかえりなさいって言えてうれしいです」	PRINTFORMW 「但是、能说出欢迎回来感觉很高兴」
PRINTFORML 「%CNAME("一人称")%、%CNAME("二人称")%さんが帰ってくるの待ってました」	PRINTFORML 「%CNAME("一人称")%、一直在等着%CNAME("二人称")%回来」
PRINTFORML 「少しだけさみしかったので抱っこしますね！」	PRINTFORML 「因为我很寂寞所以我要抱抱！」
CALL PRINT_STRW, @"「ん～_／／／_」"	CALL PRINT_STRW, @"「嗯～_／／／_」"
PRINTFORMW 「おかえりなさいです！」	PRINTFORMW 「欢迎回来！」
PRINTFORML 「こんにちはです！」	PRINTFORML 「你好呀！」
PRINTFORMW 「今日は%CNAME("一人称")%の方が先でしたね！」	PRINTFORMW 「今天是%CNAME("一人称")%在前面呐！」
PRINTFORML 「%CSTR:お茶%を入れましたけど飲みますか？」	PRINTFORML 「我泡了%CSTR:お茶%、要喝吗？」
PRINTFORMW 「ちょっとだけ練習しましたので、飲むならできれば感想がほしいです！」	PRINTFORMW 「因为还是稍微的练习过的、所以想要听听喝完之后的感想！」
PRINTFORML 「学校だと%CNAME("二人称")%さんに呼ばれない限り、ここでしか会えないですから」	PRINTFORML 「因为在学校里完全碰不到%CNAME("二人称")%、能相见的地方只有这里」
PRINTFORMW 「ちょっとだけ早く来ちゃいました♪」	PRINTFORMW 「所以老早早就来了♪」
PRINTFORMW 「……こんにちはです」	PRINTFORMW 「……你好呀」
PRINTFORMW 「きょうは%CNAME("一人称")%のほうがさきでしたね！」	PRINTFORMW 「看来%CNAME("一人称")%稍微在前到呢！」
PRINTFORML 「呼ばれてやってきました！」	PRINTFORML 「因为%CNAME("二人称")%让我过来、所以我过来了！」
PRINTFORMW 「携帯さんは便利ですね！」	PRINTFORMW 「电话桑还真是方便呢！」
PRINTFORML 「%CNAME("一人称")%にだってクラスの友達との付き合いがあるのですよ？」	PRINTFORML 「就算%CNAME("一人称")%这样的也是和班上同学有约的哦？」
PRINTFORML 「なんて、うそです」	PRINTFORML 「噗、开玩笑的」
PRINTFORMW 「ちょっとだけ気を引きたかっただけです」	PRINTFORMW 「只是想看看你的反应哦」
PRINTFORML 「クラスの人が%CNAME("一人称")%になにかご用があったみたいでしたけど」	PRINTFORML 「虽然班上的人似乎找%CNAME("一人称")%有什么事」
PRINTFORML 「%CNAME("二人称")%さんに呼ばれたらそっちが優先です！」	PRINTFORML 「不过%CNAME("二人称")%的事情自然是最优先的！」
PRINTFORMW 「だって%CNAME("一人称")%は%CNAME("二人称")%さんのモノですから！」	PRINTFORMW 「因为%CNAME("一人称")%是%CNAME("二人称")%的人！」
PRINTFORMW 「……%CNAME("一人称")%になにかご用ですか？」	PRINTFORMW 「……找%CNAME("一人称")%有什么事吗？」
PRINTFORMW 「んー？なにかごようですか？」	PRINTFORMW 「嗯ー？有什么事吗？」
PRINTFORMW 「ふぅ～んです」	PRINTFORMW 「呼～嗯」
PRINTFORMW 「むぅ～%CNAME("一人称")%帰って良いですか？」	PRINTFORMW 「姆～%CNAME("一人称")%可以回去了吗？」
PRINTFORMW 「むぅ～！むぅ～！」	PRINTFORMW 「姆～！姆～！」
PRINTFORMW 「%CNAME("一人称")%だってシてほしいです…」	PRINTFORMW 「%CNAME("一人称")%也想做啊…」
PRINTFORML 「この学校広いですね！」	PRINTFORML 「这个学校真大啊！」
PRINTFORMW 「ちょっと遅れちゃいました」	PRINTFORMW 「有点来迟了」
PRINTFORMW 「……少し遅れちゃいました」	PRINTFORMW 「……稍微来迟了啊」
PRINTFORMW 「こんにちはです！」	PRINTFORMW 「你好呀！」
PRINTFORMW 「わっ、みんな勢ぞろいですね！」	PRINTFORMW 「哇、大家都在啊！」
PRINTFORML 「こんにちはです」	PRINTFORML 「大家好呀」
PRINTFORMW 「にぎやかですね！」	PRINTFORMW 「真热闹呢！」
PRINTFORML 「むぅ…にぎやかなのも好きですが…」	PRINTFORML 「姆…喜欢热闹点吗…」
PRINTFORMW 「%CNAME("二人称")%さんを取られるのは……」	PRINTFORMW 「%CNAME("二人称")%被人抢走了……」
PRINTFORMW 「わわわ、いっぱいです！」	PRINTFORMW 「哇哇哇、好多人！」
PRINTFORMW 「こんにちはです！呼ばれて来ました！」	PRINTFORMW 「哈喽！我来了！」
PRINTFORMW 「こんにちはです。%CNAME("一人称")%にだって人付き合いがあるのですよ？」	PRINTFORMW 「你好。就算%CNAME("一人称")%这样的也是和班上同学有约的哦？」
PRINTFORMW 「こんにちはです！クラスの人が%CNAME("一人称")%に用事があったみたいですけどこっち優先です！」	PRINTFORMW 「你好呀！虽然班上的人似乎找%CNAME("一人称")%有什么事但是两边肯定是你最重要！」
PRINTFORMW 「こんにちはです！%CNAME("一人称")%になにかごようですか？」	PRINTFORMW 「哈喽！找%CNAME("一人称")%有什么事吗？」
PRINTFORMW 「迷っちゃいました！」	PRINTFORMW 「迷路了！」
PRINTFORMW 「えへへ、遅れちゃいました」	PRINTFORMW 「欸嘿嘿、我迟到了」
PRINTFORMW 『%CNAMET(ARG, CSVNAME_ACTOR)%先生、こんにちはです！』	PRINTFORMW 『%CNAMET(ARG, CSVNAME_ACTOR)%老师、你好！』
PRINTFORMW 『あっ、%CNAMET(ARG, CSVNAME_ACTOR)%先生、おつかれさまです』	PRINTFORMW 『あっ、%CNAMET(ARG, CSVNAME_ACTOR)%老师、辛苦了』
PRINTFORMW 『%CNAMET(ARG, CSVNAME_ACTOR)%先生、おつかれさまです！』	PRINTFORMW 『%CNAMET(ARG, CSVNAME_ACTOR)%老师、辛苦了！』
PRINTFORMW 『%CNAMET(ARG, CSVNAME_ACTOR)%せんせー、こんにちはです！』	PRINTFORMW 『%CNAMET(ARG, CSVNAME_ACTOR)%老师ー、你好呀！』
PRINTFORMW 『こんにちはです！遅かったですね！』	PRINTFORMW 『大家好！我来迟了！』
PRINTFORMW 『こんにちはです、%SAVESTR:お茶%を入れましたけどいりますか？』	PRINTFORMW 『你好、我泡了%SAVESTR:お茶%、要来一杯吗？』
PRINTFORMW 『こんにちはです！みんなそろってますよ！』	PRINTFORMW 『哈喽！大家已经来齐了哦！』
PRINTFORMW 『こんにちはです！おそかったですね！』	PRINTFORMW 『你来啦！来的好慢！』
PRINTFORMW 『こんにちはです！%CNAMET(ARG, CSVNAME_ACTOR)%さん』	PRINTFORMW 『你好！%CNAMET(ARG, CSVNAME_ACTOR)%』
PRINTFORMW 『%CNAMET(ARG, CSVNAME_ACTOR)%さん、こんにちはです』	PRINTFORMW 『%CNAMET(ARG, CSVNAME_ACTOR)%、你好』
PRINTFORMW 『%CNAMET(ARG, CSVNAME_ACTOR)%さんだっ！こんにちはです！』	PRINTFORMW 『%CNAMET(ARG, CSVNAME_ACTOR)%！你好！』
PRINTFORMW 「%CNAME("一人称")%になにかご用ですかっ！」	PRINTFORMW 「找%CNAME("一人称")%有什么事吗！」
PRINTFORMW 「%CNAME("二人称")%さんに呼ばれて来ましたけど、%CNAME("一人称")%になにかご用ですか？」	PRINTFORMW 「%CNAME("二人称")%叫我过来、是有什么事情要%CNAME("一人称")%吗？」
PRINTFORMW 「%CNAME("二人称")%さん！%CNAME("一人称")%になにかご用ですかっ！」	PRINTFORMW 「%CNAME("二人称")%！要%CNAME("一人称")%做什么吗！」
PRINTFORMW 「なにかごようですか！」	PRINTFORMW 「有什么事情吗！」
PRINTFORMW 「戻りました～！」	PRINTFORMW 「回来了～！」
PRINTFORMW 「……戻りました」	PRINTFORMW 「……回来了」
PRINTFORMW 「もどりました～！」	PRINTFORMW 「我回来了～！」
PRINTFORMW 「こんばんはです！」	PRINTFORMW 「晚上好！」
PRINTFORMW 「あ、%CNAME("二人称")%さん。こんばんはです」	PRINTFORMW 「啊、%CNAME("二人称")%。晚上好」
PRINTFORMW 「%CNAME("二人称")%さん、こんばんはです！いい夜ですね！」	PRINTFORMW 「%CNAME("二人称")%、晚上好！月色真美呐！」
PRINTFORMW 「……%CNAME("二人称")%さん。こんばんはです」	PRINTFORMW 「……%CNAME("二人称")%。晚上好」
PRINTFORMW 「あ、%CNAME("二人称")%さん。こんにちはです」	PRINTFORMW 「啊、%CNAME("二人称")%。中午好」
PRINTFORMW 「%CNAME("二人称")%さん、こんにちはです！お日様がかがやいてます！」	PRINTFORMW 「%CNAME("二人称")%、中午好！现在外面艳阳高照呢！」
PRINTFORMW 「……%CNAME("二人称")%さん。こんにちはです」	PRINTFORMW 「……%CNAME("二人称")%。中午好」
PRINTFORMW 「つーんです」	PRINTFORMW 「哼ー哒」
PRINTFORMW 「あっ……、う～」	PRINTFORMW 「啊……、唔～」
PRINTFORMW 「むぅ……」	PRINTFORMW 「姆……」
PRINTFORMW 「んー？いってらっしゃいです」	PRINTFORMW 「嗯ー？一路小心」
PRINTFORML 「ここが、%CNAME("二人称")%さんのいえですか…」	PRINTFORML 「这里、就是%CNAME("二人称")%的家吗…」
PRINTFORML 「きれいですね！」	PRINTFORML 「好漂亮呢！」
PRINTFORML 「う～、べたべたします…」	PRINTFORML 「唔～、粘嗒嗒的…」
PRINTFORML 「今日は暑いですね…、あっ近づいちゃヤですよ！」	PRINTFORML 「今天好热啊…、太近了、离我远点！」
PRINTFORML 「%CNAME("一人称")%、今汗くさいと思うので…」	PRINTFORML 「%CNAME("一人称")%、现在应该全是汗臭味…」
PRINTFORML 「あついです～、あっにおいを嗅ぐのはダメですよ！」	PRINTFORML 「好热～、啊、不许来闻我的味道！」
PRINTFORML 「……あついです」	PRINTFORML 「……好热」
PRINTFORML 「……ん～、おはようです……」	PRINTFORML 「……嗯～、早上好……」
PRINTFORML 「………あれ？%CNAME("二人称")%さん？」	PRINTFORML 「………啊嘞？%CNAME("二人称")%？」
PRINTFORML 「少しびっくりしました」	PRINTFORML 「稍微有点被吓到了」
PRINTFORML 「あらためて、おはようです！」	PRINTFORML 「重新来一下、早上好！」
PRINTFORML 「……ん、わぁっ！」	PRINTFORML 「……嗯、哇哇！」
PRINTFORML 「おはようです、%CNAME("二人称")%さん」	PRINTFORML 「早上好、%CNAME("二人称")%」
PRINTFORML 「……%CNAME("一人称")%の寝顔見てました…？」	PRINTFORML 「……看到%CNAME("一人称")%的睡脸了…？」
CALL PRINT_STRL, @"「……う～_／／／_」"	CALL PRINT_STRL, @"「……呜～_／／／_」"
PRINTFORML 「おはようですっ、%CNAME("二人称")%さん」	PRINTFORML 「早上好、%CNAME("二人称")%」
PRINTFORML 「……抱っこして良いですか？」	PRINTFORML 「……能抱抱吗？」
PRINTFORML 「……おはようです」	PRINTFORML 「……早上好」
PRINTFORML 「……ん～、おはよーです……」	PRINTFORML 「……嗯～、早上好ー哦……」
PRINTFORML 「こう言うのをそうしそうあいって言うんのですね！」	PRINTFORML 「这就是传说中的相思相爱啊！」
PRINTFORML 「うん！うれしいです！」	PRINTFORML 「嗯！我很高兴！」
PRINTFORML 「いまさらですけど、%CNAME("一人称")%から大好きとかいう事はありましたけど」	PRINTFORML 「虽然现在才吐槽、%CNAME("一人称")%虽然是真的喜欢你」
PRINTFORML 「%CNAME("二人称")%さんは言葉ではあんまり言わなかったですね」	PRINTFORML 「但是%CNAME("二人称")%平时都不怎么哄人的」
PRINTFORML 「だから、言葉で言ってくれたのがとってもうれしいです！」	PRINTFORML 「所以、听到你能这样和我说、我非常高兴！」
PRINTFORML 「ん～、%CNAME("二人称")%さんに「決して離れない」って言われてるから」	PRINTFORML 「嗯～、%CNAME("二人称")%说「绝不分离」这种话」
PRINTFORML 「ずっとそんなつもりだと思っていました」	PRINTFORML 「我也一直是这样的想法」
PRINTFORML 「彼女面と言うやつです！」	PRINTFORML 「这就是俗话说的女朋友了对吧！」
PRINTFORML 「でも、あらためて言葉に出してくれて」	PRINTFORML 「但是、让我重新说一次」
PRINTFORML 「ありがとうです」	PRINTFORML 「谢谢」
CALL PRINT_STRL, @"「%CNAME("一人称")%、とってもうれしいです_／／／_」"	CALL PRINT_STRL, @"「%CNAME("一人称")%、非常的高兴_／／／_」"
PRINTFORML 「えへへ～♪日曜日がたのしみですっ！」	PRINTFORML 「欸嘿嘿～♪好期待周末啊！」
CALL PRINT_STRL, @"「～～♪～～♪あっ……_／／／_はい、ちょっとうかれちゃいました_／／／_」"	CALL PRINT_STRL, @"「～～♪～～♪啊……_／／／_好、好开心_／／／_」"
CALL PRINT_STRL, @"「えへへ♪日曜日がまちきれないですっ！_／／／_」"	CALL PRINT_STRL, @"「欸嘿嘿♪周末赶快来赶快来！_／／／_」"
CALL PRINT_STRL, @"「いっぱいあそびましょうねっ！………！」"	CALL PRINT_STRL, @"「去各种地方玩吧！………！」"
CALL PRINT_STRL, @"「ふふっ_／／／__暗灰色_あと、ホテルにも行きたいですっ_／／／_」"	CALL PRINT_STRL, @"「呼呼_／／／__暗灰色_然后、爱情宾馆也想去_／／／_」"
PRINTFORML 「今日はここで殺してもいいのです？」	PRINTFORML 「今天要在这里做（指杀人）吗？」
PRINTFORML 「今日は%CNAME("二人称")%さんの部屋でするのです？」	PRINTFORML 「今天要在%CNAME("二人称")%的房间做吗？」
PRINTFORML 「なんてうそです！」	PRINTFORML 「开玩笑的！」
PRINTFORML 「持ってるのはおもちゃのナイフですよ～！」	PRINTFORML 「手上拿的是玩具匕首啦～！」
PRINTFORML 「ちょっとだけ冗談を言いたくなったのです！」	PRINTFORML 「稍微和你开个玩笑啦！」
CALL PRINT_STRL, @"「きょ、今日は%CNAME("二人称")%さんの部屋でするんですね…_／／／_」"	CALL PRINT_STRL, @"「今、今天要在は%CNAME("二人称")%的房间做啊…_／／／_」"
PRINTFORML 「抱っこして良いですか？」	PRINTFORML 「能抱抱吗？」
CALL PRINT_STRL, @"「ん……_／／／_」"	CALL PRINT_STRL, @"「嗯……_／／／_」"
CALL PRINT_STRL, @"「あったかいです……_／／／_」"	CALL PRINT_STRL, @"「好温暖……_／／／_」"
PRINTFORML 「今日はどんな事をするのです？」	PRINTFORML 「今天要做什么呢？」
PRINTFORML 「なんだか……」	PRINTFORML 「总感觉……」
PRINTFORML 「なんだか、%CNAME("二人称")%さんの部屋にいると安心します」	PRINTFORML 「总感觉、%CNAME("二人称")%的房间让人感觉到一股安心感」
「きょうはここで殺してもいいのです？」	「今天要在这里做（指杀人）吗？」
PRINTFORML 「今日は%CNAME("一人称")%の部屋で殺してもいいのです？」	PRINTFORML 「今天要在%CNAME("一人称")%的房间做（指杀人）吗？」
PRINTFORML 「今日は%CNAME("一人称")%の部屋でするんです？」	PRINTFORML 「今天要在%CNAME("一人称")%的房间做吗？」
PRINTFORML 「今日は%CNAME("一人称")%の部屋で殺してもいいのです？	PRINTFORML 「今天要在%CNAME("一人称")%的房间让我杀吗？
CALL PRINT_STRL, @"「あ、あんまり見ちゃやです…_／／／_」"	CALL PRINT_STRL, @"「不要、那么细致的观察啦…_／／／_」"
CALL PRINT_STRL, @"「%CNAME("一人称")%の部屋あんまり女の子らしくないからです…_／／／_」"	CALL PRINT_STRL, @"「因为%CNAME("一人称")%的房间不像女孩子的房间啦…_／／／_」"
CALL PRINT_STRL, @"「きょ、今日は%CNAME("一人称")%の部屋でするんですね…_／／／_」"	CALL PRINT_STRL, @"「今、今天要在%CNAME("一人称")%的房间做啊…_／／／_」"
PRINTFORML 「えーい！ぎゅーです！」	PRINTFORML 「嘿ー！亲ー！」
CALL PRINT_STRL, @"「えへへ～_／／／_」"	CALL PRINT_STRL, @"「欸嘿嘿～_／／／_」"
PRINTFORML 「%CNAME("一人称")%の部屋へようこそ！です」	PRINTFORML 「欢迎来到%CNAME("一人称")%的房间！」
PRINTFORML 「なんにもない%CNAME("一人称")%の部屋ですがくつろいでください！」	PRINTFORML 「虽然房间里什么亮眼的东西都没有、但是请慢慢的在%CNAME("一人称")%的房间放松！」
PRINTFORML 「きょうは%CNAME("一人称")%のへやで殺していいのです？」	PRINTFORML 「今天要在%CNAME("一人称")%的房间让我杀吗？」
PRINTFORML 「あっ、%CNAME("二人称")%さん！」	PRINTFORML 「啊、%CNAME("二人称")%！」
PRINTFORML 「%CNAME("一人称")%になにかご用ですか！」	PRINTFORML 「有什么事吗！」
PRINTFORML 「あっ！ちょっと待ってください！」	PRINTFORML 「啊！等等！」
PRINTFORML 「あっあっあ…」	PRINTFORML 「啊啊啊…」
PRINTFORML 「待ってくださいっていったのに…」	PRINTFORML 「都说等一下了…」
PRINTFORML 「はいです……、ちょっと部屋をもようがえしてたのです」	PRINTFORML 「是……、我把房间重新改变了一下布局」
PRINTFORML 「あれっ？%CNAME("二人称")%さん？」	PRINTFORML 「啊嘞？%CNAME("二人称")%？」
PRINTFORML 「%CNAME("一人称")%になにかご用ですか？」	PRINTFORML 「找%CNAME("一人称")%有什么事吗？」
「……なにか%CNAME("一人称")%にご用ですか？」	「……找%CNAME("一人称")%什么事吗？」
PRINTFORML 「ん～？ようこそです！」	PRINTFORML 「嗯～？欢迎！」
PRINTFORML 「わぁ！」	PRINTFORML 「哇！」
PRINTFORML 「%CNAME("一人称")%のパンツが見たかったのです？」	PRINTFORML 「你看到%CNAME("一人称")%的胖次了？」
PRINTFORML 「わっ！」	PRINTFORML 「哇！」
PRINTFORML 「言ってくれれば見せますよ？」	PRINTFORML 「你说的话我会给你看的呀？」
PRINTFORML 「えっ、スカートをめくるのが良い？」	PRINTFORML 「欸、喜欢撩起裙子看？」
CALL PRINT_STRL, @"「い、言ってくれれば_／／／_」"	CALL PRINT_STRL, @"「明明你、说的话_／／／_」"
CALL PRINT_STRL, @"「見せてあげますのに…_／／／_」"	CALL PRINT_STRL, @"「我会给你看的…_／／／_」"
CALL PRINT_STRL, @"「ぴゃあぁあ！？_／／／_」"	CALL PRINT_STRL, @"「咿呀呀！？_／／／_」"
PRINTFORML 「ふ、ふいうちはダメですっ！」	PRINTFORML 「偷、偷袭是不好的！」
CALL PRINT_STRL, @"「ひゃああ！？！？_／／／_」"	CALL PRINT_STRL, @"「咿呀咿呀！？！？_／／／_」"
PRINTFORML 「な、なにするのですかっ！」	PRINTFORML 「做、做什么呢！」
PRINTFORML 「ひゃあっ！」	PRINTFORML 「咿呀！」
CALL PRINT_STRL, @"「ダメなんですよ？_／／／_」"	CALL PRINT_STRL, @"「不行哦？_／／／_」"
PRINTFORML 「わぁっ！」	PRINTFORML 「哇！」
CALL PRINT_STRL, @"「%CNAME("一人称")%のパンツが見たかったら言ってくれればいいのに…_／／／_」"	CALL PRINT_STRL, @"「想看%CNAME("一人称")%的胖次的话和我说不就好了…_／／／_」"
PRINTFORML 「ぴゃあっ！」	PRINTFORML 「咿呀！」
CALL PRINT_STRL, @"「み、見たいのですか…？_／／／_」"	CALL PRINT_STRL, @"「那么、想看吗…？_／／／_」"
PRINTFORML 声を出してなかったけれどかなり驚いたみたいだ。	PRINTFORML 她整个人都震惊了。
PRINTFORML 「ん～？なんです？」	PRINTFORML 「嗯～？什么？」
PRINTFORML %CALLNAME:TARGET%はきょとんと%CALLNAME:MASTER%を見つめている。	PRINTFORML %CALLNAME:TARGET%有点茫然的看着%CALLNAME:MASTER%。
PRINTFORML 「ん～？また見たいのです？」	PRINTFORML 「嗯～？还想看？」
PRINTFORML 「パンツは何度でも見れる？そうなのですか～」	PRINTFORML 「胖次是永远看不腻的？这样啊～」
PRINTFORML 「あきないのです？」	PRINTFORML 「不会腻的吗？」
PRINTFORML 「全然あきない、ですか」	PRINTFORML 「完全不会、吗」
CALL PRINT_STRL, @"「あっ…はい…_／／／_」"	CALL PRINT_STRL, @"「啊…好吧…_／／／_」"
CALL PRINT_STRL, @"灰色_「ど、どうぞ_／／／_灰色_」"	CALL PRINT_STRL, @"灰色_「请、请用_／／／_灰色_」"
CALL PRINT_STRL, @"「あ、あんまりじろじろ見ないでください…_／／／_」"	CALL PRINT_STRL, @"「啊、请不要那样拿着胖次看过来看过去的…_／／／_」"
CALL PRINT_STRL, @"灰色_「は、恥ずかしいです…_／／／_灰色_」"	CALL PRINT_STRL, @"灰色_「好、好羞耻…_／／／_灰色_」"
CALL PRINT_STRL, @"「ち、近いです_／／／_」"	CALL PRINT_STRL, @"「好、好近_／／／_」"
CALL PRINT_STRL, @"「近い近い近いですよ！？_／／／_」"	CALL PRINT_STRL, @"「好近好近好近！？_／／／_」"
CALL PRINT_STRL, @"「あ、あんまりじっと見ないでくださいね…？_／／／_」"	CALL PRINT_STRL, @"「啊、能不能不要那样看…？_／／／_」"
CALL PRINT_STRL, @"「%CNAME("一人称")%だって恥ずかしいモノは恥ずかしいです…_／／／_」"	CALL PRINT_STRL, @"「就算%CNAME("一人称")%也有觉得害羞的东西啊…_／／／_」"
CALL PRINT_STRL, @"ハートピンク_「っ～～～～～～～～～～_／／／_ハートピンク_」"	CALL PRINT_STRL, @"ハートピンク_「～～～～～～～～～～_／／／_ハートピンク_」"
CALL PRINT_STRL, @"「あ、あのっ_／／／_」"	CALL PRINT_STRL, @"「那、那个_／／／_」"
CALL PRINT_STRL, @"「そ、そんなに見られてると_／／／_」"	CALL PRINT_STRL, @"「那、那样盯着看的话_／／／_」"
PRINTFORML 「……どうぞ」	PRINTFORML 「……请」
PRINTFORML 「ぱんつがみたいですか？」	PRINTFORML 「想看胖次吗？」
PRINTFORML 「ん、どうぞ」	PRINTFORML 「嗯、请」
PRINTFORML 「どうぞ！」	PRINTFORML 「请！」
CALL PRINT_STRL, @"「ん……_HH_」"	CALL PRINT_STRL, @"「嗯……_HH_」"
PRINTFORML 「おまんこが見たいのです？」	PRINTFORML 「想看小穴吗？」
PRINTFORML つぅっと溢れた愛液が太腿を伝う	PRINTFORML 汩汩流出的爱液顺着大腿流了下来
CALL PRINT_STRL, @"「あっ_／／／_」"	CALL PRINT_STRL, @"「啊_／／／_」"
CALL PRINT_STRL, @"「そ、そんなに見られたら_／／／_」"	CALL PRINT_STRL, @"「那样、盯着看的话_／／／_」"
CALL PRINT_STRL, @"「う～～～～！_／／／_」"	CALL PRINT_STRL, @"「呜～～～～！_／／／_」"
CALL PRINT_STRL, @"灰色_「シたいなら、言ってくれれば……_／／／_灰色_」"	CALL PRINT_STRL, @"灰色_「想做的话、开口说就……_／／／_灰色_」"
PRINTFORML 「%CNAME("一人称")%のおまたがみたいのです？」	PRINTFORML 「想看%CNAME("一人称")%的馒头？」
PRINTFORML 「……？おまんこっていうのですか？」	PRINTFORML 「……？要说小穴？」
PRINTFORML 「しりませんでした！」	PRINTFORML 「我不知道这么叫！」
PRINTFORML 「おまんこがみたいのです？」	PRINTFORML 「想看小穴？」
PRINTFORML 「もうお終いです？」	PRINTFORML 「就这？」
CALL PRINT_STRL, @"「ふかんぜんねんしょうなので続きがシたいです！」"	CALL PRINT_STRL, @"「因为半途而废了所以要求继续的说！」"
CALL PRINT_STRL, @"「つ、続きがシたいです……_／／／_」"	CALL PRINT_STRL, @"「唔、还想要……_／／／_」"
CALL PRINT_STRL, @"「んくっ……_HH_続きはシないのです……？」"	CALL PRINT_STRL, @"「嗯咕……_HH_我还想要啦……？」"
PRINTFORML 「あれ？もうおしまいです？」	PRINTFORML 「啊嘞？结束了？」
PRINTFORML 「んー……？」	PRINTFORML 「嗯ー……？」
PRINTFORML 「あっ、ピースです！」	PRINTFORML 「啊、V！」
PRINTFORML 直前で気が付いた%CALLNAME:TARGET%は満面の笑みでピースをした。	PRINTFORML 开始拍照之前才注意到的%CALLNAME:TARGET%、露出笑容摆着V字手。
CALL PRINT_STRL, @"「あっ、取るなら言ってくださいっ_／／／_」"	CALL PRINT_STRL, @"「啊、要拍的话和我说就好了_／／／_」"
PRINTFORML %CALLNAME:TARGET%のあわてる様がシャッターに納められた。	PRINTFORML 拍下了%CALLNAME:TARGET%慌慌张张的样子。
PRINTFORML 「あっ！」	PRINTFORML 「啊！」
PRINTFORML 隠し撮りに気が付いた%CALLNAME:TARGET%はピースをしようとしたが写真はブレてしまった。	PRINTFORML 察觉了偷拍的%CALLNAME:TARGET%慌慌张张的摆出剪刀手但是已经拍完了。
PRINTFORML 「む？………とりなおしを要求します！」	PRINTFORML 「姆？………要求重拍！」
PRINTFORML そう言うと%CALLNAME:TARGET%は咲いピースをしてきた……	PRINTFORML 说完、%CALLNAME:TARGET%露出笑容摆出V字手……
PRINTFORML スマホ越しに合った視線は%CALLNAME:TARGET%が外したことによってすぐに交じり合わなくなった。	PRINTFORML %CALLNAME:TARGET%看到手机摄像头之后移开了视线。
PRINTFORML 「…？なんです？」	PRINTFORML 「…？做什么？」
PRINTFORML %CALLNAME:TARGET%は気が付いたが意味が分かっていなのかきょとんとしている。	PRINTFORML %CALLNAME:TARGET%虽然注意到了手机、但是不明白这是什么意义。
PRINTFORML 「うんしょ、よいしょ…」	PRINTFORML 「嘿咻、嘿咻…」
PRINTFORML 一枚一枚服を脱いでいき華奢な身体をさらしていく。	PRINTFORML 一件一件的把衣服褪下、露出了曼妙的娇躯。
PRINTFORML 「脱ぎました！」	PRINTFORML 「脱完了！」
CALL PRINT_STRL, @"「恥ずかしいです恥ずかしいです恥ずかしいですっ！_／／／_」"	CALL PRINT_STRL, @"「好羞耻好羞耻好羞耻！_／／／_」"
PRINTFORML %CALLNAME:TARGET%は顔を真っ赤にしてその華奢な身体を両手で必死に隠している。	PRINTFORML %CALLNAME:TARGET%满脸通红的用两只手拼命的遮住自己的身体。
CALL PRINT_STRL, @"「恥ずかしいです…_／／／_」"	CALL PRINT_STRL, @"「好羞耻…_／／／_」"
CALL PRINT_STRL, @"「けど、%CNAME("二人称")%さんが見たいなら…_／／／_」"	CALL PRINT_STRL, @"「但是、因为%CNAME("二人称")%想看所以…_／／／_」"
PRINTFORML そう言って%CALLNAME:TARGET%はするすると服を脱いでいく。	PRINTFORML 一边说着、%CALLNAME:TARGET%一边慢慢的把衣服脱下。
PRINTFORML 「……はい、服脱ぎますね」	PRINTFORML 「……好、脱光是吧」
PRINTFORML 言われるがままにするすると服を一枚、一枚脱いでいく	PRINTFORML 她按照要求说的一件一件的褪下衣服
PRINTFORML 「ほかの人のまえでぬぐのですか？」	PRINTFORML 「在其他人的面前脱吗？」
PRINTFORML 「わかりました！」	PRINTFORML 「我知道了！」
PRINTFORML 他に人が居るのに%CALLNAME:TARGET%は何の迷いなく服を脱いだ。	PRINTFORML 明明还有其他人在、但是%CALLNAME:TARGET%没有丝毫犹豫的脱下了衣服。
PRINTFORML 「お外で脱ぐのはへんたいさんだって知ってますよ！」	PRINTFORML 「在外面脱衣服是变态行为这个我还是知道的！」
PRINTFORML 「でも、%CNAME("二人称")%さんが言うなら%CNAME("一人称")%、脱ぎます！」	PRINTFORML 「但是、%CNAME("二人称")%要求的话、%CNAME("一人称")%脱！」
CALL PRINT_STRL, @"暗灰色_「服、かえしてください……_／／／_暗灰色_」"	CALL PRINT_STRL, @"暗灰色_「衣服、还给我……_／／／_暗灰色_」"
PRINTFORML 小さな小さな声で%CALLNAME:TARGET%は顔を真っ赤にしながら%CALLNAME:MASTER%が持っている服をじっと見ている。	PRINTFORML %CALLNAME:TARGET%满脸通红用声若蚊蝇的声音向%CALLNAME:MASTER%请求着。
CALL PRINT_STRL, @"「あ、あのっ！_／／／_」"	CALL PRINT_STRL, @"「那、那个！_／／／_」"
CALL PRINT_STRL, @"灰色_「%CNAME("一人称")%、知らない人に見てほしくないです……_／／／_灰色_」"	CALL PRINT_STRL, @"灰色_「%CNAME("一人称")%、不想被其他人看到……_／／／_灰色_」"
PRINTFORML %CALLNAME:TARGET%がそう言ってくるが恥ずかしがる姿を見るのも良いなと思うのだった。	PRINTFORML 感觉看到%CALLNAME:TARGET%害羞的样子也挺好。
PRINTFORML 「おそとでぬぐのです？」	PRINTFORML 「在外面脱吗？」
PRINTFORML 「よいしょ……、こうやっておそとではだかになると」	PRINTFORML 「嘿咻……、这样就在外面裸体了」
PRINTFORML 「%CNAME("二人称")%さんとあうまえをおもいだします！」	PRINTFORML 「想起了遇到%CNAME("二人称")%之前的事情！」
PRINTFORML 服を脱いでハダカになった%CALLNAME:TARGET%は何かを思いついたように笑う。	PRINTFORML 把衣服脱光的%CALLNAME:TARGET%想到了什么突然笑了出来。
PRINTFORML 「えーい！」	PRINTFORML 「嘿ー！」
PRINTFORML そう言って%CALLNAME:MASTER%に抱きついてきた。	PRINTFORML 她突然袭击抱住了%CALLNAME:MASTER%。
PRINTFORML 「えへへ～、あったかいです！」	PRINTFORML 「欸嘿嘿～、好温暖！」
CALL PRINT_STRL, @"「は、恥ずかしいです…_／／／_」"	CALL PRINT_STRL, @"「好、好害羞…_／／／_」"
PRINTFORML そう言いながら%CALLNAME:TARGET%は顔を真っ赤にして俯いている。	PRINTFORML %CALLNAME:TARGET%满脸通红的低着头。
PRINTFORML 足を内股にもじもじさせ、右手で胸を隠し、左手はアソコを隠している。	PRINTFORML 双手堪堪勉强遮住重要的地方。
CALL PRINT_STRL, @"「う～～～～～～～～_／／／_」"	CALL PRINT_STRL, @"「呜～～～～～～～～_／／／_」"
CALL PRINT_STRL, @"「%CNAME("一人称")%の全部は%CNAME("二人称")%さんのモノです_／／／_」"	CALL PRINT_STRL, @"「%CNAME("一人称")%的全部、都是%CNAME("二人称")%的_／／／_」"
PRINTFORML 服を脱いだ%CALLNAME:TARGET%は%CALLNAME:MASTER%に見せつける様に身体をさらす。	PRINTFORML %CALLNAME:TARGET%虽然赤裸着身体、但是大方的站在%CALLNAME:MASTER%。
CALL PRINT_STRL, @"「だから、ちゃんと見てください_／／／_」"	CALL PRINT_STRL, @"「所以、要认真的看哦_／／／_」"
PRINTFORML そう言って%CALLNAME:TARGET%は咲う。	PRINTFORML %CALLNAME:TARGET%微笑着说。
PRINTFORML 「ん～ふくをぬげばいいのです？」	PRINTFORML 「嗯～把衣服脱掉就好？」
PRINTFORML 「わっかりました！」	PRINTFORML 「我知道了！」
PRINTFORML そう言って%CALLNAME:TARGET%はゴソゴソと服を脱ぎ始めた。	PRINTFORML 说完、%CALLNAME:TARGET%开始褪下自己的衣服。
PRINTFORML 「じゃーん！ぬぎましたよ～！」	PRINTFORML 「蒋ー！脱完了哦～！」
PRINTFORML 「んふっふっふっふ～」	PRINTFORML 「嗯呼呼～」
CALL PRINT_STRL, @"暗灰色_「えへへ………♪これはナイフじゃないですよぉ………」"	CALL PRINT_STRL, @"暗灰色_「欸嘿嘿………♪这个不是匕首哦………」"
CALL PRINT_STRL, @"暗灰色_「ん………おもちゃのナイフです………♪」"	CALL PRINT_STRL, @"暗灰色_「嗯………只是玩具刀而已………♪」"
PRINTFORML 布団をぽかぽかと叩いてる様からどうやら%CALLNAME:MASTER%は夢の世界で玩具のナイフで刺されてるみたいだ。	PRINTFORML %CALLNAME:MASTER%啪嚓啪嚓的打着被子、看起来是在梦里干着老本行。
CALL PRINT_STRL, @"暗灰色_「すぅ………むにゃ………%CNAME("二人称")%さん………♪」"	CALL PRINT_STRL, @"暗灰色_「嘶………姆妮………%CNAME("二人称")%………♪」"
CALL PRINT_STRL, @"暗灰色_「えへへ………♪ん………あったかいです………」"	CALL PRINT_STRL, @"暗灰色_「欸嘿嘿………♪嗯………好温暖………」"
PRINTFORML どんな夢を見ているのか分からないが%CALLNAME:TARGET%は布団を抱きしめる様に寝ている。	PRINTFORML 不知道她在做什么梦、只看到%CALLNAME:TARGET%紧紧的抱着被窝甜美的睡着。
CALL PRINT_STRL, @"暗灰色_「すぅ………すぅ………%CNAME("二人称")%さん………すぅ………ん………だいすきです………」"	CALL PRINT_STRL, @"暗灰色_「嘶………嘶………%CNAME("二人称")%………斯………嗯………最喜欢………」"
PRINTFORML とても穏やかな寝顔で抱きしめた枕に顔をうずめながらの寝言。	PRINTFORML 平静的睡脸、朱唇微张说着梦话。
PRINTFORML どうやら、夢の中で抱きつかれているらしい。	PRINTFORML 看来、是在梦中遇到了自己。
CALL PRINT_STRL, @"暗灰色_「すぅ………すぅ………ん………」"	CALL PRINT_STRL, @"暗灰色_「嘶………嘶………嗯………」"
PRINTFORML いつも元気で賑やかな%CALLNAME:TARGET%も流石に寝ている時は静かだ。	PRINTFORML 平时都像一个元气爆表的熊孩子、睡觉时候还是会安静的样子。
PRINTFORML だが、寝姿は身を守る様に丸くなっている………	PRINTFORML 虽然、睡姿就像穿山甲一般卷缩着身子………
CALL PRINT_STRL, @"暗灰色_「%CNAME("二人称")%さん………すぅ………ん………ハダカで………おそとあるいちゃ………」"	CALL PRINT_STRL, @"暗灰色_「%CNAME("二人称")%………嘶………嗯………裸体………不能去外面………」"
PRINTFORML まて、そんなけいけんはない。	PRINTFORML 等等、没有那种事情。
PRINTFORML させたけいけんはあるかもしれないが。	PRINTFORML 虽然可能有让她走出去过。
CALL PRINT_STRL, @"暗灰色_「むにゃ………むにゃ………ごはんおいしいです………」"	CALL PRINT_STRL, @"暗灰色_「姆妮………姆妮………饭好好吃………」"
PRINTFORML また典型的な寝言だ……。	PRINTFORML 经 典 梦 话……。
CALL PRINT_STRL, @"暗灰色_「たらばがに………そんなにたべらません………」"	CALL PRINT_STRL, @"暗灰色_「肚子好撑………吃不下了………」"
PRINTFORML どんなゆめだ。	PRINTFORML 这什么梦。
CALL PRINT_STRL, @"暗灰色_「それは………むにゃ………ごはんです………」"	CALL PRINT_STRL, @"暗灰色_「那个………姆妮………是我的饭………」"
PRINTFORML ご飯の夢でも見ているのだろうか……？	PRINTFORML 梦见吃的了吗……？
CALL PRINT_STRL, @"暗灰色_「おちんちんさんを………いれるところじゃないです………」"	CALL PRINT_STRL, @"暗灰色_「不是………让肉棒插进去的地方………」"
PRINTFORML 少し%CALLNAME:TARGET%とちゃんと話し合う必要があるみたいだ。	PRINTFORML 看来需要稍微的找%CALLNAME:TARGET%进行一次人生商谈了。
PRINTFORML ご飯をオカズにした事はない。	PRINTFORML 金金可不会插到那种地方去。
CALL PRINT_STRL, @"暗灰色_「すぅ………きょうは………すぅ………どんな………ごはんでしょうか………」"	CALL PRINT_STRL, @"暗灰色_「嘶………啾………嘶………今天………饭菜是什么呢………」"
PRINTFORML そう言っている%CALLNAME:TARGET%は何かをゴソゴソしている様に腕を動かしている。	PRINTFORML 这样喃喃说着的%CALLNAME:TARGET%不知为何挥舞着手。
PRINTFORML ここに来る前の記憶だろうか……？	PRINTFORML 梦到以前的事情了吗……？
CALL PRINT_STRL, @"暗灰色_「んふふ………あはは………」"	CALL PRINT_STRL, @"暗灰色_「嗯呼呼………啊哈哈………」"
PRINTFORML 何やら楽しい夢を見ている様だ。	PRINTFORML 看起来是梦到什么开心的梦了。
PRINTFORML 楽しそうに握った手で布団をぽかぽかとしている。	PRINTFORML 看起来很开心的抱着被褥。
CALL PRINT_STRL, @"暗灰色_「ごめん……なさい………ごめんなさい……ごめんなさい…」"	CALL PRINT_STRL, @"暗灰色_「对不……起………对不起……对不起…」"
PRINTFORML 声はとても苦し気で何かに必死に謝っている。	PRINTFORML 悲伤的声音不断地重复着道歉。
PRINTFORML 謝って赦される事じゃない。そんなの分かっている。	PRINTFORML 就算道歉也不会被原谅。这点我很清楚。
PRINTFORML それでも、赦すように頭を撫でる。	PRINTFORML 但是即便如此、也像原谅她一般的抚摸着她的头。
CALL PRINT_STRL, @"暗灰色_「うぅ………あぁ………」"	CALL PRINT_STRL, @"暗灰色_「呜………啊………」"
PRINTFORML うなされ何かを求める様に手を虚空に伸ばしている。	PRINTFORML 像在追求什么一般手伸向虚空。
PRINTFORML だから、手を握った。	PRINTFORML 所以、握住了她的手。
CALL PRINT_STRL, @"暗灰色_「あっ………%CNAME("一人称")%を………はなさないで……」"	CALL PRINT_STRL, @"暗灰色_「啊………不要放开%CNAME("一人称")%……………」"
PRINTFORML 寝息はもう穏やかだ。	PRINTFORML 呼吸逐渐变得平稳下来。
CALL PRINT_STRL, @"暗灰色_「うぅ………おとうさん…おかあさん…」"	CALL PRINT_STRL, @"暗灰色_「呜………爸爸…妈妈…」"
PRINTFORML うなされている%CALLNAME:TARGET%の頭をあなたは優しく、やさしく撫でる。	PRINTFORML %CALLNAME:MASTER%温柔的抚摸着悲伤呻吟着的%CALLNAME:TARGET%的头、温柔的。
CALL PRINT_STRL, @"暗灰色_「ん………すぅ………すぅ………」"	CALL PRINT_STRL, @"暗灰色_「嗯………嘶………嘶………」"
PRINTFORML 寝息は穏やかになった。	PRINTFORML 呼吸变得平稳起来了。
PRINTFORML ……両親はどうしたのだろうか？	PRINTFORML ……亲人发生了什么了吗？
PRINTFORMW 「雨ですね！かさに入れてください！」	PRINTFORMW 「下雨了呢！让我和你用一把伞！」
PRINTFORMW 「雨ですね。か、かさに入っても良いです？」	PRINTFORMW 「下雨了。伞、我能和你用一把伞吗？」
PRINTFORMW 「雨ですね！あいむしーんぐいんざれいん♪してみたいです！」	PRINTFORMW 「下雨了啊！我想试试相合伞！」
PRINTFORMW 「……雨ですね」	PRINTFORMW 「……下雨了」
PRINTFORMW 「あっ！あめですね！」	PRINTFORMW 「啊！下雨了！」
PRINTFORMW 「うにゅ？お風呂に入るのです？」	PRINTFORMW 「唔喵？要洗澡吗？」
PRINTFORMW 「いっしょに入ります！」	PRINTFORMW 「一起一起！」
PRINTFORMW 「ムラムラしてきました……」	PRINTFORMW 「莫名的难受……」
CALL PRINT_STRW, @"「シたいです……_HH_」"	CALL PRINT_STRW, @"「好想做……_HH_」"
PRINTFORMW 「ダメ……ですか？」	PRINTFORMW 「不行……吗？」
PRINTFORML [0] はい	PRINTFORML [0] 好呀好呀
PRINTFORML [1] いいえ	PRINTFORML [1] 不了不了
CALL PRINT_STRW, @"「えへへ～_HH_」"	CALL PRINT_STRW, @"「欸嘿嘿～_HH_」"
CALL PRINT_STRW, @"「やったー！です_HH_」"	CALL PRINT_STRW, @"「太好了ー！_HH_」"
PRINTFORMW 「えぇ～！こうぎします！」	PRINTFORMW 「欸～！我要抗议、我要革命！」
PRINTFORMW 「%CNAME("一人称")%はムラムラしてるのです！」	PRINTFORMW 「%CNAME("一人称")%忍不住了！」
PRINTFORMW 「えーい！」	PRINTFORMW 「嘿ー！」
PRINTFORMW 「%CNAME("二人称")%さん！背中洗いますよ！」	PRINTFORMW 「%CNAME("二人称")%！我帮你搓背！」
PRINTFORMW 「えへへ～、もこもこです！」	PRINTFORMW 「欸嘿嘿～、软乎乎的！」
PRINTFORMW 「あ、お風呂ですか」	PRINTFORMW 「啊、洗澡吗」
PRINTFORMW 「いってらっしゃいです」	PRINTFORMW 「去吧去吧」
PRINTFORMW 「次、%CNAME("一人称")%が入りますね」	PRINTFORMW 「之后就轮到我%CNAME("一人称")%去洗了」
CALL PRINT_STRW, @"「んっ……_HH_」"	CALL PRINT_STRW, @"「嗯……_HH_」"
PRINTFORMW 「お風呂入るのです？」	PRINTFORMW 「要洗澡吗？」
PRINTFORMW 「いっしょに入りたいですっ！」	PRINTFORMW 「我想一起洗！」
PRINTFORMW 「いつもなら引き下がってますが！」	PRINTFORMW 「平时的话就算了！」
PRINTFORMW 「今日はそう行きません！」	PRINTFORMW 「今天、你洗澡的对象是我白藤千纱哒！」
PRINTFORMW 「%CNAME("一人称")%だってムラムラしてるのです！」	PRINTFORMW 「%CNAME("一人称")%也会忍不住的啊！」
PRINTFORMW 「とーう！きょうせいれんこうです！」	PRINTFORMW 「嘟ー！强制带走！」
PRINTFORMW 「あ、ダメですか…」	PRINTFORMW 「啊、不行吗…」
PRINTFORMW 「そうですか…」	PRINTFORMW 「这样啊…」
PRINTFORMW 【%CALLNAME:TARGET%の欲求が少し深まった】	PRINTFORMW 【%CALLNAME:TARGET%的欲求不满度增加了】
PRINTFORMW 「……おやすみなさいです」	PRINTFORMW 「……晚安」
PRINTFORMW 【%CALLNAME:TARGET%の欲求が深まった】	PRINTFORMW 【%CALLNAME:TARGET%的欲求不满度增加了】
PRINTFORMW 「うにゅ？おふろはいってねるのです？」	PRINTFORMW 「唔喵？洗完澡就要睡了？」
PRINTFORMW 「そうですか……」	PRINTFORMW 「这样啊……」
PRINTFORMW 「もう寝ちゃうのです？」	PRINTFORMW 「已经要睡了吗？」
PRINTFORMW 「うむむむ……」	PRINTFORMW 「唔姆姆姆……」
PRINTFORMW 「あっ、もう寝るのです？」	PRINTFORMW 「啊、要睡了吗？」
CALL PRINT_STRW, @"暗灰色_「いっしょに寝たいです……」"	CALL PRINT_STRW, @"暗灰色_「我想和你一起睡……」"
CALL PRINT_STRW, @"「あっ_／／／_」"	CALL PRINT_STRW, @"「啊_／／／_」"
CALL PRINT_STRW, @"「き、聞こえてたのです……？_／／／_」"	CALL PRINT_STRW, @"「听、听到了……？_／／／_」"
CALL PRINT_STRW, @"「うぅ～……_／／／_」"	CALL PRINT_STRW, @"「呜～……_／／／_」"
CALL PRINT_STRW, @"暗灰色_「ありがとです……」"	CALL PRINT_STRW, @"暗灰色_「谢谢……」"
PRINTFORMW 聞こえないふりをして%CALLNAME:MASTER%はそのまま寝た。	PRINTFORMW %CALLNAME:MASTER%装作没听到的样子睡过去了。
PRINTFORMW 「はい。%CNAME("二人称")%さん、おやすみです」	PRINTFORMW 「好。%CNAME("二人称")%、晚安」
CALL PRINT_STRW, @"「いっしょに寝たいです……_／／／_」"	CALL PRINT_STRW, @"「我想和你一起睡……_／／／_」"
PRINTFORMW 「えへへ～やったですっ！」	PRINTFORMW 「欸嘿嘿～好欸！」
CALL PRINT_STRW, @"「ぎゅー！あったかいです_／／／_」"	CALL PRINT_STRW, @"「啾ー！好温暖_／／／_」"
PRINTFORMW 「ほんとはいっしょに寝るだけで良かったのに……」	PRINTFORMW 「本来是只要一起睡觉就觉得很好了……」
CALL PRINT_STRW, @"「ちょっと我慢できなさそうです…_HH_」"	CALL PRINT_STRW, @"「但是已经忍不住了…_HH_」"
PRINTFORMW 「むぅ～、しかたないです」	PRINTFORMW 「姆～、没办法」
PRINTFORMW 「今日はひとりで寝ます」	PRINTFORMW 「今天就一个人睡了」
PRINTFORMW 「おやすみです」	PRINTFORMW 「晚安」
PRINTFORMW 「あれっ？もうねるのです？」	PRINTFORMW 「啊嘞？已经要睡了吗？」
PRINTFORMW 「ふーん……」	PRINTFORMW 「哼ー……」
PRINTFORMW 「お昼寝ですか？」	PRINTFORMW 「午睡吗？」
PRINTFORMW 「よいしょ…、ん？なんで腕をもってるかですか？」	PRINTFORMW 「嘿咻…、嗯？为什么抱着手睡觉啊？」
PRINTFORMW 「%CNAME("一人称")%もよこで寝るからです！」	PRINTFORMW 「%CNAME("一人称")%要在你怀里睡！」
PRINTFORMW 「じゃあ%CNAME("一人称")%はお勉強でもしてますね」	PRINTFORMW 「那%CNAME("一人称")%就学习一会好了」
PRINTFORMW 「じゃあ%CNAME("一人称")%はお掃除とかしてきますね」	PRINTFORMW 「那%CNAME("一人称")%打扫一会好了」
PRINTFORMW 「じゃあ腕かして下さい！」	PRINTFORMW 「那先摸摸头！」
PRINTFORMW 「えへへ～♪あったかいです！」	PRINTFORMW 「欸嘿嘿～♪好温暖！」
PRINTFORMW 「おひるねですか？」	PRINTFORMW 「午睡吗？」
PRINTFORMW 「%TEXTR("おひさまがぽかぽかですからねー/あめがふってますからねー")%」	PRINTFORMW 「%TEXTR("太阳暖洋洋的呢ー/绵绵细雨呢ー")%」
PRINTFORMW 「休憩するのです？」	PRINTFORMW 「要休息吗？」
PRINTFORMW 「お疲れ様です！」	PRINTFORMW 「辛苦了！」
PRINTFORMW 「午後の講義までよこになるのです？」	PRINTFORMW 「下午的课不去了吗？」
CALL PRINT_STRW, @"「じゃ、じゃあ%CNAME("一人称")%のお膝を使ってください_／／／_」"	CALL PRINT_STRW, @"「那、睡在%CNAME("一人称")%膝上吧_／／／_」"
CALL PRINT_STRW, @"「ぼ、%CNAME("一人称")%は時間までお勉強でうごきませんし……_／／／_」"	CALL PRINT_STRW, @"「我、%CNAME("一人称")%就学习一会好了……_／／／_」"
PRINTFORMW 「あっ……、……♪」	PRINTFORMW 「啊……、……♪」
PRINTFORMW 「んみゅ？午後の講義までよこになる？」	PRINTFORMW 「嗯喵？下午的课不去了？」
PRINTFORMW 「でしたら、%CNAME("一人称")%のお膝使ってください！」	PRINTFORMW 「那么、睡在%CNAME("一人称")%的膝上吧！」
PRINTFORMW 「きゅうけいですか？」	PRINTFORMW 「休息吗？」
PRINTFORMW 「おつかれなんですね！」	PRINTFORMW 「辛苦了！」
PRINTFORMW 「わーい！%CNAME("二人称")%さんにほめられました！」	PRINTFORMW 「哇ー咿！被%CNAME("二人称")%表扬了！」
PRINTFORMW 「よく分かりませんが！やったーです！」	PRINTFORMW 「虽然不知道什么情况！但是好欸！」
PRINTFORMW 「あれっ？%CNAME("一人称")%なにかほめられるようなことしました？」	PRINTFORMW 「啊嘞？%CNAME("一人称")%做了什么值得夸奖的事情了吗？」
PRINTFORMW 「……でも、ほめられて嬉しいです！」	PRINTFORMW 「……不过、被夸奖还是好高兴！」
PRINTFORMW 「%CNAME("一人称")%がなにかできたと思いませんが」	PRINTFORMW 「%CNAME("一人称")%不记得我做了什么值得一夸的事情来着」
CALL PRINT_STRW, @"「ほめてもらって嬉しいです_／／／_」"	CALL PRINT_STRW, @"「被表扬真的好高兴_／／／_」"
PRINTFORMW 「……%CNAME("一人称")%、なにか%CNAME("二人称")%さんに出来ましたか？」	PRINTFORMW 「……%CNAME("一人称")%、为%CNAME("二人称")%做了什么了吗？」
PRINTFORMW 「でしたら、良かったです……」	PRINTFORMW 「这样啊、那就好……」
PRINTFORMW 「えへへ♪」	PRINTFORMW 「欸嘿嘿♪」
PRINTFORMW 「%CNAME("二人称")%さんにほめられると、とっても嬉しいです！」	PRINTFORMW 「被%CNAME("二人称")%夸奖、非常的开心！」
PRINTFORMW 「%CNAME("一人称")%はほめられるような人じゃないです……」	PRINTFORMW 「%CNAME("一人称")%不是那种有资格被表扬的人……」
PRINTFORMW 「でも……。それでも……、ほめてくれて嬉しいですっ」	PRINTFORMW 「但是……。即便是这样……、被表扬也真的好高兴」
CALL PRINT_STRW, @"暗灰色_「……%CNAME("一人称")%、なにもほめられるようなことしてないです……」"	CALL PRINT_STRW, @"暗灰色_「……%CNAME("一人称")%、完全没有做过什么值得一夸的事情……」"
PRINTFORMW 「えへへ～♪よくわかりませんがうれしいです！」	PRINTFORMW 「欸嘿嘿～♪虽然不怎么明白发生了什么、但是好开心！」
PRINTFORMW 「んー？なにか%CNAME("一人称")%ほめられることしました？」	PRINTFORMW 「嗯ー？%CNAME("一人称")%做了什么值得夸奖的事情了吗？」
PRINTFORMW 「%CNAME("一人称")%も大好きですよ！」	PRINTFORMW 「我也最喜欢%CNAME("一人称")%！」
PRINTFORMW %CALLNAME:TARGET%はその言葉の勢いのまま%CALLNAME:MASTER%に抱きついてきた。	PRINTFORMW %CALLNAME:TARGET%乘势抱住了%CALLNAME:MASTER%。
PRINTFORMW 「はい！%CNAME("一人称")%も%CNAME("二人称")%さんの事を愛してますよ！」	PRINTFORMW 「嗯！%CNAME("一人称")%也爱着%CNAME("二人称")%哦！」
PRINTFORMW %CALLNAME:TARGET%はそう言うと%CALLNAME:MASTER%に抱きつき胸にうずめて咲っている。	PRINTFORMW %CALLNAME:TARGET%开心的抱住了%CALLNAME:MASTER%。
PRINTFORMW 「愛してます！」	PRINTFORMW 「我爱你！」
CALL PRINT_STRL, @"「%CNAME("一人称")%も、あ、愛してます_／／／_」"	CALL PRINT_STRL, @"「%CNAME("一人称")%也、爱、爱你_／／／_」"
PRINTFORMW 顔を真っ赤にしながらも見つめ返して微笑んで%CALLNAME:TARGET%は%CALLNAME:MASTER%に愛を返した。	PRINTFORMW 虽然她的脸飘满了红霞、但是还是高兴的回复了%CALLNAME:MASTER%。
PRINTFORMW 「ありがとうです……」	PRINTFORMW 「谢谢……」
CALL PRINT_STRW, @"「%CNAME("一人称")%、その言葉を%CNAME("二人称")%さんに言われて一番嬉しいです_／／／_」"	CALL PRINT_STRW, @"「%CNAME("二人称")%能对%CNAME("一人称")%说这番话、真的好开心_／／／_」"
PRINTFORMW %CALLNAME:TARGET%は咲い%CALLNAME:MASTER%の手を握った。	PRINTFORMW %CALLNAME:TARGET%开心的握住了%CALLNAME:MASTER%的手。
PRINTFORMW 「%CNAME("一人称")%は、まだなにも返せてませんけど……」	PRINTFORMW 「%CNAME("一人称")%、虽然还没有办法报答什么……」
PRINTFORMW 「そんな%CNAME("一人称")%を大切にしてくれてありがとうです…」	PRINTFORMW 「但是、最重要的%CNAME("一人称")%能说出这样的话、真的谢谢…」
CALL PRINT_STRW, @"「愛してます_／／／_」"	CALL PRINT_STRW, @"「我爱你_／／／_」"
PRINTFORMW 「そんな言葉しか%CNAME("一人称")%は返せないですけど、そばに居させてください……」	PRINTFORMW 「我能做的、只有对%CNAME("一人称")%说出这一番话、请让我在你的身边吧……」
PRINTFORMW そう言って%CALLNAME:TARGET%は%CALLNAME:MASTER%の手を取り咲った。	PRINTFORMW 说着、%CALLNAME:TARGET%开心的握住了%CALLNAME:MASTER%的手。
PRINTFORMW 「愛ってむずしいですね……」	PRINTFORMW 「爱真是难啊……」
PRINTFORMW 「あっ違うですっ！」	PRINTFORMW 「啊不是那个意思！」
PRINTFORMW 「%CALLNAME:MASTER%さんに愛されている事をうたがっている訳じゃないです！」	PRINTFORMW 「不是说我不爱%CALLNAME:MASTER%！」
PRINTFORMW 「でも、%CNAME("一人称")%はもらってばっかりで」	PRINTFORMW 「只是、%CNAME("一人称")%只是在不断的被宠爱着」
PRINTFORMW そう言って%CALLNAME:TARGET%は%CALLNAME:MASTER%の手を取った。	PRINTFORMW %CALLNAME:TARGET%握住%CALLNAME:MASTER%的手。
PRINTFORMW 「%CNAME("一人称")%にできるのは%CNAME("二人称")%さんの手をこうやってする位しかできないです……」	PRINTFORMW 「%CNAME("一人称")%能做的、只有这样握紧%CNAME("二人称")%的手……」
PRINTFORMW 優しく、やさしく%CALLNAME:MASTER%の手を握った。	PRINTFORMW 温柔的、温馨的握住%CALLNAME:MASTER%的手。
PRINTFORMW 「ごめんなさい……嬉しい、ですが……」	PRINTFORMW 「对不起……明明、很开心……」
PRINTFORMW 「少し今は受け入れられないですっ……！」	PRINTFORMW 「但是总感觉有点奇怪的不能接受……！」
PRINTFORMW 俯いていて表情が見えない。	PRINTFORMW 她低着头看不到表情。
PRINTFORMW だから、	PRINTFORMW 所以、
CALL PRINT_SELECT, "頭を撫でる/何もしない"	CALL PRINT_SELECT, "摸头/什么都不做"
PRINTFORMW 「ごめっ、ごめんなさい……」	PRINTFORMW 「对不、对不起……」
PRINTFORMW 「%CNAME("一人称")%っ、%CNAME("一人称")%はっ……」	PRINTFORMW 「%CNAME("一人称")%、%CNAME("一人称")%……」
PRINTFORMW 何かの雫が落ちる音がするが%CALLNAME:MASTER%は上を見ているから何か分からない。	PRINTFORMW 听到了水滴落下的声音、但是%CALLNAME:MASTER%不知道那是什么。
PRINTFORMW 何も知らない。	PRINTFORMW 什么都不知道。
PRINTFORMW すっと撫でようとした手を戻す。	PRINTFORMW 伸出去的手收了回来。
PRINTFORMW そのまま自分の手を握り締める。	PRINTFORMW 然后什么都不做。
PRINTFORMW 「……はい」	PRINTFORMW 「……是」
PRINTFORMW 「%CNAME("一人称")%もきらいじゃないです」	PRINTFORMW 「%CNAME("一人称")%也不讨厌」
PRINTFORMW そう言う%CALLNAME:TARGET%の瞳は少し揺らいでいる。	PRINTFORMW %CALLNAME:TARGET%的眼神摇摆不定。
PRINTFORMW 「%CNAME("一人称")%もきらいじゃないですよ！」	PRINTFORMW 「%CNAME("一人称")%也不讨厌哦！」
PRINTFORMW そう%CALLNAME:TARGET%は言っているが意味を理解できてるのだろうか？	PRINTFORMW %CALLNAME:TARGET%真的理解意思了吗？
PRINTFORMW %CALLNAME:TARGET%は全く意味が理解できていないようだ……	PRINTFORMW %CALLNAME:TARGET%完全没有理解的样子……
PRINTFORMW 「%CNAME("二人称")%さん！見てください！」	PRINTFORMW 「%CNAME("二人称")%！看这个！」
PRINTFORMW そう言うと%CALLNAME:TARGET%はすらりとナイフを取り出した。	PRINTFORMW %CALLNAME:TARGET%抽出了一把匕首。
PRINTFORMW 「%TEXTR("お風呂場で/台所で/部屋で")%ピッカピッカに研ぎました！」	PRINTFORMW 「在%TEXTR("浴场/厨房/房间")%里好好的研磨过了！」
PRINTFORMW とてもきれいですねと%CALLNAME:MASTER%は真顔で答える。	PRINTFORMW %CALLNAME:MASTER%认真的回答、真是漂亮啊。
PRINTFORMW ………最近家の刃物がやけに綺麗に研がれているのは%CALLNAME:TARGET%の所為だろうか？	PRINTFORMW ………说起来最近家里的刀具都被磨的莫名的漂亮原来是%CALLNAME:TARGET%干的吗？
PRINTFORMW 「%TEXTR("あがっふろむへー♪ふぁいんでっと♪はうんでっいっと♪/あがっとゅぁろん♪すたんでっと♪びぃてっと♪/だいぶ♪ぶりーど♪いえろー♪すろーあだいす♪/ぶりーでぃんまいへっどとぅくろざー♪")%」	PRINTFORMW 「%TEXTR("I've got from hell♪ find it♪ hound it♪/I've got to you alone♪ stand it♪ beat it♪/Drive♪Bleed♪Yellow♪Throw a dice♪/Bleed in my hand to closer♪")%」
PRINTFORMW 大変楽しそうに歌っているが歌詞の意味が物騒だ。	PRINTFORMW 开心的在那唱着歌。
PRINTFORMW 「あっ！%CALLNAME:MASTER%さんお勉強しませんか！」	PRINTFORMW 「啊！%CALLNAME:MASTER%要一起学习吗！」
PRINTFORMW そう言って%CALLNAME:TARGET%は%CALLNAME:MASTER%の隣に座って教科書を広げる。	PRINTFORMW 说完、%CALLNAME:TARGET%走了过来坐在%CALLNAME:MASTER%旁边打开教科书。
PRINTFORMW 「じー」	PRINTFORMW 「盯ー」
PRINTFORMW が、教科書を全く見ずに%CALLNAME:MASTER%の事しか見ない。	PRINTFORMW 然而、完全没有看教科书一眼全程盯着%CALLNAME:MASTER%看。
PRINTFORMW 「んふっふっふっふ～実はお勉強はこうじつで%CNAME("二人称")%さんに近づきたかったのです！」	PRINTFORMW 「恩呼呼呼呼～实际上学习只是为了接近%CNAME("二人称")%的幌子啦！」
PRINTFORMW 反応を許さない速度で%CALLNAME:TARGET%は%CALLNAME:MASTER%に抱きついた。	PRINTFORMW %CALLNAME:TARGET%用完全反应不过来的速度抱住了%CALLNAME:MASTER%。
PRINTFORMW 「最近クラスの子に化粧を教えてもらったのです」	PRINTFORMW 「最近班上的同学教我怎么化妆」
PRINTFORMW そう言って貰ったのか化粧道具を見せてきた。	PRINTFORMW 然后拿出了化妆用品。
CALL PRINT_STRW, @"「その、えっと、%CNAME("一人称")%化粧したほうが、いいですか……？_／／／_」"	CALL PRINT_STRW, @"「那个、嗯、%CNAME("一人称")%是不是化妆之后、比较好……？_／／／_」"
PRINTFORMW 少し考えた後に今のままで良いと返した。	PRINTFORMW 稍微考虑了一下告诉她保持现在这样就好。
PRINTFORMW 努力してるの気持ちは嬉しいと。	PRINTFORMW 虽然知道她很努力的心情。
CALL PRINT_STRW, @"暗灰色_「あっ、ありがとうです_／／／_暗灰色_」"	CALL PRINT_STRW, @"暗灰色_「啊、谢谢_／／／_暗灰色_」"
PRINTFORMW 「このあいだクラスの%TEXTR("鈴木さん/田中さん/佐藤さん/伊藤さん/後藤さん/吉田さん")%が休み時間に%TEXTR("きゅうにほうきでエアギターしてのですよ/へんな顔してカバディし始めたのですよ/へんな声で漫才を始めたのですよ")%」	PRINTFORMW 「这之前在班里的%TEXTR("鈴木同学/田中同学/佐藤同学/伊藤同学/後藤同学/吉田同学")%在休息时候%TEXTR("用扫帚弹空气吉他/做出夸张的表情玩卡巴迪/用奇怪的声调说相声")%」
PRINTFORMW 楽しそうなクラスだと思うが、%CALLNAME:TARGET%の教育にはたして良い学級なのだろうか？と疑問が出るが。	PRINTFORMW 看起来是很好的班级的样子、等等、这样的话对%CALLNAME:TARGET%来说这样的班级真的好吗？这样的疑问冒了出来。
PRINTFORMW そもそも、%CALLNAME:MASTER%自身が教育に良くないと思い直した。	PRINTFORMW 说到底、%CALLNAME:MASTER%自己本身就是个学渣。
PRINTFORMW 「んー……」	PRINTFORMW 「嗯ー……」
PRINTFORMW 自主勉強していた%CALLNAME:TARGET%は疲れたのか軽く伸びをして横に居た%CALLNAME:MASTER%にぽすっと、もたれかかった。	PRINTFORMW %CALLNAME:TARGET%也许是学习太累了伸了伸懒腰扑通一声靠在%CALLNAME:MASTER%身上。
CALL PRINT_STRW, @"「つかれちゃったので、肩かして欲しいです_／／／_」"	CALL PRINT_STRW, @"「好累、肩膀借我靠会_／／／_」"
PRINTFORMW 労う様に%CALLNAME:TARGET%の頭を撫でてやる。	PRINTFORMW 辛苦了、%CALLNAME:TARGET%摸了摸她的头。
CALL PRINT_STRW, @"「えへへ_／／／_ありがとうです_／／／_」"	CALL PRINT_STRW, @"「欸嘿嘿_／／／_谢谢_／／／_」"
PRINTFORMW 「知らないことを知るって楽しいですね！」	PRINTFORMW 「学习到新的知识总感觉很有趣！」
PRINTFORMW そう言ってこの間買った%TEXTR("図鑑/教科書/辞書/絵本/小説/料理本/雑誌")%を見せてきた。	PRINTFORMW 这样说着打开了之前买的%TEXTR("图鉴/教科书/辞典/绘画书/小说/料理书/杂志")%看了起来。
PRINTFORMW 「楽しくて、いっぱい読んじゃいます！」	PRINTFORMW 「因为很有趣、所以在读各种各样的书！」
PRINTFORMW 楽しそうで何よりだと、%CALLNAME:MASTER%は若干薄くなった財布をちらりと見てから頭を撫でてやる。	PRINTFORMW 开心比什么都好、%CALLNAME:MASTER%看了看自己干瘪的钱包然后摸了摸她的头。
PRINTFORMW 「こうやって話すって大事ですね」	PRINTFORMW 「这样在一起说话真棒啊」
PRINTFORMW 会話が途切れた時に%CALLNAME:TARGET%がそう切り出す。	PRINTFORMW %CALLNAME:TARGET%突然这样说。
PRINTFORMW 「なやんでいたことを話せば、答えがでなくても少しはすすめるのですから」	PRINTFORMW 「如果我说想放弃了、就算没有答案也会说出一个来」
PRINTFORMW 「%CNAME("一人称")%はまだまだ知ってない事が多いです」	PRINTFORMW 「%CNAME("一人称")%不知道的事情还有很多」
PRINTFORMW 言葉を区切り、近づいてきて%CALLNAME:MASTER%の耳元で囁く。	PRINTFORMW 她顿了顿、凑近%CALLNAME:MASTER%的耳边喃喃。
CALL PRINT_STRW, @"暗灰色_「%CNAME("一人称")%にいろいろ教えてください……_HH_暗灰色_」"	CALL PRINT_STRW, @"暗灰色_「再多教%CNAME("一人称")%各种各样的事情吧……_HH_暗灰色_」"
PRINTFORMW 「ぐて～」	PRINTFORMW 「咕～」
PRINTFORMW そう言いながら%CALLNAME:MASTER%に身体をもたれかけてきた。	PRINTFORMW 一边发出声音一边把身子靠在%CALLNAME:MASTER%身上。
PRINTFORMW 「えへへ♪%CNAME("二人称")%さんはあったかいですね♪」	PRINTFORMW 「欸嘿嘿♪%CNAME("二人称")%的身体好暖和♪」
PRINTFORMW %TEXTR(@"膝に座って%CALLNAME:MASTER%の身体に、もたれかけた/横に座って%CALLNAME:MASTER%の肩に、もたれかけた/%CALLNAME:MASTER%の膝に寝転んだ/")%%CALLNAME:TARGET%はゆったりとしている。	PRINTFORMW %CALLNAME:TARGET%%TEXTR(@"坐在%CALLNAME:MASTER%膝上的时候、倚在%CALLNAME:MASTER%身上/坐在%CALLNAME:MASTER%身旁的时候、靠在%CALLNAME:MASTER%肩膀上/靠在%CALLNAME:MASTER%的膝上闭上了眼睛/")%悠闲的放松。
PRINTFORMW 会話は無くても気持ちの良い時間はあると思う。	PRINTFORMW 虽然没有对话但是这段时间也充满了温馨。
PRINTFORMW 「%TEXTR("でーいあふたーでい…しーんがろーりぐおん……/すかぁり……すかぁり……すかぁり……そーあい、すかぁり……/れてぃご…ぁろんど…ざ…こすもす……おーばーざ…ぺーえん……")%」	PRINTFORMW 「%TEXTR("Day After Day…things are rolling on……/scary……scary……scary……so I'm scary……/Let it go…around…the…cosmos……Over the…pain……")%」
PRINTFORMW 歌を口遊んでいるが前みたいに楽しそうにではなく何かを想いながら歌っている。	PRINTFORMW 虽然嘴里唱着歌、但是没有以前那样开心了、似乎是有什么心事。
PRINTFORMW けれど、何も聞かない。	PRINTFORMW 但是、没办法去开口问她。
PRINTFORMW 何時もなら今日あった事を楽しそうに話している筈だが最近%CALLNAME:TARGET%は静かだ。	PRINTFORMW 平时的话应该会很开心的说着自己的事情、但是最近%CALLNAME:TARGET%一直很沉默。
PRINTFORMW 虚空を見つめてると思ったら、偶に%CALLNAME:MASTER%の事を見つめている事もある。	PRINTFORMW 经常发呆、或者盯着%CALLNAME:MASTER%发呆。
PRINTFORMW 何か悩んでいるみたいだが、言ってこないと言う事はまだ手を差し伸べる時じゃないのだろう。	PRINTFORMW 虽然似乎在烦恼着什么、但是不说的话还是没办法去帮她。
PRINTFORMW %CALLNAME:TARGET%は自主勉強しているみたいだが教科書とは違う所を見つめている。	PRINTFORMW %CALLNAME:TARGET%手里拿着教科书、但是却看着别的地方。
PRINTFORMW どうかしたのかと尋ねる。	PRINTFORMW 怎么了吗。
PRINTFORMW 「………あっ！はい！なんですか？」	PRINTFORMW 「………啊！是！怎么了吗？」
PRINTFORMW 呆っとしてるみたいだが体調が悪いのかと聞いた。	PRINTFORMW 是不是身体不舒服。
PRINTFORMW 「いえっ……！そんなことっ……そんなこと……ない、ですよ……」	PRINTFORMW 「不……！没有……那种……事、哦……」
PRINTFORMW ………そうか。	PRINTFORMW ………这样啊。
PRINTFORMW 「%TEXTR("あがっふろむへー♪ふぁいんでっと♪はうんでっいっと♪/れてぃごっぁろんどっざっこすもすおーばーざっぺーえん♪/とぅぎーぶされんだーまいそーるわーんだりー♪/あいむしんかーあいきゃんぶれいくっだっん♪")%」	PRINTFORMW 「%TEXTR("I've got from hell♪ find it♪ hound it♪/Let it go around the cosmos Over the pain♪/To give surrender, my soul is wandering♪/I'm a thinker, I could break it down♪")%」
PRINTFORMW %CALLNAME:TARGET%は上機嫌に何かの歌を歌っている様だ。	PRINTFORMW %CALLNAME:TARGET%似乎很开心的在唱着歌的样子。
PRINTFORMW 「あっうるさかったですか……？」	PRINTFORMW 「啊、很吵吗……？」
PRINTFORMW 「クラスの冨路牟さんにおしえてもらった歌が気に入りましたので歌ってました……ごめんなさい……」	PRINTFORMW 「班上的富路牟老师教的歌、挺中意就唱了、对不起……」
PRINTFORMW 「クラスの%TEXTR("鈴木さん/田中さん/佐藤さん/伊藤さん/後藤さん/吉田さん")%とこんな話をしたのです！」	PRINTFORMW 「班上的%TEXTR("鈴木同学/田中同学/佐藤同学/伊藤同学/後藤同学/吉田同学")%和我说了这样的话！」
PRINTFORMW そうクラスメイトと話した事をとても楽しそうに笑いながら%CALLNAME:TARGET%は話している。	PRINTFORMW 然后%CALLNAME:TARGET%兴致高昂的说了班上的趣事。
PRINTFORMW 「うにゅ～、お勉強はむずかしいです……」	PRINTFORMW 「唔喵～、学习好难……」
PRINTFORMW 「あっ！%CNAME("二人称")%さん！ここ教えてください！」	PRINTFORMW 「啊！%CNAME("二人称")%！这里教教我！」
PRINTFORMW そう言って%CALLNAME:TARGET%は教科書を見せてくる。	PRINTFORMW %CALLNAME:TARGET%一边说着一边把教科书递了过来。
PRINTFORMW 中等部の範囲だから%CALLNAME:MASTER%は教えることが出来ると思い教え始めた。	PRINTFORMW 初中范围的话%CALLNAME:MASTER%还是能教的就开始帮她了。
PRINTFORMW 「おぉー！なるほどです！」	PRINTFORMW 「哦ー！原来如此！」
PRINTFORMW 理解できたからか%CALLNAME:TARGET%は答えを書き始めた。	PRINTFORMW 理解了意思的%CALLNAME:TARGET%开始奋笔疾书。
PRINTFORMW 「わーい！ありがとうです！」	PRINTFORMW 「哇ー咿！谢谢！」
PRINTFORMW うっかり問題を解いてしまった……	PRINTFORMW 感觉还没出力就把问题解决了……
PRINTFORMW 「なにもすることがないときはどうしていた？ですか？」	PRINTFORMW 「闲暇的时候做什么？」
PRINTFORMW 「んーっと、いろいろなところをあるいてました！」	PRINTFORMW 「嗯ー、走到各种各样的地方！」
PRINTFORMW 「けいさつさんにみつかるとおいかけられるので、」	PRINTFORMW 「因为要是被警察发现的话就会有点麻烦所以、」
PRINTFORMW 「おいかけっこはたのしかったですけど、けいさつさんはきらいです！」	PRINTFORMW 「虽然喜欢到处跑、但是不喜欢警察！」
PRINTFORMW 「んー？どういうときに人を殺すか？ですか？」	PRINTFORMW 「嗯ー？什么时候会杀人？」
PRINTFORMW 「えーと、さみしくなったときに殺してます！」	PRINTFORMW 「嗯ー、寂寞的时候会杀！」
PRINTFORMW 「いまは%CNAME("二人称")%さんを殺せるのでさみしくないです！」	PRINTFORMW 「现在因为能杀%CNAME("二人称")%所以不寂寞了！」
PRINTFORMW 「ここにくるまでなにをしてたかです？」	PRINTFORMW 「相遇之前在哪里做什么？」
PRINTFORMW 「んーと、はしのしたでくらしてました！」	PRINTFORMW 「嗯ー、在桥底下生活！」
PRINTFORMW 「ごはんはこんびに？のうらに、おいてあるやつをたべてました！」	PRINTFORMW 「饭的话、在便利店后面的东西、虽然不知道是什么但是一直吃的那个！」
PRINTFORMW 「たまにおいしくないのをたべると、おなかがいたい、いたいなります……」	PRINTFORMW 「偶尔吃了有点难吃的之后、肚子就会很痛、很痛……」
PRINTFORMW 「いまはおいしいごはんをたべれてうれしいです！」	PRINTFORMW 「所以现在能吃香喷喷的饭菜很高兴！」
PRINTFORMW 「%CNAME("二人称")%さんのお膝はあったかいですね！」	PRINTFORMW 「%CNAME("二人称")%的膝盖好温暖！」
PRINTFORMW %CALLNAME:TARGET%は%CALLNAME:MASTER%を見上げて、とても良い顔で咲う。	PRINTFORMW %CALLNAME:TARGET%抬头微笑的看着%CALLNAME:MASTER%。
PRINTFORMW 「ん～、………！」	PRINTFORMW 「嗯～、………！」
PRINTFORMW 何かを思いついた顔をした%CALLNAME:TARGET%はごろんと%CALLNAME:MASTER%の側に寝返りをうった。	PRINTFORMW 似乎思考着什么的%CALLNAME:TARGET%翻了个身。
PRINTFORMW 「じ～」	PRINTFORMW 「盯～」
PRINTFORMW そして、熱心に%CALLNAME:MASTER%の股間を見つめている。	PRINTFORMW 然后、充满欲望的看着%CALLNAME:MASTER%的股间。
CALL PRINT_STRW, @"「あったかいですね……_／／／_」"	CALL PRINT_STRW, @"「好温暖呐……_／／／_」"
PRINTFORMW %CALLNAME:MASTER%の膝から伝わる温かな熱に%CALLNAME:TARGET%は朗らかにゆったりと咲う。	PRINTFORMW %CALLNAME:MASTER%开心的躺着。
PRINTFORMW ごろんと不意に%CALLNAME:MASTER%の側に寝返りをうった。	PRINTFORMW 突然翻了个身。
CALL PRINT_STRW, @"「あっ……_／／／_」"	CALL PRINT_STRW, @"「啊……_／／／_」"
PRINTFORMW そして、何かに気が付いたのか顔を赤らめている。	PRINTFORMW 然后、似乎看到什么脸色变得通红。
PRINTFORMW 瞳の先は%CALLNAME:MASTER%の股間。	PRINTFORMW 视线看着%CALLNAME:MASTER%的股间。
CALL PRINT_STRW, @"「………！な、なにも見てないです、よ……？_／／／_」"	CALL PRINT_STRW, @"「………！什、什么都没看到、哦……？_／／／_」"
PRINTFORMW 「………安心します」	PRINTFORMW 「………好温馨」
PRINTFORMW %CALLNAME:MASTER%の膝で横になっている%CALLNAME:TARGET%の髪を梳かすように撫でてやる。	PRINTFORMW %CALLNAME:MASTER%抚摸着睡在自己膝上的%CALLNAME:TARGET%的秀发。
PRINTFORMW 「あははっ♪」	PRINTFORMW 「啊哈哈♪」
PRINTFORMW そう咲いながら%CALLNAME:MASTER%の手にじゃれつく様にしている。	PRINTFORMW 一边笑着一边戳着%CALLNAME:MASTER%的手。
CALL PRINT_STRW, @"「あっ……_HH_」"	CALL PRINT_STRW, @"「啊……_HH_」"
PRINTFORMW 不意に%CALLNAME:TARGET%の瞳が%CALLNAME:MASTER%の股間を捉えた。	PRINTFORMW 突然看到%CALLNAME:TARGET%的视线一直盯着%CALLNAME:MASTER%的股间。
PRINTFORMW 辺りを見て誰も居ないの確認してから、	PRINTFORMW 看了看周围确认没有人之后、
PRINTFORMW 何も言わずに%CALLNAME:MASTER%のズボンをずらして、%CALLNAME:MASTER%のソレをさらけ出させた。	PRINTFORMW 什么也没说的脱下了%CALLNAME:MASTER%裤子、%CALLNAME:MASTER%的肉棒暴露在她的面前。
PRINTFORMW 股間のジッパーを器用に口だけで下ろして、%CALLNAME:MASTER%のソレをさらけ出させた。	PRINTFORMW 灵巧的用嘴吧裤链拉下来、让%CALLNAME:MASTER%的肉棒暴露在了她的面前。
CALL PRINT_STRW,@"「ん、ちゅ……_HH_んあ……_HH_ちゅぱっ…_HH_れろ……_HH_」"	CALL PRINT_STRW,@"「嗯、啾……_HH_嗯啊……_HH_啾噗…_HH_吸溜……_HH_」"
PRINTFORMW そんなつもりのない%CALLNAME:MASTER%のソレを舐めて大きくさせた。	PRINTFORMW 虽然没有那个想法的%CALLNAME:MASTER%的肉棒在舔舐之下也开始勃起。
CALL PRINT_STRW,@"「うふふっ、おっきくなっちゃいました、ね……_HH_」"	CALL PRINT_STRW,@"「呜呼呼、变大了啊、呐……_HH_」"
PRINTFORMW 誘う様に%CALLNAME:MASTER%を蕩けた赫い瞳が見つめてくる。	PRINTFORMW 她用诱惑的的猩红赤瞳看着%CALLNAME:MASTER%。
CALL PRINT_STRW,@"「続き、シていいです、か……？_／／／_」"	CALL PRINT_STRW,@"「继续、可以、吗……？_／／／_」"
CALL PRINT_SELECT, "はい/いいえ"	CALL PRINT_SELECT, "好呀/不行"
CALL PRINT_STRW,@"「えへへ～♪じゃあ、続きシますね_HH_」"	CALL PRINT_STRW,@"「欸嘿嘿～♪那、就继续了_HH_」"
CALL PRINT_STRW,@"「あーむっ_HH_ちゅるっ、ちゅぷっ_HH_くちゅっ、くちゃっ_HH_んっ……_HH_はむっ_HH_んちゅぅっ_HH_」"	CALL PRINT_STRW,@"「啊ー姆_HH_啾噜、啾噗_HH_咕啾、咕啾_HH_嗯……_HH_哈姆_HH_嗯啾_HH_」"
PRINTFORMW %CALLNAME:TARGET%は熱心に%CALLNAME:MASTER%のを咥えて刺激してくる。	PRINTFORMW %CALLNAME:TARGET%热情的舔弄给与了%CALLNAME:MASTER%大量的刺激。
CALL PRINT_STRW,@"「んちゅっ、ちゅぱっ_HH_……んんっ_HH_ちゅぷっ、ちゅぱっ_HH_じゅっ、じゅるっ_HH_ちゅぱっ、ちゅぱっ_HH_」"	CALL PRINT_STRW,@"「嗯啾、啾噗_HH_……嗯嗯_HH_啾噗、啾噗_HH_啾、啾噜_HH_啾噗、啾噗_HH_」"
CALL PRINT_STRW,@"「じゅむっ_HH_んんっ_HH_んんんぅっ_HH__HH__HH_」"	CALL PRINT_STRW,@"「啾姆_HH_嗯嗯_HH_嗯嗯嗯_HH__HH__HH_」"
PRINTFORMW そして、迸る快楽が尿道を通り抜けて%CALLNAME:TARGET%の口の中に解き放たれる。	PRINTFORMW 然后、迸发的快感从尿道通过、在%CALLNAME:TARGET%口中释放出来。
CALL PRINT_STRW,@"「んんっ……_HH_んっ……、はぁっ_HH_んっ、くっ……_HH_んっ、んっ……_HH_」"	CALL PRINT_STRW,@"「嗯嗯……_HH_嗯……、哈啊_HH_嗯、咕……_HH_嗯、嗯……_HH_」"
CALL PRINT_STRW,@"「んくっ、ごくっ……_HH_んっ、ごくっ……_HH_んっ、んく、んくっ……_HH_ごきゅっ_HH_」"	CALL PRINT_STRW,@"「嗯咕、咕……_HH_嗯、咕……_HH_嗯、嗯、嗯姆……_HH_咕_HH_」"
PRINTFORMW %CALLNAME:MASTER%から大量に解き放たれたモノを%CALLNAME:TARGET%は頑張って飲み込んだ。	PRINTFORMW %CALLNAME:MASTER%大量的精液被%CALLNAME:TARGET%努力的全部吞咽下去。
CALL PRINT_STRW,@"「はぁっ……_HH_はぁ、はぁ……_HH_んんっ……_HH_はぁ……_HH_はぁ……_HH_はぁ……_HH_はぁ……_HH_」"	CALL PRINT_STRW,@"「哈啊……_HH_哈啊、哈……_HH_嗯嗯……_HH_哈啊……_HH_哈啊……_HH_哈啊……_HH_哈啊……_HH_」"
PRINTFORMW 飲み込むことに必死だったからか%CALLNAME:TARGET%は酸素が不足して瞳は虚空を見つめている。	PRINTFORMW 因为拼命的想要全部吞下、逐渐缺氧的%CALLNAME:TARGET%露出了阿嘿颜的眼神。
PRINTFORMW その瞳は見方によっては蕩けているモノだった。	PRINTFORMW 看到这个表情的%CALLNAME:MASTER%更加的兴奋了。
PRINTFORMW 「えへへ～♪ちゃんと全部飲みましけふっ」	PRINTFORMW 「欸嘿嘿～♪全部都喝下去了」
PRINTFORMW 咲って褒めて欲しそうにした%CALLNAME:TARGET%だが、言葉の途中でげっぷをしてしまった。	PRINTFORMW 正在索求夸奖的%CALLNAME:TARGET%、话说到一半突然停了下来。
CALL PRINT_STRW,@"ハートピンク_「っっっっっっ～～～～～～～～～～～～_／／／_ハートピンク_」"	CALL PRINT_STRW,@"ハートピンク_「呜～～～～～～～～～～～～_／／／_ハートピンク_」"
PRINTFORMW よしよしと、慰める様に頭を撫でてやる。	PRINTFORMW 乖～、安慰的抚摸着她的头。
PRINTFORMW ぐっとこらえて、いそいそとソレをしまう。	PRINTFORMW 突然就泄气了。
PRINTFORMW 不満気に%CALLNAME:TARGET%は%CALLNAME:MASTER%を睨んでいるが、無視して頭を撫でる。	PRINTFORMW %CALLNAME:MASTER%无视了满脸不高兴的%CALLNAME:TARGET%的表情、静静的摸着头。
PRINTFORMW 「………ん～♪」	PRINTFORMW 「………嗯～♪」
PRINTFORMW チョロい	PRINTFORMW 真好哄
PRINTFORMW やや強引に%CALLNAME:TARGET%を%CALLNAME:MASTER%の膝に寝かせた。	PRINTFORMW 稍微强硬的让%CALLNAME:TARGET%睡在了%CALLNAME:MASTER%的膝上。
PRINTFORMW 「あっ、………」	PRINTFORMW 「啊、………」
PRINTFORMW %CALLNAME:TARGET%は何も言わず、%CALLNAME:MASTER%の膝枕に身体を小さくちいさく丸めて横になっている。	PRINTFORMW %CALLNAME:TARGET%张了张口、然后还是枕着%CALLNAME:MASTER%的膝盖蜷缩着身子。
PRINTFORMW 髪に隠れて顔は見えない。	PRINTFORMW 头发遮住了她的脸。
PRINTFORMW 「わわっ！」	PRINTFORMW 「哇哇！」
PRINTFORMW 「びっくりしました！」	PRINTFORMW 「吓我一跳！」
PRINTFORMW 「でも、あったかいですっ！」	PRINTFORMW 「但是、好温暖！」
PRINTFORMW 「なでなで、ですか！」	PRINTFORMW 「摸头吗！」
PRINTFORMW 「えへへ～%CNAME("一人称")%、%CALLNAME:MASTER%さんになでられるの好きです！」	PRINTFORMW 「欸嘿嘿～%CNAME("一人称")%、最喜欢%CALLNAME:MASTER%摸头了！」
PRINTFORMW 「%CALLNAME:MASTER%さんになでられるとふわふわします……」	PRINTFORMW 「%CALLNAME:MASTER%摸头好舒服……」
PRINTFORMW 「幸せってこう言うのを言うのですね！」	PRINTFORMW 「幸福感就是说的这个吧！」
PRINTFORMW %CALLNAME:TARGET%は上機嫌に鼻歌を口遊んで%TEXTR("雑誌を読んで/教科書に向かって/スマホを眺めて")%いる。	PRINTFORMW %CALLNAME:TARGET%开心的哼着歌%TEXTR("读着杂志/看着教科书/玩着手机")%。
PRINTFORMW 何となく%CALLNAME:TARGET%の頭を撫でることにした。	PRINTFORMW 不管怎么说总算摸到%CALLNAME:TARGET%的头了。
CALL PRINT_STRW, @"「ひゃっ_／／／_」"	CALL PRINT_STRW, @"「咿呀_／／／_」"
CALL PRINT_STRW, @"「ふいうちはダメですよ？_／／／_」"	CALL PRINT_STRW, @"「偷袭是坏文明哦？_／／／_」"
PRINTFORMW 最初に不意打ちで殺したの誰だったか	PRINTFORMW 最开始偷袭杀人的到底是谁啊
PRINTFORMW 「む、むぅ……ごめんなさい」	PRINTFORMW 「姆、姆……对不起」
PRINTFORMW 冗談だ。と返して撫でを続ける。	PRINTFORMW 开玩笑的。和她说了之后继续摸着她的头。
PRINTFORMW 「ん…嬉しいです……」	PRINTFORMW 「嗯…好开心……」
CALL PRINT_STRW, @"「%CNAME("一人称")%、へんなかおじゃないですよね_／／／_」"	CALL PRINT_STRW, @"「%CNAME("一人称")%、没有做出奇怪的表情吧_／／／_」"
PRINTFORMW %CALLNAME:MASTER%に撫でられている%CALLNAME:TARGET%は嬉しそうに微笑んでいる。	PRINTFORMW 被%CALLNAME:MASTER%摸着头的%CALLNAME:TARGET%高兴的笑了。
PRINTFORMW %CALLNAME:TARGET%の頭を撫でてやった後、すっと%CALLNAME:TARGET%のお腹に手をやりお腹、子宮のあたりを撫でる。	PRINTFORMW 摸了摸%CALLNAME:TARGET%的头之后、手往下滑抚摸着%CALLNAME:TARGET%的腹部。
CALL PRINT_STRW, @"「あっ_HH_ダメです_／／／_もっとシたくなっちゃいます…_HH__HH_」"	CALL PRINT_STRW, @"「啊_HH_不行_／／／_会变得想要的…_HH__HH_」"
PRINTFORMW 【%CALLNAME:TARGET%の欲求がかなり深まった】	PRINTFORMW 【%CALLNAME:TARGET%的欲求不满度增加了】
PRINTFORMW 「いたいです」	PRINTFORMW 「好痛」
PRINTFORMW 「やわらくて、やさしくて、すっごくいたいです」	PRINTFORMW 「很温柔、很开心、也很痛」
PRINTFORMW 少し咲いながら%CALLNAME:MASTER%が撫でるのを受け入れている。	PRINTFORMW 嘴上抱怨着的%CALLNAME:MASTER%接受着抚摸。
CALL PRINT_STRW, @"「手、あったかいです_／／／_」"	CALL PRINT_STRW, @"「手、好温暖_／／／_」"
PRINTFORMW 「えへへ♪。もっと、おねがいです」	PRINTFORMW 「欸嘿嘿♪。更多、再摸摸」
PRINTFORMW 「あっ、その、」	PRINTFORMW 「啊、那个、」
CALL PRINT_STRW, @"暗灰色_「ごめんなさい……甘えちゃうから……やめてほしいです……」"	CALL PRINT_STRW, @"暗灰色_「对不起……娇惯……不想继续这样了……」"
PRINTFORMW 撫でようとした手は払われた。	PRINTFORMW 伸过去的手被拿开了。
PRINTFORMW 「なんだかあんしんします……」	PRINTFORMW 「总感觉很安心……」
PRINTFORMW そう言って瞳を細めて%CALLNAME:MASTER%の撫でに身を任せている。	PRINTFORMW %CALLNAME:MASTER%的眼睛眯成一条缝享受着摸头。
PRINTFORMW 「お風呂！いっしょに入りませんか！」	PRINTFORMW 「洗澡！一起去吧！」
CALL PRINT_STRW, @"「あ、あのっ_／／／_」"	CALL PRINT_STRW, @"「那、那个_／／／_」"
CALL PRINT_STRW, @"「ぼ、%CNAME("一人称")%と、いっしょにお風呂入ってほしいです……_／／／_」"	CALL PRINT_STRW, @"「我、希望和%CNAME("一人称")%、一起去洗澡……_／／／_」"
PRINTFORMW そう言って%CALLNAME:TARGET%は抱きついて来た。	PRINTFORMW 一边叫着%CALLNAME:TARGET%一边抱了过来。
CALL PRINT_STRW, @"「ペロペロ_／／／_」"	CALL PRINT_STRW, @"「peropero_／／／_」"
PRINTFORMW そして、%CALLNAME:MASTER%の頬を舐めて来た。	PRINTFORMW 然后、舔舐着%CALLNAME:MASTER%的脸颊。
CALL PRINT_STRW, @"「あっ！汚れちゃいましたね！いっしょにお風呂入りましょう！_／／／_」"	CALL PRINT_STRW, @"「啊！变脏了呐！一起来洗澡吧！_／／／_」"
PRINTFORMW 「……いっしょにお風呂入ってほしいです」	PRINTFORMW 「……想和你一起去洗澡」
PRINTFORMW 「おふろ！いっしょにはいりませんかっ！」	PRINTFORMW 「洗澡！能和我一起去吗！」
PRINTFORMW 「えっちしませんか？」	PRINTFORMW 「做爱吗？」
PRINTFORMW くぱぁとアソコを開けて期待した顔で誘ってきた。	PRINTFORMW 她拉开阴唇期待的邀请道。
PRINTFORMW クロッチの部分をずらしてアソコを見せて期待した顔で誘ってきた。	PRINTFORMW 她打开系带的部分期待的邀请道。
PRINTFORMW 服の裾をたくし上げて下着を見せて期待した顔で誘ってきた。	PRINTFORMW 她撩起衣服的下摆期待的邀请道。
CALL PRINT_STRW, @"暗灰色_「その……シたいです……_／／／_暗灰色_」"	CALL PRINT_STRW, @"暗灰色_「那个……想要……_／／／_暗灰色_」"
CALL PRINT_STRW, @"暗灰色_「ダメ……です、か……？_／／／_暗灰色_」"	CALL PRINT_STRW, @"暗灰色_「不行……吗……？_／／／_暗灰色_」"
PRINTFORMW 顔を真っ赤にしながら隠していた腕をおずおずとずらして誘ってきた。	PRINTFORMW 低着红彤彤的脸蛋然后摇晃着手臂邀请着。
PRINTFORMW クロッチの部分をずらしてアソコを見せて顔を真っ赤にしながら誘ってきた。	PRINTFORMW 拉开内裤然后脸色通红的邀请着。
PRINTFORMW 服の裾をたくし上げて下着を見せて顔を真っ赤にしながら誘ってきた。	PRINTFORMW 撩起衣服下摆脸色通红的邀请着。
CALL PRINT_STRW, @"「えっと、%CNAME("一人称")%にえっちなことシて良いですよ……？_／／／_」"	CALL PRINT_STRW, @"「那个、想和%CNAME("一人称")%做的话也可以的哦……？_／／／_」"
PRINTFORMW 腰かけてアソコをくぱぁと見せつけて顔を赤らめながら誘ってきた。	PRINTFORMW 全身露出的她脸色通红的邀请着。
PRINTFORMW クロッチとブラをずらしてアソコを見せて顔を赤らめながら誘ってきた。	PRINTFORMW 拉开内裤脸色通红的她邀请着。
PRINTFORMW 服の裾をたくし上げて下着を見せて顔を赤らめながら誘ってきた。	PRINTFORMW 她用撩起衣服下摆能看到内裤的模样邀请着。
CALL PRINT_STRW, @"「うそ、ついちゃいました。%CNAME("一人称")%がシたいのです……_HH_」"	CALL PRINT_STRW, @"「说谎、了。%CNAME("一人称")%想做……_HH_」"
PRINTFORMW 蕩けた赫い瞳で%CALLNAME:MASTER%を見つめている……	PRINTFORMW 融化一样的朱红眼眸看着%CALLNAME:MASTER%……
PRINTFORMW 「……………シてください」	PRINTFORMW 「……………做吧」
PRINTFORMW 「%CNAME("一人称")%をなにも考えられないくらいめちゃくちゃにしてください……」	PRINTFORMW 「把%CNAME("一人称")%干到什么都无法思考吧……」
PRINTFORMW 表情は俯いて見えないが、%CALLNAME:MASTER%の服の裾をぎゅうっと握っている。	PRINTFORMW 虽然低着头看不到表情、但是她紧紧的拉着%CALLNAME:MASTER%的衣服下摆。
PRINTFORMW 「えっちしましょうよ！」	PRINTFORMW 「来做瑟瑟的事情吧！」
PRINTFORMW 無邪気に笑いながら誘ってきた……	PRINTFORMW 她露出天真无邪的笑容邀请着……
PRINTFORMW 「よいしょ」	PRINTFORMW 「嘿咻」
PRINTFORMW %CALLNAME:TARGET%はそう言いながら%CALLNAME:MASTER%の頭を自身の膝に寝かせた。	PRINTFORMW %CALLNAME:TARGET%一边喊着一边%CALLNAME:MASTER%把头放在自己膝盖上。
PRINTFORMW 「えへへ～♪膝枕ってやつです！」	PRINTFORMW 「欸嘿嘿～♪这就是膝枕！」
PRINTFORMW 下から見える%CALLNAME:TARGET%の顔は楽しそうに咲っていた。	PRINTFORMW 从下面可以看到%CALLNAME:TARGET%很高兴。
PRINTFORMW 「ん……」	PRINTFORMW 「嗯……」
PRINTFORMW %CALLNAME:TARGET%は何も言わずに%CALLNAME:MASTER%を自身の膝に寝かせた。	PRINTFORMW %CALLNAME:TARGET%什么也没说的让%CALLNAME:MASTER%躺在自己膝上。
CALL PRINT_STRW, @"「た、たまには、%CNAME("一人称")%からせっきょく的にしたいのです_／／／_」"	CALL PRINT_STRW, @"「偶、偶尔也会、%CNAME("一人称")%也想让你享受一下的说_／／／_」"
PRINTFORMW ぷいっと顔を逸らしているがちらりと見える耳は真っ赤だ。	PRINTFORMW 说完之后就撇开视线、但是连耳根都红透了。
PRINTFORMW 「ん」	PRINTFORMW 「嗯」
PRINTFORMW %CALLNAME:MASTER%の肩をとんとんと軽く叩いてくる。	PRINTFORMW 她轻轻的锤着%CALLNAME:MASTER%的肩膀。
PRINTFORMW 何だと思って%CALLNAME:TARGET%の方を見ると膝を指し示していた。	PRINTFORMW 还想着干嘛呢、然后看到%CALLNAME:TARGET%指了指自己的膝盖。
PRINTFORMW 仕方ないなと、横になる。	PRINTFORMW 没办法、然后躺了下去。
PRINTFORMW すると、横になった%CALLNAME:MASTER%の髪を梳かすように撫でてくる。	PRINTFORMW 然后、温柔的顺着%CALLNAME:MASTER%的头发。
PRINTFORMW 「………えへへっ♪」	PRINTFORMW 「………欸嘿嘿♪」
PRINTFORMW 「……なにも言わないでください」	PRINTFORMW 「……什么都不要说」
PRINTFORMW %CALLNAME:MASTER%を膝枕した%CALLNAME:TARGET%の顔は陰に隠れて良く見えない。	PRINTFORMW %CALLNAME:MASTER%看不清被阴影遮挡的%CALLNAME:TARGET%的脸。
PRINTFORMW 「てーいっ！」	PRINTFORMW 「嘿ー！」
PRINTFORMW 暇を持て余していた%CALLNAME:MASTER%を%CALLNAME:TARGET%は強制的に膝枕してきた。	PRINTFORMW 正在放松的%CALLNAME:MASTER%被强硬的拉到%CALLNAME:TARGET%膝盖上躺着。
PRINTFORMW 「なんとなっくひざまくらっていうのをしたくなりましたっ！」	PRINTFORMW 「总算是做到膝枕了（物理）！」
PRINTFORMW 流石に他の人が居る時に刺されるのは不味いだろう…	PRINTFORMW 再怎么说在其他人在的时候杀人也有点不好吧…
PRINTFORMW 「冗談はやめてください…」	PRINTFORMW 「请不要开玩笑…」
PRINTFORMW %CALLNAME:MASTER%は昔の様に刺されようとしたが%CALLNAME:TARGET%はそれを断った。	PRINTFORMW %CALLNAME:TARGET%拒绝了一直以来的约定。
「もう%CNAME("一人称")%は、人を殺さないと決めたのです」	「%CNAME("一人称")%已经、决定不杀人了」
PRINTFORMW 「とくに、%CNAME("二人称")%さんをもう殺したくないです」	PRINTFORMW 「特别是、%CNAME("二人称")%是绝对不会的」
PRINTFORMW 「それに…」	PRINTFORMW 「而且…」
CALL PRINT_STRW,@"暗灰色_「今は、%CNAME("二人称")%さんに貫かれる方が……_／／／_なっなんでもないです！_／／／_」"	CALL PRINT_STRW,@"暗灰色_「现在、被%CNAME("二人称")%插的人……_／／／_什什么都没有！_／／／_」"
PRINTFORMW 「あっ！殺して良いのですかっ！」	PRINTFORMW 「啊！可以杀了吗！」
PRINTFORMW 「あっ………いえ、なんでもないです」	PRINTFORMW 「啊………不、什么都没有」
PRINTFORMW 「ん…？そうですか？わかりました！」	PRINTFORMW 「嗯…？这样吗？我知道了！」
PRINTFORMW そう言うと%CALLNAME:TARGET%はナイフを取り出し%CALLNAME:MASTER%の腹部を刺した。	PRINTFORMW 这样说着%CALLNAME:TARGET%拔出匕首干净利落的刺了下去
PRINTFORMW 「うぅん……？うーん……？うんっ！」	PRINTFORMW 「嗯……？嗯ー……？嗯！」
PRINTFORMW 独りでに%CALLNAME:TARGET%は何かを考えて何かに納得したようだ。	PRINTFORMW %CALLNAME:TARGET%思考了一会似乎总算接受了。
PRINTFORML 何時も通りに復活した%CALLNAME:MASTER%の訝しむ顔を見たのか%CALLNAME:TARGET%は	PRINTFORML 毕竟和平常一样每次都看%CALLNAME:MASTER%复活、%CALLNAME:TARGET%已经不会惊讶了
PRINTFORMW 「えっと、やっぱり殺すのは%CNAME("二人称")%さんが良いなってだけです！」	PRINTFORMW 「那个、果然杀的是%CNAME("二人称")%真的太好了！」
PRINTFORMW それは褒めているのかどうなのか……	PRINTFORMW 这算夸奖吗……
PRINTFORML 　【%CALLNAME:TARGET%に殺された数　+1】	PRINTFORML 　【%CALLNAME:TARGET%杀你的次数　+1】
PRINTFORMW 　【%CALLNAME:TARGET%の%CALLNAME:MASTER%に対する好感度　+50】	PRINTFORMW 　【%CALLNAME:TARGET%对%CALLNAME:MASTER%的好感　+50】
PRINTFORMW 「人を殺すのはダメだって分かってますけど」	PRINTFORMW 「虽然知道了杀人是不对的」
PRINTFORMW 「%CNAME("二人称")%さんを独占できてる気持ちになるのでわるくないです」	PRINTFORMW 「但是能独占%CNAME("二人称")%也不错呢」
PRINTFORMW 陶酔した表情で%CALLNAME:TARGET%は咲っている。	PRINTFORMW %CALLNAME:TARGET%狂气的笑着。
PRINTFORMW すっと、表情を戻して再び口を開く。	PRINTFORMW 然后、一下子变回了平时的脸再次开口道。
PRINTFORMW 「%CNAME("一人称")%はもう他の人を殺しませんけど、」	PRINTFORMW 「%CNAME("一人称")%不会再杀其他人、」
PRINTFORMW そして、%CALLNAME:TARGET%は%CALLNAME:MASTER%の耳元に顔を寄せて、	PRINTFORMW 然后、%CALLNAME:TARGET%凑近%CALLNAME:MASTER%的耳边说道、
CALL PRINT_STRW,@"灰色_「%CNAME("一人称")%以外の他の人に殺されちゃダメですよ_HH_灰色_」"	CALL PRINT_STRW,@"灰色_「也不要被%CNAME("一人称")%以外的人杀了可不行哦_HH_灰色_」"
PRINTFORMW 蠱惑的に囁いた。	PRINTFORMW 蠱惑的喃喃之声。
PRINTFORMW 　【%CALLNAME:TARGET%の%CALLNAME:MASTER%に対する好感度　+40】	PRINTFORMW 　【%CALLNAME:TARGET%对%CALLNAME:MASTER%的好感　+40】
PRINTFORMW 「うーん？うん……きのせいでしたっ！」	PRINTFORMW 「嗯ー？嗯……是错觉！」
PRINTFORMW 　【%CALLNAME:TARGET%の%CALLNAME:MASTER%に対する好感度　+30】	PRINTFORMW 　【%CALLNAME:TARGET%对%CALLNAME:MASTER%的好感　+30】
PRINTFORMW 「えへへ…」	PRINTFORMW 「欸嘿嘿…」
PRINTFORMW 　【%CALLNAME:TARGET%の%CALLNAME:MASTER%に対する好感度　+20】	PRINTFORMW 　【%CALLNAME:TARGET%对%CALLNAME:MASTER%的好感　+20】