//EVENT_K45_小夜.ERB

LOCALS = 私_わたし	LOCALS = 我_我
LOCALS = 後輩くん_こうはいくん	LOCALS = 后辈君_后辈君
LOCALS = 後輩さん_こうはいさん	LOCALS = 后辈桑_后辈桑
LOCALS = あなた_あなた	LOCALS = 你_你
三年生の先輩。	三年级的前辈。
媚びるようなおどおどした口調、すぼまった肩、猫背に三白眼、長い前髪と	像是献媚一样战战兢兢的语调、瑟缩着双肩、后背微驼、额前长长的刘海下是一双三白眼。
まさに虐めてくれと言わんばかりの雰囲気を纏っている。	简直是浑身上下都散发着一种惹人欺负的气氛。
PRINTFORMW 事の起こりは昼休みに端を発する。	PRINTFORMW 事情发生在午休的时候。
PRINTFORMW 昼食をとり終えた%CALLNAME:MASTER%はあてどなく校内を散策していたところだった。	PRINTFORMW 吃过了午饭的%CALLNAME:MASTER%正漫无目的地在校园中散步。
PRINTFORMW すると、だ。階段の方から何やら声がする。どれも女性の声だ。	PRINTFORMW 于是就听到了、楼梯那边好像有什么引人注意的声音。听起来好像都是女性的声音。
PRINTFORMW 思わず階段下で%CALLNAME:MASTER%は足を止める。	PRINTFORMW %CALLNAME:MASTER%情不自禁地在楼梯下面停下了脚步。
PRINTFORML ３～４人分ほど聞こえる声はどうやら２種類に分かれるらしく、多く聞こえる声はやたら攻撃的で、	PRINTFORML 大概能听到三~四个人的声音、其中不乏充满攻击性的话语、
PRINTFORMW もう一方の少ない――こちらは一人なのだろう――声はか細く媚びるような声だ。	PRINTFORMW 夹杂在那嘈杂的攻击性话语中的――还有一个人的声音――纤细、柔弱的声音。
PRINTFORMW 飛び交う攻撃的な声をよくよく聞けば因縁を付けるという言葉も陳腐になるもので聞くに堪えない。	PRINTFORMW 在楼梯间飞散的恶毒话语、即使是旁观者都会感觉难以入耳、更别说是与这些人有些因缘的家伙了。
PRINTFORML この辺りは使われている教室も少ない関係で生徒は愚か教師も余りやってこない。	PRINTFORML 因为这边的教室很少被使用、所以无论是学生还是教师都不怎么过来。
PRINTFORMW どうも、そういう場面に%CALLNAME:MASTER%は出くわしてしまったようだった。	PRINTFORMW 于是、%CALLNAME:MASTER%就遇到了这样的场面。
PRINTFORMW どうしたものかと思ったその時、攻撃的な声がヒートアップしたのを%CALLNAME:MASTER%は感じる。	PRINTFORMW 正在思考自己到底该怎么办时、%CALLNAME:MASTER%感觉到攻击性的话语突然变得更加激烈起来了。
PRINTFORMW 次いで、小さな呻くような声と嗚咽。恐らく、手が出た。	PRINTFORMW 接着便听到了微弱的呻吟声和呜咽、恐怕是被打了吧。
PRINTFORML 唐突な暴力の予感に反応したのかはたまた正義感でも湧いたのか。	PRINTFORML 是对唐突的暴力产生了条件反射、还是正义感油然而生呢？
PRINTFORMW いつの間にか%CALLNAME:MASTER%は一歩だけ階段に足を踏み出していた。	PRINTFORMW 不知不觉间、%CALLNAME:MASTER%向着楼梯迈出了一步。
PRINTFORMW 人通りの少ない場所だ。実際、その足音は大きく響く。	PRINTFORMW 这里是很少有人经过的地方。实际上、那一步脚步声非常地响。
PRINTFORMW 誰かが来た事を察知したのか複数のぱたぱたと駆ける足音が上階を上がっていくのを%CALLNAME:MASTER%は聞いた。	PRINTFORMW 大概是察觉了有谁来了、%CALLNAME:MASTER%能听到几个人跑起来的脚步声在楼梯上方渐行渐远。
PRINTFORMW どうやら…逃げてくれたらしい。	PRINTFORMW 看起来…好像是逃走了。
PRINTFORMW 事にならずに済んだことに安堵すればいいのだろうか。ともかく%CALLNAME:MASTER%は現場になっていたであろう踊り場を覗いてみる。	PRINTFORMW 事态没有进一步发展或许就可以放心了吧。总而言之、%CALLNAME:MASTER%还是想要去楼梯平台上的事发现场看看情况。
PRINTFORMW 「……うっ…うぇ…うぇえ…」	PRINTFORMW 「……嗯…呃…唔呃…」
PRINTFORMW そこにはお腹を抑えて蹲っている少女が居た。	PRINTFORMW 有一个少女、捂着肚子蹲在那里。
PRINTFORMW 髪は肩ほどに切り揃えられているが前髪が長く顔を隠している、俯いた顔は涙でくしゃくしゃになって掛けている眼鏡の奥で雫が光って見えた。	PRINTFORMW 虽然头发整整齐齐地修剪成齐肩发、但刘海长长的遮住了脸、虽然没法看清楚她低下去的脸、但被泪水打湿的眼镜正发出晶莹的光。
PRINTFORMW 「……あ」	PRINTFORMW 「……啊」
PRINTFORMW じっくりと観察している内に少女がこちらに気付いて顔を上げた。三白眼の目付きの悪い瞳がこちらを覗いている。	PRINTFORMW 在仔细观察的过程中、少女注意到了这边、抬起了头。那双望过来的三白眼、眼神看起来有些凶恶。
PRINTFORMW お互いじっくりと見合う。	PRINTFORMW 就这样默默地、两人很仔细地观察着彼此。
PRINTFORMW 見られた、という顔と見てしまった、という顔…どこか居心地の悪い空気が流れた。	PRINTFORMW 觉得被看到出洋相的人、和看到别人出洋相的人…尴尬的气氛在彼此间弥漫。
PRINTFORMW いっそこのまま見なかったことにして踵を返す選択肢が%CALLNAME:MASTER%の中に生まれ始めた頃。	PRINTFORMW 当%CALLNAME:MASTER%意识到自己或许不应该这么紧盯着看的时候。
PRINTFORMW 「あ、あああ、あの…」	PRINTFORMW 「啊、那那那、那个…」
PRINTFORMW とんでもないどもりと一緒にようやく少女が声を上げた。	PRINTFORMW 少女结结巴巴地开口说道。
PRINTFORMW 「た、たた、助けて、頂いてありがとうございます、すぅ…」	PRINTFORMW 「谢、谢谢、你救、救了我、谢…」
PRINTFORMW 助けたも何も、言わば通りがかりに物の弾みを起こしただけだった。	PRINTFORMW 倒是说不上什么救不救、倒不如说自己只是散步路过而已。
PRINTFORMW しかし少女にとってすれば確かに、助けて貰ったと言えるのかも知れない。	PRINTFORMW 但是对于少女来说、这好像确实帮助了她。
PRINTFORMW 「に、二年生、の方ですよね、ね。そ、その学年章」	PRINTFORMW 「看、看你的学年章、应该是、是二年级的学生、吧。」
PRINTFORMW そうだと頷くと少女は困ったような歪んだ表情を浮かべる。	PRINTFORMW 得到点头回应之后、少女的脸上浮现出为难的扭曲表情。
PRINTFORMW 卑屈さが混じっていてとてもそうは見えなかったが、もしかしたら愛想笑いのつもりなのかもしれない。	PRINTFORMW 那是混杂着自卑感、非常复杂的表情、但也许能称得上是亲切的笑容。
PRINTFORMW しかしそれからすぐに自分の置かれていた状況を思い出したのかあわを食ったように身嗜みを整え始めた。	PRINTFORMW 但紧接着，也许是想起了自己所处的状况，她突然一惊，开始整理起自己的仪表。
PRINTFORMW 「あ、あああ、あのっ……こ、こここ、これはっでっですねっ」	PRINTFORMW 「啊、啊啊那、那个……这、这这这、我这只是」
PRINTFORMW これはもなにも、見た通り、聞いた通りだった。	PRINTFORMW 这里发生的事、刚刚听到的、现在看到的就能够理解了。
PRINTFORMW 「ち、ちちち、違うんですよぉ…こ、これはほら、遊びと言いますかぁ、そ、そのぉ…」	PRINTFORMW 「不、不不不、并不是的…这、这只是、那个、闹着玩的、对、那个…」
PRINTFORMW まるでやった側の言い訳のように聞こえるが……これは…	PRINTFORMW 听起来简直就是在她们做辩护………
PRINTFORMW 「……そ、その、いじめ、です、かね…」	PRINTFORMW 「……是、是呢、听起来像是、霸凌、呢…」
PRINTFORMW どう見ても、その現場だった。	PRINTFORMW 无论怎么看、这里都是霸凌现场吧。
PRINTFORMW 「は、はい…ご、ごめんなさいぃ…」	PRINTFORMW 「是、是的…对、对不起…」
PRINTFORMW 結局それを指摘されて、膝を抱えて謝罪する姿はそこらの小動物よりも弱そうに見える。	PRINTFORMW 到底还是被指出被霸凌的经历后、她抱着膝盖谢罪的样子比小动物们还柔弱。
PRINTFORMW 「…で、でも、な、なれちゃいま、ましたしぃ…え、えへへへ…ははは、はぁ」	PRINTFORMW 「…但、但是、反、反正我已经习惯了…诶、诶嘿嘿…哈哈哈、哈啊」
PRINTFORMW 慣れた、という事はこれは最近始まったものではなく恒常的なものらしい。	PRINTFORMW 看她的样子、好像很久之前就已经习惯被霸凌了。
PRINTFORMW 自嘲気味に笑って溜息を吐く彼女に%CALLNAME:MASTER%は思わず頭を抱えたくなる衝動に駆られた。	PRINTFORMW 看着有些自嘲地笑着叹气的她、%CALLNAME:MASTER%不由得产生了想把她涌入怀中的冲动。
PRINTFORMW このまま放置、というのもどうにも座りが悪い。	PRINTFORMW 就这么放着她不管的话、自己也会坐立不安的。
PRINTFORMW まるで人慣れしていない姿勢からも推測になってしまうが、守ってくれる知り合いがいるようにも見えない。	PRINTFORMW 从她那不习惯与人相处的反应也能推测出、应该是没有什么能够保护她的熟人。
PRINTFORMW 囲ってしまったりした方がこの少女のためにも良いのではないだろうか。	PRINTFORMW 让她多接触接触别人，能够交上几个朋友的话会比较好吧。
PRINTFORMW 見れば……肉付きも悪くはなさそうだ…	PRINTFORMW 看起来……身材也不错的样子…
PRINTFORMW 条件を説明して勧誘するのも一つの手だろう。	PRINTFORMW 说明条件让她加入社团或许也是个办法。
PRINTFORMW 勧誘をすると、少女は俯いていた顔を少し上げてこちらではなく、虚空をじっと見つめ始めた。	PRINTFORMW 听过劝诱之后、少女抬起了低下的头、并不是看着这边、而是盯着什么都没有的一旁。
PRINTFORMW 「ぶ、部活、ですかぁ…」	PRINTFORMW 「是社、社团活动、啊…」
PRINTFORMW それだけを呟いたまた膝を抱えたまま俯いて彼女は暫く黙って何かを考え込むようにしていた。	PRINTFORMW 她只说了这一句、就又抱起膝盖低下头去、沉默了一会儿、似乎是在思考着什么。
PRINTFORMW 「そ、そ、そうですねぇ…いい、かもしれませんねぇ」	PRINTFORMW 「是、是、是啊…也、也许不错」
PRINTFORMW 「か、変わるきっかけになって…く、くれれば」	PRINTFORMW 「如、如果能给我改变自我的…机、机会的话」
PRINTFORMW 「え、えへへ、へへ。 そ、そしたら、せ、先輩っぽく、な、なれますかねぇ」	PRINTFORMW 「诶、诶嘿嘿、嘿嘿。 这、这样的话、我、也能变得、更、更像个前辈吗」
PRINTFORMW …どうやらこの人は先輩だったらしい…とてもそうは見えない。	PRINTFORMW …看来这个人是前辈啊…才怪、根本看不出来。
PRINTFORMW 「……き、き、決め、ました」	PRINTFORMW 「……我、决、决、决定了」
PRINTFORMW またしばらく考え込むようにしていた彼女はようやく顔を上げてそう呟いた。	PRINTFORMW 又低下头去思考了一会的她、终于抬起头来、这样回答着。
PRINTFORMW 「は、入り、ます。ぶ、部活、に。か、かか、か、変わるた、ために」	PRINTFORMW 「我、加、加入。社、社团、活动。是、是是、是为了、改、改变自我」
PRINTFORMW 決意を固めたようにキリッとした顔をした彼女は引き結んだ顔を歪ませる。	PRINTFORMW 坚定了决心的她紧绷着脸以至于连表情都扭曲了。
PRINTFORMW 「さ、三年生の、久留木小夜、で、です。よ、よろしく、お、おねがいしますぅ」	PRINTFORMW 「我、是三年级的、久留木小夜。请、请多多、指教」
PRINTFORMW ……ぎこちないが、恐らく笑顔なのだろう。	PRINTFORMW ……虽然看起来很不自然、但那扭曲的表情大概是笑容吧。
PRINTFORMW 怯えるように差し出された%CALLNAME:ARG%の手を%CALLNAME:MASTER%は握り返して立たせてやった。	PRINTFORMW %CALLNAME:MASTER%紧握住了%CALLNAME:ARG%怯怯地伸出的手、帮助她站了起来。
PRINTFORMW ところで、本人は言及していなかったが……Ｈな事をする、という事に関しては良いのだろうか…	PRINTFORMW 话说回来、虽然本人没有提起……做Ｈ的事情、真的没什么关系吗…
PRINTFORMW これから部活としてＨな事をさせていただきます。	PRINTFORMW 接下来作为社团活动请允许我做Ｈ的事情。
PRINTFORMW といったニュアンスで伝えたところ、%CALLNAME:TARGET%は固まった。	PRINTFORMW 用这样的语气传达之后、%CALLNAME:TARGET%就凝固住了。
PRINTFORMW えっなんて言葉の一つも出てこない見事なフリーズ具合だった。	PRINTFORMW 真的是一句话都说不出来的完美的死机状态。
PRINTFORMW 既にもう１０秒以上も固まっている。	PRINTFORMW 已经凝固了十秒以上的时间了。
PRINTFORMW 「あ、あ、あ、あ」	PRINTFORMW 「啊、啊、啊、啊」
PRINTFORMW ようやく声を発したがそれもまるで壊れたラジオのようだ。	PRINTFORMW 好不容易发出了声音、结果就像是坏掉的收音机一样。
PRINTFORMW もう一度同じことを伝えると、今度は体ごと大きく一歩引いた。	PRINTFORMW 又向她说了同一件事、这次她向后退了一大步。
PRINTFORMW 「うぇ、ぇえ、うぇ、え、ええ、え、え、Ｈな、コト、で、ででで、ですかぁ？」	PRINTFORMW 「诶、额、诶、诶、诶诶、Ｈ、Ｈ、Ｈ的、事情、是、是是、要做Ｈ的事情？」
PRINTFORMW やっとまともな言葉が絞り出された。	PRINTFORMW 好不容易从嘴中挤出了一句能够理解的话。
PRINTFORMW そもそも勧誘する時に伝えていた筈なのだが、こうも反応されると逆に驚く。	PRINTFORMW 本来在劝诱的时候就有传达过这件事、但现在才有所反应这件事更让人感觉吃惊。
PRINTFORMW 「わ、わ、忘れてました……はいぃ」	PRINTFORMW 「忘、忘、忘记了……是有这件事啊」
PRINTFORMW 「で、ででででででも、でも、%CNAME("一人称", "どもり")%なんて、そ、そその」	PRINTFORMW 「但、但但但但但、但是、和%CNAME("一人称", "どもり")%这种人、做、做那、那种」
PRINTFORMW 「え、Ｈ……な、な、ことしても、つ、つつつ、つまらないと思いますよぉ！？」	PRINTFORMW 「Ｈ、Ｈ……的、的、的事情、也、也也只、只会让人觉得无聊哦！？」
PRINTFORMW それは部長たる%CALLNAME:MASTER%が決めることだ。	PRINTFORMW 这是由身为部长的%CALLNAME:MASTER%来决定的事。
PRINTFORMW そう伝えるとしゅん、と%CALLNAME:TARGET%は肩を落とす。	PRINTFORMW 听到这句话后、%CALLNAME:TARGET%放松了肩膀。
PRINTFORMW 「う、うぇえ……わ、わわ、解りました……ぶ、部活、ですもんね」	PRINTFORMW 「唔、唔呃……知、知知、知道了……是社、社团、活动呢」
PRINTFORMW そうしてようやく%CALLNAME:TARGET%は、おずおずと一歩だけ%CALLNAME:MASTER%に距離をつめた。	PRINTFORMW 终于%CALLNAME:TARGET%这才怯怯地迈出了一步、缩短了和%CALLNAME:MASTER%的距离。
PRINTFORMW 「……%CNAME("一人称", "どもり")%なんかがこ、ここ、こんな事してて、良いん、で、でででしょうか」	PRINTFORMW 「……和%CNAME("一人称", "どもり")%这样的、做做、做这种事、真、真、真的好吗」
PRINTFORMW 「…え、え？ ……えと、か、かかか可愛い、から、良い、で、です、か」	PRINTFORMW 「…诶、诶？ ……诶、很可、可可可可爱、所以、没、没关系、吗」
PRINTFORMW 「……あ、あははは、%CNAME("二人称", "どもり")%、く、口がう、上手い、ですねぇ」	PRINTFORMW 「……啊、啊哈哈哈、%CNAME("二人称", "どもり")%、嘴、嘴巴、真甜呢」
PRINTFORMW 「…………あ、あれ？ な、なな、何か…顔、熱いですぅ…」	PRINTFORMW 「…………啊、啊嘞？ 为、为为、为啥…脸上、好热…」
PRINTFORMW 「%CNAME("二人称", "どもり")%、う、上手く、出来てましたか？」	PRINTFORMW 「%CNAME("二人称", "どもり")%、做、做的、怎么样？」
PRINTFORMW 「……え、えへへぇ…」	PRINTFORMW 「……诶、诶嘿嘿诶…」
PRINTFORMW 「よ、良かった、ですぅ…%CNAME("一人称", "どもり")%ど、どど、ドン臭いってよく言われてまして…」	PRINTFORMW 「太、太好了、啊…别人经、经常说%CNAME("一人称", "どもり")%既迟钝、又迷糊、…」
PRINTFORMW 「ほ、ほほほほ、褒められたの、なんだか、ひっ久々で…」	PRINTFORMW 「呼、被表表、表扬了啊、好久没有、被表扬过…」
PRINTFORMW 「う、嬉しい、なぁ…えへへぇ」	PRINTFORMW 「好、好开心、啊…诶嘿嘿」
PRINTFORMW 「あ…%CNAME("二人称" ,"どもり")%……す、するん、で、です、よね？」	PRINTFORMW 「啊…和%CNAME("二人称" ,"どもり")%……一、一起、做、做、啊？」
PRINTFORMW %CALLNAME:MASTER%が逢瀬に誘うと%CALLNAME:TARGET%はどことなく嬉しそうにおずおずと自分から身を寄せた。	PRINTFORMW 被%CALLNAME:MASTER%邀请幽会的%CALLNAME:TARGET%似乎很高兴的样子、扭扭捏捏地主动靠了过来。
PRINTFORMW 「す、少しおかしいのかも、し、しれないんですけど…」	PRINTFORMW 「我有、有点奇怪吗、也、也许是…」
PRINTFORMW 「そ、その、あのその……最近……あ、ぁ、え、と……う、うぇ……」	PRINTFORMW 「那、那个、这个那个……最近……啊、啊、额、唔……唔、诶……」
PRINTFORMW そこまで言いかけてもじもじとし始めた%CALLNAME:TARGET%は、	PRINTFORMW 话刚说到一半突然扭扭捏捏起来的%CALLNAME:TARGET%、
PRINTFORMW 「い、いえ、なんでも、な、ないですぅ…うぇ、え、えへ、えへへぇ…」	PRINTFORMW 「不、不、什、什么、没什么…额诶、诶嘿、诶嘿嘿…」
PRINTFORMW 結局それを誤魔化すようにして奇妙な笑みを浮かべた。	PRINTFORMW 结果到最后、还是露出奇怪的笑容、把要说的敷衍过去了。
PRINTFORMW 大変な事が起こった。	PRINTFORMW 发生了一件非常严重的事情。
PRINTFORMW %CNAME("一人称")%の人生の天変地異だ。嵐……と言っても良いかもしれない。	PRINTFORMW 可以说是让%CNAME("一人称")%的人生天翻地覆、重新来过一样的大事件。
PRINTFORMW 原因は、%CNAME("一人称")%を虐めから一度助けて、そして"部活"に入れてくれた%CNAME("二人称")%。	PRINTFORMW 而这件事的起因、就是将%CNAME("一人称")%从霸凌中救出、还邀请加入"社团活动"的%CNAME("二人称")%。
PRINTFORMW なんとなく、顔が見たい。 なんとなく、顔を見せたい。	PRINTFORMW 不知为何、想要注视那脸颊。 不知为何、想要看着那容颜。
PRINTFORMW なんとなく、声を掛けたい。 なんとなく、声を聞きたい。	PRINTFORMW 不知为何、总想要打个招呼。 不知为何、总想听到那个嗓音。
PRINTFORMW なんとなく、触れたくて……なんとなく、触れて欲しい。	PRINTFORMW 不知为何、总想要去触碰……不知为何、总是渴求着被触碰。
PRINTFORMW そんないっぱいの、%CNAME("一人称")%のなんとなくが詰まった人。	PRINTFORMW 那个将%CNAME("一人称")%的内心、填的满满的人。
PRINTFORMW %CNAME("一人称")%でも、流石に解る。	PRINTFORMW 即使是%CNAME("一人称")%、也已经察觉到了。
PRINTFORMW 解ってしまう。	PRINTFORMW 已经明白了啊。
PRINTFORMW 恋をしている。	PRINTFORMW 已经坠入爱河了啊。
PRINTFORMW %CNAME("二人称")%に、こんな、%CNAME("一人称")%が。	PRINTFORMW %CNAME("二人称")%、或许是、%CNAME("一人称")%的。
PRINTFORMW 初恋、なのかもしれない。	PRINTFORMW 初恋啊。
PRINTFORMW 今まで小説の中やクラスメイトの自慢話を小耳に挟む位でしか見聞きしない、全然別の世界の出来事が今、%CNAME("一人称")%の上に降ってきたのだ。	PRINTFORMW 迄今为止、只在小说和同学的自吹自擂中听到的、好像是另一个世界的事情、如今、也降临在%CNAME("一人称")%的身上了啊。
PRINTFORMW %CNAME("二人称")%は、酷い人だ。エッチな人だ。いじわるな人、だ。	PRINTFORMW %CNAME("二人称")%、那个残酷的家伙。总是那么好色。总是一副坏心眼。
PRINTFORMW そして…優しい人だ。こんな%CNAME("一人称")%の手を取ってくれた、初めての、人だ。	PRINTFORMW 可是…也是那么温柔的人。也是第一个愿意握住%CNAME("一人称")%手的人。
PRINTFORMW でも%CNAME("一人称")%は、ドン臭いから。駄目な人だから。	PRINTFORMW 但是%CNAME("一人称")%、既迟钝又迷糊。根本就是个废柴。
PRINTFORMW きっと後ろについて回る位が精々で、隣に立つなんて…ましてや、手を繋いで、その手を引くなんて烏滸がましいにも程がある。	PRINTFORMW 仅仅是跟在那个背影后面都要竭尽全力、却还想待着那个人身边…说到底、居然想要握住那只手、不想要放开什么的、废人也要有点自知之明吧。
PRINTFORMW だけれど、%CNAME("一人称")%は、%CNAME("一人称")%はもしそう出来たら。	PRINTFORMW 但是、%CNAME("一人称")%、如果%CNAME("一人称")%真的可以的话。
PRINTFORMW 頼れる先輩らしく振舞って、%CNAME("二人称")%を助けられたら。	PRINTFORMW 能够像一个可以被依靠的前辈一样、也能够帮助到%CNAME("二人称")%的话。
PRINTFORMW 恩返しになるんじゃないかな、自己満足、かも、知れないけれど…	PRINTFORMW 能不能算是报恩呢、也许只是自我满足吧…
PRINTFORMW %CNAME("一人称")%は…	PRINTFORMW %CNAME("一人称")%到底是…
PRINTFORMW 「あ、あの、%CNAME("二人称", "どもり")%っ」	PRINTFORMW 「那、那个、%CNAME("二人称", "どもり")%」
PRINTFORMW 「%CNAME("一人称", "どもり")%っこっこれから、がが、頑張るます、る…からっ」	PRINTFORMW 「%CNAME("一人称", "どもり")%从今往后、会会、更加努力的、是…」
PRINTFORMW 「あ、ああ、こ、これまでが、ががっ頑張ってなかったんじゃないんです…だけ、どっ」	PRINTFORMW 「啊、啊啊、也、也不是说、在此之前都没有努力过…只、只是」
PRINTFORMW 「あ、ぅ…………く、口調？」	PRINTFORMW 「啊、唔…………语、语调？」
PRINTFORMW 「ううぇえっ……い、いい、一応、せ、せせせせ先輩っなのでっだ、だから…」	PRINTFORMW 「唔诶……我、我我、姑且算是、前、前前前前前辈哦、所以说…」
PRINTFORMW 「…ら、らしくしようって思いまし…思って…せ、せめて、あの…か、形からっ」	PRINTFORMW 「…想、想要改变一下风格…所以…一开始、至、至少…要、看起来像个前辈一样」
PRINTFORMW 「うぇ…変…で、ですよ、ね……ご、ごご、ごめんなさ――」	PRINTFORMW 「很…很…奇、奇怪、吧……对、对对、对不起――」
PRINTFORMW 「……良い、の？ …………うん、が、がが、頑張るっ」	PRINTFORMW 「……很好、吗？ …………嗯、我、我会、加油的」
PRINTFORMW 「じ、自信持てるように、なって、みる」	PRINTFORMW 「我会、试着去变得、更有、自信的」
PRINTFORMW 「だから――」	PRINTFORMW 「所以――」
PRINTFORMW ――――だからその時は、%CNAME("一人称")%の一番になってください。	PRINTFORMW ――――所以那个时候、请成为%CNAME("一人称")%最重要的人。
PRINTFORMW 言いかけた言葉を慌てて飲み下して%CALLNAME:TARGET%は%CALLNAME:MASTER%の顔を見れず俯いてしまった…	PRINTFORMW 慌慌张张地咽下这差点说出的话、%CALLNAME:TARGET%低下头去不敢去看%CALLNAME:MASTER%的脸…
PRINTFORMW 「ねぇ、%CNAME("二人称")%…」	PRINTFORMW 「呐、%CNAME("二人称")%…」
PRINTFORMW 「大好き、大好きだよ……大好き」	PRINTFORMW 「最喜欢、最喜欢你了……最喜欢啊」
PRINTFORMW 「ううん…不安、とか、じゃなくて…言いたかったんだぁ…それだけなの」	PRINTFORMW 「唔嗯…没有、感觉不安什么的…就只是很想说出来…就是这样」
PRINTFORMW 「で、でもね、それだけでも……いっぱい胸が痛くって」	PRINTFORMW 「但、但是啊、只是这种程度……胸口就感觉好痛啊」
PRINTFORMW 「なのに、それよりもいっぱいいっぱい、幸せだなぁ…って、お、思うんだぁ」	PRINTFORMW 「但是、比起这个、更多的是幸福哦…嗯、我、是这样想的」
PRINTFORMW 「え、へへぇ……」	PRINTFORMW 「诶、嘿嘿……」
PRINTFORMW 「あ、ぅ……え、えと、あのぉ……あのね、%CNAME("二人称", "どもり")%、わ、笑わないでね」	PRINTFORMW 「啊、……诶、那、那个……呃、%CNAME("二人称", "どもり")%、不、不要笑啊」
PRINTFORMW ホテルに到着し、部屋に入るなり%CALLNAME:TARGET%は、恥ずかしそうに言って上着を脱いだ。	PRINTFORMW 到达的酒店、进入了房间之后%CALLNAME:TARGET%、这样害羞地说着脱下了上衣。
PRINTFORMW 「……す、少し、頑張って、み、みましたー…く、クリスマス、だから…な、なんちゃって」	PRINTFORMW 「……稍、稍微、努力、尝、尝试了一下…毕、毕竟、是…圣诞节嘛」
PRINTFORML 着ているセーター等は確かにいつも通りなのだが、	PRINTFORML 虽然穿着的毛衣还是平时穿的那一件、
PRINTFORMW ジーパンなどを好んで履く彼女にしてはホットパンツやパンストなどたしかに頑張っている。	PRINTFORMW 对于喜欢穿牛仔裤的她来说、热裤、裤袜也确实是需要一些努力才会穿上。
PRINTFORMW 「こ、こういうの、す……すきなら……い、いいん、だけど……」	PRINTFORMW 「喜、喜欢这种打扮、的话……我也没……没、关系的、嗯……」
PRINTFORMW うつむき、頬を染めて目を逸らすあ彼女を抱きしめてやると、	PRINTFORMW 将低下头去、脸颊通红目光躲闪的她拥入怀中、
PRINTFORMW ほんのりとした化粧の香りと蒸れた女のにおいが鼻腔を突いた。	PRINTFORMW 化妆品淡淡的香味和温热的女性气味一同扑鼻而来。
PRINTFORMW 「………………あぅ……や、やっ、やっぱり、は、はずっ…うぅ…」	PRINTFORMW 「………………啊呜……果、果、果然、好、好害…羞…」
PRINTFORMW 抱きしめる%CALLNAME:MASTER%に頭を預けるようにして、彼女は深く懐へ潜り込む。	PRINTFORMW 就像是逃避的鸵鸟一样、她把自己深深地埋进%CALLNAME:MASTER%的怀中。
PRINTFORMW それからしばらく、お互い沈黙が続き…	PRINTFORMW 之后一段时间、双方都这样默默地拥抱着…
PRINTFORMW 「……………ぁふ……良い、におい」	PRINTFORMW 「……………啊呜……味道、好香」
PRINTFORMW ようやく%CALLNAME:MASTER%の懐の中で顔を上げた%CALLNAME:TARGET%と目が合うと、	PRINTFORMW 终于、%CALLNAME:MASTER%能够与自怀中抬起头来的%CALLNAME:TARGET%视线交汇、
PRINTFORMW 「……は、ぇ……ん……………ん♪」	PRINTFORMW 「……哈、诶……嗯……………嗯♪」
PRINTFORMW 自然に二人の唇の距離が詰められて、特別な時間の始まりを告げた……	PRINTFORMW 两人嘴唇间的距离自然地越来越近、属于两人的特别时间开始了……
PRINTFORMW 声を掛けられた%CALLNAME:TARGET%はどこか嬉しそうに支度を始めた。	PRINTFORMW 被打了招呼的%CALLNAME:TARGET%好像很开心地开始准备了。
PRINTFORMW 確かにそのつもりで声をかけた手前ではあるが…	PRINTFORMW 虽然打招呼的时候确实是有那方面的打算…
PRINTFORMW %CALLNAME:MASTER%は――	PRINTFORMW %CALLNAME:MASTER%是――
CALL PRINT_SELECT, "悪戯心を発揮した/終わるまでそれを眺めていた"	CALL PRINT_SELECT, "突然想要恶作剧一下/一直等到她做好准备"
PRINTFORMW ――何をしているんですか？	PRINTFORMW ――你在做什么啊？
PRINTFORMW 「……ふえっ？」	PRINTFORMW 「……唔诶？」
PRINTFORMW そう言った風に声を掛けると、いやにテキパキと準備を進めていた%CALLNAME:TARGET%の手が止まる。	PRINTFORMW 突然听到这么没来由的一句话、正麻利地做着准备的%CALLNAME:TARGET%的手停了下来。
PRINTFORMW ゴギギ、と音が鳴りそうな具合でゆっくりと顔をこちらに向ける%CALLNAME:TARGET%。	PRINTFORMW %CALLNAME:TARGET%一顿一顿地转过头来、仿佛能听到生硬的咯吱声。
PRINTFORMW 「えっ、あ、え、えええ、えっ…ち、その、す、するんだよ、ね……？」	PRINTFORMW 「呃、啊、诶、诶诶诶、诶啊…唔、那个、不是、是要做、吗……？」
PRINTFORMW 顔に不安と書かずともそう解る。	PRINTFORMW 一眼就能看出她表情的不安、她好像认为自己会错意了。
PRINTFORMW 先程の機嫌が嘘のように今にも泣きそうな青い顔だ。	PRINTFORMW 刚刚的好心情全都消失了、眼看着就要哭出来。
PRINTFORMW 「うぇ……あ、ぁの、ごめ……%CNAME("一人称" ,"どもり")%」	PRINTFORMW 「诶……啊、那个、对不起……%CNAME("一人称" ,"どもり")%」
PRINTFORMW 流石に可哀想になってきたので冗談だと伝えると、	PRINTFORMW 因为看着实在是太可怜了、所以就告诉她只是开玩笑、
PRINTFORMW 「あ、す、するよね…はぁぁぁああ……良かったぁ」	PRINTFORMW 「啊、还是、要做啊…啊啊啊……太好了」
PRINTFORMW 「も、もう！ お、驚かさないでよ%CNAME("二人称", "どもり")%っ」	PRINTFORMW 「真、真是的！ 别、别吓%CNAME("二人称", "どもり")%啊」
PRINTFORMW 大げさに息を吐いて、怒りながらも%CALLNAME:TARGET%はまた機嫌良さそうに支度を再開した…	PRINTFORMW 夸张地吐了一口气、虽然看起来还气呼呼的、但继续做着准备的%CALLNAME:TARGET%好像心情又好起来了…
PRINTFORMW 「お、おまたせ…」	PRINTFORMW 「久、久等了…」
PRINTFORMW 程なくして彼女の支度は終わった。	PRINTFORMW 没等多久、她就做好准备了。
PRINTFORMW 「ぁ……」	PRINTFORMW 「啊……」
PRINTFORMW 抱き寄せてやると、%CALLNAME:TARGET%は小さく息を吐いて目を閉じた…	PRINTFORMW 一把她抱入怀中、%CALLNAME:TARGET%就微微地喘息起来闭上眼睛…
PRINTFORMW 「え、へへ…♪」	PRINTFORMW 「诶、嘿嘿…♪」
PRINTFORMW Ｈの為に声を掛けられた%CALLNAME:TARGET%は伏し目がちなまま目に見えて顔を歪めた。	PRINTFORMW 在为了要做Ｈ的事情而向%CALLNAME:TARGET%打过招呼之后、虽然她马上低下了头、但还是隐约看到了脸上扭曲的古怪表情。
PRINTFORMW 「あ、え、あ、ち、違う、よっ」	PRINTFORMW 「啊、诶、啊、不、不是哦」
PRINTFORMW そんな自分の表情に気付いたのか、%CALLNAME:TARGET%は頬を赤らめる。	PRINTFORMW 好像是发现自己的表情被看到了、%CALLNAME:TARGET%的脸颊涨的通红。
PRINTFORMW 「う、嬉しいけどっ……」	PRINTFORMW 「虽、虽然是很高兴啦……」
PRINTFORMW 「あっ、い、いいや、あ、あのっえ、えっちなの、が、う、嬉しいんじゃな、なくてっ」	PRINTFORMW 「啊、不、不是、那、那个、是要做Ｈ的事情、好、好、好高兴啊、这样想的」
PRINTFORMW 「%CNAME("二人称", "どもり")%、と…あ、あの、その……」	PRINTFORMW 「和%CNAME("二人称", "どもり")%一起做、…啊、这个、那个……」
PRINTFORMW 「あぅ……」	PRINTFORMW 「啊呜……」
PRINTFORMW 尻すぼみにそう言うと、その台詞の先も恥ずかしいのか目に見えて汗を垂らして黙ってしまった。	PRINTFORMW 她垂下头去、也许是感觉说出这种台词实在是太过害羞、就只好沉默下来了。
PRINTFORMW 「ぅ、ぅうぇ！？」	PRINTFORMW 「唔、呜哇！？」
PRINTFORMW 急に抱き寄せられた%CALLNAME:TARGET%は目に見えて狼狽して表情を固める。	PRINTFORMW 突然被抱入怀中的%CALLNAME:TARGET%明显地惊慌失措起来、表情僵硬。
PRINTFORMW だらだらと汗が伝う頬は紅潮していて、ほのかな熱がこちらにも伝わってきそうだった。	PRINTFORMW 香汗淋漓的脸颊上泛着红晕、怀中娇柔的身体也在传递着微微的热度。
PRINTFORMW 「ぁ、ぁ、ぁ」	PRINTFORMW 「啊、啊~啊~~」
PRINTFORMW 小さく何度も声を出そうとしてか細い嗚咽のようなものが漏れる。	PRINTFORMW 几次都想想要说出什么、却又只能发出几声细微的呜咽。
PRINTFORMW なんとか一息飲み込んだ%CALLNAME:TARGET%は、ようやく状況が察せたのだろう。	PRINTFORMW 终于咽下了一口气的%CALLNAME:TARGET%、好不容易才搞清楚了现在的状况。
PRINTFORMW 「ん、んーーーっ」	PRINTFORMW 「嗯、嗯ーーー唔」
PRINTFORMW ぎゅっと目を瞑って子供がふざけてそうするように自らを抱く%CALLNAME:MASTER%のキスを待つ。	PRINTFORMW 她就那样紧紧地闭上眼睛、等待着像小孩子恶作剧一样突然抱住自己的%CALLNAME:MASTER%的亲吻。
PRINTFORMW ……本人は恐らく大真面目なのだろう…	PRINTFORMW ……她本人恐怕是非常认真的吧…
PRINTFORMW 「あ、%CNAME("二人称" ,"どもり")%……%CNAME("一人称", "どもり")%…と？」	PRINTFORMW 「啊、%CNAME("二人称" ,"どもり")%……和%CNAME("一人称", "どもり")%…？」
PRINTFORMW 「そ、そっかぁ……%CNAME("一人称" ,"どもり")%と……」	PRINTFORMW 「是、是吗……要和%CNAME("一人称" ,"どもり")%……」
PRINTFORMW 「しょ、しょうがない、なぁっ%CNAME("二人称", "どもり")%はぁっ」	PRINTFORMW 「真、真拿%CNAME("二人称", "どもり")%没办法啊」
PRINTFORMW 「……えへへぇ♪」	PRINTFORMW 「……诶嘿嘿♪」
PRINTFORMW 「うぇ……ま、また、ですかぁ……」	PRINTFORMW 「又……又、又要、做吗……」
PRINTFORMW 「い、いえぇ……や、やや、やりまっやり、ますぅ…」	PRINTFORMW 「不、不是……会、会会、会拙的、做的…」
PRINTFORMW 「こ、ここ、こういう、ことって…やっぱり……」	PRINTFORMW 「这、这这、这样、的事情…果然还是……」
PRINTFORMW 「い、いぃい、いえ、な、なんでもない、で、ですぅ…」	PRINTFORMW 「不、不不不、不是、什、什么事都没、没、的…」
PRINTFORMW 「うぇえ……は、恥ずかしい……で、です」	PRINTFORMW 「唔诶……好、好害羞……的、的说」
PRINTFORMW 「で、でで、でも……%CNAME("一人称", "どもり")%が、き……決めたこと、で、ですから…」	PRINTFORMW 「但、但但、但是……这是%CNAME("一人称", "どもり")%自己、的……决定、所、所以说…」
PRINTFORMW %CALLNAME:TARGET%は怯えからか体を震わせたまま顔を伏せた…	PRINTFORMW %CALLNAME:TARGET%可能是感到害怕吧、颤抖着身体、低下头去…
PRINTFORMW 「…………ぇ、え、ぇ、えぇ、と」	PRINTFORMW 「…………诶、诶、那、那、那个」
PRINTFORMW %CALLNAME:TARGET%はベッドの隅に縮こまって中々動かないでいた。	PRINTFORMW %CALLNAME:TARGET%蜷缩在床上的角落里一动不动。
PRINTFORMW 「へぁ！？」	PRINTFORMW 「呀啊！？」
PRINTFORMW 仕方なく諦めを促すように抱き寄せてやると素っ頓狂な声を上げる。	PRINTFORMW 实在是没有办法、像是催促她赶紧放弃抵抗一样抱住她的话、就又会发出尖叫。
PRINTFORMW 「……あ、あああ、ああぁ、あ、の」	PRINTFORMW 「……啊、啊啊啊、啊啊、那、那个」
PRINTFORMW 「…………ぁ、う」	PRINTFORMW 「…………啊、唔」
PRINTFORMW それから顔を真赤にして俯いた彼女は、徐々に%CALLNAME:MASTER%に体を預けた。	PRINTFORMW 脸颊涨的通红、低下头去的她、渐渐将身体托付给了%CALLNAME:MASTER%。
PRINTFORMW 「う、うぇ……そ、そんな、また…」	PRINTFORMW 「唔、唔诶……怎、怎么、又要…」
PRINTFORMW 「%TEXTR("い、言わない/か、からかわない")%で、く、ください……うぅ…」	PRINTFORMW 「%TEXTR("别、别说了/别、别捉弄我了")%、啊、好嘛……呜呜…」
PRINTFORMW 「ぁぅ……顔ま、また、熱い……」	PRINTFORMW 「啊呜……脸上、又变得、好烫……」
PRINTFORMW %CALLNAME:TARGET%は真っ赤になった自身の頬を触って気にしている…	PRINTFORMW %CALLNAME:TARGET%有些出神地抚摸着自己正在发烫的脸颊…
PRINTFORMW 「あ、あの……今日はその……」	PRINTFORMW 「啊、那个……今天那个……」
PRINTFORMW 「い、いぃえ……な、なんでも、その……ない、です……」	PRINTFORMW 「不、不是……什、什么、问题……都、没有……」
PRINTFORMW 「あ……え、ぇと」	PRINTFORMW 「啊……话、话说」
PRINTFORMW 事を始める空気を感じ取ったのか、%CALLNAME:TARGET%は体の前で組んだ指をせわしなく動かして口ごもる。	PRINTFORMW 好像是感觉到要做那种事了、%CALLNAME:TARGET%的手指紧张得交织在一起、结结巴巴地说着。
PRINTFORMW 「きょっ……今日は、その、どっ どう…しましょう、か…へ、えへ、へぇ…」	PRINTFORMW 「今天……今天、的话、要…怎么做、呢…诶、诶嘿、诶嘿…」
PRINTFORMW なんとか目線をこちらに合わせてそう言うと、困ったように笑みを浮かべた。	PRINTFORMW 好不容易才让自己的视线看向这边、她的脸上露出有些困扰的笑容。
PRINTFORMW 「わ、解りました」	PRINTFORMW 「我、我明白了」
PRINTFORMW 「う、上手く、出来るように……がっ、がんばります、ね！」	PRINTFORMW 「我、会尽量、努力……好好、做、的！」
PRINTFORMW %CALLNAME:TARGET%は何やら張り切っているようだ…	PRINTFORMW %CALLNAME:TARGET%不知为何好像很有干劲的样子…
PRINTFORMW 「え、えぇえっ…ちを、その、するのは…き、嫌いじゃない……ですよ」	PRINTFORMW 「唉、诶诶…姑且、算是、不讨厌…做、做这种事……的说」
PRINTFORMW 「そ、その……ほ、褒めて貰えるの……う、うぅ…嬉しいんです……え、えへへ」	PRINTFORMW 「那、那个……还、还会被夸奖……所、所以…很高兴……诶、诶嘿嘿」
PRINTFORMW 「ぁ……あの、その……えと、ご、ごめんなさい…」	PRINTFORMW 「啊……那个、这个……那个、对、对不起…」
PRINTFORMW 「い、いぃ、一番好きな、ぷ、ぷれい、で、ですか……？」	PRINTFORMW 「最、最、最喜欢的、play、是、是吗……？」
PRINTFORMW 「ぁ、ぁ、え、ええと……その……」	PRINTFORMW 「啊、啊、诶、诶诶……那个……」
PRINTFORMW 「な、なめるの……とか……」	PRINTFORMW 「舔、用舌头舔的……什么的……」
PRINTFORMW 「て、手でするの……は、す、好きです…」	PRINTFORMW 「用、用手来做……喜、喜欢、这种…」
PRINTFORMW 「し、してもらうの……き、気持ちよくて……すき、です…」	PRINTFORMW 「做、和你做……就很、舒服……喜、喜欢…」
PRINTFORMW 「じゅ、準備は、で、でで、できてまゅっ(ｶﾞﾘｯ」	PRINTFORMW 「准、准备、做、做做、做好惹」
PRINTFORMW 「ふ、ぇえ…ひ、ひは、はひまひた……ひはい…」	PRINTFORMW 「呼、诶诶…要、要到、蛇头热……唔诶…」
PRINTFORMW 「………………んんっ、何度やっても、な、慣れませんね」	PRINTFORMW 「………………嗯嗯、不管做多少次、都、好难习惯啊」
PRINTFORMW 「あ、あは、はは…ほほ、ほんと、%CNAME("一人称")%って、ど、ドン臭い…なぁ…」	PRINTFORMW 「啊、啊哇、哈哈…真真、真是的、%CNAME("一人称")%啊、真、真迷糊…啊…」
PRINTFORMW 「え、ぇと……は、始めましょう、か…」	PRINTFORMW 「诶、那个……开、开始、吧…」
PRINTFORMW 「す、少しは、ど、度胸もついてきてると……い、良いんですけど、ね」	PRINTFORMW 「稍、稍微、提、提高了点胆量……好、好像也不错、嘛」
PRINTFORMW %CALLNAME:TARGET%は困ったような笑みを浮かべている	PRINTFORMW %CALLNAME:TARGET%的脸上露出了为难的笑容。
PRINTFORMW 「ふ、ふぅううう……よ、良かったぁ……」	PRINTFORMW 「呼、呼咻~~~~……太、太好了……」
PRINTFORMW 目が覚めると、%CALLNAME:TARGET%の膝の上だった。	PRINTFORMW 醒过来的时候、正枕在%CALLNAME:TARGET%的膝盖上。
PRINTFORMW 「が、頑張ってくれたのは、嬉しいけど……が、頑張り過ぎちゃ、だ、駄目だよ」	PRINTFORMW 「这、你这么努力、我好高兴……但、但努力过头是、不、不行的哦」
PRINTFORML 心配しているというよりはもはや呆れているという表情で	PRINTFORML 那脸上的表情与其说是担心、不如说是惊讶到目瞪口呆的程度
PRINTFORMW こちらを覗く%CALLNAME:TARGET%はわざとらしく頬をふくらませている。	PRINTFORMW 看着这边的%CALLNAME:TARGET%故意地鼓起了腮帮子。
PRINTFORMW どうやら倒れたことにご立腹のようで、頑張って怒っている顔を作っているのが解った。	PRINTFORMW 看得出来、她好像还在因为这边突然倒下的事而担心、所以正在努力做出生气的样子。
PRINTFORMW 「……で、でも」	PRINTFORMW 「……但、但是」
PRINTFORMW かと思えば、その頬は嘘のように緩んで、	PRINTFORMW 好像想到了什么、她那生气的表情又松弛下来、
PRINTFORMW 「よ、喜んでくれたんだよね……良かったぁ」	PRINTFORMW 「我、我有让你感觉很满足吧……太好了」
PRINTFORMW えへへ、と笑ってみせるのだった。	PRINTFORMW 诶嘿嘿、又露出了她平时一贯的傻笑。
PRINTFORMW 「あっ…あ、ぅ、あぁ！ だ……だだだ、大丈夫！？」	PRINTFORMW 「啊…啊、唔、啊啊！ 没……没没没、没关系吗！？」
PRINTFORMW 「良かったぁ……あ、あの…辛かったら、言うん、だ、だよ？」	PRINTFORMW 「太好了……那、那个…要是感觉很辛苦的话、要说、说出来、哦？」
PRINTFORMW 限界に倒れた%CALLNAME:MASTER%が目を覚ますと、頭に柔らかい感触を感じた。	PRINTFORMW 因为到达极限而倒下的%CALLNAME:MASTER%醒来的时候、头上传来了柔软的触感。
PRINTFORMW 「……お、おはよ、%CNAME("一人称")%」	PRINTFORMW 「……早、早上好、%CNAME("一人称")%」
PRINTFORMW うっすらと目を開けるとこちらを見下ろす%CALLNAME:TARGET%の顔が見える。	PRINTFORMW 微微睁开眼睛、就能看到%CALLNAME:TARGET%俯视着这边的面容。
PRINTFORMW どうやら膝枕をされていたらしい…	PRINTFORMW 好像是正枕在她的膝盖上…
PRINTFORMW 「お疲れ様……が、頑張ったねぇ……」	PRINTFORMW 「辛苦了……很、很努力呢……」
PRINTFORMW 「も、もう少し、ね…休んでて…」	PRINTFORMW 「再、再稍微、休…休息一下吧…」
PRINTFORMW %CALLNAME:TARGET%は%CALLNAME:MASTER%の髪を撫ぜながら途切れがちにそう言った…	PRINTFORMW %CALLNAME:TARGET%一边抚摸着%CALLNAME:MASTER%的头发、一边这样说着…
PRINTFORMW 「あ、ぁ、あ、あれ！？」	PRINTFORMW 「啊、啊、啊、啊嘞！？」
PRINTFORMW 「%CNAME("一人称" ,"どもり")%！？ あ、わわ、あわわわぁああ！？」	PRINTFORMW 「%CNAME("一人称" ,"どもり")%！？ 啊、哇哇、啊哇哇哇啊啊！？」
PRINTFORMW 「ぇぐっ……ぇぐっ…ひっぐ…よ、よ゛、ぉ、よ゛がっ゛だぁ゛ぁ゛！」	PRINTFORMW 「呜呜……呃…呜呜…太、太、太、太好了！」
PRINTFORMW 「ぶ、ぶぶぶ、ぶじっ…ぶじでじだぁ゛ぁ゛…」	PRINTFORMW 「唔、呜呜、你没…没事真是太好了…」
PRINTFORMW 「……ふぁ」	PRINTFORMW 「……呼啊」
PRINTFORMW 体力の限界が来た様子の%CALLNAME:TARGET%を膝を貸してやると、彼女は驚いた様子できょとんとした顔をする。	PRINTFORMW 准备把膝盖借给体力已经到极限的%CALLNAME:TARGET%枕一下的时候、她好像很吃惊的样子、露出了呆滞的表情。
PRINTFORMW 「……えへ、へへへ…」	PRINTFORMW 「……诶嘿、嘿嘿嘿…」
PRINTFORMW 「あの、あのね……楽しい……クリスマス、で、でした♪……な、なんちゃって……へ、へへ…」	PRINTFORMW 「那个、总感觉……好高兴……圣诞节、好、开心♪……什、什么的……嘿、嘿嘿…」
PRINTFORMW %CALLNAME:MASTER%の胴に手を回して鼻を擦り付けてはにかんだ…	PRINTFORMW 她收回了在%CALLNAME:MASTER%身上摸来摸去的手、害羞地蹭了蹭鼻子…
PRINTFORMW 「ぅう…ごめん、ね……た、体力、なくて…」	PRINTFORMW 「呜呜…对不、起……没、没有、体力了…」
PRINTFORMW 「こ、今度は、もっと、が、がんばる、から…」	PRINTFORMW 「下、下次、会更加、努、努力的…」
PRINTFORMW 「%CNAME("一人称")%…すぐに参っちゃうなぁ」	PRINTFORMW 「%CNAME("一人称")%…就要吃不消了啊」
PRINTFORMW 「や、やっぱり…う、運動とかした方が良いのか、な」	PRINTFORMW 「果、果然…还、还是运动一下比较好、吗」
PRINTFORMW 「もっといっぱい、%CNAME("二人称" ,"どもり")%と……し、シたい…し…」	PRINTFORMW 「还想、和%CNAME("二人称" ,"どもり")%做……做、更多……」
PRINTFORMW 「ぅぇぇ…」	PRINTFORMW 「唔诶诶…」
PRINTFORMW 体力の限界に達したのか%CALLNAME:TARGET%はうめき声を上げながら突っ伏してしまった。	PRINTFORMW 好像是体力用尽了、%CALLNAME:TARGET%发出不像话的声音倒了下去。
PRINTFORMW 「ぜぇ…ぜぇ…はふっ……はっふ……ふぅ…」	PRINTFORMW 「唔诶…诶…哈呼……哈呼……呼…」
PRINTFORMW 「ごめ…ふ…ごめんなさ…ぅ」	PRINTFORMW 「对不…呼…对不起…呼」
PRINTFORMW 「%CNAME("一人称")%…体力、ない…ので…ご、ごめんなさい…ぃ」	PRINTFORMW 「%CNAME("一人称")%…没、没有…体力了…对、对不起…」
PRINTFORMW 「……えへへ…」	PRINTFORMW 「……诶嘿嘿…」
PRINTFORMW 余裕を残して行為を終え、%CALLNAME:TARGET%は軽く%CALLNAME:MASTER%に口付けをした。	PRINTFORMW 性行为以彼此都很满意的程度结束了、%CALLNAME:TARGET%轻轻地吻了%CALLNAME:MASTER%一下。
PRINTFORMW 「……凄くね……今、凄く温かいの」	PRINTFORMW 「……感觉……现在、好温暖」
PRINTFORMW %CALLNAME:MASTER%の腕に手を回して握り込んだ手は情事の余韻もあって冬場だと言うのに確かに暖かい。	PRINTFORMW 她环抱着%CALLNAME:MASTER%的手臂来回摩挲着、正在享受性事的余韵、虽然是冬天、但确实很温暖。
PRINTFORMW 「……素敵なクリスマス……だなぁって……えへ、へへへ♪」	PRINTFORMW 「……真是……很棒的圣诞节啊……诶嘿、嘿嘿嘿♪」
PRINTFORMW 「え、えへへぇ……」	PRINTFORMW 「诶、诶嘿嘿……」
PRINTFORMW 「ぁ、ぅ……いっぱい、できたなっ…て…お、思っただけ、なんだけど」	PRINTFORMW 「啊、唔……好像做了、好多啊……虽、虽然是这么想的」
PRINTFORMW 「あ、あ、ま、満足……できた、かな…%CNAME("一人称")%うまく……で、できてたかな…」	PRINTFORMW 「啊、啊、有、让你……满足了吗…%CNAME("一人称")%有做的……很、很好吗…」
PRINTFORMW 「…………えへへぇ…そ、それなら、い、いいなぁ」	PRINTFORMW 「…………诶嘿嘿…那、那就好、太、好了」
PRINTFORMW 「……ぅ、ぅう」	PRINTFORMW 「……唔、呜呜」
PRINTFORMW 何やら%CALLNAME:TARGET%は膝を抱えて唸っていた。	PRINTFORMW 不知为何%CALLNAME:TARGET%抱着膝盖呻吟起来。
PRINTFORMW 「ぁ、ぁあ、あの、%CNAME("一人称" ,"どもり")%……い、いっぱい…」	PRINTFORMW 「啊、那、那个、%CNAME("一人称" ,"どもり")%……做、做了那么多…」
PRINTFORMW 「ぁぅ…………は、恥ずかしぃ…」	PRINTFORMW 「啊呜…………好、好害羞…」
PRINTFORMW どうやら今回の行為を今更反芻しているようだ…	PRINTFORMW 看起来好像还在回味这次的体验…
PRINTFORMW 「あ…お、終わ、る？…つ、つかれ、ちゃった、かな？」	PRINTFORMW 「啊…结、结束、了？…累、很累了、吗？」
PRINTFORMW 「そ、そっか……」	PRINTFORMW 「是、是吗……」
PRINTFORMW 「あ、あのっ……つ、疲れた、なら」	PRINTFORMW 「那、那个……要是、累了的话」
PRINTFORMW 「お、おひ、ひぃひ、ひじゃ……んっぐ……」	PRINTFORMW 「不、不介意、吸、嘻溪……膝枕……」
PRINTFORMW 「……お膝…をぉ、貸して……あ、あげ、ます……る」	PRINTFORMW 「……把膝盖…借、借给……你、枕、枕一下……」
PRINTFORMW 「も、もういい、の？」	PRINTFORMW 「已、已经可以、了吗？」
PRINTFORMW 「……そ、そっかぁ…ぅう」	PRINTFORMW 「……是、是吗…唔」
PRINTFORMW 「あ、い、い、にゃな、なんっなんでもないよ！」	PRINTFORMW 「啊、不、不、不是哦、什么问题都没有！」
PRINTFORMW 「た、ただ……も、もう少し…そ、その…」	PRINTFORMW 「只、只是……再、再稍微…那、那个…」
PRINTFORMW 「……もう少し、一緒に…い、居て欲し……くて…」	PRINTFORMW 「……还想、再稍微…一起……待一会…」
PRINTFORMW 「ぁぅ……ごめん、なさい……」	PRINTFORMW 「啊呜……对不、起……」
PRINTFORMW 「え、えぇと……終わり……で、い、良い、んですよ…ね？」	PRINTFORMW 「诶、诶诶……结束了吗……我、做、做的、还好…吗？」
PRINTFORMW 「うぇぇ……ま、まだ、ど、ドキドキします…」	PRINTFORMW 「唔诶……心、跳的、好快…」
PRINTFORMW 「ふ、ふぅううう……お、終わりましたぁ…」	PRINTFORMW 「呼、呼唔~~~~……结、结束了啊…」
PRINTFORMW 「き……気持ちよかった、です、か？」	PRINTFORMW 「有……感觉很舒服、吗？」
PRINTFORMW 「……そ、そうです…か……え、えへへぇ…よ、よかった…」	PRINTFORMW 「……是、是这样…吗……诶、诶嘿嘿…太、太好了…」
PRINTFORMW 「う、うぇええ……い、いい、いえ…嫌だったとか、じゃ、なくて…」	PRINTFORMW 「唔、唔诶诶……不、不不、不是…并不是感觉讨厌、的…」
PRINTFORMW 「お、おおちついたら、きゅ、急に恥ずかしさが……ぅぅ…」	PRINTFORMW 「一、一冷静下来、就、就突然感觉好害羞……呜呜…」
PRINTFORMW 「ひ、ぃ！？……な、なな、なんです、かぁ！？」	PRINTFORMW 「咦、咿！？……在、在在、干干什么、啊！？」
PRINTFORMW 「ぁ、ぇ…さ、触る、だけ…？」	PRINTFORMW 「啊、诶…只、只是、在摸…？」
PRINTFORMW 「……わ、解りました…え、ええ、エッチな事って…そういうこと、するん、です、よね…」	PRINTFORMW 「……我、我明白了…做、做做、色色的事…就是像这样、做的、吧…」
PRINTFORMW 「ぇい、いいいい、いえぇ……や、やったこと、とか、無くって…」	PRINTFORMW 「不、不不不不、不是……没、这种事、从来、都没做过…」
PRINTFORMW 「そ、そのぉ……ま、漫画、とか……」	PRINTFORMW 「那、那个……看、看过、漫画……」
PRINTFORMW 「ふぇ……え、あの……な、なんで…………？」	PRINTFORMW 「呼诶……诶、那个……为、为啥…………？」
PRINTFORMW 足での無造作な愛撫をやめ、優しげな手付きで愛撫してやると%CALLNAME:TARGET%は困惑した表情を見せた。	PRINTFORMW 停下用足尖随意的拨弄、而慢慢地温柔抚摸的话、%CALLNAME:TARGET%就露出了一幅困惑的表情。
PRINTFORMW 「あ、う、%CNAME("二人称", "どもり")%……んっ………ぅう……」	PRINTFORMW 「啊、唔、%CNAME("二人称", "どもり")%……嗯………呜呜……」
PRINTFORMW 指先が性感帯をなぞる度に体は反応しているが、どうにも物足りなさそうにしている…	PRINTFORMW 每当指尖划过性感带的时候、她的身体都会起反应、但只是这样的话好像怎么都不满足…
CALL PRINT_STRW, "「……んひっ_HH_」"	CALL PRINT_STRW, "「……嗯咿_HH_」"
PRINTFORMW 仕方なく軽く足先で触れてやると、今度は短い嬌声を上げた…	PRINTFORMW 是在没办法、用足尖轻轻触碰了一下、这次又发出了简短的娇吟…
PRINTFORMW 「……あ……え、えへへ…………」	PRINTFORMW 「……啊……诶、诶嘿嘿…………」
PRINTFORMW 無造作な愛撫をやめて、手による愛撫を始めると、目を瞑って耐えていた%CALLNAME:TARGET%は顔を綻ばせた。	PRINTFORMW 停下自己不加修饰的粗暴动作、用更加温柔的力度爱抚的话、闭着眼忍耐着的%CALLNAME:TARGET%也露出了笑容。
PRINTFORMW 「う、うん……気持ちいい、よ……えと、さっきも、気持ちよかった、け、けど……」	PRINTFORMW 「唔、唔嗯……很舒服、哦……嗯、刚才也、很舒服、但、但是……」
PRINTFORMW 「……演技だって、解ってても……さっきの%CNAME("二人称", "どもり")%……とっても、こ、怖かった、から……」	PRINTFORMW 「……我也知道、刚刚的是演技……但是那时的%CNAME("二人称", "どもり")%……看起来、好、好可怕……」
CALL PRINT_STRW, @"「はっ_HH_ ひゅっ_HH_ま、待って、よぉ……%CNAME("二人称" ,"どもり")%……ぁぅ_HH_」"	CALL PRINT_STRW, @"「哈啊_HH_ 咻_HH_等、等下、啊……%CNAME("二人称" ,"どもり")%……啊呜_HH_」"
CALL PRINT_STRW, "「ひぃっ_HH_ ……い、いいいまだめっだめだよぉっ_HH_」"	CALL PRINT_STRW, "「咿~咿_HH_ ……现、现现现在不行啊_HH_」"
CALL PRINT_STRW, "「はひっ_HH_ はひっ_HH_ や、やだっ い、いいいまやさひくさわっちゃ_HH_」"	CALL PRINT_STRW, "「哈_HH_ 哈咿_HH_ 糟、糟糕、现现在、不要碰啊_HH_」"
CALL PRINT_STRW, "「いぃ_HH_ いじ、ひじっ_HH_ ひじわるっ_HH_」"	CALL PRINT_STRW, "「咿咿_HH_ 别、不要_HH_ 别使坏啊_HH_」"
CALL PRINT_STRW, @"「%CNAME("二人称" ,"どもり")%しゅ、すっ、いっぱ、いっぱいひじわるだよぉっ_HH_」"	CALL PRINT_STRW, @"「%CNAME("二人称" ,"どもり")%啊、摸了那么多地方、揉的太卖力了啊_HH_」"
CALL PRINT_STR, @"「ひぁっ_HH_ %CNAME("二人称", "どもり")%っ_HH_ い、今、今ダメ、だ、よっ」_W"	CALL PRINT_STR, @"「咿呀_HH_ %CNAME("二人称", "どもり")%_HH_ 现、现在、现在不行、啊」_W"
CALL PRINT_STR, @"「わ、わきっ、わきなめちゃっ_HH_　び、びんかんっにゃっ_HH_」_W"	CALL PRINT_STR, @"「啊、腋下、不要舔_HH_　那、那里很敏感啊_HH_」_W"
PRINTFORMW 「あ、ぅう！？ ……そこ、わ、腋っ……」	PRINTFORMW 「啊、呜呜！？ ……腋、腋下……」
PRINTFORMW 「%TEXTR("な、なめっ/や、やめっ")%……んっひっ……%TEXTR("あっぐっは、あははははっ！/ひっ")%」	PRINTFORMW 「%TEXTR("别、别舔/呀、住手")%……嗯咿……%TEXTR("啊咕啊、啊哈哈哈！/咿呀")%」
PRINTFORMW 「うぇっ……うぇえ……わ、腋、腋はっ……ひっ……」	PRINTFORMW 「唔……唔诶……居、居然、舔腋下………」
PRINTFORMW 「く、くすぐっ……ふっ……%TEXTR("ふひひっ/ふひゃひゃっ/あははははっ")%！」	PRINTFORMW 「好、好痒……呼……%TEXTR("呼嘿嘿/呼咻~呼咻/啊哈哈哈")%！」
PRINTFORMW 「あのね……あの……触られるの、す、好き……なんだぁ…」	PRINTFORMW 「那个……那个……被触摸什么的、好、喜欢……啊…」
CALL PRINT_STRW, "「……え、へへ……だ、だからもっと、さ、触って欲しい…なぁ、なん、て_HH_」"	CALL PRINT_STRW, "「……诶、嘿嘿……所、所以说、再、多摸摸我…啊_HH_」"
PRINTFORMW 「あ……触、る…の？」	PRINTFORMW 「啊……要、摸…吗？」
CALL PRINT_STRW, "「え、へへぇ……い、いい、よ……ど、どど、どうぞ_HH_」"	CALL PRINT_STRW, "「诶、嘿嘿……好、好的……请、请请、摸吧_HH_」"
PRINTFORMW 「ぁ、%TEXTR("ふぁ/ぁ/ん")%……」	PRINTFORMW 「啊、%TEXTR("呼啊/啊/嗯")%……」
PRINTFORMW 「……%CNAME("二人称" ,"どもり")%の、手……だぁ…」	PRINTFORMW 「……%CNAME("二人称" ,"どもり")%的、手……啊…」
PRINTFORMW 「……ぃ、へ、へへぇ……♪」	PRINTFORMW 「……咿、嘿、嘿嘿……♪」
PRINTFORMW 「%TEXTR("ぁ/ぇ/あぅ")%……お、おわ……った？」	PRINTFORMW 「%TEXTR("啊/诶/啊咿")%……结、结束……了？」
PRINTFORMW 足による愛撫を止めて、手で優しく愛撫してやると、%CALLNAME:TARGET%は一瞬、落胆したような声を上げる。	PRINTFORMW 停止用脚爱抚的动作、转而用手温柔地爱抚的话、有一瞬间、%CALLNAME:TARGET%发出了失望的声音。
PRINTFORMW しばらくの間、その視線は%CALLNAME:MASTER%の足に注がれていた…	PRINTFORMW 那之后的一段时间、她的视线都注视在%CALLNAME:MASTER%的脚上…
PRINTFORMW 「……ひっ……ぃ、ぁ……ぇ？」	PRINTFORMW 「……咿……咿、啊……诶？」
PRINTFORMW また足による酷い愛撫をされるのかと身を硬直させた%CALLNAME:TARGET%に、優しく触れてやる。	PRINTFORMW 停下了脚步粗暴的爱抚动作、转而温柔地抚摸起%CALLNAME:TARGET%紧绷僵硬的身体。
PRINTFORMW 「あ、ああ、足、しない……です…………%TEXTR("はひっ/んんっ/ぁ")%……」	PRINTFORMW 「不、不不、不用脚、做了……吗…………%TEXTR("哈咻/嗯/啊")%……」
PRINTFORMW 指先が彼女をなぞる度に硬直は徐々に解け、最後には頭を預ける形で寄りかかる…	PRINTFORMW 每当指尖在她是身体上拂过、她因为紧张而僵直的身体都会变得放松、最后慢慢地、她的头也靠近了怀中…
PRINTFORMW 「ぅ、ぁう……よ、よ」	PRINTFORMW 「呜、啊呜……嘤、嘤」
PRINTFORMW しばらくして、スンッスンッと啜るような声が聞こえ、	PRINTFORMW 没过一会、就听到了她的啜泣声、
PRINTFORMW 「……よ、よかったぁ…ぁ、ぁあ……い、いつもの、%CNAME("二人称", "どもり")%、で、ですぅ……」	PRINTFORMW 「……太、太好了…啊、啊啊……还、还是平时的、那个、%CNAME("二人称", "どもり")%……」
PRINTFORMW　はらはらと涙を流す%CALLNAME:TARGET%の頭を%CALLNAME:MASTER%は優しく撫でてやった。	PRINTFORMW　面对着泪眼婆娑的%CALLNAME:TARGET%、%CALLNAME:MASTER%也像平时那样温柔地摸了摸她的头。
CALL PRINT_STRW, "「あっあっ、あの、あぅ_HH_」"	CALL PRINT_STRW, "「啊那、那个、啊呜_HH_」"
CALL PRINT_STRW, "「ふっ_HH_ あ、ぅ_HH_い、今そ、そんなさわっちゃ……ひぁっ_HH_」"	CALL PRINT_STRW, "「呼_HH_ 啊、呜_HH_刚、刚刚、那种摸法……不行_HH_」"
CALL PRINT_STRW, "「ぁ、う……も、もう、つ、疲れっ……ぃひ_HH_」"	CALL PRINT_STRW, "「啊、呜……已、已经、累、累了啊……咿_HH_」"
CALL PRINT_STRW, "「また、ゆびっ_HH_」"	CALL PRINT_STRW, "「手指、又要_HH_」"
PRINTFORMW 「ひぅっ……ふぇ？ ど、どんな感じ、か、ですか…？」	PRINTFORMW 「咿呜……呼诶？ 现在、什、什么感觉、吗…？」
PRINTFORMW 「き、気持いい、です……あの……じ、じんじん…くる…」	PRINTFORMW 「很、很舒服……那个……感觉、有些…麻麻的…」
PRINTFORMW 「んっ……っ……はぁ、わ、ぅ…………」	PRINTFORMW 「嗯……啊……哈啊、哇、唔…………」
PRINTFORMW 「あ、あの……もう少し、そ、その……だ、大丈夫、ですよ……つ、強くしても……」	PRINTFORMW 「那、那个……再稍微、那、那个……再、激烈一些、也……没关系的哦……」
CALL PRINT_STRW, "「……んっ_HH_」"	CALL PRINT_STRW, "「……嗯_HH_」"
PRINTFORMW 「っ……っ……は、ひ……んぁっ……んん……」	PRINTFORMW 「呜…………哈、咿……嗯啊……嗯嗯……」
PRINTFORMW 指先が彼女を撫でる度に、%CALLNAME:TARGET%は控え目な喘ぎを漏らした…	PRINTFORMW 每当指尖拂过她的身体、%CALLNAME:TARGET%都会止不住漏出剧烈的喘息…
PRINTFORMW 「っ……あ、ぅ……ご、ごめんなさいぃ……」	PRINTFORMW 「……啊、呜……对、对不起……」
PRINTFORMW 「あの、あの……や、優しくしてくれるのは、わ、わかってるんですけどぉ…」	PRINTFORMW 「那个、那个……虽、虽然知道、你对我、很温柔…」
PRINTFORMW 「ひぃ…………ぁ……ぅ……あ、ぅ、うぇえ…」	PRINTFORMW 「咿…………啊……呜……啊、呜、唔诶…」
PRINTFORMW 「ご、ごめんなさい…%TEXTR("触られるの……あんまり、慣れて、な、なく……て/ま、まだ少し、怖い……です…")%」	PRINTFORMW 「对、对不起…%TEXTR("还不怎么……习惯、被、被、被摸……/还、还是有点、害怕………")%」
PRINTFORMW 「わ、わわわっそ、そっち、はっ」	PRINTFORMW 「哇、哇哇哇、那边、哈」
PRINTFORMW 「%TEXTR("ぃきっ/あぅっ/きゅっ")%……%TEXTR("や/も")%…%TEXTR("ぴりっ/びくっ")%て……し、します…」	PRINTFORMW 「%TEXTR("咿咿/啊呜/咿啊")%……%TEXTR("呀/哦")%…%TEXTR("好痒/一跳一跳的")%……」
PRINTFORMW 「お、重く……ない？」	PRINTFORMW 「不、不……重吗？」
PRINTFORMW 「つ、辛かったらちゃんと、お、教えて、ね……」	PRINTFORMW 「要、要是觉得难受的话、要、告诉我、啊……」
PRINTFORMW 「う、うぇえ……あ、あの、い、息、で、出来なかったら、教えて下さっ、さいねっ」	PRINTFORMW 「唔、呜诶……那、那个、要、要是、不、不能呼吸了的话、要告诉我、哦」
PRINTFORMW 「ぃ、ひひ……%CNAME("二人称", "どもり")%、どう？ いいにおい…？」	PRINTFORMW 「咿、嘻嘻……%CNAME("二人称", "どもり")%、怎样？ 好闻吗…？」
PRINTFORMW 「じゃ、じゃあ、言うことがあるよね……ありがとう、って…い、言うんだよね？」	PRINTFORMW 「那、那么、这个时候……应该、说、谢谢的吧？」
PRINTFORMW 「へ、へぇ…言えないんだぁ……？ ふひっ…じゃあずぅっと座ってようかなぁ…♪」	PRINTFORMW 「嘿、嘿…说不出来吗……？ 呼呼…那么就这样一直坐着喽…♪」
PRINTFORMW 「%CNAME("二人称", "どもり")%のだぁい好きな、臭い♪」	PRINTFORMW 「是%CNAME("二人称", "どもり")%最喜欢的、臭味哦♪」
PRINTFORMW 「そぉれぇはぁ……んひぃっ♪ えへ、ふひっ……♪」	PRINTFORMW 「来了哦……嗯咿♪ 诶嘿、呼诶……♪」
PRINTFORMW 「の、乗っちゃったぁ♪ %CNAME("一人称", "どもり")%、自分から%CNAME("二人称")%の顔に、お、お尻乗せちゃった♪」	PRINTFORMW 「坐、坐上去了♪ %CNAME("一人称", "どもり")%、把自己的屁股坐到%CNAME("二人称")%的脸上了♪」
PRINTFORMW 「ね、臭い？ 臭いかなぁ…っ 臭いって言ってたもんねぇ…っ」	PRINTFORMW 「怎样、臭吗？ 很臭吧…我都说了很臭了吧…」
PRINTFORMW 「じゃあ%CNAME("二人称")%は、ふ、ふひっ……%CNAME("二人称", "どもり")%のく、くっさぁい臭い、す、好きなんだねぇ♪」	PRINTFORMW 「那么%CNAME("二人称")%是、呼、呼嘻……%CNAME("二人称", "どもり")%是最喜欢、这个难以忍受的臭味的吧♪」
CALL PRINT_STR, "「おちんちんは、正直だねぇ……え、偉い、ねえ_HH_」_W"	CALL PRINT_STR, "「小鸡鸡倒是、很诚实哦……了、了不起、了不起_HH_」_W"
PRINTFORMW 「…いひぃっ♪ く、首振ってぇどうしたのぉ、%CNAME("二人称", "どもり")%♪」	PRINTFORMW 「…咿嘻嘻♪ 头、头摇的那么厉害是怎么了、%CNAME("二人称", "どもり")%♪」
CALL PRINT_STR, "「ぁ……_HH_ き、気持ちよくしてくれるんだねぇ…_HH_」_W"	CALL PRINT_STR, "「啊……_HH_ 是感、感觉很舒服的吧…_HH_」_W"
PRINTFORMW 「あ、ありがとうねぇ♪ じゃあ、お、お礼に……ぃひひっ♪ もっとた、体重……掛けてあげるねぇ♪」	PRINTFORMW 「谢、谢谢♪ 那么、做、作为回礼……咦嘻嘻♪ 要更加、用力……了哦♪」
PRINTFORMW 「ふ、ふへへ……し、知ってるよぉ、%CNAME("二人称")%」	PRINTFORMW 「呼、呼嘿嘿……我、知道的哦、%CNAME("二人称")%」
PRINTFORMW 「%CNAME("一人称", "どもり")%にす、座られるの、す、好きだよ、ねぇ…っ」	PRINTFORMW 「被%CNAME("一人称", "どもり")%、坐在身下、很、很喜欢的、吧…」
PRINTFORMW 「く、くさいくさいって、い、言うくせにっ……す、好きなんだよねっ」	PRINTFORMW 「明、明明嘴上说着、好臭、好臭什么的……不、不还是挺喜欢的吗」
PRINTFORMW 「い、良いんだよ……い、いひひっ……い、いっぱい、いーっぱい……座ってあげる、ね……ひっ」	PRINTFORMW 「好、好啊……咿、咿嘻嘻……在、在你满足、之前……我都会一直坐在、你……脸上哦」
PRINTFORMW 「だ、だめだよぉ。%CNAME("二人称")%のお顔はい、い、いま、%CNAME("一人称")%の椅子なんだから…」	PRINTFORMW 「不、不行哦。因为%CNAME("二人称")%的脸现、现、现在、是%CNAME("一人称")%坐着的椅子啊…」
PRINTFORMW 「っ、ね？……だから、じぃっと、してて、ね？……ふ、ふひっ…」	PRINTFORMW 「对吧？……所以、要、乖乖的、哦？……呼、呼嘻…」
PRINTFORMW 「%CNAME("一人称", "どもり")%くっ臭くて、ご、ごめん、なさいぃっ」	PRINTFORMW 「%CNAME("一人称", "どもり")%有点臭、对、对不、对不起」
PRINTFORMW 「で、でもぉ、おお、お風呂ちゃんと入った、か、からぁっ」	PRINTFORMW 「但、但是、我我、我有在认真洗澡的、所、所以说」
PRINTFORMW 「だだ、だからっ、%TEXTR("あぅっ/いきゅっ/あぃっ/はふっ")%……%TEXTR("ぃひ/ふぃ/あ")%っ♪」	PRINTFORMW 「所所、所以说、%TEXTR("啊呜/咿嘻/啊咿/哈呼")%……%TEXTR("咿/呼/啊")%♪」
PRINTFORMW 「お、重いよねっ い、今、ど、どど、どくからっ」	PRINTFORMW 「很、很重吧 现、现、现在、就就、站起来」
PRINTFORMW そう言いつつ腰を上げた%CALLNAME:TARGET%の%TEXTR("アソコ/秘部/おまんこ")%に、%CALLNAME:MASTER%の息が吹き掛かる。	PRINTFORMW 说着就要抬起腰来的%CALLNAME:TARGET%的%TEXTR("那里/秘部/小穴")%、感受到了%CALLNAME:MASTER%那深润的吐息。
