//文件: EVENT_K47_DAILY.ERB
PRINTFORMW 「ごめん、我慢できなかった。他に我慢できなかった二人もつれてきたけど、いいよね？」	PRINTFORMW 「ごめん、我慢できなかった。他に我慢できなかった二人もつれてきたけど、いいよね？存疑」
PRINTFORMW 「朝ごはん？はい、母乳」	PRINTFORMW 「想吃早饭吗？给你，这是我的母乳」
PRINTFORMW 「少しは抑えてよ！流石に危ないよ！」	PRINTFORMW 「稍微克制一下，再怎么说也太危险了呀！」
PRINTFORMW 「んっ」	PRINTFORMW 「嗯~」
PRINTFORMW 「あ、起きた。おはよう」	PRINTFORMW 「啊，起来了吗。早上好」
PRINTFORMW 「メイドさんが朝ごはん、作ってるみたいだよ。一緒に食べよ?」	PRINTFORMW 「女仆小姐正在做饭呢，要一起吃吗?」
PRINTFORMW 「おはよう」	PRINTFORMW 「早上好」
PRINTFORMW 「メイドさんが朝ごはん、作ってるみたいだよ。一緒に食べよ?」	PRINTFORMW 「女仆小姐正在做饭呢，要一起吃吗?」
PRINTFORMW 「ご馳走様。美味しかったよ」	PRINTFORMW 「多谢款待。很美味哦」
CALL PRINT_STRW, "「ん…_WH_」"	CALL PRINT_STRW, "「嗯…_WH_」"
PRINTFORMW 「あ、起きた。おはよう」	PRINTFORMW 「啊，起来了吗。早上好」
PRINTFORMW 「はい、%CNAME("二人称")%の体育服。今日は体育がある日だよ。頑張ってね。」	PRINTFORMW 「给，这是%CNAME("二人称")%的体育服。今天有体育课哦，加油吧。」
PRINTFORMW 「ほら、早く朝ごはん食べて学校行かないと遅刻するよ？」	PRINTFORMW 「快点吃晚早饭去学校吧，不然就要迟到了吧？」
PRINTFORMW 「私達が一番乗りみたいですね」	PRINTFORMW 「我们也想一起去呢」
PRINTFORMW 「まぁすぐみんな来てくれるよね」	PRINTFORMW 「嘛，大家不久以后就会来了吧」
PRINTFORMW 「ただいま。」	PRINTFORMW 「就在刚刚。」
PRINTFORMW 「お帰りなさい。待ってたよ」	PRINTFORMW 「欢迎回家，稍等一下哦」
PRINTFORMW 「夕食の前にベットに行かない？風呂？そんなこと気にしなくても大丈夫だよ？」	PRINTFORMW 「吃晚饭前要先和我一起上床吗？洗澡？不用在意这种事情也可以啦」
PRINTFORMW 「先に来てたよ。今日は何するの？」	PRINTFORMW 「我先来了哟。今天要做什么呢？」
PRINTFORMW 「もちろん私としてくれるよね？そろそろ限界なんだ…」	PRINTFORMW 「当然要和我做了对吧，我已经忍耐到极限了」
PRINTFORMW 「急ぎの用事？とりあえず来たよ」	PRINTFORMW 「有急事？总之先跟我来就好啦」
PRINTFORMW 「ううぅ...入って大丈夫なのかな....」	PRINTFORMW 「唔唔...进去真的没问题吗....」
PRINTFORMW 彼女は不安そうにしながら入ってきた。	PRINTFORMW 她一边感到很不安，一边进入了。
PRINTFORMW 「あ、もう皆さん来ていたのですね。こんにちは。」	PRINTFORMW 「啊，大家已经到期了吗。下午好。」
PRINTFORMW 「呼ばれたから来たよ」	PRINTFORMW 「听到有人在叫我，所以我过来了哦」
PRINTFORMW 「%CNAME("二人称")%に用でもあるの？」	PRINTFORMW 「%CNAME("二人称")%接下来有什么预定吗」
PRINTFORMW 「こんにちは。」	PRINTFORMW 「下午好。」
PRINTFORMW 『%CNAME(CALLNAME_ACTOR)%、こんにちは』	PRINTFORMW 『%CNAME(CALLNAME_ACTOR)%老师、下午好。』
PRINTFORMW 『%CNAME(CALLNAME_ACTOR)%。来るの遅かったですね』	PRINTFORMW 『%CNAME(CALLNAME_ACTOR)%。你来晚了呢』
PRINTFORMW 『こんにちは』	PRINTFORMW 『下午好』
PRINTFORMW 「来たよ。何か用かな？」	PRINTFORMW 「我来了哟，找我有什么事吗？」
PRINTFORMW 「行ってらっしゃい。後片付けは%CNAME("一人称")%がやっておくね。」	PRINTFORMW 「一路顺风。接下来交给%CNAME("一人称")%收拾就好。」
PRINTFORMW 「頼まれたから作ってきたけど…」	PRINTFORMW 「因为被拜托了，所以就给你做了…」
PRINTFORML そう言って開けたものは真っ黒になった焼き魚とご飯だった…	PRINTFORML 一边这么说着一边打開饭盒，里面只有米饭和一条烧成焦黑的鱼…
PRINTFORMW 「その…ごめん無理して食べなくてもいいから…」	PRINTFORMW 「那个...对不起…不用勉强去吃也可以的…」
PRINTFORML %CALLNAME:PLAYER%は塩も醤油の味もしない焦げた焼き魚とご飯を掻き込んだ	PRINTFORML %CALLNAME:PLAYER%将米饭就着既没有盐味也没有酱油味的烧焦的鱼，狼吞虎咽地吃了起来。
PRINTFORMW 「はい、今日の弁当」	PRINTFORMW 「给，这是今天的便当」
PRINTFORMW 「フェリシエルさんに教えてもらいながら作ったし今日は大丈夫だと…思う…」	PRINTFORMW 「这次是弗理希艾尔教我做的，应该没问题了...我猜..」
PRINTFORMW 「はい、今日の弁当」	PRINTFORMW 「给，这是今天的便当」
PRINTFORMW 「昼間っから盛んな事するのかなと思って、性がつくもの作ってきた」	PRINTFORMW 「昼間っから盛んな事するのかなと思って、性がつくもの作ってきた，存疑」
PRINTFORMW 「見ていいの？やった！」	PRINTFORMW 「可以看吗？太好了！」
PRINTFORMW 「え、ここでするの？」	PRINTFORMW 「诶，要在这里做吗？」
PRINTFORMW 「どう考えてもおかしくない？%CNAME("パートナー")%も黙ってないでおかしいって言おうよ。」	PRINTFORMW 「怎么想都很奇怪吧？你也不要不说话，快说你也觉得很奇怪呀。」
PRINTFORML 「えっと…その…服と住むところをくれてありがとうございます」	PRINTFORML 「那个...十分感谢你能给我衣服和住所」
PRINTFORML 彼女は%CALLNAME:PLAYER%に礼を言った	PRINTFORML 她十分礼貌地对%CALLNAME:PLAYER%说道
PRINTFORML 「うぅ…暑い…暑いよぉ…」	PRINTFORML 「唔…好热…好热呀…」
PRINTFORML 「ふにゃー。おはようございます。今何時でしたっけ？」	PRINTFORML 「唔喵~，早上好。现在是几点钟了？」
PRINTFORML 「たまにはと思って着てみたけど…どうかな？」	PRINTFORML 「偶尔也想像这样穿穿看…怎么样？」
PRINTFORML 「まさか拾われてから虫をまた食べる事になるとは思わなかった」	PRINTFORML 「没想到被收养之后还能有机会再吃虫子」
PRINTFORML 「え？何を食べてたのかって?」	PRINTFORML 「诶？问我吃过什么?」
PRINTFORML 「研究所から逃げた後%CNAME("二人称")%と出会うまで食べれるものなんて何も無かったからさ、ナメクジ、カタツムリ、ネズミ、ゴキブリ何でも食べてたよ？」	PRINTFORML 「我从研究所逃离之后，在遇到%CNAME("二人称")%之前，根本找不到什么能吃的东西呐、蛞蝓、蜗牛、老鼠、蟑螂，无论什么我都吃哦？」
PRINTFORML 「だって食べないと餓死しちゃうし...」	PRINTFORML 「因为如果不吃的话就会被饿死...」
PRINTFORML %CALLNAME:TARGET%は感染症になってないか詳しく病院で検査したほうが良さそうだ...	PRINTFORML 看来最好去医院仔细检测一下%CALLNAME:TARGET%有没有感染什么病菌比较好呢...
PRINTFORML 「今までありがとう。そしてこれからもよろしくね？」	PRINTFORML 「感谢你至今为止的照顾，然后接下来也请多指教？」
PRINTFORML 「…ここでするの？」	PRINTFORML 「…要在这里做吗？」
PRINTFORML 「別に構わないけど何故%CNAME("二人称")%の部屋に？」	PRINTFORML 「虽然也没什么関系，不过为什么要到%CNAME("二人称")%的房间里？」
PRINTFORML 「%CNAME("一人称")%の部屋へようこそ」	PRINTFORML 「欢迎来到%CNAME("一人称")%的房间」
PRINTFORML 「…といっても何もないけどね」	PRINTFORML 「…虽然这么说，实际上什么也没有就是了」
PRINTFORML 何もないとは言うが部屋中に漂う淫臭とまだ乾いてないローターが部屋の端っこに転がっていたのを%CALLNAME:PLAYER%は見逃さなかった…	PRINTFORML 在称得上空无一物的房间里弥漫着淫靡的气味，在房间的角落里一个湿润的跳蛋正在嗡嗡地震动着，这些%CALLNAME:PLAYER%没有看漏…
PRINTFORML 「え、あ、その…」	PRINTFORML 「诶、啊、那个…」
PRINTFORML 「見てる暇あるなら手伝ってよ！」	PRINTFORML 「既然有看的功夫就快过来帮忙呀！」
PRINTFORML 「もうここでするくらい溜まってるんだからさ！」	PRINTFORML 「已经积攒到这种程度了呀！」
PRINTFORML 「あ、見ちゃった？」	PRINTFORML 「啊，被看到了吗？」
PRINTFORML 「別にいいよ、そのくらいなら。減るものでもないし」	PRINTFORML 「没関系哦，只是这种程度的话。反正我也没有损失什么」
PRINTFORML 「いや、流石にこの大きさは…ジョークグッズだよね？」	PRINTFORML 「哎呀、再怎么说这个大小…是魔术道具对吧？」
PRINTFORML 「さすがに盗撮はやめよう？ね？」	PRINTFORML 「偷拍是不好的，不要再做这种事了？好吗？」
PRINTFORML 「すぐそこに%CNAME(CALLNAME:ACTOR)%いるんだけど」	PRINTFORML 「但是%CNAME(CALLNAME:ACTOR)%还在这里」
PRINTFORML 「他の人もいるのに…」	PRINTFORML 「明明还有其他人在场…」
PRINTFORML 「ここでするんだよね？%CNAME("一人称")%もう限界。早く始めよ？」	PRINTFORML 「要在这里做对吧？%CNAME("一人称")%已经忍耐到极限了。快点開始吧？」
PRINTFORML 「じゃあさっそく始める？」	PRINTFORML 「那么就快点開始吧？」
PRINTFORML 「何故学校にこんな場所が…」	PRINTFORML 「为什么在学校里会有这种地方…」
PRINTFORML 「まぁいっか。じゃあさっそく始める？」	PRINTFORML 「算了怎么都好。让我们快点開始吧？」
PRINTFORML 「ん？%CNAME("一人称")%の名前？少し前まで腕に取り付けてたネームタグにはLydieって書いてあったね。どっちかというと発音はリディーのほうが正しい気もするけどリディアって呼ばれてた。」	PRINTFORMW 「嗯？%CNAME("一人称")%的名字？不久之前还装在胳膊上的命名牌写着Lydie呐。实在要说的话是因为莉迪亚的发音感觉和这个比较像，所以才叫莉迪亚。」
PRINTFORML 「自分の名前なのになんでらしいなのかって？研究所で記憶を弄られたみたいでね。余り出身地のことは覚えてないんだ。昔の自分のことも。なぜこんな体になってるのかも。」	PRINTFORMW 「为什么连自己的名字都不确定？在研究所时我的记忆似乎被篡改过。对家乡的事情基本上没有什么印象了，对自己的过去也是，自己的身体为什么会变成这样也是。」
PRINTFORML 「多分日本語しか話せないのも記憶を弄られたからじゃないかな。ある意味%CNAME("二人称")%と会えたことを考えると幸運なのかもしれない。」	PRINTFORMW 「或许只会说日语也是由于记忆被篡改的原因。这么说的话和%CNAME("二人称")%相遇看来是很幸运的事呢。」
PRINTFORML 「どうやって魔法使ってるのか知りたいって？」	PRINTFORMW 「想知道我是怎么使用的魔法？」
PRINTFORML 「%CNAME("一人称")%は血を魔力に変換して色々魔法を使ってるね。」	PRINTFORMW 「%CNAME("一人称")%是用血转化成魔力，然后使用各种各样的魔法的呢。」
PRINTFORML 「メイドさんと違って魂じゃなく血って違いはあるけどできることはほぼ変わらない…と思う。」	PRINTFORMW 「虽然和女仆小姐靠灵魂使用魔法不太一样，但是能使用的魔法基本上没有什么差别…我猜是这样的。」
PRINTFORML 「え？こんな服装で学校歩き回って大丈夫部なのかって？」	PRINTFORMW 「诶？你问我穿成这样在学校里来回走有没有问题？」
PRINTFORML 「認識阻害の魔法使ってるし問題ないと思うよ？」	PRINTFORMW 「我用了认知阻碍的魔法，应该没有问题？」
PRINTFORML 「というか服は%CNAME("二人称")%がくれたこれしかないし…洗濯？魔法で洗浄してるから大丈夫だよ？」	PRINTFORMW 「况且衣服是%CNAME("二人称")%给的，我只有这一件衣服能穿…洗衣服怎么办？我是用魔法清洗的所以应该没问题？」
PRINTFORML 「…よく他の人といちゃついておいてすぐこっち向けるね」	PRINTFORML 「…刚和别人调完情，就立刻转向我这边呢」
PRINTFORML 「…いや、怒ってるんじゃなくてその度胸に驚いてる」	PRINTFORML 「…不，也不是在生气，只是对你的胆量感到惊讶而已」
PRINTFORML 「…次は%CNAME("一人称")%？」	PRINTFORML 「…下一个是%CNAME("一人称")%吗？」
PRINTFORML %CALLNAME:TARGET%は窓から夜空を見上げている…	PRINTFORML %CALLNAME:TARGET%正透过窗户眺望夜空…
PRINTFORML %CALLNAME:TARGET%は窓から空を眺めている…	PRINTFORML %CALLNAME:TARGET%正透过窗户眺望天空…
PRINTFORML 「ごはん…」	PRINTFORML 「午饭喵…」
PRINTFORML 「…いただきます…」	PRINTFORML 「…開饭了喵…」
PRINTFORMW 「相合傘してくれるの？ありがと」	PRINTFORMW 「要一起打一把伞吗？谢谢」
PRINTFORMW 「まるでカップルみたいだね」	PRINTFORMW 「简直就像夫妻一样呢」
PRINTFORMW 「何してるのかって？母乳出してるだけだだよ？」	PRINTFORMW 「你问我在做什么？我只是在挤出母乳哦？」
PRINTFORMW 「だってこれやらないと服が汚れちゃうし…」	PRINTFORMW 「因为要是不这么做的话衣服会被弄脏…」
PRINTFORMW 乳房を揉みながら排水溝に向かって母乳を流す%CALLNAME:TARGET%	PRINTFORMW %CALLNAME:TARGET%一边揉着乳房，一边将母乳流入排水口
PRINTFORMW 「飲みたいの？分かった。いいよ」	PRINTFORMW 「想要喝吗？可以的哟」
PRINTFORMW 「その…今まで言えなかったんだけどさ」	PRINTFORMW 「那个…虽然至今为止都没有提过」
PRINTFORMW 「出来れば部員のみんなと同じような普通の体に戻りたいなって」	PRINTFORMW 「如果可以的话，我也想恢复成像部员的大家那样的普通的身体呢」
PRINTFORMW 「本当はさ、出会ったときに言いたかったけど…」	PRINTFORMW 「本来的话，这句话在刚刚相遇的时候就该讲到的…」
PRINTFORMW 「そこまでお願いする勇気がなくてさ」	PRINTFORMW 「但是没有拜托到这种地步的勇气」
PRINTFORMW 「そもそもお腹に貼られたこれが解除できる人ってあんまりいなさそうだし」	PRINTFORMW 「说到底基本找不到能解除我的贴在腹部的这个东西的人」
PRINTFORMW 「%CNAME("一人称")%は%CNAME("二人称")%の今の体をどう思ってるのか知らないけどさ」	PRINTFORMW 「虽然%CNAME("一人称")%不知道%CNAME("二人称")%现在怎么看待我的身体」
PRINTFORMW 「もし%CNAME("二人称")%が良いなら、%CNAME("一人称")%の体、元に戻せる人探してほしい」	PRINTFORMW 「如果%CNAME("二人称")%可以的话、希望你帮%CNAME("一人称")%寻找恢复原来身体的办法」
PRINTFORMW 「お願いばかりでごめんね。もし無理なら聞かなかったことにしてもいいから」	PRINTFORMW 「对不起呐，总是。如果觉得这是无理的要求的话，请你当做没听到就好了」
PRINTFORMW 彼女の体を元に戻せる知識がある人がアドバイザーにいる場合、お願いで%CALLNAME:TARGET%の体を元に戻せないかアドバイザーに交渉できるようになりました。	PRINTFORMW 当知道如何恢复她的身体的人以指导者的身份在场时、可以在拜托里与%CALLNAME:TARGET%交涉，询问她是否选择恢复原来的身体。
PRINTFORMW 「こんにちは。今日は何するの？」	PRINTFORMW 「下午好。今天要做什么呢？」
PRINTFORMW 挨拶した%CALLNAME:PLAYER%の頭をがっしりとつかみ、そのままアソコに押し付けてきた！	PRINTFORMW 打过招呼之后，莱迪亚牢牢地抓住%CALLNAME:PLAYER%的头，然后就这么压在自己的那个地方！
PRINTFORMW 物凄い力で頭をアソコに押し付けられ、もがくこともできずクンニを強制されている…	PRINTFORMW 被以惊人的力量压着头、连呼吸都做不到，被强制地舔着小穴…
PRINTFORMW 「それが挨拶で通じると思ってる？」	PRINTFORMW 「你觉得这样的算打招呼吗？」
PRINTFORMW 彼女が何かを一瞬唱えた瞬間。あなたのペニスに射精しそうな感覚が一気に込みあがる!	PRINTFORMW 在她咏唱什么东西的一瞬间，射精感涌上了你的阴茎!
PRINTFORMW あなたはまるでお漏らししてしまったかのように射精してしまった…	PRINTFORMW 你就像失禁了一样射精了…
PRINTFORMW ズボンに大きな染みが広がる…	PRINTFORMW 裤子上有一片污渍在不断扩大…
PRINTFORMW 彼女が何かを一瞬唱えた瞬間。あなたの腰が砕けそうなほどの強烈な快感が押し寄せる!	PRINTFORMW 在她咏唱什么东西的一瞬间。从你的腰部传来了触电般的强烈快感!
PRINTFORMW あなたは膝立ちになりながらまるでお漏らししてしまったかのように潮と共に精液を漏らしながら絶頂した！	PRINTFORMW 保持着跪着的姿势，你像失禁了一样同时射精和高潮了！
PRINTFORMW スカートの下はびしょびしょになりながら床にも液体をぽたぽたと垂らしている…	PRINTFORMW 裙子下面已经湿透，各种液体滴答滴答地滴在床上…
PRINTFORMW あなたは膝立ちになりながらまるでお漏らししてしまったかのように潮を噴きながら絶頂した！	PRINTFORMW 保持着跪着的姿势，你像失禁了一样一边潮吹一边高潮了！
PRINTFORMW スカートの下はびしょびしょになりながら床にも潮をぽたぽたと垂らしている…	PRINTFORMW 裙子下面已经湿透，从小穴流出的液体滴答滴答地滴在床上…
PRINTFORMW 「欲求不満はこれで収まった？せめて時と場所は考えてね？」	PRINTFORMW 「欲求不满现在缓解一点了吗？至少要注意时间和场合吧？」
PRINTFORMW 「まぁ、他人がいないしいいけどさ。」	PRINTFORMW 「嘛、反正没有其他人在场，也没什么问题。」
PRINTFORMW 「眠くなってきた。お休み。%CNAME("二人称")%」	PRINTFORMW 「開始犯困了，%CNAME("二人称")%晚安。」
PRINTFORMW 「暑すぎるから脱ぐ」	PRINTFORMW 「因为太热了所以脱了」
PRINTFORMW 「結構作るの大変だったからさ、そう言ってもらえてよかった」	PRINTFORMW 「能做成这样真的很辛苦呢，你能这么说真是太好了」
PRINTFORML 「えっと...褒めても何も出ないよ？」	PRINTFORML 「那个...即使夸奖我也不会发生什么事哦？」
PRINTFORMW 彼女は嬉しそうにしている	PRINTFORMW 她看上去感觉很高兴
PRINTFORMW 「うん。%CNAME("一人称")%も%CNAME("二人称")%を愛してる」	PRINTFORMW 「嗯，%CNAME("一人称")%也爱%CNAME("二人称")%哦」
PRINTFORML 彼女は微笑みながら返事をした	PRINTFORML 她一边微笑一边回复道
PRINTFORMW 「あ、その、うぅ…」	PRINTFORMW 「啊、这样啊、唔…」
PRINTFORML 愛の言葉を囁かれた%CNAME("一人称")%は顔を真っ赤にしている。	PRINTFORML 听到爱的话语的%CNAME("一人称")%脸一瞬间变得通红。
PRINTFORML 「%CNAME("一人称")%の愛の言葉よりももっとすごい言葉、囁いてあげる」	PRINTFORML 「比%CNAME("一人称")%的情话更厉害的话语、让你见识一下吧」
PRINTFORMW そう言うと彼女はよく分からない言葉を紡ぎだし…	PRINTFORMW 她一边这么说着，一边開始编织一些听不懂的咒语…
PRINTFORMW いつの間にか%CALLNAME:PLAYER%は	PRINTFORMW 不知从何时開始，%CALLNAME:PLAYER%已经不能将自己的目光从她身上移開…
PRINTFORMW 「涼しくなって来たし夏もそろそろ終わるね」	PRINTFORMW 「天气渐渐变凉了，夏天差不多要结束了呢」
PRINTFORMW 「そろそろ暑くなってきたし夏だね。嫌だなぁ…」	PRINTFORMW 「很热的夏天就要来了呢，真讨厌…」
PRINTFORMW 「この学園のお花ってきれいだけど枯れてるの多いよね。なんでだろ？」	PRINTFORMW 「这个学园的花明明很美，却有很多都枯萎了。为什么会这样呢？」
PRINTFORMW 「この前、部員がやってたゲーム、ルールがわからなかったから参加できなくてさ。」	PRINTFORMW 「在这之前，部员们在玩一种游戏，但是我不知道规则所以参加不了。」
PRINTFORMW 「次は参加したいから教えてくれない？」	PRINTFORMW 「我下次也想参加，你可以教我规则吗？」
PRINTFORMW 「拭いてくれるの。ありがとね。」	PRINTFORMW 「要帮我擦汗吗？谢谢你」
PRINTFORMW 「でも拭いた後のタオルをかぐのはさすがにどうかと思うよ？」	PRINTFORMW 「但是去闻擦汗之后的毛巾再怎么说也不太好吧？」
PRINTFORMW 「ひゃっ、冷たい！」	PRINTFORMW 「咿呀，好凉！」
PRINTFORMW 「お湯と水間違えた…」	PRINTFORMW 「把热水和凉水搞错了…」
PRINTFORMW 「あ、嫌って訳じゃ無いけど、今は体が疼いて疼いて仕方がないから下着じゃなくて%CNAME("一人称")%の裸を見て欲しいな。」	PRINTFORMW 「啊，并不是感到讨厌、今天的身体实在是疼得受不了所以才没穿内衣，希望你能看看%CNAME("一人称")%的裸体呢。」
PRINTFORMW 「%CNAME("一人称")%の下着、漁ったでしょ？」	PRINTFORMW 「你刚刚动了%CNAME("一人称")%的内衣，对吧？」
PRINTFORMW 「今回%CNAME("一人称")%だったからいいけどさ。他の人に怒られても知らないよ？」	PRINTFORMW 「这次是%CNAME("一人称")%所以没问题。要是其他人的话生气我也不管哦？」
PRINTFORMW 「ふぅ、さっぱりした。」	PRINTFORMW 「呼，清爽多了。」
PRINTFORMW 「別に服は今着てるのあるし、新しいの用意しなくても大丈夫だけど…」	PRINTFORMW 「我现在已经穿着别的衣服了，不准备新的衣服也没関系的…」
PRINTFORMW 「…もしかしてあそこに置いてあった奴着てほしいの？」	PRINTFORMW 「…难道你想让我穿放在那里的衣服？」
PRINTFORMW 「…遠慮しとく。洗って帰すの面倒だし」	PRINTFORMW 「…还是算了吧，洗完再还回去也很麻烦」
PRINTFORMW 「%CNAME("一人称")%は学校行ってないから勉強する必要はないんだけど…」	PRINTFORMW 「%CNAME("一人称")%不用去上学，所以没有必要学习…」
PRINTFORMW 「そこ分からないの？%CNAME("一人称")%が教えようか？」	PRINTFORMW 「这个地方不明白吗？需要%CNAME("一人称")%来教你吗？」
PRINTFORMW 「%CNAME("一人称")%がなんでここ理解してるのかって？なんでこんな記憶があるのか%CNAME("一人称")%が聴きたいよ。」	PRINTFORMW 「你问为什么%CNAME("一人称")%会明白这些知识？%CNAME("一人称")%也想找人告诉我为什么自己会有这些记忆。」
PRINTFORMW 「ちょ、ちょっと何するのさ!」	PRINTFORMW 「等，等下，你在做什么呢!」
PRINTFORML いつもの彼女とは思えない強烈な力で%CALLNAME:PLAYER%の手は引き剥がされた…	PRINTFORML 她用惊人的力量将%CALLNAME:PLAYER%的手从胸部挪開了…
PRINTFORMW 「その…胸揉まれると、母乳出るみたいだから…時と場所を考えてほしい。」	PRINTFORMW 「那个…如果这么揉胸部的话、母乳会流出来的…稍微注意下时间和场合呀。」
PRINTFORMW 「その…胸触りたいなら…時と場所を考えてほしい。」	PRINTFORMW 「那个…要是触摸胸部的话…稍微注意下时间和场合呀。」
PRINTFORMW 彼女が何かを一瞬唱えた瞬間。%CALLNAME:PLAYER%のペニスに射精しそうな感覚が一気に込みあがる!	PRINTFORMW 在她咏唱了什么东西的一瞬间，从%CALLNAME:PLAYER%的阴茎突然涌上了射精感!
PRINTFORMW %CALLNAME:PLAYER%はまるでお漏らししてしまったかのように射精してしまった…	PRINTFORMW %CALLNAME:PLAYER%仿佛漏尿一样射精了…
PRINTFORMW ズボンに大きな染みが広がる…	PRINTFORMW 裤子上有一片污渍在不断扩大…
PRINTFORMW 彼女が何かを一瞬唱えた瞬間。%CALLNAME:PLAYER%の腰が砕けそうなほどの強烈な快感が押し寄せる!	PRINTFORMW 在她咏唱了什么东西的一瞬間，从%CALLNAME:PLAYER%腰部传来了触电般强烈的快感!
PRINTFORMW %CALLNAME:PLAYER%は膝立ちになりながらまるでお漏らししてしまったかのように潮と共に精液を漏らしながら絶頂した！	PRINTFORMW 保持着跪着的姿势，%CALLNAME:PLAYER%像失禁了一样同时射精和高潮了！
PRINTFORMW スカートの下はびしょびしょになりながら床にも液体をぽたぽたと垂らしている…	PRINTFORMW 裙子下面已经湿透，各种液体滴答滴答地滴在床上…
PRINTFORMW %CALLNAME:PLAYER%は膝立ちになりながらまるでお漏らししてしまったかのように潮を噴きながら絶頂した！	PRINTFORMW 保持着跪着的姿势，%CALLNAME:PLAYER%像失禁了一样一边潮吹一边绝顶了！
PRINTFORMW スカートの下はびしょびしょになりながら床にも潮をぽたぽたと垂らしている…	PRINTFORMW 裙子下面已经湿透，从小穴流出的液体滴答滴答地滴在床上…
PRINTFORMW 「欲求不満はこれで収まったかな？せめて時と場所は考えてね？」	PRINTFORMW 「欲求不满现在缓解一点了吗？至少要注意时间和场合呐？」
PRINTFORMW 「胸、触りたいの？分かった。いいよ」	PRINTFORMW 「胸、想要摸一摸？我知道了，可以的哟」
PRINTFORMW 「マッサージ？別にマッサージなんて必要ないけど…」	PRINTFORMW 「按摩？虽然并没有按摩的必要就是了…」
PRINTFORMW 「変なことしないなら別にしてもいいよ？」	PRINTFORMW 「只要不做奇怪的事情的话，可以哟？」
PRINTFORMW 「ごめん。%CNAME("一人称")%、まだ未成年だと思うから遠慮しとく。」	PRINTFORMW 「抱歉。%CNAME("一人称")%还未成年所以容我拒绝。」
PRINTFORMW 「え？尻尾に触りたい？」	PRINTFORMW 「诶？想摸尾巴？」
PRINTFORMW 「うん、興味本位で触るくらいなら別にいいけど。」	PRINTFORMW 「唔嗯，如果只是为了满足好奇心的话，稍微摸一摸倒是可以。」
PRINTFORMW 「でも他の先輩達にこんなことお願いしたら駄目だよ。セクハラだよ？」	PRINTFORMW 「不能向其他的前辈们提出这种请求哟，这是性骚扰哟？」
PRINTFORMW 「ゴロゴロ…」	PRINTFORMW 「咕噜咕噜…」
PRINTFORMW 頭を撫でられて心地よさそうに喉を鳴らしている...	PRINTFORMW 被摸头仿佛心情很好似的，从喉咙发出了这样的声音...
PRINTFORMW 「%CNAME("一人称")%はそろそろお風呂に入ろうかなと思うけど、一緒に入ろ？」	PRINTFORMW 「%CNAME("一人称")%差不多该去洗澡了，一起洗吧？」
PRINTFORMW 「%CNAME("一人称")%はそろそろお風呂に入ろうかなと思うけど、一緒に入らない？」	PRINTFORMW 「%CNAME("一人称")%差不多该去洗澡了，要不要一起洗？」
PRINTFORMW 「ごめん。もう限界」	PRINTFORMW 「抱歉，已经到极限了」
PRINTFORMW 「%CNAME("一人称")%の性処理に付き合ってほしい…」	PRINTFORMW 「希望你能帮%CNAME("一人称")%进行性处理呢…」
PRINTFORMW 「折角なので耳掃除しよっか。綿棒はここかな?」	PRINTFORMW 「因为很难得所以给你清理一下耳朵吧，棉签是在这里对吧?」
PRINTFORMW 「あった。じゃあ%CNAME("一人称")%の膝で横になってね」	PRINTFORMW 「找到了，那么请在%CNAME("一人称")%的膝盖这里躺下吧」
PRINTFORMW 「はいお茶」　　	PRINTFORMW 「给你，这是茶」　　
PRINTFORMW 「何かしないの？部活の時間なのに」	PRINTFORMW 「什么都不做吗？明明现在是社团时间」
PRINTFORMW 「ちょっと席を外すね。」	PRINTFORMW 「稍微外出一下。」
PRINTFORMW 「一人で収めてた…」	PRINTFORMW 「我自己一个人解决好了…」
PRINTFORMW 「だって%CNAME("二人称")%付き合ってくれないし…」	PRINTFORMW 「因为%CNAME("二人称")%都不愿意陪我做那个…」
PRINTFORMW 「トイレでやることって普通聞かないでもわからない？」	PRINTFORMW 「在厕所里要做的事就算不说也知道吧？」
PRINTFORMW 「それ、本気で言ってるの…？」	PRINTFORMW 「那个，你是认真地在说这话吗...？」
PRINTFORMW 「はぁ、分かったよ。そんなに溜まっててつらいなら今楽にしてあげる」	PRINTFORMW 「唉，我知道了。既然你积攒了这么多，那么现在就给你解脱」
PRINTFORMW 彼女が何かを一瞬唱えた瞬間。%CALLNAME:PLAYER%のペニスに射精しそうな感覚が一気に込みあがる!	PRINTFORMW 在她咏唱了什么东西的一瞬间，从%CALLNAME:PLAYER%的阴茎突然涌上了射精感!
PRINTFORMW %CALLNAME:PLAYER%はまるでお漏らししてしまったかのように射精してしまった…	PRINTFORMW %CALLNAME:PLAYER%仿佛漏尿一样射精了…
PRINTFORMW ズボンに大きな染みが広がる…	PRINTFORMW 裤子上有一片污渍在不断扩大…
PRINTFORMW 彼女が何かを一瞬唱えた瞬間。%CALLNAME:PLAYER%の腰が砕けそうなほどの強烈な快感が押し寄せる!	PRINTFORMW 在她咏唱了什么东西的一瞬間，从%CALLNAME:PLAYER%腰部传来了触电般强烈的快感!
PRINTFORMW %CALLNAME:PLAYER%は膝立ちになりながらまるでお漏らししてしまったかのように潮と共に精液を漏らしながら絶頂した！	PRINTFORMW 保持着跪着的姿势，%CALLNAME:PLAYER%像失禁了一样同时射精和高潮了！
PRINTFORMW スカートの下はびしょびしょになりながら床にも液体をぽたぽたと垂らしている…	PRINTFORMW 裙子下面已经湿透，各种液体滴答滴答地滴在床上…
PRINTFORMW %CALLNAME:PLAYER%は膝立ちになりながらまるでお漏らししてしまったかのように潮を噴きながら絶頂した！	PRINTFORMW 保持着跪着的姿势，%CALLNAME:PLAYER%像失禁了一样一边潮吹一边绝顶了！
PRINTFORMW スカートの下はびしょびしょになりながら床にも潮をぽたぽたと垂らしている…	PRINTFORMW 裙子下面已经湿透，从小穴流出的液体滴答滴答地滴在床上…
PRINTFORMW 「欲求不満はこれで収まったかな？せめてTPOは考えてね？」	PRINTFORMW 「这下子欲求不満有没有缓解一些？至少要注意一下时间和场合呐？」
PRINTFORMW 「%PANTIES(TARGET, "パンツ")%チェックって…何がしたいのかよくわからないんだけど」	PRINTFORMW 「检查胖次这种事…完全不理解到底有什么意义」
PRINTFORMW 「ここで眺めてるならベットでしたほうが良いんじゃない？」	PRINTFORMW 「比起在这里盯着看，不如去床上怎么样？」
PRINTFORMW 「…何処に目線が行ってるのか分かってるよ？」	PRINTFORMW 「…你在看哪里我现在是知道的哟？」
PRINTFORMW 「…まぁいっか。見てるだけだし」	PRINTFORMW 「…嘛算了，反正只是看看」
PRINTFORMW 「うわっ、ちょっとさすがにやめてよ！」	PRINTFORMW 「呜哇、等等，再怎么说也不要这样做啊！」
PRINTFORMW 「もぉ～、他の人もいるんだからね！」	PRINTFORMW 「真是的～、明明还有其他人在这里！」
PRINTFORMW 説教された…	PRINTFORMW 被说教了一番…
PRINTFORMW 「うわっ、ちょっとさすがにやめてよ！」	PRINTFORMW 「呜哇、等等，再怎么说也不要这样做啊！」
PRINTFORMW 「もぉ～、他の人もいるんだからね！」	PRINTFORMW 「真是的～、明明还有其他人在这里！」
PRINTFORMW 説教された…	PRINTFORMW 被说教了一番…
PRINTFORMW 「うわっ、ちょっとさすがにやめてよ！」	PRINTFORMW 「呜哇、等等，再怎么说也不要这样做啊！」
PRINTFORMW 「いや確かに減るものじゃないって言ったけどさ、他の人もいるんだからね！」	PRINTFORMW 「不，虽然确实没有什么损失，但是还有其他人在这里呢！」
PRINTFORMW 説教された…	PRINTFORMW 被说教了一番…
PRINTFORMW 「ん？何してるの？」	PRINTFORMW 「嗯？在做什么呢？」
PRINTFORMW まだ寝ぼけいるようで自分が何をされてるか理解してないようだ…	PRINTFORMW 还睡得迷迷糊糊的，不能理解自己正在被做什么…
PRINTFORMW 「うわっ、ちょっとさすがにやめてよ！」	PRINTFORMW 「呜哇、等等，再怎么说也不要这样做啊！」
PRINTFORMW 「もぉ～、他の人もいるんだからね！」	PRINTFORMW 「真是的～、明明还有其他人在这里！」
PRINTFORMW 説教された…	PRINTFORMW 被说教了一番…
PRINTFORMW 「うわっ、ちょっとさすがにやめてよ！」	PRINTFORMW 「呜哇、等等，再怎么说也不要这样做啊！」
PRINTFORMW 「いや確かに減るものじゃないって言ったけどさ、他の人もいるんだからね！」	PRINTFORMW 「不，虽然确实没有什么损失，但是还有其他人在这里呢！」
PRINTFORMW 説教された…	PRINTFORMW 被说教了一番…
PRINTFORMW 「それが挨拶で通じると思ってる？」	PRINTFORMW 「你觉得这样的打招呼方式行得通吗？」
PRINTFORMW 彼女が何かを一瞬唱えた瞬間。あなたのペニスに射精しそうな感覚が一気に込みあがる!	PRINTFORMW 在她咏唱什么东西的一瞬间，射精感涌上了你的阴茎!
PRINTFORMW あなたはまるでお漏らししてしまったかのように射精してしまった…	PRINTFORMW 你就像失禁了一样射精了…
PRINTFORMW ズボンに大きな染みが広がる…	PRINTFORMW 裤子上有一片污渍在不断扩大…
PRINTFORMW 彼女が何かを一瞬唱えた瞬間。あなたの腰が砕けそうなほどの強烈な快感が押し寄せる!	PRINTFORMW 在她咏唱什么东西的一瞬间。从你的腰部传来了触电般的强烈快感!
PRINTFORMW あなたは膝立ちになりながらまるでお漏らししてしまったかのように潮と共に精液を漏らしながら絶頂した！	PRINTFORMW 保持着跪着的姿势，你像失禁了一样同时射精和高潮了！
PRINTFORMW スカートの下はびしょびしょになりながら床にも液体をぽたぽたと垂らしている…	PRINTFORMW 裙子下面已经湿透，各种液体滴答滴答地滴在床上…
PRINTFORMW あなたは膝立ちになりながらまるでお漏らししてしまったかのように潮を噴きながら絶頂した！	PRINTFORMW 保持着跪着的姿势，你像失禁了一样一边潮吹一边高潮了！
PRINTFORMW スカートの下はびしょびしょになりながら床にも潮をぽたぽたと垂らしている…	PRINTFORMW 裙子下面已经湿透，从小穴流出的液体滴答滴答地滴在床上…
PRINTFORMW 「欲求不満はこれで収まった？せめて時と場所は考えてね？」	PRINTFORMW 「欲求不满现在缓解一点了吗？至少要注意时间和场合吧？」
PRINTFORMW 「それが挨拶で通じると思ってる？」	PRINTFORMW 「你觉得这样的打招呼方式行得通吗？」
PRINTFORMW 「まぁ、他人がいないしいいけどさ。」	PRINTFORMW 「嘛、反正没有其他人在场，也没什么问题。」
PRINTFORMW 「うわっ、ちょっと今日は履いてないんだからさすがにやめてよ！」	PRINTFORMW 「呜哇。等等，今天没有穿鞋子所以不要这样」
PRINTFORMW 「うわっ、ちょっとさすがにやめてよ！」	PRINTFORMW 「呜哇、等等，再怎么说也不要这样做啊！」
PRINTFORMW 「もぉ～、他の人もいるんだからね！」	PRINTFORMW 「真是的～、明明还有其他人在这里！」
PRINTFORMW 説教された…	PRINTFORMW 被说教了一番…
PRINTFORMW 「パンツでいいの？分かった。」	PRINTFORMW 「胖次就可以了吗？我知道了。」
PRINTFORMW 「次の日曜一緒にデートとか、どうかな？」	PRINTFORMW 「次の周日一緒に约会とか、どうかな？」
PRINTFORMW 「やった！、じゃあ楽しみに待ってるね」	PRINTFORMW 「太棒了！那么我就满怀期待地等着吧」
PRINTFORMW 「分かった。返事待ってるね」	PRINTFORMW 「我知道了，那我就等你的回复了呢」
PRINTFORMW 「デート？いいよ、分かった」	PRINTFORMW 「约会？可以哟，我明白了」
PRINTFORMW 「今から%CNAME("一人称")%は%CNAME("二人称")%の家に向かうね」	PRINTFORMW 「从今天起%CNAME("一人称")%就去%CNAME("二人称")%的家里住呐」
PRINTFORMW 「どうせ服はこれしかないから%CNAME("一人称")%は特に準備はいらないよ。」	PRINTFORMW 「反正衣服只有这一件，不用%CNAME("一人称")%は特地去准备也行。」
PRINTFORMW 「%CNAME("二人称")%のほうは準備は大丈夫？」	PRINTFORMW 「倒是%CNAME("二人称")%要做准备没问题吗？」
PRINTFORMW 「今日は楽しかったね」	PRINTFORMW 「今天过得很開心呐」
PRINTFORMW 「いつまでもこの幸せが続くといいなぁ…」	PRINTFORMW 「这份幸福要是能一直这样持续下去就好了…」
PRINTFORMW 「今日は楽しかったね」	PRINTFORMW 「今天过得很開心呐」

//文件: EVENT_K47_SELECT.ERB
STR:選択肢 = %STR:選択肢% [60] %TEXT_LJ("呪いを解いて貰う", 16)% … %CALLNAME:ASSI%に%CALLNAME:TARGET%の淫紋と避妊の護符を外せないか交渉します/	STR:選択肢 = %STR:選択肢% [60] %TEXT_LJ("呪いを解いて要", 16)% … 向%CALLNAME:ASSI%询问能不能解除%CALLNAME:TARGET%身上的淫纹和避孕的护符/
STR:選択肢 = %STR:選択肢% [60] %TEXT_LJ("呪いを解いて貰う", 16)% … %CALLNAME:ASSI%に%CALLNAME:TARGET%の淫紋と避妊の護符を外せないか交渉します/	STR:選択肢 = %STR:選択肢% [60] %TEXT_LJ("呪いを解いて要", 16)% … 向%CALLNAME:ASSI%询问能不能解除%CALLNAME:TARGET%身上的淫纹和避孕的护符/
PRINTFORMW あなたはオスカーに事情を話し彼女の護符が解除できないか聞いた。	PRINTFORMW 你正在向奥斯卡询问能不能解除莉迪亚的护符。
CALL PRINT_STRL, "黄色_- オスカー -_"	CALL PRINT_STRL, "黄色_- 奥丝卡 -_"
PRINTFORMW 『なるほど、避妊の護符を解除できなくて困っているのか。』	PRINTFORMW 『原来如此，正在为解除不了避孕的护符而感到困扰。』
PRINTFORMW 『いいだろう。外してやる。』	PRINTFORMW 『好吧，我能帮你解開』
CALL PRINT_STRL, "黄色_- リディア -_"	CALL PRINT_STRL, "黄色_- 莉迪亚 -_"
PRINTFORMW 「良いの？でも悪魔さんって願いを叶えるには魂が必要だって聞いたよ？%CNAME("一人称")%、払える程魂なんて持ってないよ？」	PRINTFORMW 「可以吗？但是听说要让恶魔视线愿望，好像必需要献上灵魂？%CNAME("一人称")%没有足够的灵魂来支付哦？」
CALL PRINT_STRL, "黄色_- オスカー -_"	CALL PRINT_STRL, "黄色_- 奥丝卡 -_"
PRINTFORMW 『そなたが持ってなくても払ってくれるだろう。そうだろう？%CNAMET(ASSI, "二人称")%。』	PRINTFORMW 『就算你没有足够的灵魂也会支付，没错吧？%CNAMET(ASSI, "二人称")%。』
PRINTFORMW あなたは当たり前だと返事をする。	PRINTFORMW 你回答说当然。
CALL PRINT_STRL, "黄色_- リディア -_"	CALL PRINT_STRL, "黄色_- 莉迪亚 -_"
PRINTFORMW 「%CALLNAME:ASSI%さん。ありがとう。それと魂を払ってくれた%CNAME("二人称")%も。二人がしてくれたことを%CNAME("一人称")%は忘れない。」	PRINTFORMW 「谢谢你，%CALLNAME:ASSI%小姐，支付灵魂的%CNAME("二人称")%也是。%CNAME("一人称")%永元不会忘记你们两人为我做的一切的。」
PRINTFORMW あなたの魂一つを対価にリディアの護符を完全に解除しました	PRINTFORMW 以你的灵魂为代价，莉迪亚的护符被完全解除了
PRINTFORMW あなたは%CALLNAME:ASSI%に事情を話し彼女の護符が解除できないか聞いた。	PRINTFORMW 你正在正向%CALLNAME:ASSI%询问能不能解除莉迪亚的护符。
CALL PRINT_STRL, "黄色_- マリー -_"	CALL PRINT_STRL, "黄色_- 玛丽 -_"
PRINTFORMW 『なるほど、避妊の護符を無理やりつけられて困っていると。』	PRINTFORMW 『原来如此，因为被迫打上避孕的护符而感到困扰吗。』
PRINTFORMW 『大丈夫ですよ、今解除してあげますから。』	PRINTFORMW 『没问题的哟，现在就可以解除。』
CALL PRINT_STRL, "黄色_- リディア -_"	CALL PRINT_STRL, "黄色_- 莉迪亚 -_"
PRINTFORMW 「良いの？%CNAME("一人称")%、払えるもの何もないけど。」	PRINTFORMW 「可以吗？%CNAME("一人称")%没有任何能支付给你的东西。」
CALL PRINT_STRL, "黄色_- マリー -_"	CALL PRINT_STRL, "黄色_- 玛丽 -_"
PRINTFORMW 『困ってる時はお互い様ですから』	PRINTFORMW 『有困难时就要互相帮助嘛』
CALL PRINT_STRL, "黄色_- リディア -_"	CALL PRINT_STRL, "黄色_- 莉迪亚 -_"
PRINTFORMW 「ありがとう%CNAME("マリー")%。あなたがしてくれたことを私は忘れない。」	PRINTFORMW 「谢谢%CNAME(@"{FIND_COND("玛丽")}")%。我永远不会忘记你对我的帮助的。」
PRINTFORMW %CALLNAME:ASSI%の協力によってリディアの護符を完全に解除しました	PRINTFORMW 在%CALLNAME:ASSI%的帮助下莉迪亚的护符被完全解除了
PRINTFORMW あなたは%CALLNAME:ASSI%に事情を話し、彼女の護符が解除できないか聞いた。	PRINTFORMW 你正在正向%CALLNAME:ASSI%询问，能不能解除莉迪亚的护符。
PRINTFORMW …彼女の護符を外してくれるようだ！	PRINTFORMW …看来似乎愿意帮忙解除莉迪亚的护符！
PRINTFORMW 「ありがとう%CALLNAME:ASSI%さん。あなたがしてくれたことを私は忘れない。」	PRINTFORMW 「谢谢你%CALLNAME:ASSI%。我永远不会忘记你对我的帮助的。」
PRINTFORMW %CALLNAME:ASSI%の協力によってリディアの護符を完全に解除しました。	PRINTFORMW 在%CALLNAME:ASSI%的帮助下莉迪亚的护符被完全解除了。
PRINTFORMW %CALLNAME:MASTER%は%ARGS%をした。	PRINTFORMW %CALLNAME:MASTER%进行了%ARGS%。
PRINTFORMW %ARGS%を受けての%CALLNAME:TARGET%の反応	PRINTFORMW 受到%ARGS%的%CALLNAME:TARGET%的反应
PRINTFORMW %CALLNAME:MASTER%は%ARGS%をした。	PRINTFORMW %CALLNAME:MASTER%进行了%ARGS%。
PRINTFORMW %ARGS%を受けての%CALLNAME:TARGET%の反応	PRINTFORMW 受到%ARGS%的%CALLNAME:TARGET%的反应
STR:選択肢 += "血を渡す/"	STR:選択肢 += "供给血液/"
STR:選択肢 += "乳絞り/"	STR:選択肢 += "从乳头挤奶/"
STR:選択肢 += "豆弄り/"	STR:選択肢 += "玩弄小豆豆/"
STR:選択肢 += "壺弄り/"	STR:選択肢 += "玩弄小穴/"
PRINTFORMW 何か猛烈に嫌な予感がする…今血を渡すのは危険そうだ…それでも%CALLNAME:TARGET%に渡しますか？	PRINTFORMW 产生了某种强烈的讨厌的预感…现在把血液交出去似乎会发生很危险的事…即便如此也要把血液交%CALLNAME:TARGET%吗？
CALL PRINT_SELECT, "渡す/やめておく"	CALL PRINT_SELECT, "转让血液/还是算了"
PRINTFORMW 「良いの？ありがとう。じゃあ遠慮なく貰うね!」	PRINTFORMW 「可以吗？谢谢。那我就不客气地收下了呐!」
PRINTFORML そう言うと彼女はいきなりあなたを押し倒し喉元に噛みついてきた！	PRINTFORML 这句话说完之后，突然把你推倒在地，然后一口咬在你的喉咙上！
PRINTFORMW 強烈な痛みと共に意識が薄れていく…	PRINTFORMW 感受到剧烈痛觉的同时你的意识越来越模糊…
CALL PRINT_STR, "紅_＜リザレクション！＞_W_"	CALL PRINT_STR, "紅_＜復活！＞_W_"
PRINTFORMW %CALLNAME:MASTER%は最後の力を振り絞って復活した	PRINTFORMW %CALLNAME:MASTER%使用最后的一丝力气，嘶声竭力般复活了
PRINTFORMW 　【%CALLNAME:TARGET%の%CALLNAME:MASTER%に対する好感度　+30】	PRINTFORMW 　【%CALLNAME:TARGET%对%CALLNAME:MASTER%的好感度　+30】
PRINTFORMW やめておくことにした…	PRINTFORMW 果然还是算了…
PRINTFORMW 「良いの？ありがとう。じゃあ遠慮なく貰うね」	PRINTFORMW 「可以吗？谢谢。那我就不客气地收下了呐」
PRINTFORMW そう言って彼女は抱きついて何かを囁いた後首元に噛みついてきた	PRINTFORMW 这句话说完之后抱住了我，朝着耳朵低语了什么，然后咬在了我的脖子上
PRINTFORML だんだんと頭がボーとしていく…	PRINTFORML 头脑逐渐变得昏沉…
PRINTFORMW 「ありがとう。でも今は大丈夫だよ」	PRINTFORMW 「谢谢，但是我现在已经没问题了哟」
PRINTFORMW 「時と場所を考えてって言ったよね？」	PRINTFORMW 「希望你能注意一下时间和场所呐？」
PRINTFORMW 彼女が何かを一瞬唱えた瞬間。あなたのペニスに射精しそうな感覚が一気に込みあがる!	PRINTFORMW 在她咏唱什么东西的一瞬间，射精感涌上了你的阴茎!
PRINTFORMW あなたはまるでお漏らししてしまったかのように射精してしまった…	PRINTFORMW 你就像失禁了一样射精了…
PRINTFORMW ズボンに大きな染みが広がる…	PRINTFORMW 裤子上有一片污渍在不断扩大…
PRINTFORMW 彼女が何かを一瞬唱えた瞬間。あなたの腰が砕けそうなほどの強烈な快感が押し寄せる!	PRINTFORMW 在她咏唱什么东西的一瞬间。从你的腰部传来了触电般的强烈快感!
PRINTFORMW あなたは膝立ちになりながらまるでお漏らししてしまったかのように潮と共に精液を漏らしながら絶頂した！	PRINTFORMW 保持着跪着的姿势，你像失禁了一样同时射精和高潮了！
PRINTFORMW スカートの下はびしょびしょになりながら床にも液体をぽたぽたと垂らしている…	PRINTFORMW 裙子下面已经湿透，各种液体滴答滴答地滴在床上…
PRINTFORMW あなたは膝立ちになりながらまるでお漏らししてしまったかのように潮を噴きながら絶頂した！	PRINTFORMW 保持着跪着的姿势，你像失禁了一样一边潮吹一边高潮了！
PRINTFORMW スカートの下はびしょびしょになりながら床にも潮をぽたぽたと垂らしている…	PRINTFORMW 裙子下面已经湿透，从小穴流出的液体滴答滴答地滴在床上…
PRINTFORMW 「欲求不満はこれで収まったかな？せめて時と場所は考えてね？」	PRINTFORMW 「欲求不满现在缓解一点了吗？至少要注意时间和场合呐？」
PRINTFORMW 「え？%CNAME("一人称")%で乳絞りがしたい？」	PRINTFORMW 「诶？想给%CNAME("一人称")%挤奶？」
PRINTFORMW 「正気なの？」	PRINTFORMW 「你的精神还正常吗？」
PRINTFORMW 「うん、まぁ、約束したからね。別触ってもいいよ。」	PRINTFORMW 「唔姆，嘛，必竟约定好了呢。给你摸一摸也可以哟。」
PRINTFORMW 彼女の乳房をさらけ出し、あなたは用意したコップを使って乳しぼりを開始した	PRINTFORMW 将她的乳房袒露出来，你拿着准备好的杯子開始榨乳。
PRINTFORMW 乳首を指で挟み伸ばすように刺激すると母乳が溢れてくる…	PRINTFORMW 将乳头用手指捏住然后轻轻一拉，像这样刺激一下母乳就流了出来…
PRINTFORMW 「えっ、それ飲むの？」	PRINTFORMW 「诶，你要把这个喝掉吗？」
PRINTFORMW しかし、いくら絞っても母乳が出ることはなかった…	PRINTFORMW 然而，无论怎么尝试都没有母乳流出...
PRINTFORMW 「時と場所を考えてって言ったよね？」	PRINTFORMW 「希望你能注意一下时间和场所呐？」
PRINTFORMW 彼女が何かを一瞬唱えた瞬間。あなたのペニスに射精しそうな感覚が一気に込みあがる!	PRINTFORMW 在她咏唱什么东西的一瞬间，射精感涌上了你的阴茎!
PRINTFORMW あなたはまるでお漏らししてしまったかのように射精してしまった…	PRINTFORMW 你就像失禁了一样射精了…
PRINTFORMW ズボンに大きな染みが広がる…	PRINTFORMW 裤子上有一片污渍在不断扩大…
PRINTFORMW 彼女が何かを一瞬唱えた瞬間。あなたの腰が砕けそうなほどの強烈な快感が押し寄せる!	PRINTFORMW 在她咏唱什么东西的一瞬间。从你的腰部传来了触电般的强烈快感!
PRINTFORMW あなたは膝立ちになりながらまるでお漏らししてしまったかのように潮と共に精液を漏らしながら絶頂した！	PRINTFORMW 保持着跪着的姿势，你像失禁了一样同时射精和高潮了！
PRINTFORMW スカートの下はびしょびしょになりながら床にも液体をぽたぽたと垂らしている…	PRINTFORMW 裙子下面已经湿透，各种液体滴答滴答地滴在床上…
PRINTFORMW あなたは膝立ちになりながらまるでお漏らししてしまったかのように潮を噴きながら絶頂した！	PRINTFORMW 保持着跪着的姿势，你像失禁了一样一边潮吹一边高潮了！
PRINTFORMW スカートの下はびしょびしょになりながら床にも潮をぽたぽたと垂らしている…	PRINTFORMW 裙子下面已经湿透，从小穴流出的液体滴答滴答地滴在床上…
PRINTFORMW 「欲求不満はこれで収まったかな？せめて時と場所は考えてね？」	PRINTFORMW 「欲求不满现在缓解一点了吗？至少要注意时间和场合呐？」
PRINTFORMW 「ごめん、もう疲れたよ。今日は%CNAME("一人称")%の身体で遊ぶのはやめてほしい。」	PRINTFORMW 「抱歉，我已经累了。希望今天不要玩弄%CNAME("一人称")%的身体了。」
PRINTFORMW 「え？%CNAME("一人称")%のクリトリスを弄り回したい？ベットの上でするとかじゃなくてただ弄りたいってこと？」	PRINTFORMW 「诶？想玩弄%CNAME("一人称")%的阴蒂？不是去床上做而是就直接就这么做？」
PRINTFORMW 「本気で言ってるの？」	PRINTFORMW 「你说这话是认真的吗？」
PRINTFORMW 「うん、まぁ、約束したからね。別触ってもいいよ。」	PRINTFORMW 「唔姆，嘛，必竟约定好了呢。给你摸一摸也可以哟。」
PRINTFORM %CALLNAME:PLAYER%は%CALLNAME:TARGET%の	PRINTFORM %CALLNAME:PLAYER%将
PRINTFORM %TEXTR("パンツの中に手を入れ/パンツの上に手を当て/パンツをずらし")%	PRINTFORM %TEXTR("手伸入了%CALLNAME:TARGET%的胖次里/手包在了%CALLNAME:TARGET%的胖次上/%CALLNAME:TARGET%的胖次挪開")%
PRINTFORMW 敏感な豆への愛撫を開始した。	PRINTFORMW 開始抚摸敏感的小豆豆。
PRINTFORM %CALLNAME:TARGET%は%CALLNAME:PLAYER%の%TEXTR("ローターの刺激/クリに這い回る指の動き/円を描くような愛撫/根元の刺激/軽く押しつぶす感覚/挟んで擦り上げる感覚")%を楽しみながら、	PRINTFORM %CALLNAME:PLAYER%%TEXTR("用跳蛋刺激阴蒂/用手指来回挑弄阴蒂/画圈圈一样进行爱抚/对阴蒂根部进行刺激/轻轻按压阴蒂/在狭缝里来回摩擦")%，%CALLNAME:TARGET%感到十分開心，
PRINTFORM %CALLNAME:TARGET%は%CALLNAME:PLAYER%の%TEXTR("ローターの刺激/クリに這い回る指の動き/円を描くような愛撫/根元の刺激/軽く押しつぶす感覚/挟んで擦り上げる感覚")%に反応し、	PRINTFORM %CALLNAME:PLAYER%%TEXTR("用跳蛋刺激阴蒂/用手指来回挑弄阴蒂/画圈圈一样进行爱抚/对阴蒂根部进行刺激/轻轻按压阴蒂/在狭缝里来回摩擦")%，%CALLNAME:TARGET%对此产生了反应，
PRINTFORMW 敏感な場所への強い刺激に%TEXTR("腰を浮かして/甘い声を上げて/悶えて/股を強く閉じて/%CALLNAME:PLAYER%の手を押さえて")%いる…	PRINTFORMW 同时由于敏感的场所受到强烈的刺激，%TEXTR("腰部也挺了起来/漏出了甘甜的声音/感到十分苦闷/大大地张開了双腿/用力摁住了%CALLNAME:PLAYER%的手")%…
PRINTFORMW %CALLNAME:TARGET%は%TEXTR("声を我慢しながら/膝をがくがくと揺らしながら/足をぴんと延ばしながら/甘い声を上げながら/%CALLNAME:PLAYER%の手を強く抑え押さえて")%%TEXTR("潮/尿")%を%TEXTR("まるで漏らすように/パンツに染みができる程度に/激しく")%出しながら絶頂した。	PRINTFORMW %CALLNAME:TARGET%%TEXTR("强忍着不发出声音/摇晃着颤抖的膝盖/将腿伸得直直的/发出甘甜的声音/将%CALLNAME:PLAYER%的手用力按住")%，一边%TEXTR("像是失禁一样/以会在胖次染上一大片污渍的程度/激烈地")%不停流出%TEXTR("潮水/尿液")%，一边高潮了。
PRINTFORMW 肩で息をしながら絶頂の余韻に浸り、膣からはまだ液体がちょろちょろと流れている…	PRINTFORMW 在肩膀上下起伏地呼吸着的同时沉浸在高潮的余韵里，液体像涓流一样从小穴内不断流出…
PRINTFORMW 「時と場所を考えてって言ったよね？」	PRINTFORMW 「希望你能注意一下时间和场所呐？」
PRINTFORMW 彼女が何かを一瞬唱えた瞬間。あなたのペニスに射精しそうな感覚が一気に込みあがる!	PRINTFORMW 在她咏唱什么东西的一瞬间，射精感涌上了你的阴茎!
PRINTFORMW あなたはまるでお漏らししてしまったかのように射精してしまった…	PRINTFORMW 你就像失禁了一样射精了…
PRINTFORMW ズボンに大きな染みが広がる…	PRINTFORMW 裤子上有一片污渍在不断扩大…
PRINTFORMW 彼女が何かを一瞬唱えた瞬間。あなたの腰が砕けそうなほどの強烈な快感が押し寄せる!	PRINTFORMW 在她咏唱什么东西的一瞬间。从你的腰部传来了触电般的强烈快感!
PRINTFORMW あなたは膝立ちになりながらまるでお漏らししてしまったかのように潮と共に精液を漏らしながら絶頂した！	PRINTFORMW 保持着跪着的姿势，你像失禁了一样同时射精和高潮了！
PRINTFORMW スカートの下はびしょびしょになりながら床にも液体をぽたぽたと垂らしている…	PRINTFORMW 裙子下面已经湿透，各种液体滴答滴答地滴在床上…
PRINTFORMW あなたは膝立ちになりながらまるでお漏らししてしまったかのように潮を噴きながら絶頂した！	PRINTFORMW 保持着跪着的姿势，你像失禁了一样一边潮吹一边高潮了！
PRINTFORMW スカートの下はびしょびしょになりながら床にも潮をぽたぽたと垂らしている…	PRINTFORMW 裙子下面已经湿透，从小穴流出的液体滴答滴答地滴在床上…
PRINTFORMW 「欲求不満はこれで収まったかな？せめて時と場所は考えてね？」	PRINTFORMW 「欲求不满现在缓解一点了吗？至少要注意时间和场合呐？」
PRINTFORMW 「ごめん、もう疲れたよ。今日は%CNAME("一人称")%の身体で遊ぶのはやめてほしい」	PRINTFORMW 「抱歉，我已经累了。希望今天不要玩弄%CNAME("一人称")%的身体呐」
PRINTFORMW 「え？%CNAME("一人称")%の膣を弄り回したい？入れたいわけじゃなくてただ膣内を弄りたいってこと？」	PRINTFORMW 「诶？想玩弄%CNAME("一人称")%的小穴？不是想要把那个东西放进去而只是想玩弄小穴？」
PRINTFORMW 「何がしたいのかよくわからないんだけど…」	PRINTFORMW 「虽然不知道你想做什么…」
PRINTFORMW 「うん、まぁ、約束したからね。いいよ。」	PRINTFORMW 「唔姆，嘛，毕竟约定好了呢，可以哟。」
PRINTFORM %CALLNAME:PLAYER%は%CALLNAME:TARGET%の	PRINTFORM %CALLNAME:PLAYER%将
PRINTFORM %TEXTR("パンツの中に手を入れ/パンツをずらし")%	PRINTFORM %TEXTR("手伸入%CALLNAME:TARGET%的胖次里/%CALLNAME:TARGET%的胖次挪開")%
PRINTFORMW 敏感な膣内の愛撫を開始した。	PRINTFORMW 開始爱抚敏感的小穴。
PRINTFORM %CALLNAME:TARGET%は%CALLNAME:PLAYER%の%TEXTR("クリと同時に攻めるバイブ/Gスポットを中心に刺激を与えるバイブ/膣の中をはい回る指/奥を中心に攻め立てるバイブ/うねるバイブ/Gスポットを擦り上げる指/Gスポットをかき回す指/奥をつつく指")%を楽しみながら、	PRINTFORM %CALLNAME:PLAYER%%TEXTR("使用振动棒按摩阴蒂/使用振动棒刺激G点/在小穴里不断蠕动手指/将振动棒插入小穴深处/用振动棒来回摩擦/用手指来回摩擦G点/用手指来回拨弄G点/用手指插入小穴深处")%，%CALLNAME:TARGET%感到開心，
PRINTFORM %CALLNAME:TARGET%は%CALLNAME:PLAYER%の%TEXTR("クリと同時に攻めるバイブ/Gスポットを中心に刺激を与えるバイブ/膣の中をはい回る指/奥を中心に攻め立てるバイブ/うねるバイブ/Gスポットを擦り上げる指/Gスポットをかき回す指/奥をつつく指")%をに反応し、	PRINTFORM %CALLNAME:PLAYER%%TEXTR("使用振动棒按摩阴蒂/使用振动棒刺激G点/在小穴里不断蠕动手指/将振动棒插入小穴深处/用振动棒来回摩擦/用手指来回摩擦G点/用手指来回拨弄G点/用手指插入小穴深处")%，%CALLNAME:TARGET%对此产生了反应，
PRINTFORMW 敏感な場所への強い刺激に%TEXTR("腰を浮かして/甘い声を上げて/悶えて/股を強く閉じて/%CALLNAME:PLAYER%の手を押さえて")%いる…	PRINTFORMW 同时由于敏感的场所受到强烈的刺激，%TEXTR("腰部也挺了起来/漏出了甘甜的声音/感到十分苦闷/大大地张開了双腿/用力摁住了%CALLNAME:PLAYER%的手")%…
PRINTFORMW 「ちょ、ちょっと！激しいって！もっと優しくしてよ！」	;PRINTFORMW 「ちょ、ちょっと！激しいって！もっと優しくしてよ！」
PRINTFORMW %CALLNAME:TARGET%は%TEXTR("声を我慢しながら/膝をがくがくと揺らしながら/足をぴんと延ばしながら/甘い声を上げながら/%CALLNAME:PLAYER%の手を強く抑え押さえて")%%TEXTR("潮/尿")%を%TEXTR("まるで漏らすように/パンツに染みができる程度に/激しく")%出しながら絶頂した。	PRINTFORMW %CALLNAME:TARGET%%TEXTR("强忍着不发出声音/摇晃着颤抖的膝盖/将腿伸得直直的/发出甘甜的声音/将%CALLNAME:PLAYER%的手用力按住")%，一边%TEXTR("像是失禁一样/以会在胖次染上一大片污渍的程度/激烈地")%不停流出%TEXTR("潮水/尿液")%，一边高潮了。
PRINTFORMW 肩で息をしながら絶頂の余韻に浸り、膣からはまだ液体がちょろちょろと流れている…	PRINTFORMW 在肩膀上下起伏地呼吸着的同时沉浸在高潮的余韵里，液体像涓流一样从小穴内不断流出…
PRINTFORMW %SAVESTR:デート%での%CALLNAME:TARGET%の反応	PRINTFORMW %SAVESTR:约会%での%CALLNAME:TARGET%の反応存疑
PRINTFORMW 「%CNAME("一人称")%にお願い？出来る事なら別に構わないけど…」	PRINTFORMW 「有想要拜托%CNAME("一人称")%的事？如果我能做到的话倒是没関系…」
PRINTFORMW 「%CNAME("一人称")%さ、多分%CNAME("二人称")%に拾われなければさ、多分どっかの偉い人の玩具として終わってたと思う。」	PRINTFORMW 「%CNAME("一人称")%呐，如果没有被%CNAME("二人称")%收养的话，现在大概已经变成某个有钱人的玩具了吧。」
PRINTFORMW 「でも、%CNAME("一人称")%は%CNAME("二人称")%のおかげで恋をし、愛す人もできた。」	PRINTFORMW 「但是，正因为有%CNAME("二人称")%在，%CNAME("一人称")%才能体验到恋爱，并且最终有了爱着的人。」
PRINTFORMW 「ありがとう。愛してる。」	PRINTFORMW 「谢谢，我爱你。」
PRINTFORMW 「ごめん。無理」	PRINTFORMW 「对不起，你是个好人」
PRINTFORMW 「%CNAME("一人称")%を拾ったことは本当に感謝している。けど%CNAME("二人称")%を愛しているわけじゃない」	PRINTFORMW 「%CNAME("一人称")%虽然对被收养一事非常感谢。但是我对%CNAME("二人称")%没有爱」
PRINTFORMW 「そもそも履いてないから無理」	PRINTFORMW 「说到底我根本没穿，所以不行」
PRINTFORMW 「いや、こんなもの渡してどうするのさ」	PRINTFORMW 「不行，况且你要这种东西有什么用」
PRINTFORMW 「…欲しいということは何かに使う気なんだろうけどさ。何に使うかは聞かないでおく」	PRINTFORMW 「…既然你想要就说明是想用在什么地方吧。你想用在什么地方说来给我听听」
PRINTFORMW 「予備ないからさ、洗っても履けないような状態にするのはやめてね？」	PRINTFORMW 「因为没有备用的，所以不要弄成即使洗了也不能穿的状态呐？」
PRINTFORMW 「また渡すの？」	PRINTFORMW 「还要给你吗？」
PRINTFORMW 「まぁいいけどさ。これってそんなに欲しくなるものなの？」	PRINTFORMW 「嘛，倒是没有関系，不过这东西有这么让你迷恋吗？」
PRINTFORMW 「%CNAME("一人称")%は%CNAME("二人称")%に体を許してるのに」	PRINTFORMW 「明明%CNAME("一人称")%都允许%CNAME("二人称")%玩弄我的身体了」
PRINTFORMW 「ここで渡すのは流石にやだ」	PRINTFORMW 「再怎么说也不能在这里脱下来给你吧」
PRINTFORMW 「やだ。」	PRINTFORMW 「不要。」
PRINTFORMW 「これ渡したらノーパンになること考えよう？ね？」	PRINTFORMW 「把这条胖次给你我就没有胖次能穿了哟？呐？」
PRINTFORMW 「無理」	PRINTFORMW 「不行」
PRINTFORMW 「そもそも弁当どころか料理した事すら無いんだけど」	PRINTFORMW 「别说是便当了，我根本连饭都没做过」
PRINTFORMW 「%CNAME("一人称")%、料理したことないんだけど…」	PRINTFORMW 「%CNAME("一人称")%虽然根本没做过料理…」
PRINTFORMW 頼むのは良いけど文句は言わないでよ?	PRINTFORMW 我可以给你做便当，但到时候可不要抱怨哦?
PRINTFORMW 「ピルあろうとなかろうと%CNAME("一人称")%は妊娠できないけど…」	PRINTFORMW 「口服避孕药什么的，%CNAME("一人称")%可是不会怀孕的体制哦…」
PRINTFORMW 「まぁいっか。%CNAME("二人称")%がピル代負担するなら別にいいよ。」	PRINTFORMW 「嘛，也行。只要你愿意承担药费的话那%CNAME("二人称")%也没什么関系。」
PRINTFORMW 「何これ？淫紋のように見えるけど？」	PRINTFORMW 「这是什么？看起来像是淫纹？」
PRINTFORMW 「これをお腹に貼れってことだよね？」	PRINTFORMW 「是把这个贴到肚子上吗？」
PRINTFORMW 「分かった。後で貼っとく」	PRINTFORMW 「我知道了，待会会贴上的」
PRINTFORMW 「はい。貼るんでしょ？」	PRINTFORMW 「好好，贴上吧？」
PRINTFORML 彼女は服をめくり上げた	PRINTFORML 她把衣服掀起来了
PRINTFORMW 「え？買い物？」	PRINTFORMW 「诶？买东西？」
PRINTFORMW 「少し待って、準備する。」	PRINTFORMW 「稍等，我准备一下。」
PRINTFORMW 「%CNAME("一人称")%もですか？」	PRINTFORMW 「%CNAME("一人称")%也要一起来吗？」
PRINTFORMW 「うぅ…%CNAME("一人称")%が入っていいお店ではないと思うんだけど…」	PRINTFORMW 「唔…%CNAME("一人称")%在想这是不是一家我可以进去的店…」
PRINTFORMW 「行ってらっしゃい。ローションがないので忘れずに買ってきてね？」	PRINTFORMW 「一路顺风，话说润滑液已经用光了别忘了买哦？」
PRINTFORMW 「コンドームがないよ。必要なときになかったら大変だから絶対買い忘れないでね？」	PRINTFORMW 「已经没有安全套了。如果哪天必须用到的时候没有就糟了，所以绝对不要忘了买哦？」
PRINTFORMW 「行ってらっしゃい。絆創膏がないので買ってきてくれると嬉しいな」	PRINTFORMW 「一路顺风，话说创可贴已经用光了，如果能再买些的话我会很高兴的呐」
PRINTFORMW 「%CNAME("二人称")%にお金渡すから買って来てってこと？」	PRINTFORMW 「把钱给%CNAME("二人称")%，然后去买东西？」
PRINTFORML 「え？欲しいもの？」	PRINTFORMW 「诶？想要的东西？」
PRINTFORML 「ローションがないみたいなのでこれを買わない？」	PRINTFORMW 「因为已经没有润滑液了所以买些怎么样？」
PRINTFORML 「初めての人にはこれを使うといいみたいだよ。」	PRINTFORMW 「对于刚開始的人来说使用这个或许会比较好。」
PRINTFORML 「コンドームがないよ。%CNAME("一人称")%は生でいいけど、先輩たちに生でするなんて駄目だよ。安全日だからって言い訳してないで必ずゴムはつけてね？」	PRINTFORMW 「安全套已经用光了。虽然对%CNAME("一人称")%来说没什么问题，但对前辈们来说这样就不行了吧。不能因为是安全日所以就找借口，一定要好好戴上安全套呐？」
PRINTFORML 「絆創膏がないよ。備えあれば患いなし。怪我をするような部活ではないけどあって損はないと思う」	PRINTFORMW 「创可贴已经用光了。有备无患，虽然是不会受伤的社团活动，但是多准备一些还是没有损失的」
PRINTFORML 「う～ん、今は無いかな」	PRINTFORMW 「唔～嗯，现在没有想要的东西呐」
PRINTFORMW 「良く分からないから適当なもの買って来たけど…これでよかった？」	 PRINTFORMW 「因为不是很清楚所以就适当的都买了一些回来…这样可以吗？」
PRINTFORMW 「はい、%CNAME("二人称")%のよりちょっと大きいの買ってきたよ。これより小さいのは見つからなかった。」	PRINTFORMW 「给，我买来了比%CNAME("二人称")%的那个稍微大一些的，没找到比这个更小的呐。」
PRINTFORMW 「そもそも、小さいとはいえ自分のがあるのにこれ使うなんて虚しくないの？」	PRINTFORMW 「话说、虽然自己长着的比这个小了一点，但是用这种东西难道不会感到空虚吗？」
PRINTFORMW 「まぁ、%CNAME("一人称")%は%CNAME("二人称")%の小さいの好きだけどね。デカくても苦しいだけだと思うし。」	PRINTFORMW 「嘛、%CNAME("一人称")%倒是更喜欢%CNAME("二人称")%的小一点的呐，我觉得就算更大也只会更痛苦呢。」
PRINTFORMW 「…今の%CNAME("一人称")%は大丈夫だけどさ…最初は苦しかったし。」	PRINTFORMW 「…虽然现在的%CNAME("一人称")%已经没问题了…最開始的时候可是吃了不少苦头呢。」
PRINTFORMW 「はい、ちっさいの買ったよ。」	PRINTFORMW 「给，我买来了稍微小一点的哟。」
PRINTFORMW 「自分のが女の子に入らないのは分かるけどさ、これ使って虚しくならないの？」	PRINTFORMW 「虽然我知道自己和普通的女孩子不太一样，不过使用这种东西难道不会感到空虚吗？」
PRINTFORMW 「はい、%CNAME("二人称")%のより小さいの買ってきた。」	PRINTFORMW 「给，我买来了比%CNAME("二人称")%的那个稍微小一点的哟。」
PRINTFORMW 「おっきくても苦しいだけだよ？」	PRINTFORMW 「就算更大也只会更痛苦哟？」
PRINTFORMW 「…今の%CNAME("一人称")%は大丈夫だけどさ…最初は苦しかったし。」	PRINTFORMW 「…虽然现在的%CNAME("一人称")%已经没问题了…最開始的时候可是吃了不少苦头呢。」
PRINTFORMW 「自分のがあるんだしこれいらないと思うんだけど…」	PRINTFORMW 「反正自己也长着，我想应该不需要这种东西…」
PRINTFORMW 「とりあえず買うのはいいけどさ、部室にはいろんな人がいるわけだし、お尻に入れられても知らないよ？」	PRINTFORMW 「总之既然已经买来了所以就算了，部室里有很多人，被捅到屁股里我可不管哟？」
PRINTFORMW 「はい、買ってきたよ。」	PRINTFORMW 「给，我买来了哟。」
PRINTFORMW 「はい、一番分厚いの買ってきた」	PRINTFORMW 「给，我把最厚的那个买回来了」
//文件: EVENT_K47_リディア.ERB
LOCALS = リディア_りでぃあ	LOCALS = 莉迪亚_りでぃあ
LOCALS = 私_わたし	LOCALS = 私_我
LOCALS = %CALLNAME:MASTER%さん_%CALLNAME:MASTER%さん	LOCALS = %CALLNAME:MASTER%桑_%CALLNAME:MASTER%桑
LOCALS = 君_きみ	LOCALS = 君_你
LOCALS = %CALLNAME:PLAYER%くん_%CSTR:PLAYER:ふりがな%くん	LOCALS = %CALLNAME:PLAYER%君_%CALLNAME:PLAYER%君
LOCALS = %CALLNAME:PLAYER%ちゃん_%CSTR:PLAYER:ふりがな%ちゃん	LOCALS = %CALLNAME:PLAYER%酱_%CALLNAME:PLAYER%酱
LOCALS = %CALLNAME:PLAYER%先生_%CSTR:PLAYER:ふりがな%せんせい	LOCALS = %CALLNAME:PLAYER%老师_%CALLNAME:PLAYER%老师
IF TALENT:PLAYER:オトコ	IF TALENT:PLAYER:男性
LOCALS = %CALLNAME:PLAYER%くん_%CSTR:PLAYER:ふりがな%くん	LOCALS = %CALLNAME:PLAYER%君_%CALLNAME:PLAYER%君
LOCALS = %CALLNAME:PLAYER%ちゃん_%CSTR:PLAYER:ふりがな%ちゃん	LOCALS = %CALLNAME:PLAYER%酱_%CALLNAME:PLAYER%酱
LOCALS = %CALLNAME:PLAYER%さん_%CSTR:PLAYER:ふりがな%さん	LOCALS = %CALLNAME:PLAYER%桑_%CALLNAME:PLAYER%桑
LOCALS = ご主人様_ごしゅじんさま	LOCALS = 主人様_主人大人
SELECTCASE CSTR:ASSI:学年	SELECTCASE CSTR:PLAYER:学年
IF TALENT:ASSI:オトコ	IF TALENT:PLAYER:男性
LOCALS = %CALLNAME:ASSI%くん_%CSTR:ASSI:ふりがな%くん	LOCALS = %CALLNAME:PLAYER%君_%CALLNAME:PLAYER%君
LOCALS = %CALLNAME:ASSI%ちゃん_%CSTR:ASSI:ふりがな%ちゃん	LOCALS = %CALLNAME:PLAYER%酱_%CALLNAME:PLAYER%酱
LOCALS = %CALLNAME:ASSI%先生_%CSTR:ASSI:ふりがな%せんせい	LOCALS = %CALLNAME:PLAYER%老师_%CALLNAME:PLAYER%老师
IF TALENT:ASSI:オトコ	IF TALENT:PLAYER:男性
LOCALS = %CALLNAME:ASSI%くん_%CSTR:ASSI:ふりがな%くん	LOCALS = %CALLNAME:PLAYER%君_%CALLNAME:PLAYER%君
LOCALS = %CALLNAME:ASSI%ちゃん_%CSTR:ASSI:ふりがな%ちゃん	LOCALS = %CALLNAME:PLAYER%酱_%CALLNAME:PLAYER%酱
LOCALS = %CALLNAME:ASSI%さん_%CSTR:ASSI:ふりがな%さん	LOCALS = %CALLNAME:PLAYER%桑_%CALLNAME:PLAYER%桑
LOCALS = %CALLNAME:MASTER%さん_%CALLNAME:MASTER%さん	LOCALS = %CALLNAME:MASTER%桑_%CALLNAME:MASTER%桑
LOCALS = %CALLNAME:MASTER%_%CALLNAME:MASTER%	LOCALS = %CALLNAME:MASTER%_%CALLNAME:MASTER%
LOCALS = 君_きみ	LOCALS = 君_你
LOCALS = %CALLNAME:MASTER%さん_%CALLNAME:MASTER%さん	LOCALS = %CALLNAME:MASTER%桑_%CALLNAME:MASTER%桑
LOCALS = %CALLNAME:MASTER%_%CALLNAME:MASTER%	LOCALS = %CALLNAME:MASTER%_%CALLNAME:MASTER%
LOCALS = 君_きみ	LOCALS = 君_你
LOCALS = %CALLNAME:ACTOR%先生_%CSTR:ACTOR:ふりがな%せんせい	LOCALS = %CALLNAME:ACTOR%老师_%CALLNAME:ACTOR%老师
LOCALS = %CALLNAME:ACTOR%くん_%CSTR:ACTOR:ふりがな%くん	LOCALS = %CALLNAME:ACTOR%君_%CALLNAME:ACTOR%君
LOCALS = %CALLNAME:ACTOR%ちゃん_%CSTR:ACTOR:ふりがな%ちゃん	LOCALS = %CALLNAME:ACTOR%酱_%CALLNAME:ACTOR%酱
LOCALS = %CALLNAME:ACTOR%くん_%CSTR:ACTOR:ふりがな%くん	LOCALS = %CALLNAME:ACTOR%君_%CALLNAME:ACTOR%君
LOCALS = %CALLNAME:ACTOR%ちゃん_%CSTR:ACTOR:ふりがな%ちゃん	LOCALS = %CALLNAME:ACTOR%酱_%CALLNAME:ACTOR%酱
LOCALS = %CALLNAME:ACTOR%さん_%CSTR:ACTOR:ふりがな%さん	LOCALS = %CALLNAME:ACTOR%桑_%CALLNAME:ACTOR%桑
STR:1 = 研究室で実験用生物として肉体改造された少女	PRINTFORML 在研究所里作为做实验用生物而被进行了肉体改造的少女
STR:2 = 脱走し、彷徨った果てに%CALLNAME:MASTER%の元へたどり着いた	PRINTFORML 从研究所逃脱，在彷徨的尽头遇到了%CALLNAME:MASTER%
PRINTFORMW 学校から自宅へ帰る途中、何か視線を感じる…	PRINTFORMW 从学校回家的途中，感觉到了某种视线…
PRINTFORMW そう思った瞬間、いきなり目の前に現れた猫耳少女に押し倒された。	PRINTFORMW 在这么思考的瞬间，突然就被出现在眼前的猫耳少女给推倒了。
PRINTFORMW 何かに飢えたような表情を浮かべる彼女に恐怖を覚えもがくあなたとあなたを抑えようとする彼女。	PRINTFORMW 被她浮现出的饥渴的表情所吓到，你挣扎着想要逃開，而她一直按住着想要逃開的你。
PRINTFORMW 一瞬が一時間にも感じるような取っ組み合いを続け…	PRINTFORMW 仿佛每个瞬间都像一小时那么漫长，你们两人扭抱成一团…
CALL PRINT_STRW, "「んんーッ_WH_……」"	CALL PRINT_STRW, "「唔嗯~_WH_……」"
PRINTFORMW 何かを我慢してるような声と共に何かの苦しみから逃れるようにあなたに抱き着いてきた	PRINTFORMW 像是在努力忍耐着什么，同时也像是想要逃离什么似的，她紧紧地抱住了你，
PRINTFORMW 一瞬の時が過ぎた後に漂う淫臭。	PRINTFORMW 你当即就闻到了散发出来的淫靡的气味。
PRINTFORMW そして貴方の股間周囲はグッショリ濡らされ、	PRINTFORMW 你股间周围直接湿透了
PRINTFORMW 呼吸すらままならない彼女を引きはがすとあなたの目に映ったのは、	PRINTFORMW 当你把呼吸变得困难的她从你的身上拉開之后，映入你的眼帘的是、
PRINTFORMW 彼女の下腹部に輝く紋章。	PRINTFORMW 在她的下腹部上闪烁的纹章。
PRINTFORMW 淫紋、といわれて誰もが疑わないものだった。	PRINTFORMW 显而易见，是淫纹。
PRINTFORMW そこに手を触れると彼女は再び身をくねらせた。	PRINTFORMW 用手稍微触碰一下淫纹，她的身体又扭动起来。
PRINTFORMW どうやら取っ組み合い中にこの紋章に触れてしまったらしい。	PRINTFORMW 看来是刚才扭抱在一起的时候不小心碰到了淫纹。
PRINTFORMW 彼女のボロボロの服装を見る限り浮浪者であると判断したあなたは余韻に浸ってる彼女をそのまま連れて帰り、風呂に入れてやることにした。	PRINTFORMW 从她身上破破烂烂的衣服可以看出来她应该在街上流浪很久了、于是你把沉浸在余韵的她带回了家、给她洗了个澡。
PRINTFORML とりあえず風呂場で彼女のありとあらゆる液体を流し終え、	PRINTFORML 总之先在浴室里把她身上的各种液体都冲洗干净了、
PRINTFORMW 近くにあったコスプレ用のチャイナ服を着せたあなたは、なぜ自分を襲ったのか聞いた	PRINTFORMW 你给她穿上身边的用来cosplay的旗袍、询问她为什么要袭击自己
PRINTFORMW どうやら彼女は研究室で実験動物並みの扱いを受けていたようだ。	PRINTFORMW 看来她在研究所里被当做普通的实验动物对待
PRINTFORML それが嫌になって脱走したはいいもの研究所で与えられていた血液が欲しくて欲しくてたまらなくなりあなたを襲ったようだ	PRINTFORML 讨厌被当成研究动物对待，所以她从研究所逃脱了，但是由于想喝血液想喝得不得了，所以袭击了你
PRINTFORMW 「それであの…さっきはごめんなさい…何でもしますので血を少し分けてくれませんか…お願いします…本当に何でもします…」	PRINTFORMW 「然后那个…刚刚的事情对不起…我什么都愿意做，所以能把你的血液分一些给我吗…拜托了…我真的什么都愿意去做…」
PRINTFORML なんでもしてくれるみたいなので住むところと血を少し分けてやることにした。	PRINTFORML 她似乎什么都愿意做的样子，所以你给了她住所，并将少量的血液分给了她。
PRINTFORMW 「ありがとうございます。」	PRINTFORMW 「真的十分感谢。」
PRINTFORMW そういうと彼女はあなたに抱きつき何かよくわからない言葉をしゃべった後首元に噛みついてきた	PRINTFORMW 她这么说完之后抱住了你，咏唱了什么完全听不懂的咒语，之后朝着你的后脖子咬了上去
PRINTFORMW 先ほど唱えた言葉が故か痛みこそないが彼女の甘い香りと共に頭がボーっとしてくる…	PRINTFORMW 或许是因为她之前咏唱的咒语的缘故，你完全感受不到疼痛，一边闻着她身上散发出来的甜甜的香气，你的头脑渐渐变得昏沉…
PRINTFORMW 彼女の唇が首から離れると何故か血こそ出なかったものの、貧血であなたはふらふらしたまま一日を過ごすのであった…	PRINTFORMW 当她的唇离開你的脖子时、不知为何完全没有血流出来，你由于贫血摇摇晃晃地度过了一天…
CALL PRINT_STRW, @"%CALLNAME:MASTER%は%CALLNAME:TARGET%から_イエロー_[キス][アナルセックス][呼び出しＨ][性処理]_の合意を得た。"	CALL PRINT_STRW, @"%CALLNAME:MASTER%从%CALLNAME:TARGET%那里获得了_イエロー_[接吻][肛門性交][叫出来Ｈ][性処理]_的许可。"
PRINTFORMW %NAME:TARGET%は居候として "同棲中" となります。	PRINTFORMW %NAME:TARGET%以借住的形式，变成 "同居中" 了。
PRINTFORMW %NAME:TARGET%は認識阻害の魔法を使って学校にもやってきます	PRINTFORMW %NAME:TARGET%能使用阻碍认知的魔法，所以也可以去学校
PRINTFORML ベットと扇風機。そして普通の生活をするのに必要な衣装すら入るか怪しい小さな箱が一つ置かれている	PRINTFORML 床和电风扇，以及一个奇怪的小盒子，里面放着日常生活所需的衣服。
PRINTFORML 掃除することはほとんどないのか部屋の隅には埃が多く残ってる	PRINTFORML 由于几乎没怎么打扫过，房间的角落里堆积着很多灰尘。
PRINTFORML …敷布団掛布団共に干されてる事を見たことはないが大丈夫なのだろうか？	PRINTFORML …从来没见过她晾晒被子和褥子，真的没有问题吗？
PRINTFORMW 「ちょっと待って」	PRINTFORMW 「稍微等一下」
PRINTFORMW 「先にお手洗い行きたいんだけど…」	PRINTFORMW 「我想先去一趟洗手间…」
PRINTFORMW 「今始めると途中で漏らしそうだし…」	PRINTFORMW 「如果现在開始的话说不定途中会漏出来…」
CALL PRINT_SELECT, "トイレに行かせてあげる/トイレに行かせてあげない/口の中に出してもらう"	CALL PRINT_SELECT, "让她去厕所/不让她去厕所/就这么尿在我的嘴里吧"
PRINTFORMW 「ありがとう。じゃあ行ってくるね」	PRINTFORMW 「谢谢。那么让我们開始吧」
PRINTFORMW 「え、なんで駄目なの？漏らしそうなのに…」	PRINTFORMW 「诶、为什么不行？明明已经快要漏出来了…」
PRINTFORMW 「うぅ…漏らしても知らないからね？」	PRINTFORMW 「唔…漏出来了我可不管呐？」
PRINTFORMW 「え？本気で言ってるの？」	PRINTFORMW 「诶？你说这话是认真的吗？」
PRINTFORMW 「うぅ…分かった。何でもするって約束したし…」	PRINTFORMW 「唔…我知道了。毕竟约定好了什么都会去做了…」
PRINTFORMW 「口の中に出すんだよね？横になって。跨るから」	PRINTFORMW 「尿在嘴里对吧？躺下吧，我会跨上去的」
PRINTFORMW 横になった%CALLNAME:MASTER%の頭の上に顔を真っ赤にした%CALLNAME:TARGET%が跨った。	PRINTFORMW 脸变得通红的%CALLNAME:TARGET%跨坐在%CALLNAME:MASTER%的头上。
PRINTFORMW 「何時になったら出すのかって、少し待ってよ！流石に恥ずかしんだから！」	PRINTFORMW 「你问什么时候尿出来？再等一等呐！这实在是羞耻死了！」
PRINTFORMW 「ほんとに出すからね！やめるなら今だよ！」	PRINTFORMW 「我真的要尿出来了呐！想要停下就只能趁现在了哟！」
PRINTFORMW そう言われても何も反応がない%CALLNAME:MASTER%を見てついに%CALLNAME:TARGET%は覚悟を決めた	PRINTFORMW 看着没有任何反应的%CALLNAME:MASTER%，%CALLNAME:TARGET%终于下定了决心
PRINTFORMW 「んっ……あっ……」	PRINTFORMW 「嗯……啊……」
PRINTFORMW 声を漏らすと同時にありえないところに排泄する罪悪感に震えながら%CALLNAME:MASTER%の口の中に放尿した。	PRINTFORMW 由于在这种莫名其妙的地方排泄，产生的罪恶感使莉迪亚浑身颤抖，漏出了声音的同时朝%CALLNAME:MASTER%的口中尿了出来。
PRINTFORMW 「何でもするって約束したし、いいよ。大丈夫」	PRINTFORMW 「已经约定好了什么都会做的、可以哟，没问题」
PRINTFORMW 「じゃあ、初めよっか。するんでしょ？。%TEXTR("小作り/妊娠するまで")%。」	PRINTFORMW 「那么、让我们開始吧。要做爱对吧？%TEXTR("要生孩子对吧？/要做到怀孕对吧？")%。」
PRINTFORMW 「じゃあ、初めよっか。するんでしょ？」	PRINTFORMW 「那么、让我们開始吧。要做爱对吧？」
PRINTFORMW 「見た感じ一回もイってないけどいいの？」	PRINTFORMW 「我看到你一次也没去过，没関系吗？」
PRINTFORMW 「満足した？」	PRINTFORMW 「满足了吗？」
PRINTFORMW 「ちょっと、ねえ、起きてよ、お願いだから、目を覚ましてよ！」	PRINTFORMW 「等等、呐、快起来、求求你了、快张開眼睛呐！」
PRINTFORMW 「ムラムラは収まった？まぁ答える余裕もないよねぇ？」	PRINTFORMW 「性兴奋平息了吗？看样子还没有回答的余裕呢？」
PRINTFORMW 「%CNAME("二人称")%が答えなくても、ここが答えてるから別に言わなくてもいいけどね。」	PRINTFORMW 「即使%CNAME("二人称")%不回答、这里已经好好地回答了，所以不说话也没有関系呐。」
PRINTFORMW そう言って彼女は%TEXTR("息も絶え絶えな/抵抗できない")%%CALLNAME:PLAYER%のしなびたペニスを弄って楽しんでいる…	PRINTFORMW 她一边这么说着，一边開心地玩弄着%TEXTR("奄奄一息/无法抵抗")%的%CALLNAME:PLAYER%的干瘪的阴茎…
PRINTFORMW 「でも%CNAME("一人称")%は満足してないから少しここ、借りるね？」	PRINTFORMW 「不过%CNAME("一人称")%还没有满足，所以这里在借我一会呐？」
PRINTFORMW そう言うと彼女はあなたにまたがり満足するまでペニスに素股を続けた…	PRINTFORMW 她一边这么说着，一边用双腿夹住你的阴茎在股间摩擦，直到她满足为止…
PRINTFORMW 「あ、出た。もしかして動けないだけでまだ出せるの？」	PRINTFORMW 「啊、射精了。难道就算身体不能动，也能射精吗？」
PRINTFORMW %CALLNAME:PLAYER%は否定の言葉すら上げられぬまま望まぬ射精を繰り返した…	PRINTFORMW %CALLNAME:PLAYER%连否定都做不到，违背自己的意愿反复地射精…
PRINTFORMW そう言って彼女は%TEXTR("息も絶え絶えな/抵抗できない")%%CALLNAME:PLAYER%の%TEXTR("縮んだクリトリス/乳首")%を弄って楽しんでいる…	PRINTFORMW 她一边这么说着，一边開心地玩弄着%TEXTR("气息奄奄/抵抗不了")%的%CALLNAME:PLAYER%的%TEXTR("收缩的阴蒂/乳头")%…
PRINTFORMW そう言って彼女は%TEXTR("息も絶え絶えな/抵抗できない")%%CALLNAME:PLAYER%の%TEXTR("縮んだクリトリス/乳首/膣内")%を弄って楽しんでいる…	PRINTFORMW 她一边这么说着，一边開心地玩弄着%TEXTR("气息奄奄/抵抗不了")%的%CALLNAME:PLAYER%的%TEXTR("收缩的阴蒂/乳头/小穴深处")%…
PRINTFORMW 「ねえ、無理しすぎじゃない？」	PRINTFORMW 「呐、是不是有点太过勉强了？」
PRINTFORMW 「%CNAME("二人称")%はいつでも大丈夫なんだからそんなに無理する必要ないと思うけど…？」	PRINTFORMW 「什么时候想和%CNAME("二人称")%做都可以，所以不用这么勉强也行哟…？」
PRINTFORMW 「触りたいの？いいよ。」	PRINTFORMW 「想要摸摸吗？可以的哟。」
PRINTFORMW 「い、イキそう…」	PRINTFORMW 「要、要去了」
CALL PRINT_STRW, @"「ま、待ってよ、これ以上擦られたら、あっ_HH_やだ_HH_激し_HH_き、来ちゃう_HH_」"	PRINTFORMW 「等、等一下、再摩擦那里的话、啊_HH_讨厌_HH_太_HH_激烈、去了_HH_」
PRINTFORMW 「んっ、もっと激しくしても大丈夫だよ」	PRINTFORMW 「嗯、再激烈一点也没关系的哟」
PRINTFORMW 「ちょ、激しい、優しくしてよ！」	PRINTFORMW 「等、太用力了、温柔一点呀！」
PRINTFORMW 「先っぽがじんじんする…」	PRINTFORMW 「滋滋地在摩擦…」
PRINTFORMW 「お腹、撫でられると気持ちいい、もっと、してほしいな」	PRINTFORMW 「肚子、被摸感觉、很舒服、再摸、想要再被摸一会」
PRINTFORMW 「うん、気持ちいいよ」	PRINTFORMW 「唔嗯、很舒服哟」
PRINTFORMW 「ねぇ…まさかそこ舐める気じゃないよね…？」	PRINTFORMW 「呐…你该不是想舔这个地方吧…？」
PRINTFORMW 「いくら何でもそこ舐めたら病気になるかもしれないし困るのは%CNAME("二人称")%だと思うんだけど…」	PRINTFORMW 「再怎么讲也不太好吧，舔这个地方可能会生病，况且也只有%CNAME("二人称")%会感到难堪…」
PRINTFORMW 「次するときから前もってキレイにするから今日は止めてほしい」	PRINTFORMW 「下次做之前我会事先好好洗干净的，所以今天就别这么做了呐」
PRINTFORMW …アナル舐めをやめる？	PRINTFORMW …不要舔屁股洞，好吗？
CALL PRINT_SELECT, "やめない/考え直す/むしろ汚れてるのが良い"	CALL PRINT_SELECT, "执迷不悟/再考虑一下/倒不如说越脏越好"
PRINTFORMW 「うぅ…病気になっても知らないからね？」	PRINTFORMW 「唔…要是生病了我可不管哟？」
PRINTFORMW 「…ありがとね」	PRINTFORMW 「…谢谢」
PRINTFORMW 「…え？」	PRINTFORMW 「…诶？」
PRINTFORMW 「%CNAME("一人称")%は病気になっても知らないからね！責任取れないよ！」	PRINTFORMW 「就算%CNAME("一人称")%生病了我也不管呐！我不会负责的哟！」
PRINTFORMW 「%CNAME("一人称")%の処女、あげる。」	PRINTFORMW 「%CNAME("一人称")%的处女、给你。」
PRINTFORMW 「代わりに%CNAME("二人称")%の童貞、貰うね」	PRINTFORMW 「作为交换%CNAME("二人称")%的童貞、%CNAME("一人称")%收下了」
PRINTFORMW 「いいよね？あげたいから、受け取って。」	PRINTFORMW 「可以的吧？因为想要给你、所以请收下吧。」
PRINTFORMW 「この時まで%CNAME("一人称")%の処女、残してくれてありがとね。」	PRINTFORMW 「能够让%CNAME("一人称")%的処女、保留到现在、非常感谢。」
PRINTFORMW 「残してくれたから、今愛してる%CNAME("二人称")%に捧げる幸せを感じることが出来る。%CNAME("一人称")%、嬉しい。」	PRINTFORMW 「因为留到了现在、所以能够感觉到将最重要的东西献给最爱的%CNAME("二人称")%的幸福感。%CNAME("一人称")%、很开心。」
PRINTFORMW 「%CNAME("一人称")%、居候の身で何もできないから…せめていっぱい気持ち良くなってね。%CNAME("一人称")%のことは気にしないで激しくしても大丈夫だよ」	PRINTFORMW 「%CNAME("一人称")%明明借居在这里，却什么都做不到…至少要让你感觉舒服呐。不用在意%CNAME("一人称")%，激烈一点也没问题哟」
PRINTFORMW 「%CNAME("一人称")%、居候の身で何もできないから…せめて生でいっぱい気持ち良くなってね。%CNAME("一人称")%のことは気にしないで激しくしても大丈夫だよ」	PRINTFORMW 「%CNAME("一人称")%明明借居在这里，却什么都做不到…至少要好好地让你感觉舒服呐。不用在意%CNAME("一人称")%，激烈一点也没问题哟」
PRINTFORMW 「…ごめん、何がしたいのかよくわからない。」	PRINTFORMW 「…抱歉、不是很清楚应该做些什么。」
PRINTFORMW 「…ごめん、何がしたいのかよくわからない。」	PRINTFORMW 「…抱歉、不是很清楚应该做些什么。」
PRINTFORMW 「か、体が…熱い！」	PRINTFORMW 「身体…好热！」
PRINTFORMW 「%CNAME("二人称")%、この薬本当に大丈夫なの！？」	PRINTFORMW 「%CNAME("二人称")%、这个药、真的没有问题吗！？」
PRINTFORMW 「はいはい、抵抗しても無駄だから、諦めてね。」	PRINTFORMW 「抵抗也是没有任何用的、所以快点乖乖放弃吧。」
PRINTFORMW 「バイブ使う気なのはいいけどさ、%CNAME("一人称")%、たぶん処女だよ?」	PRINTFORMW 「想用振动棒倒是没问题、可是%CNAME("一人称")%大概还是处女的哟?」
PRINTFORMW 「記憶にある限りでは男性経験ないし」	PRINTFORMW 「至少在我的记忆里没有和男性做过的经历」
PRINTFORMW 「%CNAME("一人称")%、%CNAME("二人称")%の勃起してるそれ挿入れても大丈夫だよ？」	PRINTFORMW 「%CNAME("一人称")%想、%CNAME("二人称")%把你正在勃起的那个东西插进来也没问题哟？」
PRINTFORMW 「男って自分のペニスに処女を捧げられる事に至福を感じる人だと思ってたけど%CNAME("二人称")%は違うの？」	PRINTFORMW 「男人用自己的阴茎夺走处女时应该会感觉很幸福，难道%CNAME("二人称")%不是这样吗？」
PRINTFORMW 「後、それはどう考えても入らない。%CNAME("二人称")%は童貞だから分からないのかもしれないけど、入れるならせめて自分についてるそれにして欲しい」	PRINTFORMW 「况且、再怎么想也放不进来吧。因为%CNAME("二人称")%是处男所以不了解、如果要放进来的话，至少想用长在%CNAME("二人称")%身上的那个呐」
PRINTFORMW 「後、それはどう考えても入らない。まさかねじ込むつもりじゃないよね？どう考えても怪我すると思うんだけど」	PRINTFORMW 「况且、再怎么想也放不进来吧。难道想把这东西捅到我的身体里吗？怎么想都会受伤的吧」
PRINTFORMW …バイブで処女を奪うのをやめる？	PRINTFORMW …不要用振动棒夺走我的处女，好吗？
CALL PRINT_SELECT, "やめない/考え直す"	CALL PRINT_SELECT, "执迷不悟/回头是岸"
PRINTFORMW 「ねぇ…まさかそこ舐める気じゃないよね…？」	PRINTFORMW 「呐…你该不是想舔这个地方吧…？」
PRINTFORMW 「いくら何でもそこ舐めたら病気になるかもしれないし困るのは%CNAME("二人称")%だと思うんだけど…」	PRINTFORMW 「再怎么讲也不太好吧，舔这个地方可能会生病，况且也只有%CNAME("二人称")%会感到难堪…」
PRINTFORMW 「次するときから前もってキレイにするから今日は止めてほしい」	PRINTFORMW 「下次做之前我会事先好好洗干净的，所以今天就别这么做了呐」
PRINTFORMW …アナル舐めをやめる？	PRINTFORMW …不要舔屁股洞，好吗？
CALL PRINT_SELECT, "やめない/考え直す/むしろ汚れてるのが良い"	CALL PRINT_SELECT, "执迷不悟/再考虑一下/倒不如说越脏越好"
PRINTFORMW 「うぅ…病気になっても知らないからね？」	PRINTFORMW 「唔…要是生病了我可不管哟？」
PRINTFORMW 「…ありがとね」	PRINTFORMW 「…谢谢」
PRINTFORMW 「…え？」	PRINTFORMW 「…诶？」
PRINTFORMW 「%CNAME("一人称")%は病気になっても知らないからね！責任取れないよ！」	PRINTFORMW 「就算%CNAME("一人称")%生病了我也不管呐！我不会负责的哟！」
PRINTFORMW 「お尻でしたいの?…」	PRINTFORMW 「想用屁股来做吗?…」
PRINTFORMW 「%CNAME("一人称")%、お尻でする準備してないよ？」	PRINTFORMW 「%CNAME("一人称")%还没有做好用屁股做的准备哟？」
PRINTFORMW 「%CNAME("二人称")%が病気になったら大変だし、次から準備するから今日は止めてほしい」	PRINTFORMW 「%CNAME("二人称")%要是生病就不好了、从下次開始会好好准备的，所以这次就不要这么做了呐」
CALL PRINT_SELECT, "やめない/考え直す/準備なんかしちゃダメ"	CALL PRINT_SELECT, "坚持要做/再考虑考虑/不许做准备什么的"
PRINTFORMW 「うぅ…病気になっても知らないからね？」	PRINTFORMW 「唔…要是生病了我可不管哟？」
PRINTFORMW 「…ありがとね」	PRINTFORMW 「…谢谢」
PRINTFORMW 「…え？」	PRINTFORMW 「…诶？」
PRINTFORMW 「%CNAME("一人称")%は病気になっても知らないからね！責任取れないよ！」	PRINTFORMW 「就算%CNAME("一人称")%生病了我也不管呐！我不会负责的哟！」

//@KOJO_ENDCOM_K47 @KOJO_ENDCOM_K47, ARG
PRINTFORMW 「あ、あれ？、反応ないけど大丈夫？」	PRINTFORMW 「啊、嗯？连反应都没有了，你还好吗？」
PRINTFORMW 彼女は肩をゆすって正気に戻してきた…	PRINTFORMW 她摇晃着你的肩膀直到你恢复清醒…
PRINTFORMW 「あ、起きた、おはよう。」	PRINTFORMW 「啊、醒了吗、早上好。」
PRINTFORMW 「あ、ゴム付けてくれるんだ…」	PRINTFORMW 「啊、你戴上安全套了呐…」
PRINTFORMW 「%CNAME("一人称")%研究所で避妊の護符ってもの付けられたから生でも大丈夫だと思うよ？」	PRINTFORMW 「%CNAME("一人称")%在研究所被刻上了避孕的护符，所以直接插进来也没问题哟？」
PRINTFORMW 「少し後片付けが面倒だと思うけど…」	PRINTFORMW 「虽然事后清理会很麻烦就是了…」
CALL PRINT_SELECT, "それでも着ける/お言葉に甘えて生挿入！"	CALL PRINT_SELECT, "即便如此也要戴着/果然还是直接插入！"
PRINTFORMW 「良いの？うん、分かった。ありがとね」	PRINTFORMW 「这样吗？唔嗯、我知道了。谢谢你呐」